,idDBLP,idScholar,Scholar_Match,DBLP_Match,MatchId
0,conf/sigmod/epstein95,,65893,1634,67527
1,,bv48iknfbb8j,9556,9557,19113
2,,url:http://portal.acm.org/ft_gateway.cfm3fid3d60187926type3dpdf26dl3dguide26dl3dacm26cfid3d1111111126cftoken3d2222222,9464,9465,18929
3,journals/sigmod/luoi02,,64306,47,64353
4,,dnm-avln230j,8538,8539,17077
5,journals/sigmod/dogac98,,64668,409,65077
6,,url:http://www.springerlink.com/index/u2p4pv601173r065.pdf,8137,8138,16275
7,journals/vldb/aperscs02,,66703,2444,69147
8,journals/vldb/abbadisw01,,66752,2493,69245
9,,url:http://www.ingentaconnect.com/search/expand3fpub3dinfobike://els/13891286/2000/00000034/00000006/art0015226unc3d,7895,7896,15791
10,,url:http://www.springerlink.com/index/n2vq4nk4h736r74t.pdf,7885,7886,15771
11,journals/tods/snodgrass01a,,66602,2343,68945
12,,i7hxbbrnpkoj,64058,64059,128117
13,conf/sigmod/ellison95,,65889,1630,67519
14,,4zz7lxt4ppij,63843,63844,127687
15,conf/sigmod/chaudhurid97,,65642,1383,67025
16,journals/sigmod/franklin97,,64827,568,65395
17,,tuobvmb4pbsj,6327,6328,12655
18,journals/vldb/atkinson00,,66743,2484,69227
19,,o0iehbfkd3oj,6291,6292,12583
20,journals/sigmod/rossajs02,,64352,93,64445
21,,url:http://portal.acm.org/ft_gateway.cfm3fid3d29059926type3dpdf26dl3dguide26dl3dacm26cfid3d1111111126cftoken3d2222222,62488,62489,124977
22,journals/tods/snodgrass01,,66590,2331,68921
23,,url:http://www.springerlink.com/index/j206181t84860874.pdf,62148,62149,124297
24,,url:http://doi.wiley.com/10.1002/ev.1658,61808,61809,123617
25,journals/sigmod/liu01,,64414,155,64569
26,journals/sigmod/winslett01,,64408,149,64557
27,,m2mf-4bglp4j,60265,60266,120531
28,,f0vufxhfrp8j,59996,59997,119993
29,conf/vldb/koudass03,,66444,2185,68629
30,journals/vldb/halevy02,,66726,2467,69193
31,,url:http://www.springerlink.com/index/0ykcku5lkg6g102t.pdf,5985,5986,11971
32,conf/sigmod/casatis01,,64998,739,65737
33,,7h9j9z0x_3uj,59102,59103,118205
34,,cdn9ooqste0j,58477,58478,116955
35,journals/vldb/atlurijy03,,66555,2296,68851
36,,url:http://www.springerlink.com/index/6ueykj4uqtk18h6d.pdf,58129,58130,116259
37,journals/vldb/bernsteinir03,,66540,2281,68821
38,conf/sigmod/haash01,,64917,658,65575
39,,thep1s1typgj,57827,57828,115655
40,,url:http://portal.acm.org/ft_gateway.cfm3fid3d64100426type3dpdf26dl3dguide26dl3dacm26cfid3d1111111126cftoken3d2222222,57556,57557,115113
41,journals/sigmod/aberer03a,,66875,2616,69491
42,journals/sigmod/critchlow01,,64634,375,65009
43,,wuqbvqacacsj,56981,56982,113963
44,conf/sigmod/sheth95,,65918,1659,67577
45,,eu-7ssxw5jej,56857,56858,113715
46,,url:http://portal.acm.org/ft_gateway.cfm3fid3d30423126type3dpdf26dl3dguide26dl3dacm26cfid3d1111111126cftoken3d2222222,55748,55749,111497
47,conf/sigmod/chakrabarti99,,65338,1079,66417
48,,pyiczyqmylej,54935,54936,109871
49,conf/sigmod/chamberlin03,,64666,407,65073
50,,url:http://portal.acm.org/ft_gateway.cfm3fid3d95908526type3dpdf26dl3dguide26dl3dacm26cfid3d1111111126cftoken3d2222222,53274,53275,106549
51,journals/sigmod/motroa03,,66170,1911,68081
52,conf/sigmod/bussler02,,64845,586,65431
53,,url:http://portal.acm.org/ft_gateway.cfm3fid3d56480126type3dpdf26dl3dguide26dl3dacm26cfid3d1111111126cftoken3d2222222,53149,53150,106299
54,conf/sigmod/clossmanshkpb98,,65516,1257,66773
55,,q0jr0cgwn5mj,51628,51629,103257
56,,rqtxo0ix3quj,5033,5034,10067
57,journals/sigmod/meersmans02,,66848,2589,69437
58,conf/sigmod/gal00,,65135,876,66011
59,,i6qoooyvoqqj,50274,50275,100549
60,,url:http://portal.acm.org/ft_gateway.cfm3fid3d33547726type3dpdf26coll3dguide26dl3dacm26cfid3d1111111126cftoken3d2222222,50037,50038,100075
61,conf/sigmod/bratsbergt00,,65136,877,66013
62,journals/sigmod/dogac02,,64486,227,64713
63,,kx9tzqflvrgj,50002,50003,100005
64,journals/sigmod/hammer02,,64264,5,64269
65,,url:http://portal.acm.org/ft_gateway.cfm3fid3d58445526type3dpdf26dl3dguide26dl3dacm26cfid3d1111111126cftoken3d2222222,4974,4975,9949
66,conf/sigmod/dullmann99,,65333,1074,66407
67,,5bp8rsfakzej,47841,47842,95683
68,conf/sigmod/blakeleyd00,,65132,873,66005
69,,zsr-mthg9uej,46115,46116,92231
70,,url:http://portal.acm.org/ft_gateway.cfm3fid3d60185926type3dpdf26dl3dguide26dl3dacm26cfid3d1111111126cftoken3d2222222,45736,45737,91473
71,journals/sigmod/hammer02a,,64338,79,64417
72,journals/sigmod/shethgjrsww96,,65017,758,65775
73,,yi5e8tgu5bwj,45339,45340,90679
74,journals/sigmod/mcclatcheyv97,,64799,540,65339
75,,url:http://portal.acm.org/ft_gateway.cfm3fid3d27108726type3dpdf26dl3dguide26dl3dacm26cfid3d1111111126cftoken3d2222222,41706,41707,83413
76,,rdrdlwdhgb0j,41380,41381,82761
77,journals/sigmod/gottlobkp03a,,66232,1973,68205
78,conf/vldb/deckerk03,,66309,2050,68359
79,,es2ksnccugmj,40383,40384,80767
80,,url:http://portal.acm.org/ft_gateway.cfm3fid3d27324726type3dpdf26dl3dguide26dl3dacm26cfid3d1111111126cftoken3d2222222,39967,39968,79935
81,journals/sigmod/chaudhri98,,64876,617,65493
82,,66uax5eptkcj,39829,39830,79659
83,conf/sigmod/fernandezs96,,65761,1502,67263
84,journals/sigmod/snodgrass98a,,64896,637,65533
85,,upblq76s_g4j,39332,39333,78665
86,conf/vldb/leymann01,,65347,1088,66435
87,,erh9ha637amj,39105,39106,78211
88,journals/sigmod/snodgrassgimsu98,,64865,606,65471
89,,toa0zxk5ba4j,38552,38553,77105
90,,2kinfwtpqp4j,3812,3813,7625
91,journals/sigmod/segevjs95,,65100,841,65941
92,,url:http://portal.acm.org/ft_gateway.cfm3fid3d31006226type3dpdf26dl3dguide26dl3dacm26cfid3d1111111126cftoken3d2222222,37353,37354,74707
93,journals/sigmod/nascimentom99,,64681,422,65103
94,journals/sigmod/musickm98,,64879,620,65499
95,,gt83e4ub09wj,36907,36908,73815
96,journals/sigmod/rosscgjbv99,,64767,508,65275
97,,cgvd6du5kaoj,34034,34035,68069
98,,kcrwfqei9g8j,33956,33957,67913
99,conf/sigmod/shuklad00,,65180,921,66101
100,,url:http://www.ingentaconnect.com/search/expand3fpub3dinfobike://els/08830355/2001/00000035/00000002/art0001026unc3d,33717,33718,67435
101,journals/sigmod/aberer03c,,66160,1901,68061
102,,qlewwlgl5ksj,32427,32428,64855
103,journals/vldb/c95a,,66804,2545,69349
104,,5wh3y-mbqjqj,31795,31796,63591
105,conf/sigmod/smith01,,64904,645,65549
106,conf/vldb/cliftonfhkls03,,66308,2049,68357
107,,ff4u5cqjanqj,31288,31289,62577
108,,url:http://portal.acm.org/ft_gateway.cfm3fid3d38188926type3dpdf26dl3dguide26dl3dacm26cfid3d1111111126cftoken3d2222222,29215,29216,58431
109,journals/sigmod/berndtssonh96,,64949,690,65639
110,,url:http://portal.acm.org/citation.cfm3fid3d640990.64100326dl3dportal26dl3dacm26idx3dj68926part3dperiodical26wanttype3dperiodical26title3dacm2520sigmod2520record26cfid3d1111111126cftoken3d2222222,28428,28429,56857
111,journals/sigmod/lacroixb03,,66868,2609,69477
112,,yjlutek7zwkj,27844,27845,55689
113,conf/vldb/mohan02,,66454,2195,68649
114,conf/vldb/chaudhuris01,,65341,1082,66423
115,,4bs3tvlq-laj,25267,25268,50535
116,conf/vldb/patong01,,65343,1084,66427
117,,mhcrmuxqnbsj,2509,2510,5019
118,journals/sigmod/catarcic96,,64999,740,65739
119,,url:http://portal.acm.org/ft_gateway.cfm3fid3d24588826type3dpdf26dl3dguide26dl3dacm26cfid3d1111111126cftoken3d2222222,24469,24470,48939
120,journals/sigmod/boucelmacgjll02,,64387,128,64515
121,,i9jxy0-r4ggj,24328,24329,48657
122,,fskoynvjbwwj,24270,24271,48541
123,journals/sigmod/pissinousemopstd94,,65179,920,66099
124,,uyieoe280owj,23521,23522,47043
125,conf/sigmod/bussler01,,64921,662,65583
126,,oytmj53qv0uj,22547,22548,45095
127,conf/sigmod/gunopulosd01,,64995,736,65731
128,conf/sigmod/mohan02,,64846,587,65433
129,,eyxiitge9mqj,22366,22367,44733
130,,f9jfepe5a24j,21519,21520,43039
131,conf/sigmod/mohan96,,65757,1498,67255
132,journals/sigmod/bernsteindk99,,64735,476,65211
133,,ye5ftbimouwj,20562,20563,41125
134,,hr-ylnuhtl4j,19155,19156,38311
135,journals/sigmod/ramamrithams97,,64811,552,65363
136,,url:http://portal.acm.org/ft_gateway.cfm3fid3d50736626type3dpdf26dl3dguide26dl3dacm26cfid3d1111111126cftoken3d2222222,191,192,383
137,journals/sigmod/gobler02,,64508,249,64757
138,,bj0pr7fqzzoj,18386,18387,36773
139,conf/vldb/sarawagi02,,66455,2196,68651
140,conf/sigmod/garofalakisgr02,,64849,590,65439
141,,s6pwjhrforyj,18258,18259,36517
142,conf/sigmod/careymn97,,65640,1381,67021
143,,u64n4ymnma4j,17693,17694,35387
144,,url:http://portal.acm.org/ft_gateway.cfm3fid3d31007126type3dpdf26dl3dguide26dl3dacm26cfid3d1111111126cftoken3d2222222,166,167,333
145,journals/sigmod/careys99,,64688,429,65117
146,journals/sigmod/carmelms01,,64621,362,64983
147,,bolov3crmywj,14289,14290,28579
148,,url:http://portal.acm.org/ft_gateway.cfm3fid3d39000426type3dpdf26dl3dguide26dl3dacm26cfid3d1111111126cftoken3d2222222,14169,14170,28339
149,journals/sigmod/snodgrass99b,,64739,480,65219
150,conf/sigmod/suciu99,,65336,1077,66413
151,,fopggqjyllsj,11882,11883,23765
152,conf/sigmod/blakeley94,,66087,1828,67915
153,,vld1pgyion8j,11817,11818,23635
154,,url:http://portal.acm.org/ft_gateway.cfm3fid3d22388326type3dpdf26dl3dguide26dl3dacm26cfid3d1111111126cftoken3d2222222,11236,11237,22473
155,conf/sigmod/norrie95,,65920,1661,67581
156,conf/vldb/cerim03,,66446,2187,68633
157,,hfpnve44a04j,11235,11236,22471
158,conf/sigmod/grayssu03,,64669,410,65079
159,,nnkrsx4j4pkj,9993,9994,19987
160,journals/tods/gravanogt99,,66633,2374,69007
161,,axlcafb2y5kj,9937,9938,19875
162,,fdpwbrqbfiaj,9786,9787,19573
163,conf/sigmod/acharyafz97,,65498,1239,66737
164,,8drb_dyz2cgj,9719,9720,19439
165,conf/vldb/christophebpv00,,65659,1400,67059
166,,lu7bfmnargyj,97,98,195
167,conf/vldb/cormodedim02,,66449,2190,68639
168,,pot1wbtbb4cj,9639,9640,19279
169,conf/sigmod/dasujms02,,64789,530,65319
170,,auelzkc-txij,9636,9637,19273
171,conf/vldb/floresculsy99,,65874,1615,67489
172,conf/vldb/shmueli01,,65369,1110,66479
173,,reweqoans-gj,9610,9611,19221
174,,uguuv9ate1yj,9574,9575,19149
175,conf/sigmod/jhingran00,,65080,821,65901
176,conf/sigmod/nazeribo01,,64864,605,65469
177,,2e9i_luggc4j,9477,9478,18955
178,journals/vldb/nybergbcgl95,,66794,2535,69329
179,,a1phylxpkl4j,9379,9380,18759
180,,url:http://portal.acm.org/ft_gateway.cfm3fid3d21202226type3dpdf26dl3dguide26dl3dacm26cfid3d1111111126cftoken3d2222222,9336,9337,18673
181,journals/sigmod/qian95a,,65046,787,65833
182,conf/sigmod/stonebraker03,,64581,322,64903
183,,_cgwfox5yt0j,9270,9271,18541
184,,f2ecyx97f2sj,9172,9173,18345
185,conf/sigmod/lometw98,,65362,1103,66465
186,,qs4jhfgpbm8j,905,906,1811
187,conf/sigmod/krishnamurthybn99,,65246,987,66233
188,conf/vldb/dyreson96,,66869,2610,69479
189,,afm_n94rvd0j,8748,8749,17497
190,conf/vldb/kamelf94,,64514,255,64769
191,,a7woazxoj9yj,848,849,1697
192,,6vaqed6muakj,841,842,1683
193,conf/sigmod/kornmz03,,64672,413,65085
194,conf/sigmod/spiro98,,65509,1250,66759
195,,u4zai-drohkj,8377,8378,16755
196,,,8244,8245,16489
197,journals/sigmod/eisenbergm98,,64860,601,65461
198,,5zpm_qmafv4j,8234,8235,16469
199,journals/tods/bertinobfs98,,66625,2366,68991
200,journals/sigmod/cardelli01,,64463,204,64667
201,,uyaoi4dyoxuj,8156,8157,16313
202,,hr5ogcjqc2mj,8146,8147,16293
203,conf/vldb/manolopoulost01,,65409,1150,66559
204,,url:http://portal.acm.org/ft_gateway.cfm3fid3d24589826type3dpdf26dl3dguide26dl3dacm26cfid3d1111111126cftoken3d2222222,8112,8113,16225
205,journals/sigmod/santuccit96,,65007,748,65755
206,journals/sigmod/mani03,,66142,1883,68025
207,,fglcpqaf8c8j,8090,8091,16181
208,conf/sigmod/meccaamms98,,65524,1265,66789
209,,j-7xdqqw5rwj,8051,8052,16103
210,conf/sigmod/mohan94,,65994,1735,67729
211,,ft1yziffu0cj,7995,7996,15991
212,journals/sigmod/frewd97,,64833,574,65407
213,,5jmt1penhsij,7923,7924,15847
214,,p0age7qyzacj,7822,7823,15645
215,conf/vldb/agrawals94,,64355,96,64451
216,journals/vldb/ramamohanaraoh94,,66825,2566,69391
217,,uiwvxn_y9saj,7709,7710,15419
218,conf/vldb/shisz03,,66353,2094,68447
219,,,7678,7679,15357
220,,2j1dalv3kcej,7554,7555,15109
221,conf/vldb/gentili01,,65538,1279,66817
222,,wywnjy4gseyj,7540,7541,15081
223,conf/vldb/mohan96,,66102,1843,67945
224,,i-r1le1najaj,7532,7533,15065
225,journals/sigmod/hampapur99,,64707,448,65155
226,journals/vldb/bertino94,,66824,2565,69389
227,,ylp7n4gu-dqj,7509,7510,15019
228,,cphjwu8o-bkj,7494,7495,14989
229,conf/sigmod/kotidisr98,,65396,1137,66533
230,,lhjvkpdcjkuj,7406,7407,14813
231,conf/vldb/fecteau95,,64383,124,64507
232,,iqmup3fkvo4j,7346,7347,14693
233,journals/sigmod/jainh94,,65065,806,65871
234,conf/vldb/dayal99,,65866,1607,67473
235,,url:http://portal.acm.org/citation.cfm3fid3d645925.671502,7275,7276,14551
236,,q-td2yanr18j,7257,7258,14515
237,conf/vldb/baralisw94,,64353,94,64447
238,,fr8cpbk-ifij,7205,7206,14411
239,conf/sigmod/freeston95,,65735,1476,67211
240,journals/sigmod/qian96,,64962,703,65665
241,,niswboduzhaj,7202,7203,14405
242,,4bbje8qkhvgj,7055,7056,14111
243,journals/sigmod/ahlberg96,,65011,752,65763
244,,url:http://www.vldb.org/conf/2003/papers/s32p01.pdf,7053,7054,14107
245,conf/vldb/leymann03,,66306,2047,68353
246,,oum0e0bhexij,704,705,1409
247,conf/vldb/chaudhuriw00,,65656,1397,67053
248,conf/vldb/gottlobkp02,,66448,2189,68637
249,,lmljpf_m6jwj,6994,6995,13989
250,,q_jrmsxfem4j,6941,6942,13883
251,journals/vldb/scheuermannwz98,,66697,2438,69135
252,conf/vldb/bergerbsw03,,66300,2041,68341
253,,kadcx48-o5ij,6898,6899,13797
254,journals/sigmod/liefkes00,,64542,283,64825
255,,n0eowmtiaukj,6851,6852,13703
256,journals/sigmod/aberer02a,,64323,64,64387
257,,url:http://portal.acm.org/ft_gateway.cfm3fid3d60427426type3dpdf26dl3dguide26dl3dacm26cfid3d1111111126cftoken3d2222222,6684,6685,13369
258,,saycyucugbyj,655,656,1311
259,conf/vldb/chaudhurign03,,66271,2012,68283
260,,gahdnmzncwgj,6493,6494,12987
261,conf/sigmod/brunoks02,,64798,539,65337
262,conf/sigmod/chendlt00,,65084,825,65909
263,,url:http://portal.acm.org/citation.cfm3fid3d342009.336560,64106,64107,128213
264,,url:http://portal.acm.org/ft_gateway.cfm3fid3d27636926type3dpdf26dl3dguide26dl3dacm26cfid3d1111111126cftoken3d2222222,6408,6409,12817
265,conf/sigmod/naumans98,,65375,1116,66491
266,conf/sigmod/shashab02a,,64710,451,65161
267,,url:http://portal.acm.org/citation.cfm3fid3d564691.56479826dl3dguide26dl3dacm26type3dseries26idx3d56469126part3dproceedings26wanttype3dproceedings26title3dinternational2520conference2520on2520management2520of2520data2520and2520symposium2520on2520principles2520of2520database2520systems26cfid3d1111111126cftoken3d2222222,64006,64007,128013
268,conf/sigmod/pirahesh94,,66058,1799,67857
269,,vg96hl8afvgj,63996,63997,127993
270,,hnmlty0usf0j,63912,63913,127825
271,conf/sigmod/yernenilgu99,,65188,929,66117
272,,rfuptelfglkj,63801,63802,127603
273,conf/vldb/bamfordbkm98,,65805,1546,67351
274,journals/sigmod/gerlax03,,66118,1859,67977
275,,kkiefntreouj,63749,63750,127499
276,,wgk6p4mdsimj,63689,63690,127379
277,journals/sigmod/eisenbergm02,,64261,2,64263
278,,_nig_hi8paaj,63667,63668,127335
279,journals/sigmod/seshadri98,,64873,614,65487
280,,zmwpmsd8rggj,63633,63634,127267
281,conf/vldb/lesliejby95,,64303,44,64347
282,,q3mhg5rk29oj,63628,63629,127257
283,conf/vldb/shahrs02,,66497,2238,68735
284,conf/vldb/ishikawasf98,,65858,1599,67457
285,,d1hcbthhokcj,63489,63490,126979
286,conf/vldb/palpanasscp02,,66388,2129,68517
287,,nlh2wxzt3vij,63483,63484,126967
288,,ryav3ktsj2ij,63386,63387,126773
289,conf/sigmod/zhangndll01,,64973,714,65687
290,conf/vldb/stoltea02,,66505,2246,68751
291,,n3bry6ssmw8j,63383,63384,126767
292,conf/vldb/darmonts99,,65714,1455,67169
293,,ebi8v9fzxcgj,63378,63379,126757
294,,bp69wmyw9daj,63303,63304,126607
295,conf/vldb/cochinwalab94,,64440,181,64621
296,,l1ibwd8w1g0j,63302,63303,126605
297,conf/vldb/sathes01,,65517,1258,66775
298,,sdvmepmugqij,63192,63193,126385
299,journals/vldb/aguileracmvv02,,66702,2443,69145
300,,bqv5hyb-jiej,63183,63184,126367
301,conf/sigmod/cohenm03,,64642,383,65025
302,journals/sigmod/changass98,,64899,640,65539
303,,cpzroudnzqgj,63015,63016,126031
304,conf/vldb/cerifp99,,65738,1479,67217
305,,8oroaqnaveij,63009,63010,126019
306,journals/vldb/sarawagi01,,66759,2500,69259
307,,xx6kw0tceqij,62999,63000,125999
308,conf/sigmod/getoortk01,,64981,722,65703
309,,bvdjyu3xg_yj,62898,62899,125797
310,,a8ysbamwfjoj,62874,62875,125749
311,journals/sigmod/hadzilacost97,,64814,555,65369
312,journals/sigmod/stacey95,,65152,893,66045
313,,rdxuggm5kg0j,62870,62871,125741
314,,gbjxwfztqtsj,62844,62845,125689
315,conf/vldb/moni96,,66104,1845,67949
316,,cjk2swlyrryj,62819,62820,125639
317,journals/sigmod/elmagarmidjf95,,65110,851,65961
318,,htvxhmkb69aj,62734,62735,125469
319,journals/sigmod/chenhkpw94,,65238,979,66217
320,journals/tods/chen95,,66509,2250,68759
321,,1px2xyevmzwj,6267,6268,12535
322,,4hvb6arvsk8j,62614,62615,125229
323,conf/vldb/gravanog95,,66195,1936,68131
324,,gkuflkzgavej,62558,62559,125117
325,journals/sigmod/eisenbergm01,,64417,158,64575
326,conf/vldb/taop02,,66488,2229,68717
327,,7zyv9ivzysqj,62449,62450,124899
328,journals/vldb/albanogo95,,66781,2522,69303
329,,_tswcghoswmj,62386,62387,124773
330,journals/vldb/abiteboulb95,,66780,2521,69301
331,,pkocuf5hmjyj,62368,62369,124737
332,journals/sigmod/pourabbasr00,,64546,287,64833
333,,3y6y5axu-j0j,62294,62295,124589
334,journals/sigmod/abiteboul99,,64765,506,65271
335,,j_7kzs39msaj,62244,62245,124489
336,,s7k6ricx3fkj,62211,62212,124423
337,conf/sigmod/chog00,,65114,855,65969
338,,_xlk2p-e2pyj,62190,62191,124381
339,conf/sigmod/zhugeghw95,,65869,1610,67479
340,,ixksngvyu08j,62099,62100,124199
341,conf/sigmod/weininger02,,64744,485,65229
342,,hjiwq2cqrbkj,61968,61969,123937
343,conf/sigmod/llirbatfs97,,65603,1344,66947
344,,zmgbs5u_gwyj,61576,61577,123153
345,conf/sigmod/deligiannakisr03,,64476,217,64693
346,,d45fvuwvon0j,61562,61563,123125
347,conf/vldb/suciu96,,66837,2578,69415
348,journals/tods/shashalsv95,,66519,2260,68779
349,,0avkzjogllaj,61477,61478,122955
350,journals/vldb/kraissw98,,66689,2430,69119
351,,lmz7v87sxxyj,61310,61311,122621
352,,dnifr9w2fucj,61309,61310,122619
353,journals/vldb/kornlkf00,,66662,2403,69065
354,,7fuowtsbiogj,61218,61219,122437
355,conf/vldb/wang95,,64292,33,64325
356,journals/sigmod/wiegand02,,64308,49,64357
357,,racovquezd8j,61162,61163,122325
358,journals/sigmod/lomet98,,64847,588,65435
359,,xlm0yvcccugj,6107,6108,12215
360,,jsksbyzon5ej,60982,60983,121965
361,conf/sigmod/katayamas97,,65657,1398,67055
362,conf/sigmod/koudass03,,64671,412,65083
363,,url:http://portal.acm.org/ft_gateway.cfm3fid3d87287126type3dpdf26dl3dportal26dl3dacm26cfid3d1111111126cftoken3d2222222,60794,60795,121589
364,conf/vldb/catozzir01,,65488,1229,66717
365,,x_mqiy3gcmaj,60780,60781,121561
366,,s6ax0wdzp6ij,60633,60634,121267
367,conf/vldb/vaskevitch95,,64376,117,64493
368,,tmcyyf1cnsyj,60620,60621,121241
369,conf/vldb/papadiasts03,,66266,2007,68273
370,conf/vldb/kornms02,,66389,2130,68519
371,,mclztqppje4j,60602,60603,121205
372,conf/vldb/donjerkovicr99,,65692,1433,67125
373,,eq1w4lpv_igj,60503,60504,121007
374,,b1uni67mfjcj,60384,60385,120769
375,conf/vldb/wangc03,,66263,2004,68267
376,,bxrf6rasxhgj,60360,60361,120721
377,conf/vldb/mchughw99,,65690,1431,67121
378,,qynfyydysawj,60340,60341,120681
379,journals/sigmod/pourabbasr02,,64298,39,64337
380,conf/sigmod/bonnet02,,64721,462,65183
381,,bqyt1789jj8j,6025,6026,12051
382,,xod5vxzqj8aj,60166,60167,120333
383,conf/vldb/sheth96,,66107,1848,67955
384,conf/vldb/dayalhl01,,66442,2183,68625
385,,0xyrlw9tvw8j,59946,59947,119893
386,,url:http://portal.acm.org/citation.cfm3fid3d335465,59929,59930,119859
387,conf/sigmod/weininger00,,65082,823,65905
388,conf/vldb/deutscht03,,66334,2075,68409
389,,qkj_iyvmlfuj,59847,59848,119695
390,,url:http://portal.acm.org/citation.cfm3fid3d603867.60386926coll3dguide26dl3dacm26idx3dj68926part3dperiodical26wanttype3dperiodical26title3dacm2520sigmod2520record26cfid3d1111111126cftoken3d2222222,59821,59822,119643
391,journals/sigmod/aberer01,,64443,184,64627
392,,txvfep4wtd0j,59689,59690,119379
393,conf/sigmod/bhargavagi95,,65871,1612,67483
394,,_sltxcfrkhyj,59683,59684,119367
395,journals/sigmod/fankhauser01,,64392,133,64525
396,conf/vldb/donghlpw01,,65302,1043,66345
397,,c_h34ddegi8j,59620,59621,119241
398,,lkrtculva6oj,59598,59599,119197
399,journals/sigmod/kuanl99,,64716,457,65173
400,journals/sigmod/loeffen94,,65182,923,66105
401,,gb-yidoxaekj,59497,59498,118995
402,conf/vldb/labrinidisr03,,66349,2090,68439
403,,0gmnedjfvv0j,59360,59361,118721
404,,vge-ibwymm4j,59314,59315,118629
405,conf/sigmod/ramanan02,,64766,507,65273
406,,ecqjru0eiagj,58987,58988,117975
407,journals/tods/fegarasm00,,66583,2324,68907
408,,4ttqjrg4pn8j,58900,58901,117801
409,conf/vldb/chon02,,66498,2239,68737
410,,9mlauurfkhyj,58757,58758,117515
411,conf/vldb/vassalosp97,,65937,1678,67615
412,conf/sigmod/lahirig01,,64895,636,65531
413,,2ejigkjsqf4j,58685,58686,117371
414,conf/vldb/kochbg03,,66345,2086,68431
415,,xcbxljhlr48j,586,587,1173
416,,lsno-7ii1vej,58520,58521,117041
417,conf/sigmod/ramakrishnand98,,65539,1280,66819
418,,ewvrekow_qgj,58500,58501,117001
419,conf/sigmod/callancd99,,65195,936,66131
420,journals/vldb/helmerm03,,66546,2287,68833
421,,fz4pkduwgmoj,584,585,1169
422,,udqshc_ps4ij,58380,58381,116761
423,journals/vldb/navarro02,,66710,2451,69161
424,,hhmtxxflyu8j,58315,58316,116631
425,conf/sigmod/jagatheesanr03,,64547,288,64835
426,,9phyz-n58a8j,58262,58263,116525
427,conf/sigmod/vossenw99,,65387,1128,66515
428,,ma-zryj0pxij,58237,58238,116475
429,conf/vldb/raghavang03,,66329,2070,68399
430,conf/vldb/helmerm97,,65950,1691,67641
431,,xsh0c_ncllsj,58161,58162,116323
432,conf/sigmod/ivinskis95,,65823,1564,67387
433,,9faadi_zgnej,58154,58155,116309
434,conf/vldb/tamurak99,,65769,1510,67279
435,,rahgafoqookj,57987,57988,115975
436,,3m-kkbvf8kkj,57951,57952,115903
437,conf/vldb/graefe99,,65712,1453,67165
438,journals/vldb/antoshenkov97,,66677,2418,69095
439,,glex-n_dgkcj,57769,57770,115539
440,conf/vldb/yuv00,,65459,1200,66659
441,,43n2r_suyccj,57698,57699,115397
442,,itp4yy9sluuj,57585,57586,115171
443,conf/sigmod/brown99,,65340,1081,66421
444,conf/vldb/wildfogely97,,65985,1726,67711
445,,uqyakln84x0j,57576,57577,115153
446,journals/sigmod/eisenberg96,,65012,753,65765
447,,tfbkjo2wcfmj,57535,57536,115071
448,,fb4oyrm9n4ej,57497,57498,114995
449,conf/vldb/may01,,65484,1225,66709
450,,ajq2idlfphmj,57484,57485,114969
451,journals/sigmod/domingo-ferrerh98,,64673,414,65087
452,conf/sigmod/atzenit97,,65645,1386,67031
453,,i2li1twifbyj,57337,57338,114675
454,,lcx8pm2abjsj,57212,57213,114425
455,conf/vldb/raghavang01,,66436,2177,68613
456,,a8rgbqif7mij,57167,57168,114335
457,conf/vldb/gionisim99,,65677,1418,67095
458,,url:http://portal.acm.org/ft_gateway.cfm3fid3d56479226type3dpdf,57123,57124,114247
459,conf/sigmod/cotton02,,64851,592,65443
460,journals/vldb/cliftongb95,,66796,2537,69333
461,,ykivdnoc64cj,57071,57072,114143
462,,q_o5zij9ncej,5695,5696,11391
463,conf/sigmod/liupbhpt00,,65060,801,65861
464,,5ng-blunasqj,56938,56939,113877
465,conf/sigmod/chakravarthy97,,65609,1350,66959
466,,mbhz3gsr3nmj,56873,56874,113747
467,conf/sigmod/babcockcd03,,64555,296,64851
468,,db8lvc2d9fcj,5681,5682,11363
469,conf/sigmod/kleissner95,,65828,1569,67397
470,journals/sigmod/hellerstein03,,66205,1946,68151
471,,phhvswioffaj,56806,56807,113613
472,conf/sigmod/bilirisp94,,65990,1731,67721
473,,kyhmilhkq_ij,56703,56704,113407
474,conf/vldb/waascb01,,65388,1129,66517
475,,y_gkgtzuphij,56650,56651,113301
476,journals/tods/levenel99,,66621,2362,68983
477,,iwpgaj1eqrkj,56539,56540,113079
478,,8-eadtdtfy4j,56524,56525,113049
479,conf/sigmod/mamoulis03,,64545,286,64831
480,,wxwco2uldquj,56436,56437,112873
481,journals/tods/eitergm97,,66605,2346,68951
482,,3zf3wst0b6uj,56415,56416,112831
483,conf/vldb/goldmanw97,,65963,1704,67667
484,,r62imnche0ij,56344,56345,112689
485,conf/sigmod/mistryrsr01,,64928,669,65597
486,conf/sigmod/waasg00,,65040,781,65821
487,,xnocdneqykaj,56173,56174,112347
488,journals/sigmod/yang94,,65257,998,66255
489,,shj914npztuj,56169,56170,112339
490,journals/tods/lic01,,66588,2329,68917
491,,_gwfttqatekj,56141,56142,112283
492,,tkcwrg5osiwj,56029,56030,112059
493,journals/tods/brunocg02,,66597,2338,68935
494,,mkrjhoroqjsj,5600,5601,11201
495,conf/sigmod/papadiastfs03,,64576,317,64893
496,,vcvaydltty8j,5581,5582,11163
497,conf/sigmod/maheshwaril97,,65554,1295,66849
498,,60i0j0quhvyj,55791,55792,111583
499,conf/sigmod/seshadrilr94,,66042,1783,67825
500,conf/vldb/bouganimfv96,,66054,1795,67849
501,,tiffiv1y6amj,55716,55717,111433
502,conf/sigmod/dasgr03,,64456,197,64653
503,,jajkfzmaebyj,55670,55671,111341
504,journals/vldb/chakrabartigrs01,,66755,2496,69251
505,,ptmcbognupaj,55556,55557,111113
506,journals/sigmod/adelbergkg96,,64944,685,65629
507,,gfiqygac5twj,55396,55397,110793
508,conf/sigmod/nguyens96,,65715,1456,67171
509,,cd4nnuznin8j,55346,55347,110693
510,,gfjhzswtm0ej,55313,55314,110627
511,journals/sigmod/roussopoulos98,,64874,615,65489
512,journals/vldb/atkinsonm95,,66787,2528,69315
513,,n5got4higpgj,55253,55254,110507
514,conf/vldb/gawlick96,,66849,2590,69439
515,,y5ojk6_d-zuj,55232,55233,110465
516,conf/vldb/cabrera03,,66307,2048,68355
517,,url:http://wwwdb.informatik.uni-rostock.de/vldb2003/papers/s31p01.pdf,5520,5521,11041
518,journals/sigmod/guptahr97,,64802,543,65345
519,,,55107,55108,110215
520,,gbnxn3mpucmj,55048,55049,110097
521,journals/sigmod/finkelstein95,,65151,892,66043
522,conf/sigmod/natsevrs99,,65320,1061,66381
523,,otjvavxuuygj,54972,54973,109945
524,,4ioz9jssjvqj,54791,54792,109583
525,conf/sigmod/shivakumarg97,,65658,1399,67057
526,conf/sigmod/moore95,,65887,1628,67515
527,,uh57squxyuij,5466,5467,10933
528,conf/vldb/kornackerb95,,66191,1932,68123
529,,in_sibghb9mj,54558,54559,109117
530,,y4zzn4xhknuj,54430,54431,108861
531,journals/sigmod/date03,,66099,1840,67939
532,,oifrks2rprcj,54259,54260,108519
533,conf/vldb/gaasterlandl94,,64494,235,64729
534,journals/sigmod/baeza-yatesn96,,64951,692,65643
535,,1avo1fqtq6qj,54209,54210,108419
536,conf/sigmod/luwybly02,,64838,579,65417
537,,jkq1qe-naxqj,54143,54144,108287
538,journals/tods/casaticpp99,,66635,2376,69011
539,,6f_cujero6sj,54089,54090,108179
540,,fh1qpzpwhumj,54031,54032,108063
541,conf/sigmod/chaudhurig96,,65688,1429,67117
542,conf/vldb/changg97,,65968,1709,67677
543,,2syixa0vgn4j,54006,54007,108013
544,,rlzc9c2-6_oj,53992,53993,107985
545,conf/vldb/anciauxbp03,,66274,2015,68289
546,journals/sigmod/fininj02,,64365,106,64471
547,,rg8576nvnkuj,53954,53955,107909
548,conf/vldb/whiteheadsm97,,65967,1708,67675
549,,ciypfp3-5_kj,53905,53906,107811
550,,b3unqvqyjrmj,53887,53888,107775
551,conf/vldb/labiog96,,66077,1818,67895
552,,lvztvlp7s7oj,53789,53790,107579
553,journals/tods/winslettsq94,,66570,2311,68881
554,conf/vldb/diaof03,,66339,2080,68419
555,,crt1jz1eej0j,5371,5372,10743
556,conf/vldb/sahugueta99,,65717,1458,67175
557,,pk5bydjezfij,5367,5368,10735
558,,qjliaklj6eqj,53665,53666,107331
559,journals/vldb/lomets97,,66671,2412,69083
560,,fdm1w8iek_yj,53587,53588,107175
561,journals/sigmod/doanpsb97,,64986,727,65713
562,journals/sigmod/qian95b,,65094,835,65929
563,,url:http://portal.acm.org/ft_gateway.cfm3fid3d21977226type3dpdf26dl3dguide26dl3dacm26cfid3d1111111126cftoken3d2222222,53539,53540,107079
564,conf/vldb/hulgeris02,,66471,2212,68683
565,,xgcm9auhrbmj,53502,53503,107005
566,conf/sigmod/hidber99,,65271,1012,66283
567,,rn-e82gm1rqj,53438,53439,106877
568,,dtval1ye6p8j,53310,53311,106621
569,conf/vldb/keidlssk02,,66412,2153,68565
570,,gzjii5f7ozaj,53271,53272,106543
571,conf/sigmod/kim94,,66079,1820,67899
572,,jg81wytxtzoj,53258,53259,106517
573,conf/sigmod/chakrabartim99,,65160,901,66061
574,conf/sigmod/liuhbpt99,,65233,974,66207
575,,pkq1dcqiwi0j,53252,53253,106505
576,conf/sigmod/parkcy95,,65801,1542,67343
577,,ko0i4azclbgj,53198,53199,106397
578,,hccevkoobdsj,53189,53190,106379
579,conf/vldb/moerkotte98,,65997,1738,67735
580,,s40fqzss4woj,53175,53176,106351
581,conf/sigmod/adelbergd99,,65297,1038,66335
582,,f2n_dxlirwij,5305,5306,10611
583,conf/vldb/riedelgf98,,65822,1563,67385
584,conf/vldb/klots96,,66108,1849,67957
585,,dtoruw_9yroj,52883,52884,105767
586,journals/vldb/mehtagpn98,,66695,2436,69131
587,,7zf8y2iddb0j,52847,52848,105695
588,,url:http://portal.acm.org/citation.cfm3fid3d245882.24588626dl3dguide26dl3dacm26idx3dj68926part3dperiodical26wanttype3dperiodical26title3dacm2520sigmod2520record26cfid3d1111111126cftoken3d2222222,52830,52831,105661
589,journals/sigmod/darwen96,,65002,743,65745
590,journals/sigmod/bussler02,,64497,238,64735
591,,phcd3c1cflcj,52791,52792,105583
592,conf/vldb/labioycgw00,,65597,1338,66935
593,,,52785,52786,105571
594,,7ibl1cudvr0j,52744,52745,105489
595,journals/tods/salemgs94,,66557,2298,68855
596,,u6sx6e5i4l8j,52701,52702,105403
597,conf/sigmod/quassw97,,65652,1393,67045
598,,jfxeos8bqdaj,52698,52699,105397
599,conf/sigmod/shintanik98,,65473,1214,66687
600,journals/sigmod/manola98,,64894,635,65529
601,,vijfh9f94xkj,52685,52686,105371
602,,qfohkpytawoj,52569,52570,105139
603,conf/sigmod/chaudhuridn01,,64856,597,65453
604,,spi2g7jfhuyj,52537,52538,105075
605,journals/sigmod/bruniek96,,64902,643,65545
606,journals/sigmod/roantreemh99,,64683,424,65107
607,,jjk6wgpyubgj,52447,52448,104895
608,,gronhwln1wmj,52434,52435,104869
609,conf/vldb/cohenmks03,,66328,2069,68397
610,conf/vldb/christodoulakistz97,,66123,1864,67987
611,,lojhmj5xwewj,5237,5238,10475
612,conf/vldb/margaritisft01,,65301,1042,66343
613,,z2esesrbfsyj,52362,52363,104725
614,conf/vldb/joshibll98,,65806,1547,67353
615,,rufebupznbyj,52348,52349,104697
616,conf/vldb/chaudhurig99,,65751,1492,67243
617,,l-sn0enuhxkj,52147,52148,104295
618,,qnlsbj_fu5ej,52096,52097,104193
619,conf/vldb/hanf95,,66214,1955,68169
620,journals/sigmod/freemang96,,64952,693,65645
621,,em3qp7rgalkj,52066,52067,104133
622,journals/sigmod/barclaybgs94,,65248,989,66237
623,,wphdoeiinqsj,52050,52051,104101
624,,9jyzas_rfd4j,51864,51865,103729
625,journals/sigmod/westmannkhm00,,64557,298,64855
626,journals/tods/wijsen99,,66622,2363,68985
627,,_d3jpe9ngngj,51745,51746,103491
628,journals/tods/cerifpt94,,66569,2310,68879
629,,aphxpco8qkgj,51743,51744,103487
630,journals/vldb/maedchems03,,66552,2293,68845
631,,qkj1c8d-95wj,51729,51730,103459
632,,n8sykkpn6ioj,51705,51706,103411
633,journals/vldb/antoshenkovz96,,66779,2520,69299
634,,w3l3pq62_ymj,51698,51699,103397
635,conf/vldb/bayer95,,66185,1926,68111
636,,ue3gcyiirokj,51605,51606,103211
637,conf/sigmod/hanpdw01,,64885,626,65511
638,journals/sigmod/fagin02,,64314,55,64369
639,,c3swzi1md5yj,51444,51445,102889
640,conf/vldb/papadimitrioubf03,,66366,2107,68473
641,,pavcmcv_-lmj,51304,51305,102609
642,conf/sigmod/kalnisp01,,64959,700,65659
643,,,51024,51025,102049
644,conf/sigmod/brunocg01,,64955,696,65651
645,,8kj9xfv1esaj,50969,50970,101939
646,conf/vldb/greco98,,65904,1645,67549
647,,ccr8culhensj,50895,50896,101791
648,,xggbizmlvmgj,50811,50812,101623
649,conf/sigmod/ballinger94,,66014,1755,67769
650,,lswvpfb8tc4j,50776,50777,101553
651,conf/sigmod/fegarasm95,,65848,1589,67437
652,conf/sigmod/rajaraman99,,65288,1029,66317
653,,url:http://portal.acm.org/ft_gateway.cfm3fid3d30424626type3dpdf26dl3dguide26dl3dacm26cfid3d1111111126cftoken3d2222222,5073,5074,10147
654,,nd7-ctb1lrgj,50693,50694,101387
655,conf/vldb/miloz98,,65842,1583,67425
656,,medoulcndsgj,50639,50640,101279
657,conf/vldb/zureks99,,65742,1483,67225
658,,ve-jh2ynn0kj,5057,5058,10115
659,conf/vldb/srikanta95,,64279,20,64299
660,journals/tods/ng01,,66591,2332,68923
661,,npckxd_vlm8j,50519,50520,101039
662,,yxcroroo320j,50485,50486,100971
663,journals/vldb/pacittis00,,66641,2382,69023
664,,9oylimeddj0j,50456,50457,100913
665,conf/vldb/huyn97,,66143,1884,68027
666,conf/sigmod/franklinz98,,65366,1107,66473
667,,5cj9wx8llkwj,5025,5026,10051
668,,9mi4jooqkn4j,50148,50149,100297
669,conf/vldb/chog00,,65636,1377,67013
670,,1sa9lhkthsuj,50139,50140,100279
671,conf/sigmod/wattezcbff00,,65042,783,65825
672,,mg9abng06o4j,50020,50021,100041
673,conf/sigmod/hristidiskp01,,64983,724,65707
674,conf/vldb/hamilton99,,65702,1443,67145
675,,_zptedzhfhqj,49973,49974,99947
676,,h7_7szri7m0j,49912,49913,99825
677,conf/vldb/lusl95,,64286,27,64313
678,,gzbmx-quxfyj,49814,49815,99629
679,conf/vldb/sarawagis96,,66831,2572,69403
680,conf/vldb/garofalakisrs99,,65707,1448,67155
681,,xm3ygcvkmn8j,49792,49793,99585
682,journals/vldb/li03,,66549,2290,68839
683,,hlxyquidobmj,49767,49768,99535
684,conf/vldb/shahdr03,,66331,2072,68403
685,,zlk6tn-spxwj,49563,49564,99127
686,,8but_7furyij,49551,49552,99103
687,conf/sigmod/greenwaldk01,,64945,686,65631
688,,gxdfgci-rq4j,49532,49533,99065
689,conf/sigmod/galhardas00,,65090,831,65921
690,,zeezqsnvcyyj,49412,49413,98825
691,conf/vldb/yupm03,,66343,2084,68427
692,journals/vldb/mecellap01,,66756,2497,69253
693,,_jwgwzutaoej,49282,49283,98565
694,conf/vldb/rastogis98,,65988,1729,67717
695,,aywuej5k2ioj,49008,49009,98017
696,conf/vldb/lifantsevc02,,66485,2226,68711
697,,gpvydduyrg4j,48852,48853,97705
698,journals/sigmod/chaudhurid97,,64825,566,65391
699,,zlbj-7jzdp0j,48832,48833,97665
700,conf/vldb/chandrasekaranf02,,66472,2213,68685
701,,y-0iu9ss36yj,48819,48820,97639
702,,vtctqej5jsqj,48639,48640,97279
703,journals/sigmod/koubarakistid03,,66198,1939,68137
704,conf/vldb/kemperk94,,64346,87,64433
705,,qufwv4vvxegj,48631,48632,97263
706,,hvmtb3fyojqj,48626,48627,97253
707,conf/sigmod/chaudhurimn98,,65431,1172,66603
708,,g85jsnuajzmj,48616,48617,97233
709,journals/vldb/georgakopoulosrl94,,66815,2556,69371
710,,cjup6vfsm50j,48587,48588,97175
711,conf/vldb/miklaus03,,66284,2025,68309
712,conf/vldb/papadiaszmt03,,66261,2002,68263
713,,hj8vp7fyol0j,48575,48576,97151
714,,labg3ufzvvuj,48145,48146,96291
715,journals/sigmod/widom94,,65268,1009,66277
716,,vsr4pwhmgwsj,47913,47914,95827
717,conf/vldb/koudasim00,,65615,1356,66971
718,journals/vldb/berendts00,,66658,2399,69057
719,,_0meuij3zjej,47853,47854,95707
720,conf/vldb/lomett95,,64291,32,64323
721,,p7gugc5bz7wj,47580,47581,95161
722,,pj2uekvg_hoj,47501,47502,95003
723,conf/vldb/baumann03,,66311,2052,68363
724,,ylzfc8rnoeqj,47363,47364,94727
725,conf/vldb/goldsteinr00,,65475,1216,66691
726,conf/sigmod/greer99,,65236,977,66213
727,,onpjybzrurgj,47012,47013,94025
728,conf/sigmod/goldmanw00,,65095,836,65931
729,,ol886ck3jz4j,46936,46937,93873
730,conf/sigmod/gorelikwd94,,66070,1811,67881
731,,1qvhrpz7kbgj,46933,46934,93867
732,conf/sigmod/rafieim97,,65584,1325,66909
733,,hd2lugurqeyj,46869,46870,93739
734,,cr7xwkidcnyj,46790,46791,93581
735,conf/sigmod/vaskevitch94,,66001,1742,67743
736,journals/sigmod/qian96a,,64922,663,65585
737,,url:http://portal.acm.org/ft_gateway.cfm3fid3d23490326type3dpdf26dl3dguide26dl3dacm26cfid3d1111111126cftoken3d2222222,46782,46783,93565
738,conf/sigmod/babcocko03,,64455,196,64651
739,,acnzsolhfywj,46740,46741,93481
740,journals/vldb/shethtp03,,66718,2459,69177
741,,trekvtmb7pcj,46641,46642,93283
742,,sfmnhrhoqzgj,46625,46626,93251
743,conf/sigmod/brodskyk95,,65838,1579,67417
744,,77sb5mlyasgj,46613,46614,93227
745,conf/vldb/chaudhurigs95,,64271,12,64283
746,conf/sigmod/bunemanm95,,65884,1625,67509
747,,v9difmu3vi8j,46609,46610,93219
748,journals/sigmod/kumar03,,66138,1879,68017
749,,vunnpxjwvqkj,46607,46608,93215
750,,7vslb0yit3yj,46488,46489,92977
751,conf/sigmod/zhusz03,,64679,420,65099
752,conf/vldb/lerners03,,66361,2102,68463
753,,ktkbm7ohxrej,4636,4637,9273
754,,6iobooxjvqij,46314,46315,92629
755,conf/vldb/rahmm95,,66217,1958,68175
756,,uldehvmigfaj,46300,46301,92601
757,conf/vldb/mohan02a,,66411,2152,68563
758,,qxshx7aniuej,46234,46235,92469
759,conf/sigmod/reveszckllw00,,65159,900,66059
760,conf/vldb/duranti01,,65525,1266,66791
761,,gqw6iyg5vh0j,46091,46092,92183
762,,gckqtlqjsj8j,46087,46088,92175
763,conf/vldb/dattart99,,65741,1482,67223
764,journals/sigmod/cerifp99,,64718,459,65177
765,,zcbdzvfxwhaj,45994,45995,91989
766,,o0wqjrybq5kj,45859,45860,91719
767,conf/vldb/taops02,,66482,2223,68705
768,conf/vldb/sarawagi95,,64364,105,64469
769,,w9je55hjolwj,45845,45846,91691
770,conf/vldb/agrawalksx02,,66469,2210,68679
771,,xk-kpra2qjcj,45765,45766,91531
772,conf/sigmod/toyama98,,65478,1219,66697
773,,h4oqc4n4kjij,45732,45733,91465
774,journals/sigmod/dogac96,,64913,654,65567
775,,url:http://portal.acm.org/citation.cfm3fid3d234889.23490026dl3dguide26dl3dacm26idx3dj68926part3dperiodical26wanttype3dperiodical26title3dacm2520sigmod2520record26cfid3d1111111126cftoken3d2222222,45731,45732,91463
776,journals/tods/chog03,,65165,906,66071
777,,hqawyub11loj,45387,45388,90775
778,journals/sigmod/snodgrass03c,,66096,1837,67933
779,,url:http://portal.acm.org/ft_gateway.cfm3fid3d95906226type3dpdf26dl3dguide26dl3dacm26cfid3d1111111126cftoken3d2222222,45363,45364,90727
780,conf/sigmod/lehnerspc00,,65155,896,66051
781,,ufkz6q0wvi4j,45170,45171,90341
782,,mg0a5yz-_wyj,45160,45161,90321
783,conf/vldb/roussopoulosk98,,66038,1779,67817
784,journals/sigmod/danish98,,64686,427,65113
785,,mkzyopzargcj,44893,44894,89787
786,,nwwvf5fgx4qj,44827,44828,89655
787,journals/vldb/steinbrunnmk97,,66672,2413,69085
788,,7bgxvuviuvoj,44712,44713,89425
789,conf/vldb/baumannfrw97,,65965,1706,67671
790,journals/vldb/halkidinvv03,,66550,2291,68841
791,,j0hrpruvsgmj,44546,44547,89093
792,,zwp_jdeq8mgj,44541,44542,89083
793,conf/vldb/pound99,,65705,1446,67151
794,journals/sigmod/dogacaod95,,65033,774,65807
795,,ououtmrb0esj,4429,4430,8859
796,conf/vldb/suciu96a,,66253,1994,68247
797,,tjtsq968rwgj,44274,44275,88549
798,,lkrewul_euyj,44271,44272,88543
799,journals/sigmod/bunemanlstw94,,65267,1008,66275
800,journals/sigmod/ritter98,,64656,397,65053
801,,mzqmeyggt_ij,44152,44153,88305
802,,e0gh54hirssj,44135,44136,88271
803,journals/sigmod/rashids00,,64598,339,64937
804,,_oimkpnidhsj,43544,43545,87089
805,conf/vldb/zous98,,66000,1741,67741
806,conf/sigmod/mogik96,,65674,1415,67089
807,,hxwb8uqmcdgj,43498,43499,86997
808,journals/sigmod/mchughagqw97,,64829,570,65399
809,,fuxcnb3hhi4j,43469,43470,86939
810,,i1xhta3f3msj,43364,43365,86729
811,conf/vldb/baumgartnerfg01,,65298,1039,66337
812,,y2dz5crja_ij,43359,43360,86719
813,journals/tods/melnikg03,,65191,932,66123
814,conf/vldb/papadiasmd98,,65911,1652,67563
815,,7vbpci-dbawj,43287,43288,86575
816,,m2ccumfeawgj,43258,43259,86517
817,journals/sigmod/hasanfv96,,64911,652,65563
818,conf/sigmod/han96,,65703,1444,67147
819,,dlqd7wikvf0j,43257,43258,86515
820,conf/vldb/arunj98,,66026,1767,67793
821,,1dqemkscm74j,4307,4308,8615
822,conf/vldb/padmanabhan96,,66110,1851,67961
823,,1ijlmvlbfc0j,43047,43048,86095
824,,s0v9b-k8owej,4289,4290,8579
825,conf/vldb/bertinobfs96,,66860,2601,69461
826,,ggyahg9kwysj,42863,42864,85727
827,conf/vldb/baumgartnerfg01a,,65492,1233,66725
828,conf/vldb/jaedickem99,,65672,1413,67085
829,,zh6yaox2xiqj,42790,42791,85581
830,,p_pdgjvrus4j,42577,42578,85155
831,conf/sigmod/guosbs03,,64520,261,64781
832,journals/sigmod/silberschatzsu96,,64933,674,65607
833,,_zsi_bvijmwj,42508,42509,85017
834,journals/sigmod/suress02,,64366,107,64473
835,,a-owmulbkooj,42407,42408,84815
836,,qizj09n-qr8j,4233,4234,8467
837,journals/sigmod/tank03,,66116,1857,67973
838,conf/vldb/lim01,,65305,1046,66351
839,,vkmywc5tzugj,42183,42184,84367
840,,2pc6rkyb8ykj,42135,42136,84271
841,conf/vldb/gotok02,,66398,2139,68537
842,journals/sigmod/rafanellibt96,,64997,738,65735
843,,mfwzubavpfuj,42134,42135,84269
844,,gdvzvvrtxiaj,42121,42122,84243
845,conf/vldb/lamkr02,,66424,2165,68589
846,,pmivkwj5_v4j,41764,41765,83529
847,journals/sigmod/snodgrass03b,,66157,1898,68055
848,,pgix0qz6uz4j,41750,41751,83501
849,conf/sigmod/guptahr97,,65661,1402,67063
850,,_ebkupc1jyaj,41734,41735,83469
851,conf/sigmod/andersonaf98,,65533,1274,66807
852,conf/vldb/helmernm03,,66273,2014,68287
853,,8-hpan0xpjcj,41703,41704,83407
854,conf/vldb/jermaine03,,66291,2032,68323
855,,393zqh9szo0j,41567,41568,83135
856,journals/sigmod/jannink95,,65085,826,65911
857,,22yr9rn5xuqj,41551,41552,83103
858,conf/sigmod/cerifp98,,65505,1246,66751
859,,iuga3pkj-20j,41496,41497,82993
860,journals/sigmod/qian97,,64984,725,65709
861,,url:http://portal.acm.org/citation.cfm3fid3d248603.24861826dl3dguide26dl3dacm26idx3dj68926part3dperiodical26wanttype3dperiodical26title3dacm2520sigmod2520record26cfid3d1111111126cftoken3d2222222,41450,41451,82901
862,journals/vldb/nanopoulosm02,,66705,2446,69151
863,,icowjiz_6iij,41449,41450,82899
864,journals/tods/bunemano96,,66526,2267,68793
865,,,41267,41268,82535
866,journals/vldb/baumann94,,66803,2544,69347
867,,2yii02idzcuj,41086,41087,82173
868,,m1eeqnywl0oj,41082,41083,82165
869,conf/vldb/campbell99,,65711,1452,67163
870,,l5_h15lkpcsj,4094,4095,8189
871,conf/vldb/hulgeris03,,66264,2005,68269
872,,sutdmv9xsicj,4091,4092,8183
873,conf/vldb/vieiram03,,66270,2011,68281
874,,mjaw_2c6eraj,40898,40899,81797
875,conf/vldb/skubiszewskiv97,,65941,1682,67623
876,,ewnl82c8kimj,40830,40831,81661
877,conf/sigmod/daregp98,,65449,1190,66639
878,,qtzv3inq2o8j,40745,40746,81491
879,journals/sigmod/bargal02,,64267,8,64275
880,conf/sigmod/aulakh98,,65378,1119,66497
881,,xfk4ckkj14ej,40689,40690,81379
882,,9rbctpoednuj,40632,40633,81265
883,conf/vldb/linlyz03,,66260,2001,68261
884,,knydz76c_hsj,40403,40404,80807
885,journals/sigmod/huyn01,,64438,179,64617
886,journals/tods/kemmea00,,66585,2326,68911
887,,wiupadlpcvoj,40366,40367,80733
888,,7p1lldstrgyj,40173,40174,80347
889,conf/vldb/chakrabartim00,,65651,1392,67043
890,conf/sigmod/adelberggk95,,65807,1548,67355
891,,nblabagwoh4j,40084,40085,80169
892,conf/sigmod/grust02,,64652,393,65045
893,,fyfyf-sjqnij,40077,40078,80155
894,conf/vldb/bestavrosb95,,64318,59,64377
895,,lgyhpspv6ogj,39872,39873,79745
896,conf/vldb/hasanm95,,66229,1970,68199
897,,,39814,39815,79629
898,conf/sigmod/thapergik02,,64762,503,65265
899,,pbwqfdiq79uj,39801,39802,79603
900,journals/vldb/poulovassiliss96,,66765,2506,69271
901,,b87s9mftez8j,39601,39602,79203
902,,epbltcj0_duj,39599,39600,79199
903,conf/vldb/mattos96,,66851,2592,69443
904,,j7y20fylgbcj,39485,39486,78971
905,journals/sigmod/clementlgmk97,,64808,549,65357
906,conf/vldb/cowleyp00,,65606,1347,66953
907,,kgefsgtirosj,39426,39427,78853
908,,url:http://portal.acm.org/ft_gateway.cfm3fid3d24590626type3dpdf26dl3dguide26dl3dacm26cfid3d1111111126cftoken3d2222222,39374,39375,78749
909,journals/sigmod/sidell96,,65018,759,65777
910,journals/sigmod/bergamaschicv99,,64701,442,65143
911,,4c9a2hgs4qsj,39335,39336,78671
912,journals/sigmod/seligman97,,64801,542,65343
913,,url:http://portal.acm.org/citation.cfm3fid3d601858.60187226dl3dguide26dl3dacm26type3dissue26idx3dj68926part3dperiodical26wanttype3dperiodical26title3dacm2520sigmod2520record26cfid3d1111111126cftoken3d2222222,39216,39217,78433
914,,aatonnelw78j,39143,39144,78287
915,journals/sigmod/eisenbergm98a,,64655,396,65051
916,conf/vldb/sarawagi00,,65624,1365,66989
917,,z5dmaobjsjaj,3911,3912,7823
918,journals/tods/muralidhars99,,66579,2320,68899
919,,dkvepapybmcj,39058,39059,78117
920,,gefy87ma0xuj,38990,38991,77981
921,conf/vldb/subietakl95,,64266,7,64273
922,,706pcmwa_e4j,38855,38856,77711
923,journals/sigmod/halevy03,,66163,1904,68067
924,,ua-e1lbgle0j,38768,38769,77537
925,journals/sigmod/ramdd99,,64752,493,65245
926,,tzsvvmiihqej,38392,38393,76785
927,conf/sigmod/karbharirxd02,,64732,473,65205
928,conf/sigmod/agrawalcd02,,64728,469,65197
929,,iabzel2zoz8j,38381,38382,76763
930,,kopz_nxj3wuj,38347,38348,76695
931,conf/sigmod/englert94,,66053,1794,67847
932,,hcszil0nuvej,38247,38248,76495
933,conf/vldb/blecken00,,65549,1290,66839
934,,ivmj4bk708kj,38107,38108,76215
935,conf/sigmod/lazaridism01,,64953,694,65647
936,,v-kvo2hnsgkj,38051,38052,76103
937,conf/vldb/graefebc98,,65883,1624,67507
938,,jszfxags4pgj,38046,38047,76093
939,conf/sigmod/bertinocf01,,64938,679,65617
940,conf/vldb/bouganimp02,,66466,2207,68673
941,,pherwocokogj,38023,38024,76047
942,conf/sigmod/zhangrl96,,65679,1420,67099
943,,hk9p76djfcaj,37932,37933,75865
944,conf/sigmod/ojjeh99,,65287,1028,66315
945,,url:http://portal.acm.org/ft_gateway.cfm3fid3d30424526type3dpdf26dl3dguide26dl3dacm26cfid3d1111111126cftoken3d2222222,3787,3788,7575
946,,ah9b3bwu0jej,37770,37771,75541
947,conf/sigmod/georgeh97,,65667,1408,67075
948,,zworcqffsq8j,37597,37598,75195
949,journals/sigmod/caleropr03,,66227,1968,68195
950,,bymq_6ssse4j,37534,37535,75069
951,conf/sigmod/zhangnbb94,,65962,1703,67665
952,,plitmluijyyj,37425,37426,74851
953,journals/sigmod/gardels97,,64977,718,65695
954,,rkckzi1v0-0j,37344,37345,74689
955,journals/tods/ciacciatz96,,66534,2275,68809
956,,hcykj7chbwyj,37130,37131,74261
957,conf/vldb/wangym97,,66128,1869,67997
958,,h5idn0_mqw4j,37105,37106,74211
959,conf/sigmod/chaudhuriggm03,,64615,356,64971
960,conf/vldb/yagoubfiv00,,65463,1204,66667
961,,195hlqu94qej,36997,36998,73995
962,,elf0estn5g4j,36933,36934,73867
963,journals/sigmod/orlandicls02,,64310,51,64361
964,conf/sigmod/fegaras98,,65460,1201,66661
965,,xvtljyx2g_wj,36928,36929,73857
966,conf/vldb/kossmannrr02,,66477,2218,68695
967,,iglztgiste4j,36853,36854,73707
968,,ttv6gglq9nmj,36636,36637,73273
969,conf/sigmod/darr94,,65999,1740,67739
970,journals/tods/kossmanns00,,66575,2316,68891
971,,pngvbzqcwy0j,36611,36612,73223
972,conf/vldb/flodinr95,,64282,23,64305
973,,wmtidgy_bdoj,36537,36538,73075
974,,2dilfd0rgpgj,36467,36468,72935
975,conf/vldb/deshpande00,,65560,1301,66861
976,conf/sigmod/vancem96,,65685,1426,67111
977,,cmmamlywgpkj,36363,36364,72727
978,conf/vldb/ferrandinamz94,,64405,146,64551
979,,yq2tmz92gaij,36341,36342,72683
980,conf/vldb/lul00,,65471,1212,66683
981,,ih5hy-nrmfgj,36309,36310,72619
982,,vadxnmtpz4oj,36293,36294,72587
983,conf/vldb/mignetmac01,,65348,1089,66437
984,,jrxukm3e_foj,36237,36238,72475
985,journals/sigmod/englertgh95,,65096,837,65933
986,,ayje-iluhaoj,36175,36176,72351
987,journals/tods/liuhd98,,66612,2353,68965
988,,hbol6dafumyj,36165,36166,72331
989,conf/vldb/kornmz03,,66376,2117,68493
990,,ouisl_yuscyj,35951,35952,71903
991,journals/sigmod/leef01,,64468,209,64677
992,conf/vldb/lempelm02,,66484,2225,68709
993,,dcsygpdhxwoj,35851,35852,71703
994,,nqshgztslaoj,35831,35832,71663
995,journals/tods/meo00,,66586,2327,68913
996,,efwtno1wrnmj,35791,35792,71583
997,conf/sigmod/roussopouloskv95,,65844,1585,67429
998,,url:http://portal.acm.org/citation.cfm3fid3d673137,35780,35781,71561
999,conf/vldb/bassiliadesv95,,66219,1960,68179
1000,journals/tods/chomicki03,,65166,907,66073
1001,,phul-9khwh0j,35774,35775,71549
1002,journals/vldb/panagosb97,,66669,2410,69079
1003,,ht4yl1kjuxij,35757,35758,71515
1004,journals/sigmod/yeunghl94,,65274,1015,66289
1005,,yqv94p3te1ij,35669,35670,71339
1006,,rwfbclnj7_yj,35582,35583,71165
1007,journals/sigmod/ashishk97,,64784,525,65309
1008,conf/vldb/kleewein96,,66844,2585,69429
1009,,rxacsxty6aaj,35576,35577,71153
1010,conf/vldb/jermainedo99,,65766,1507,67273
1011,,eawaezvwj4gj,35551,35552,71103
1012,journals/tods/tariss97,,66606,2347,68953
1013,,wgaad7ctrnmj,35513,35514,71027
1014,journals/tods/cliffordc94,,66558,2299,68857
1015,,oy6bjhhbz2cj,35498,35499,70997
1016,,h1e3guqcouaj,35378,35379,70757
1017,conf/sigmod/hullz96,,65708,1449,67157
1018,,77mq-gn4liaj,35293,35294,70587
1019,journals/sigmod/meltzerc98,,64649,390,65039
1020,,9nmg2kcklecj,35284,35285,70569
1021,conf/vldb/amer-yahiacd98,,65908,1649,67557
1022,,raoqg4yyzm4j,35092,35093,70185
1023,journals/sigmod/busslerfm02,,66867,2608,69475
1024,,mgg31wuhuuij,35072,35073,70145
1025,journals/sigmod/palpanas00,,64552,293,64845
1026,,faz2kwztkloj,34910,34911,69821
1027,conf/vldb/konopnickis95,,64309,50,64359
1028,conf/vldb/aksoyzf01,,65354,1095,66449
1029,,z6z1hqyhtamj,34698,34699,69397
1030,journals/sigmod/ailamakig03,,66840,2581,69421
1031,,url:http://portal.acm.org/ft_gateway.cfm3fid3d77700426type3dpdf26dl3dguide26dl3dacm26cfid3d1111111126cftoken3d2222222,34630,34631,69261
1032,,e_cqlx3k0w4j,34510,34511,69021
1033,journals/vldb/bunemanfs00,,66654,2395,69049
1034,,krhyzelneoij,34407,34408,68815
1035,conf/sigmod/tomasicgs94,,66025,1766,67791
1036,,fcb_7jx0pomj,34369,34370,68739
1037,conf/vldb/amer-yahiafsx03,,66332,2073,68405
1038,conf/vldb/fegarase01,,65309,1050,66359
1039,,pinpem3rvm0j,34318,34319,68637
1040,conf/vldb/shenker03,,66327,2068,68395
1041,,5yetse57mzgj,34293,34294,68587
1042,conf/vldb/sacks-davis96,,66209,1950,68159
1043,,gkinzg_iffaj,34153,34154,68307
1044,,lwvwahlsyyyj,3406,3407,6813
1045,conf/vldb/garcia-molinaly98,,65921,1662,67583
1046,,url:http://portal.acm.org/ft_gateway.cfm3fid3d24590926type3dpdf26dl3dguide26dl3dacm26cfid3d1111111126cftoken3d2222222,3400,3401,6801
1047,journals/sigmod/qian96b,,65025,766,65791
1048,,j3cfnmfb4lsj,33964,33965,67929
1049,conf/vldb/santinig02,,66423,2164,68587
1050,,tqzwee_nsa0j,33684,33685,67369
1051,conf/sigmod/faginks03,,64469,210,64679
1052,,qxtgovscf78j,33670,33671,67341
1053,conf/sigmod/deutschfs99,,65327,1068,66395
1054,journals/sigmod/ioannidis96,,64980,721,65701
1055,,igqsvaud8bij,33669,33670,67339
1056,,7f9icgggyvgj,33504,33505,67009
1057,journals/sigmod/wong95,,65141,882,66023
1058,,dd4qumoxnpej,33380,33381,66761
1059,conf/sigmod/guhars98,,65393,1134,66527
1060,,yxxd9dexoagj,33367,33368,66735
1061,journals/vldb/seshadri98,,66691,2432,69123
1062,,_2hj6sns3foj,33296,33297,66593
1063,conf/sigmod/mohann94,,65961,1702,67663
1064,journals/sigmod/pusw01,,64643,384,65027
1065,,nkw4in6jqfaj,33211,33212,66423
1066,conf/vldb/chakrabartisd98,,66008,1749,67757
1067,,wnke8ff8hyuj,33149,33150,66299
1068,conf/vldb/bamfordap99,,65770,1511,67281
1069,,2y9m1qzvu4ej,33144,33145,66289
1070,,hlhxdvhzlvwj,33037,33038,66075
1071,conf/sigmod/kornm00,,65118,859,65977
1072,,z9mqwq7g3gyj,32922,32923,65845
1073,conf/sigmod/mamoulisp99,,65223,964,66187
1074,journals/sigmod/grayg97,,64790,531,65321
1075,,ffcqy9v5xngj,3292,3293,6585
1076,,jlngghvj438j,3272,3273,6545
1077,conf/vldb/xieh94,,64512,253,64765
1078,journals/sigmod/reichb98,,64662,403,65065
1079,,hzozxa_vjk8j,32707,32708,65415
1080,,mswqieweeguj,32588,32589,65177
1081,conf/sigmod/jaedickem98,,65442,1183,66625
1082,conf/sigmod/papakonstantinoupv02,,64786,527,65313
1083,,5xmfwqndii8j,32586,32587,65173
1084,,kvev4thh4cgj,32574,32575,65149
1085,conf/sigmod/srikanta96,,65698,1439,67137
1086,journals/vldb/papadiass94,,66802,2543,69345
1087,,um0nh_l5epoj,32555,32556,65111
1088,,y_h9p9lqj3ij,32541,32542,65083
1089,conf/sigmod/reinwaldp98,,65513,1254,66767
1090,,tbz0j3hli18j,32501,32502,65003
1091,journals/sigmod/kappelr98,,64863,604,65467
1092,,nwwpgh3mx7mj,32495,32496,64991
1093,conf/sigmod/hanwdpw02,,64731,472,65203
1094,,6nbnx8nsta0j,32490,32491,64981
1095,journals/sigmod/zobelmr96,,65022,763,65785
1096,conf/vldb/deutschpt99,,65671,1412,67083
1097,,0ajoxaunqyij,32461,32462,64923
1098,,aomma8tnfkij,32381,32382,64763
1099,conf/vldb/kornacker99,,65745,1486,67231
1100,journals/vldb/pottingerh01,,66758,2499,69257
1101,,kv3zfrukcogj,3216,3217,6433
1102,,uzvc1wsi3y4j,32125,32126,64251
1103,journals/tods/deys96,,66529,2270,68799
1104,,khi1yotbmlkj,32035,32036,64071
1105,conf/vldb/murthyb03,,66278,2019,68297
1106,,c7vuxp5kvsaj,31973,31974,63947
1107,conf/vldb/pantisg00,,65418,1159,66577
1108,,hzoxzj6x2xuj,31817,31818,63635
1109,journals/sigmod/winslett94,,65158,899,66057
1110,conf/vldb/treschpl95,,64275,16,64291
1111,,1rpuqmfss3aj,3178,3179,6357
1112,journals/tods/suciu02,,66596,2337,68933
1113,,y7khphu3np0j,31694,31695,63389
1114,conf/sigmod/gravanogt94,,66004,1745,67749
1115,,h6fwl-csuy4j,31683,31684,63367
1116,conf/vldb/pappasc00,,65423,1164,66587
1117,,url:http://portal.acm.org/citation.cfm3fid3d645926.671850,31636,31637,63273
1118,,h_tzr6yojlej,31387,31388,62775
1119,conf/sigmod/hanplj01,,64870,611,65481
1120,journals/tods/taop03,,65209,950,66159
1121,,faqax7j_kl8j,31226,31227,62453
1122,,zso1y5w7wkwj,31188,31189,62377
1123,journals/sigmod/libkin99,,64760,501,65261
1124,,qexcem3qaugj,31119,31120,62239
1125,journals/tods/chen95a,,66517,2258,68775
1126,conf/vldb/balminpp00,,65638,1379,67017
1127,,foavdcye0tsj,30867,30868,61735
1128,journals/vldb/yangw03,,66544,2285,68829
1129,,7waqngnv1l4j,30779,30780,61559
1130,journals/sigmod/han98,,64884,625,65509
1131,,y0gdvvrbzfqj,30665,30666,61331
1132,conf/sigmod/royssb00,,65048,789,65837
1133,,ozhs88jhgdkj,30443,30444,60887
1134,journals/sigmod/ngh95,,65086,827,65913
1135,,url:http://portal.acm.org/citation.cfm3fid3d202660.20266526dl3dguide26dl3dacm26idx3dj68926part3dperiodical26wanttype3dperiodical26title3dacm2520sigmod2520record26cfid3d1111111126cftoken3d2222222,30338,30339,60677
1136,,d1h_johvya4j,30275,30276,60551
1137,conf/sigmod/olstonjw03,,64550,291,64841
1138,,ghz2pmqww2uj,30158,30159,60317
1139,conf/vldb/shivakumargc98,,65902,1643,67545
1140,,7xra4pixriij,30097,30098,60195
1141,conf/sigmod/moonsl00,,65059,800,65859
1142,,iuyrrjjdbcij,29989,29990,59979
1143,conf/vldb/zhus02,,66487,2228,68715
1144,conf/sigmod/agrawals00,,65143,884,66027
1145,,ufpubsn4eg0j,29958,29959,59917
1146,,ozgnxuggcwmj,29909,29910,59819
1147,conf/vldb/kilgerm94,,64413,154,64567
1148,journals/sigmod/floresculm98,,64843,584,65427
1149,,_sr_prtna6ij,29829,29830,59659
1150,,kj26gup0pyij,29773,29774,59547
1151,journals/sigmod/babuw01,,64437,178,64615
1152,,dm9hrpkpqmmj,29747,29748,59495
1153,journals/vldb/zezulasar98,,66651,2392,69043
1154,conf/sigmod/whitecf98,,65371,1112,66483
1155,,torqjzetkvmj,29692,29693,59385
1156,conf/vldb/torlonea03,,66292,2033,68325
1157,,v6kudd3iteoj,29647,29648,59295
1158,,kaf2duuvabij,29629,29630,59259
1159,conf/sigmod/brunoc02,,64764,505,65269
1160,conf/sigmod/liefkes00,,65120,861,65981
1161,,vnc0ml_3bfsj,29612,29613,59225
1162,,lxjsnbxb7esj,29594,29595,59189
1163,conf/vldb/flescafm03,,66346,2087,68433
1164,conf/sigmod/ponnekantik00,,65153,894,66047
1165,,iddfq2o4zsoj,29490,29491,58981
1166,conf/vldb/tsur00,,65443,1184,66627
1167,,bui2v0eiczoj,29458,29459,58917
1168,,xtkz6ouegiej,29457,29458,58915
1169,conf/vldb/hallmark95,,64385,126,64511
1170,conf/sigmod/blohsfeldks99,,65210,951,66161
1171,,pqbi3parh84j,29365,29366,58731
1172,conf/vldb/brin95,,64367,108,64475
1173,,dxegp-rmzxej,29302,29303,58605
1174,,w-6r_ooehluj,29284,29285,58569
1175,conf/sigmod/chong98,,65531,1272,66803
1176,conf/sigmod/christophidesacs94,,65979,1720,67699
1177,,dgbuukhwnhmj,29243,29244,58487
1178,,bw_c9mk0_7ij,29207,29208,58415
1179,conf/sigmod/bersongmj94,,66017,1758,67775
1180,,fp-ribg9ovsj,29172,29173,58345
1181,journals/sigmod/colliat96,,64918,659,65577
1182,,fjn_2e8aihyj,28947,28948,57895
1183,conf/vldb/kumarrrt99,,65736,1477,67213
1184,conf/vldb/wanghh00,,65654,1395,67049
1185,,qbxhq9qxvruj,28698,28699,57397
1186,,xppwyyxopksj,28173,28174,56347
1187,conf/sigmod/mohan99,,65250,991,66241
1188,,4weou-kgkm8j,28168,28169,56337
1189,conf/vldb/agrawalk02,,66468,2209,68677
1190,conf/sigmod/dohertyhr96,,65787,1528,67315
1191,,v3ia8go4ujij,27850,27851,55701
1192,,ery6k1e8h_sj,27830,27831,55661
1193,conf/sigmod/squire95,,65832,1573,67405
1194,journals/vldb/fahlr97,,66693,2434,69127
1195,,zxscj9lzz8cj,27809,27810,55619
1196,,wbsak4ze17yj,27648,27649,55297
1197,journals/sigmod/papazoglouh99,,64711,452,65163
1198,,_avm808lqocj,27626,27627,55253
1199,journals/sigmod/kosch02,,64272,13,64285
1200,conf/vldb/qianzxp03,,66371,2112,68483
1201,,chp-3uwmgtqj,27519,27520,55039
1202,,url:http://portal.acm.org/ft_gateway.cfm3fid3d20267126type3dpdf26dl3dguide26dl3dacm26cfid3d1111111126cftoken3d2222222,27451,27452,54903
1203,journals/sigmod/jarke95,,65089,830,65919
1204,journals/sigmod/bertram94,,65071,812,65883
1205,,qasgl5tvq1aj,27444,27445,54889
1206,,rrh6z1op78cj,27428,27429,54857
1207,journals/tods/beneventanobs03,,65219,960,66179
1208,conf/sigmod/hanks97,,65583,1324,66907
1209,,nd_yjp9tnuij,27414,27415,54829
1210,,qhn6nrbvow8j,27349,27350,54699
1211,journals/vldb/sciore94,,66819,2560,69379
1212,,pvm9r7whzdaj,27277,27278,54555
1213,journals/sigmod/gallagher94,,65186,927,66113
1214,conf/sigmod/cohen98,,65427,1168,66595
1215,,psq-qyd4aiaj,27069,27070,54139
1216,,kxebbnlkwl4j,27038,27039,54077
1217,conf/vldb/scheuermannsv96,,66090,1831,67921
1218,,c6lzpzswbkaj,27006,27007,54013
1219,journals/sigmod/rosenthals99,,64750,491,65241
1220,conf/sigmod/tajima96,,65777,1518,67295
1221,,izszllgi8tuj,2696,2697,5393
1222,,lrl4lmmtwnyj,26904,26905,53809
1223,conf/vldb/kotidis01,,65397,1138,66535
1224,conf/vldb/helall00,,65587,1328,66915
1225,,lpapcvy4rfkj,26832,26833,53665
1226,,wzt3s2g1fjcj,26773,26774,53547
1227,journals/vldb/abiteboulcm98,,66684,2425,69109
1228,,ic9nubu5xpoj,26652,26653,53305
1229,journals/vldb/kashyaps96,,66778,2519,69297
1230,conf/vldb/sullivan96,,66197,1938,68135
1231,,zgrq_2im_9mj,26565,26566,53131
1232,,jfmkt9kvkwoj,2646,2647,5293
1233,journals/sigmod/kempsterst99,,64521,262,64783
1234,,iljdcu_qodkj,26434,26435,52869
1235,conf/sigmod/chosg00,,65028,769,65797
1236,,epvkqkfm2osj,26376,26377,52753
1237,conf/vldb/johnsona00,,65621,1362,66983
1238,journals/vldb/catarcisc97,,66681,2422,69103
1239,,iiykl2ned3uj,26303,26304,52607
1240,,zw3-t-venvaj,26103,26104,52207
1241,journals/sigmod/fong95,,65124,865,65989
1242,journals/vldb/cuiw03,,66722,2463,69185
1243,,saod6rdz5zgj,26075,26076,52151
1244,conf/vldb/chaudhurin97,,65924,1665,67589
1245,,haqeljgacfsj,26069,26070,52139
1246,,urdwk2s7qvwj,2605,2606,5211
1247,conf/vldb/wiesnerk01,,65530,1271,66801
1248,,5aiesu9p7fij,26038,26039,52077
1249,journals/sigmod/kimballs95,,65049,790,65839
1250,conf/sigmod/adibey01,,65004,745,65749
1251,,3jui_yf4dfij,25994,25995,51989
1252,,2e-nagqt-joj,25897,25898,51795
1253,journals/tods/ammannjr97,,66608,2349,68957
1254,,f9pollecn2gj,25874,25875,51749
1255,conf/sigmod/seshadrip97,,65611,1352,66963
1256,,fdwfhiq6br4j,25811,25812,51623
1257,conf/sigmod/taop02,,64796,537,65333
1258,,url:http://portal.acm.org/ft_gateway.cfm3fid3d37574226type3dpdf26dl3dguide26dl3dacm26cfid3d1111111126cftoken3d2222222,25757,25758,51515
1259,conf/sigmod/maguire01,,64886,627,65513
1260,conf/vldb/huyn01,,65535,1276,66811
1261,,sbl4xw4mcewj,25678,25679,51357
1262,conf/vldb/ganguly98,,65901,1642,67543
1263,,a8cb2s6td-sj,2566,2567,5133
1264,conf/vldb/frohnlu94,,64340,81,64421
1265,,xpreqf8k7n4j,25608,25609,51217
1266,conf/vldb/mina98,,66043,1784,67827
1267,,butmjwjgxusj,256,257,513
1268,,kpta4iis_sgj,25594,25595,51189
1269,conf/vldb/ladin00,,65557,1298,66855
1270,,iq3zi3crc9wj,25469,25470,50939
1271,conf/vldb/grumbachrs00,,65647,1388,67035
1272,conf/vldb/agrawalsx02,,66426,2167,68593
1273,,a1clm5govtyj,25402,25403,50805
1274,,ut53pjesmxej,25338,25339,50677
1275,conf/vldb/toivonen96,,66828,2569,69397
1276,,g9dgyrd0cnmj,25320,25321,50641
1277,conf/vldb/sarawagibkm02,,66431,2172,68603
1278,,6mofnthdhw0j,25282,25283,50565
1279,conf/vldb/staudtj96,,66088,1829,67917
1280,conf/vldb/moerkotte02,,66464,2205,68669
1281,,jigdthcreckj,25028,25029,50057
1282,,0hmk-yuh4i8j,25,26,51
1283,journals/sigmod/stonebraker02,,64505,246,64751
1284,,gq6d6zmepxoj,24969,24970,49939
1285,journals/tods/alagic99,,66629,2370,68999
1286,,yqqmvrrafbwj,2495,2496,4991
1287,journals/sigmod/arpinard00,,64566,307,64873
1288,,hnoti13kb_8j,24882,24883,49765
1289,journals/vldb/pucheralbvb01,,66753,2494,69247
1290,conf/vldb/venkataramanz98,,65800,1541,67341
1291,,kraybsajhzej,24870,24871,49741
1292,,z5rwzhbxteej,24775,24776,49551
1293,journals/tods/parsonsw00,,66573,2314,68887
1294,conf/vldb/seshadrilr97,,66133,1874,68007
1295,,kiznmorszkoj,2474,2475,4949
1296,,fi5o4mfwwzij,24659,24660,49319
1297,journals/sigmod/lomet01,,64396,137,64533
1298,,dyfiqvog7rgj,24544,24545,49089
1299,conf/sigmod/zous96,,65676,1417,67093
1300,,wtyq40rn_tuj,2443,2444,4887
1301,conf/vldb/ramaswamyms98,,65991,1732,67723
1302,journals/sigmod/eisenbergm00,,64527,268,64795
1303,,4md1efchkkwj,24354,24355,48709
1304,,7mnckz7d-r8j,24318,24319,48637
1305,conf/sigmod/brindg95,,65813,1554,67367
1306,journals/sigmod/tomasics97,,64966,707,65673
1307,,,24290,24291,48581
1308,conf/sigmod/laursenop94,,66081,1822,67903
1309,,ftbcv3lh8w0j,24276,24277,48553
1310,,bcj7boiqdc0j,24256,24257,48513
1311,conf/vldb/silversteinbmu98,,66011,1752,67763
1312,conf/sigmod/nybergbcgl94,,65980,1721,67701
1313,,kd-0q-m1o2gj,24168,24169,48337
1314,,ahu54top-eoj,24128,24129,48257
1315,conf/sigmod/faloutsosrm94,,65974,1715,67689
1316,,eybuiurx77sj,23941,23942,47883
1317,conf/vldb/fox02,,66400,2141,68541
1318,conf/vldb/eicklerkk97,,65944,1685,67629
1319,,pcfjuvxyxtwj,23796,23797,47593
1320,,url:http://portal.acm.org/citation.cfm3fid3d645927.672033,23664,23665,47329
1321,conf/vldb/wadler01,,66441,2182,68623
1322,,p1luspttxlaj,23596,23597,47193
1323,conf/sigmod/fegarassrm00,,65185,926,66111
1324,conf/sigmod/aboulnagac99,,65266,1007,66273
1325,,wwaxlmipttmj,23553,23554,47107
1326,conf/vldb/hjelsvoldm94,,64504,245,64749
1327,,eyncyx9rcfwj,23483,23484,46967
1328,conf/vldb/nipplm98,,65855,1596,67451
1329,,c5jvmnqie4ij,23473,23474,46947
1330,conf/vldb/novaretti01,,65373,1114,66487
1331,,tztnfoh5ly0j,23313,23314,46627
1332,conf/sigmod/goeli96,,65691,1432,67123
1333,,hd6w1ebfjwcj,23245,23246,46491
1334,,knaoaipo7hyj,23233,23234,46467
1335,conf/sigmod/deshpandegr01,,64950,691,65641
1336,,2ua-pwtof_yj,23191,23192,46383
1337,conf/sigmod/agrawalcn01,,64976,717,65693
1338,conf/sigmod/griffinh97,,65493,1234,66727
1339,,uwopyy_jchkj,23164,23165,46329
1340,,ffkp2grm2lej,23024,23025,46049
1341,conf/vldb/ananthakrishnacg02,,66500,2241,68741
1342,conf/vldb/linr98,,65835,1576,67411
1343,,9qhycgzqxc4j,22967,22968,45935
1344,journals/tods/ciacciap02,,65194,935,66129
1345,,dardziv5ve4j,2295,2296,4591
1346,journals/sigmod/bonifatic00,,64541,282,64823
1347,,xcdmixlp41ij,22935,22936,45871
1348,conf/sigmod/catarcis01,,65021,762,65783
1349,,frbexwv4diwj,22894,22895,45789
1350,,pbki-jcalcij,2287,2288,4575
1351,conf/sigmod/olstonw02,,64657,398,65055
1352,,rkjgge7xhn0j,22814,22815,45629
1353,conf/vldb/adibey00,,65578,1319,66897
1354,conf/vldb/mogik95,,64322,63,64385
1355,,39dbh8h18iej,22767,22768,45535
1356,conf/sigmod/acharyapr99,,65282,1023,66305
1357,,0dy1brfaezgj,22713,22714,45427
1358,conf/vldb/mihalisin98,,65825,1566,67391
1359,,fuzslpzjrokj,22711,22712,45423
1360,conf/vldb/sakuraiyku01,,65291,1032,66323
1361,,oqmyc3s0ny8j,22493,22494,44987
1362,,qcd01zjsncij,22158,22159,44317
1363,conf/vldb/spintzik95,,64386,127,64513
1364,,k7g60pxtd58j,22154,22155,44309
1365,conf/vldb/pardona00,,65461,1202,66663
1366,,4ij3fd2xnuyj,22049,22050,44099
1367,conf/vldb/srinivasak03,,66283,2024,68307
1368,,ebgzkqpyh_4j,21910,21911,43821
1369,conf/vldb/evangelidisls95,,64361,102,64463
1370,,x8fdhanksuij,21884,21885,43769
1371,conf/sigmod/agrawalggr98,,65389,1130,66519
1372,,danygpqtoqej,21833,21834,43667
1373,journals/sigmod/mchughw97,,64773,514,65287
1374,,2p2a5_qgf5cj,21798,21799,43597
1375,journals/sigmod/richey95,,65133,874,66007
1376,conf/vldb/uhl02,,66496,2237,68733
1377,,n5ssabtjbpaj,21733,21734,43467
1378,,f-v-vg2rbqoj,2162,2163,4325
1379,conf/vldb/browns95,,64301,42,64343
1380,,r_hyw6eiuuyj,21534,21535,43069
1381,conf/vldb/olstonw00,,65644,1385,67029
1382,,vcixh8qcrimj,2153,2154,4307
1383,conf/sigmod/nguyenacp01,,65026,767,65793
1384,,q4n41koenf8j,21294,21295,42589
1385,conf/sigmod/dord99,,65293,1034,66327
1386,journals/vldb/sakuraiyuk02,,66707,2448,69155
1387,,7j-rvgqd8smj,21291,21292,42583
1388,journals/sigmod/ouksel03,,66196,1937,68133
1389,,8m_z-oukoxyj,21220,21221,42441
1390,,x-h7bqz0hw8j,21170,21171,42341
1391,conf/vldb/ammannjr95,,64262,3,64265
1392,journals/tods/taosp03,,65161,902,66063
1393,,fbp7oibu4ygj,21138,21139,42277
1394,journals/tods/mamoulisp01,,66600,2341,68941
1395,,rg8v7nsk9tmj,2113,2114,4227
1396,,tote7iddlmmj,20949,20950,41899
1397,conf/sigmod/gehrkeks01,,65010,751,65761
1398,conf/vldb/faloutsosg96,,66083,1824,67907
1399,,vwcvawlojn0j,20898,20899,41797
1400,journals/tods/zobelmr98,,66626,2367,68993
1401,,tddlf6rffisj,20567,20568,41135
1402,,jjygke2n34gj,20464,20465,40929
1403,conf/vldb/pacittms99,,65794,1535,67329
1404,conf/sigmod/labrinidisr00,,65101,842,65943
1405,,dkuouekk_b4j,20437,20438,40875
1406,,3ozte0ucnjaj,20302,20303,40605
1407,conf/vldb/labrinidisr01,,65514,1255,66769
1408,journals/sigmod/chengp03,,66145,1886,68031
1409,,6fapr3uvx28j,20274,20275,40549
1410,,zn8ngmwndlgj,202,203,405
1411,conf/sigmod/arasug03,,64471,212,64683
1412,,3nmpg1vungwj,19954,19955,39909
1413,conf/sigmod/piatkoyls96,,65754,1495,67249
1414,,ygoujdrcozqj,19729,19730,39459
1415,journals/sigmod/sycarakwl99,,64709,450,65159
1416,,f86vsmjz9gaj,1969,1970,3939
1417,journals/sigmod/zhang95,,65050,791,65841
1418,,1lrzz4bzvxej,19680,19681,39361
1419,conf/sigmod/mayrs99,,65198,939,66137
1420,journals/vldb/shegalovgw01,,66734,2475,69209
1421,,_6ernqyzwxsj,19575,19576,39151
1422,,sarbinqppwqj,19469,19470,38939
1423,conf/vldb/atzenimm97,,66117,1858,67975
1424,,ga4l4qhcxu4j,19437,19438,38875
1425,conf/sigmod/catarcis94,,66109,1850,67959
1426,conf/vldb/celis96,,66200,1941,68141
1427,,bg5vcyrbkd8j,19327,19328,38655
1428,conf/vldb/hristidisp02,,66385,2126,68511
1429,,rzjlf9oq_hej,19061,19062,38123
1430,conf/vldb/mohan99,,65720,1461,67181
1431,,4n472vsotmmj,18980,18981,37961
1432,,eid4uo0kv04j,18906,18907,37813
1433,journals/sigmod/ramanathanh97,,64822,563,65385
1434,,zzo47z-jvx4j,18838,18839,37677
1435,conf/sigmod/adelberggw97,,65568,1309,66877
1436,conf/vldb/diaolct00,,65622,1363,66985
1437,,lzbvxzxlkjij,1874,1875,3749
1438,,lovlkpxuzusj,18661,18662,37323
1439,conf/vldb/brightr02,,66503,2244,68747
1440,conf/sigmod/papadopoulosm98,,65414,1155,66569
1441,,dlzaj-i1nccj,18522,18523,37045
1442,conf/sigmod/christophidescm96,,65719,1460,67179
1443,,q3y-mlx2susj,18414,18415,36829
1444,,w5_hkketh-wj,18323,18324,36647
1445,conf/sigmod/theobaldw02,,64828,569,65397
1446,,4rrnbx-rjpsj,18298,18299,36597
1447,journals/tods/baralisw00,,66587,2328,68915
1448,,6njy0-27w5cj,18297,18298,36595
1449,journals/tods/baraliscp96,,66527,2268,68795
1450,conf/vldb/daregp98,,65810,1551,67361
1451,,d6gxih90yu4j,18216,18217,36433
1452,journals/sigmod/kiyokikh94,,65075,816,65891
1453,,xt3mwy4t5kej,18127,18128,36255
1454,conf/sigmod/godfreygxz01,,64897,638,65535
1455,,lnnvt5tpbhkj,17906,17907,35813
1456,conf/vldb/spaccapietra94,,64465,206,64671
1457,,zpvztb1a7voj,17664,17665,35329
1458,,n-o3npu-nbij,17629,17630,35259
1459,conf/vldb/savasereon95,,66213,1954,68167
1460,conf/vldb/hammond96,,66856,2597,69453
1461,,ldxivdru6eej,17572,17573,35145
1462,conf/sigmod/kotidisr99,,65203,944,66147
1463,,qzjtgdo7oumj,1755,1756,3511
1464,,8ftklh07lm0j,17414,17415,34829
1465,conf/vldb/catozzir95,,64380,121,64501
1466,conf/vldb/alsabtirs97,,65943,1684,67627
1467,,nqozsuydoqkj,17349,17350,34699
1468,conf/vldb/choenniv00,,65445,1186,66631
1469,,r1j3cdeolwsj,17296,17297,34593
1470,conf/vldb/maedat01,,65330,1071,66401
1471,,dipegptdsoqj,17280,17281,34561
1472,journals/tods/wolfsonjh97,,66609,2350,68959
1473,,flc-ff1hbbuj,17271,17272,34543
1474,,t1tgiax4zvcj,17150,17151,34301
1475,conf/vldb/wangsg03,,66314,2055,68369
1476,conf/sigmod/reissk03,,64568,309,64877
1477,,l1m30vg-d5sj,17058,17059,34117
1478,conf/sigmod/colletc95,,65936,1677,67613
1479,,vp27nkxi4mej,17019,17020,34039
1480,,rnvpclfguumj,16986,16987,33973
1481,conf/sigmod/bunemandhs96,,65713,1454,67167
1482,,vcsbj6mwklgj,16904,16905,33809
1483,conf/vldb/guptahq95,,66237,1978,68215
1484,,qybdbs7epmsj,16864,16865,33729
1485,conf/vldb/chakrabartidar97,,66168,1909,68077
1486,,4fjxochhe1kj,16695,16696,33391
1487,conf/sigmod/braumandlkk99,,65230,971,66201
1488,journals/sigmod/jhingran00,,64601,342,64943
1489,,lrgge6mtvckj,16668,16669,33337
1490,,ewsbmn0qva4j,16616,16617,33233
1491,conf/vldb/kornlkf98,,66005,1746,67751
1492,journals/sigmod/datta94,,65228,969,66197
1493,,pph2nlobswsj,16537,16538,33075
1494,,cbe5x4ekjiej,16502,16503,33005
1495,conf/vldb/hemyw03,,66360,2101,68461
1496,,9ai_9dzchg4j,16197,16198,32395
1497,journals/sigmod/dadamk97,,64794,535,65329
1498,journals/sigmod/lightstonelz02,,64351,92,64443
1499,,7tyvqtwq9fij,15949,15950,31899
1500,,4iawcbk6dmqj,1594,1595,3189
1501,conf/sigmod/shklarskt95,,65929,1670,67599
1502,journals/sigmod/bhargavaap95,,65116,857,65973
1503,,sql66udivnwj,15918,15919,31837
1504,conf/vldb/mohan01,,66428,2169,68597
1505,,tao-l_skmswj,15840,15841,31681
1506,conf/vldb/draluk01,,65374,1115,66489
1507,,xqzrilmr-qqj,15839,15840,31679
1508,conf/vldb/chiueh94,,64429,170,64599
1509,,nof-suseaaej,15512,15513,31025
1510,conf/vldb/sheikholeslamicz98,,65992,1733,67725
1511,,btydmrjmbqoj,15268,15269,30537
1512,conf/sigmod/team95b,,65947,1688,67635
1513,,v80ffbutw_0j,15231,15232,30463
1514,,i5fv3jpcrmaj,15217,15218,30435
1515,conf/vldb/dinggs00,,65417,1158,66575
1516,,bfcbzlt6vngj,15074,15075,30149
1517,conf/sigmod/adyaglm95,,65737,1478,67215
1518,,k6ukzru4nx8j,14757,14758,29515
1519,journals/tods/fukudammt01,,66592,2333,68925
1520,conf/sigmod/beyerr99,,65196,937,66133
1521,,6cdfxiuibd0j,14479,14480,28959
1522,,2k6rhx16hxwj,14373,14374,28747
1523,journals/sigmod/cingil02,,64490,231,64721
1524,,arle7w8evdoj,14319,14320,28639
1525,journals/sigmod/yaog02,,64326,67,64393
1526,conf/vldb/gravanog97,,66131,1872,68003
1527,,cdulyvaaxvsj,13995,13996,27991
1528,,fu9j50kk4y4j,1396,1397,2793
1529,journals/sigmod/bilirisp96,,64915,656,65571
1530,,5oyguprggimj,13886,13887,27773
1531,conf/sigmod/johnsond03,,64532,273,64805
1532,journals/tods/chakrabartikmp02,,65201,942,66143
1533,,ehy42lnl_lsj,13810,13811,27621
1534,,nl5wl20jb-kj,13722,13723,27445
1535,conf/vldb/lesk94,,64451,192,64643
1536,journals/sigmod/ailamakih03,,66176,1917,68093
1537,,url:http://portal.acm.org/ft_gateway.cfm3fid3d94572526type3dpdf26dl3dguide26dl3dacm26cfid3d1111111126cftoken3d2222222,13580,13581,27161
1538,journals/sigmod/grohe02,,64382,123,64505
1539,,jzwiskprlouj,13571,13572,27143
1540,conf/vldb/seshadrilr96,,66084,1825,67909
1541,,,13460,13461,26921
1542,,qvl2bcdayqej,13296,13297,26593
1543,journals/sigmod/griffink98,,64848,589,65437
1544,,nlyeh7gkrjoj,13239,13240,26479
1545,conf/vldb/vieille98,,65809,1550,67359
1546,conf/vldb/papakonstantinouag96,,66256,1997,68253
1547,,gkbvvgj8kduj,13168,13169,26337
1548,,,13147,13148,26295
1549,conf/vldb/kemmea00,,65457,1198,66655
1550,,nldvk5j0wwej,13119,13120,26239
1551,conf/vldb/zhous03,,66352,2093,68445
1552,,jgenqflqc1uj,1311,1312,2623
1553,journals/sigmod/vianu03,,66238,1979,68217
1554,,ikk1rb4o66uj,13103,13104,26207
1555,journals/sigmod/suciu02,,64507,248,64755
1556,journals/sigmod/vassilakis00,,64544,285,64829
1557,,nzo8za4eyzyj,12966,12967,25933
1558,journals/vldb/peckhammd95,,66807,2548,69355
1559,,zofvtngewz0j,12946,12947,25893
1560,,xaxf0hsf4h8j,12936,12937,25873
1561,journals/sigmod/neven02,,64333,74,64407
1562,conf/vldb/atal96,,66853,2594,69447
1563,,paw8zjinr9cj,12875,12876,25751
1564,,url:http://portal.acm.org/ft_gateway.cfm3fid3d22387226type3dpdf26dl3dguide26dl3dacm26cfid3d1111111126cftoken3d2222222,12728,12729,25457
1565,conf/sigmod/perna95,,65905,1646,67551
1566,,llp2fn3bzumj,12716,12717,25433
1567,conf/vldb/sterling98,,66020,1761,67781
1568,journals/vldb/eyalm01,,66761,2502,69263
1569,,ntrssbumclmj,12687,12688,25375
1570,conf/sigmod/leflersw96,,65704,1445,67149
1571,,4b12czc8qk4j,12483,12484,24967
1572,,xqykehcggzqj,12442,12443,24885
1573,conf/vldb/yangg01,,65352,1093,66445
1574,conf/vldb/cuppens96,,66866,2607,69473
1575,,8_htxom0cvgj,12368,12369,24737
1576,conf/vldb/longs03,,66344,2085,68429
1577,,zu4mulifrryj,12344,12345,24689
1578,conf/sigmod/vingralekbw94,,65982,1723,67705
1579,,rm8ecg1wl4kj,12324,12325,24649
1580,conf/sigmod/chengk01,,64963,704,65667
1581,,8ogkueiawo0j,12242,12243,24485
1582,conf/sigmod/gibbsbt94,,65956,1697,67653
1583,,is9rqqelsjmj,12107,12108,24215
1584,,b3pwhnu8y6ij,11952,11953,23905
1585,conf/vldb/johnson99,,65686,1427,67113
1586,journals/sigmod/halkidibv02,,64297,38,64335
1587,,ghjgdrebqm4j,11885,11886,23771
1588,journals/sigmod/suciu01,,64390,131,64521
1589,,_vovquzsv-gj,11736,11737,23473
1590,conf/vldb/shaferam96,,66874,2615,69489
1591,,5hhrnlsy0saj,11705,11706,23411
1592,conf/vldb/agrawalsx01,,65285,1026,66311
1593,,bpwvavozlbwj,11616,11617,23233
1594,journals/tods/kotidisr01,,66601,2342,68943
1595,,04utamfvle4j,11460,11461,22921
1596,journals/tods/taopz02,,65202,943,66145
1597,,cxbjwfndozaj,11367,11368,22735
1598,,higjgc6mx0cj,11353,11354,22707
1599,conf/sigmod/zhus03,,64635,376,65011
1600,journals/sigmod/hellersteinhm03,,66141,1882,68023
1601,,6ussagzdl6oj,11314,11315,22629
1602,conf/vldb/taylor00,,65660,1401,67061
1603,,af_4cncu3mwj,11309,11310,22619
1604,conf/sigmod/babcockbdm03,,64479,220,64699
1605,,a2wqpkma5j4j,1119,1120,2239
1606,conf/vldb/theodoratoss97,,65928,1669,67597
1607,,cvuc4rc5ju8j,11151,11152,22303
1608,,ofgtgwuhhuqj,11068,11069,22137
1609,conf/sigmod/chaudhurigs03,,64472,213,64685
1610,journals/vldb/gibsonkr00,,66664,2405,69069
1611,,9fbwt6xfossj,11046,11047,22093
1612,conf/vldb/banerjee00,,65441,1182,66623
1613,,owfpkt5ip68j,11036,11037,22073
1614,conf/vldb/morimotoim97,,65938,1679,67617
1615,,3enylshvol8j,11031,11032,22063
1616,conf/sigmod/keoghcmp01,,64992,733,65725
1617,,qtzuinlmnr4j,10941,10942,21883
1618,conf/vldb/pogue98,,66047,1788,67835
1619,,byljqg3ppngj,10912,10913,21825
1620,conf/vldb/sakuraiyuk00,,65602,1343,66945
1621,,k2xcmgimpvkj,10845,10846,21691
1622,,p--jtvlva8aj,10723,10724,21447
1623,journals/tods/kuo96,,66533,2274,68807
1624,,farbjw1op8yj,10686,10687,21373
1625,conf/vldb/cluet03,,66302,2043,68345
1626,,ro4-ya3tlfoj,10623,10624,21247
1627,conf/sigmod/acharyaafz95,,65799,1540,67339
1628,journals/tods/fraternalit95,,66523,2264,68787
1629,,8k0ts22xvpcj,10596,10597,21193
1630,,qcfuivkspywj,10564,10565,21129
1631,journals/tods/chaudhuris99,,66634,2375,69009
1632,,vjga5yc23kij,10513,10514,21027
1633,journals/tods/galindo-legariar97,,66536,2277,68813
1634,,fltkbg-bw7sj,10429,10430,20859
1635,journals/vldb/bonifaticp01,,66757,2498,69255
1636,journals/sigmod/qian94,,65278,1019,66297
1637,,url:http://portal.acm.org/ft_gateway.cfm3fid3d18746226type3dpdf26coll3dguide26dl3dacm26cfid3d1111111126cftoken3d2222222,10356,10357,20713
1638,,rgju30qjbhkj,1033,1034,2067
1639,journals/sigmod/fong97,,64821,562,65383
1640,journals/sigmod/musickc99,,64769,510,65279
1641,,ma4kkq9z3tyj,10203,10204,20407
1642,,jyycpqlrbw8j,60335,60336,120671
1643,conf/sigmod/fernandezms01,,64877,618,65495
1644,,ph7zpmdnopej,10594,10595,21189
1645,conf/vldb/meccacm01,,65296,1037,66333
1646,,rjb06zlxblij,42504,42505,85009
1647,conf/sigmod/abiteboulbcmm03,,64553,294,64847
1648,conf/sigmod/garofalakisgrss00,,65123,864,65987
1649,,5uvr4ku1uooj,10092,10093,20185
1650,conf/vldb/morimotofmty98,,65896,1637,67533
1651,,31yus02mfq8j,57394,57395,114789
1652,conf/vldb/bar-yossefbcfw00,,65415,1156,66571
1653,,,9671,9672,19343
1654,conf/vldb/ramsakmfzeb00,,65631,1372,67003
1655,,4fn0qeu0keaj,62482,62483,124965
1656,conf/vldb/abiteboulbmmw02,,66435,2176,68611
1657,,mm3mxwb8qs0j,49617,49618,99235
1658,,,49278,49279,98557
1659,conf/vldb/florescuklp97,,66119,1860,67979
1660,conf/sigmod/antonjlpzz02,,64820,561,65381
1661,,89p3ededuoej,37887,37888,75775
1662,,vitgygjdz3aj,47871,47872,95743
1663,journals/vldb/roysssa98,,66688,2429,69117
1664,,gbvvawwctcgj,4868,4869,9737
1665,conf/vldb/ginishkmt97,,65977,1718,67695
1666,,emczn8zxnjij,15135,15136,30271
1667,conf/vldb/chakrabartisst00,,65580,1321,66901
1668,conf/sigmod/zaharioudakisclpu00,,65044,785,65829
1669,,pbl_cblykwyj,4980,4981,9961
1670,,c22l_wx_adwj,33368,33369,66737
1671,conf/vldb/manolescufkxo00,,65424,1165,66589
1672,,ebmulqbhqzej,47235,47236,94471
1673,conf/sigmod/altinelabfsz99,,65235,976,66211
1674,,5otqgz1gb18j,2498,2499,4997
1675,conf/sigmod/deolaseekprs01,,64910,651,65561
1676,,d8bbxc5ato8j,41624,41625,83249
1677,conf/vldb/koudasggsv03,,66267,2008,68275
1678,,1xo59nofvkoj,18351,18352,36703
1679,conf/vldb/carusocglm00,,65585,1326,66911
1680,conf/vldb/fangsgmu98,,65907,1648,67555
1681,,mdwczg0rbhyj,60386,60387,120773
1682,,ov-znc5uzhuj,28745,28746,57491
1683,conf/vldb/baumanndfrw99,,65885,1626,67511
1684,conf/sigmod/baumanndfrw98,,65481,1222,66703
1685,,k3wa-ae7sh4j,20512,20513,41025
1686,,pfevlg2dimkj,6673,6674,13347
1687,conf/vldb/anciauxbbpv01,,65486,1227,66713
1688,conf/sigmod/merialdoammp00,,65172,913,66085
1689,,qq0whehyvv8j,9648,9649,19297
1690,,rga2dgnvpbuj,48932,48933,97865
1691,journals/vldb/ramakrishnansss94,,66813,2554,69367
1692,conf/vldb/sumiyaytsi95,,64294,35,64329
1693,,zomjwb0ps2kj,55209,55210,110419
1694,conf/vldb/ashwinrsss97,,65954,1695,67649
1695,,5vckjo7jbomj,35407,35408,70815
1696,,nskztbqurcwj,11983,11984,23967
1697,conf/sigmod/jarkeqblms99,,65295,1036,66331
1698,,fnnilijz08ej,1364,1365,2729
1699,conf/sigmod/ashleyfhlnp95,,65935,1676,67611
1700,journals/vldb/beckergosw96,,66772,2513,69285
1701,,bnq07koyongj,41365,41366,82731
1702,journals/sigmod/ailamakiffsv03,,66093,1834,67927
1703,,rmv2ynfwvggj,40738,40739,81477
1704,,kq6elbya84qj,55167,55168,110335
1705,journals/sigmod/palpanaspkg03,,66135,1876,68011
1706,journals/vldb/constantopoulosjmv95,,66797,2538,69335
1707,,_da6pvkqbm4j,49839,49840,99679
1708,,jo9jnx_ggiuj,37082,37083,74165
1709,conf/vldb/bridgejkllm97,,66153,1894,68047
1710,,f5liqde9lb8j,60242,60243,120485
1711,journals/vldb/mylopouloscpst96,,66773,2514,69287
1712,conf/sigmod/breitbartkrss99,,65275,1016,66291
1713,,xv2lpkhwcsyj,35977,35978,71955
1714,conf/sigmod/dattadrtv01,,64872,613,65485
1715,,qk-n8yvlswuj,1806,1807,3613
1716,,gdofpiezehqj,38345,38346,76691
1717,conf/sigmod/agichteingv01,,64932,673,65605
1718,,89avc7qz9yoj,2516,2517,5033
1719,conf/sigmod/cranorgjss02,,64725,466,65191
1720,,qswdifzbxiqj,61090,61091,122181
1721,conf/sigmod/faloutsosstt00,,65117,858,65975
1722,journals/vldb/mirbelpstv00,,66745,2486,69231
1723,,tuecojf_6buj,58859,58860,117719
1724,,pweouta2itaj,14894,14895,29789
1725,conf/vldb/goldmansvg98,,65818,1559,67377
1726,conf/vldb/abiteboulabbnm03,,66323,2064,68387
1727,,td1x4bo-eysj,21844,21845,43689
1728,conf/vldb/pereirafls00,,65572,1313,66885
1729,,kaw0nlm2wvaj,50958,50959,101917
1730,,mbzmaslhlfej,16977,16978,33955
1731,conf/vldb/lahiriscmc01,,65367,1108,66475
1732,conf/sigmod/goyalhkmsz97,,65639,1380,67019
1733,,ocgpxryxbsuj,33444,33445,66889
1734,,0igfv6jl3jwj,25653,25654,51307
1735,conf/sigmod/annamalaicd00,,65150,891,66041
1736,,eaz5gz22biuj,45782,45783,91565
1737,conf/vldb/heymanntkwrmf02,,66425,2166,68591
1738,,6cpwnsuqjnij,11526,11527,23053
1739,conf/sigmod/tomasicabknr97,,65620,1361,66981
1740,conf/vldb/mohanbwsz00,,65437,1178,66615
1741,,zcy0pfken7wj,24415,24416,48831
1742,conf/sigmod/corralmtv00,,65047,788,65835
1743,,tsshfxpwf6yj,49281,49282,98563
1744,,,55921,55922,111843
1745,journals/tods/gunopuloskmsts03,,65214,955,66169
1746,,pucw4qzlkmsj,18304,18305,36609
1747,conf/vldb/bhattacharjeepmlch03,,66282,2023,68305
1748,conf/sigmod/padmanabhanbmch03,,64594,335,64929
1749,,wi75ufss0bwj,17259,17260,34519
1750,,awfxlugiceuj,8431,8432,16863
1751,conf/sigmod/zhouwggzwxyf03,,64687,428,65115
1752,,vg5fk8bjkzgj,53687,53688,107375
1753,journals/sigmod/dogacdatkcd98,,64667,408,65075
1754,conf/sigmod/berensonbgmoo95,,65739,1480,67219
1755,,kpqrgyyji34j,45255,45256,90511
1756,,zqfzn1t6xq8j,48427,48428,96855
1757,conf/sigmod/luokmpwln02,,64823,564,65387
1758,,hmswzu5tjwyj,54632,54633,109265
1759,conf/vldb/yagoubfiv00a,,65502,1243,66745
1760,journals/sigmod/andlerhembe96,,64929,670,65599
1761,,onyokyvjokgj,11193,11194,22387
1762,conf/sigmod/buttlerlpp01,,64900,641,65541
1763,,8tcpkdik1r0j,42565,42566,85131
1764,,nqvbo5khityj,61319,61320,122639
1765,conf/sigmod/riedewaldaa02,,64663,404,65067
1766,journals/sigmod/rosenthalsmbtl95,,65134,875,66009
1767,,,5251,5252,10503
1768,,2vzhaz4yll4j,30929,30930,61859
1769,conf/vldb/adityabchns02,,66421,2162,68583
1770,,qtvvvrztlr4j,50575,50576,101151
1771,conf/sigmod/chakrabartidi98,,65407,1148,66555
1772,,srdgeoadv7cj,53101,53102,106203
1773,conf/sigmod/theodoulidisaacks94,,66100,1841,67941
1774,,-9bxttm_m4cj,13599,13600,27199
1775,conf/vldb/amsalegfg95,,66182,1923,68105
1776,,hkm-zp0lt_uj,53019,53020,106039
1777,journals/vldb/shanmugasundaramsbclpr01,,66749,2490,69239
1778,journals/sigmod/demersgrty03,,66147,1888,68035
1779,,qoblzux-xbmj,32065,32066,64131
1780,conf/sigmod/olstonwacelss98,,65456,1197,66653
1781,,utya5uf9zsij,20954,20955,41909
1782,conf/vldb/cericw00,,65632,1373,67005
1783,,hbrsuunpd1qj,37639,37640,75279
1784,conf/vldb/goodmanrs94,,64439,180,64619
1785,,8cchakngj1ej,1681,1682,3363
1786,,durgvghlwbsj,7503,7504,15007
1787,journals/vldb/braumandlkkkkss01,,66735,2476,69211
1788,conf/sigmod/gebhardtjj97,,65596,1337,66933
1789,,9mbr0dyw1ngj,41524,41525,83049
1790,,jd6ndnmhp3aj,24149,24150,48299
1791,journals/sigmod/spynsmj02,,66861,2602,69463
1792,conf/vldb/chatziantoniour97,,65958,1699,67657
1793,,xx-psjq7mv8j,44217,44218,88435
1794,,sn_r4n1q2swj,10235,10236,20471
1795,conf/vldb/fernandezscms03,,66294,2035,68329
1796,,rqtfvft_w9gj,15448,15449,30897
1797,conf/sigmod/grumbachrs98,,65413,1154,66567
1798,,hossi1gtry8j,45546,45547,91093
1799,conf/vldb/ansvkig01,,65400,1141,66541
1800,conf/sigmod/dogactpplktk02,,64740,481,65221
1801,,wi8177rdpbyj,44193,44194,88387
1802,conf/sigmod/shanmugasundaramnsr99,,65215,956,66171
1803,,eqjfv7qxsqqj,6964,6965,13929
1804,,sfs0xompphij,16945,16946,33891
1805,journals/sigmod/halkidibv02a,,64372,113,64485
1806,conf/sigmod/altinellkmplwb02,,64734,475,65209
1807,,htytq-fn8ccj,54077,54078,108155
1808,conf/sigmod/witkowskibbdfgss03,,64519,260,64779
1809,,ygce1xrfukgj,57245,57246,114491
1810,,wr6cgftuyh0j,2794,2795,5589
1811,conf/sigmod/sunaa03,,64567,308,64875
1812,conf/sigmod/liyvgpuv98,,65469,1210,66679
1813,,6jehlsgjcskj,58532,58533,117065
1814,,5ibukqcy-kaj,38872,38873,77745
1815,conf/sigmod/papakonstantinouv99,,65324,1065,66389
1816,journals/sigmod/lometbcln98,,64859,600,65459
1817,,url:http://portal.acm.org/ft_gateway.cfm3fid3d29060826type3dpdf26dl3dguide26dl3dacm26cfid3d1111111126cftoken3d2222222,28322,28323,56645
1818,conf/sigmod/lahirijjc98,,65376,1117,66493
1819,,qtwj7xwg9jij,60116,60117,120233
1820,journals/tods/fernandezksmt02,,65193,934,66127
1821,,ckrgsn0vbomj,32846,32847,65693
1822,,1sbvg9oxpmaj,32764,32765,65529
1823,journals/sigmod/kramernkrlklz97,,64964,705,65669
1824,journals/vldb/angsvki02,,66730,2471,69201
1825,,kbzz1guoa1aj,63407,63408,126815
1826,,4bvjebysdrkj,40497,40498,80995
1827,conf/vldb/yuaa03,,66275,2016,68291
1828,journals/vldb/fernandezfls00,,66657,2398,69055
1829,,uo79zyqub10j,20182,20183,40365
1830,journals/sigmod/chakravarthyaefo03,,66258,1999,68257
1831,,url:http://portal.acm.org/citation.cfm3fid3d641006,41856,41857,83713
1832,,sg9kphg_aruj,18003,18004,36007
1833,conf/sigmod/graysebw94,,66021,1762,67783
1834,conf/sigmod/hammergipuw95,,65953,1694,67647
1835,,ylzkvqxmx7cj,32546,32547,65093
1836,journals/sigmod/shethmka01,,64431,172,64603
1837,,url:http://portal.acm.org/ft_gateway.cfm3fid3d60428626type3dpdf26dl3dguide26dl3dacm26cfid3d1111111126cftoken3d2222222,32200,32201,64401
1838,journals/vldb/dattadvrn01,,66763,2504,69267
1839,,ick75z3vugij,45716,45717,91433
1840,conf/sigmod/miloaabn03,,64483,224,64707
1841,,fhp5e4rxt7cj,32705,32706,65411
1842,conf/vldb/beneventanobccgmmv00,,65582,1323,66905
1843,,q6jryriltm4j,2606,2607,5213
1844,conf/vldb/abiteboulbbccdmmp03,,66298,2039,68337
1845,,fancvlga8waj,42831,42832,85663
1846,conf/vldb/galhardasfsss01,,65402,1143,66545
1847,,nloakkw_ry8j,63351,63352,126703
1848,,,51548,51549,103097
1849,conf/vldb/chaudhuris94,,64487,228,64715
1850,journals/sigmod/glavitschsw94,,65237,978,66215
1851,,iqjgtyprufuj,40205,40206,80411
1852,,oui-frswzcaj,3686,3687,7373
1853,journals/tods/wijesekerajph03,,65207,948,66155
1854,conf/vldb/abiteboulmrvw98,,65816,1557,67373
1855,,cdqhfdik_cwj,27885,27886,55771
1856,journals/tods/srivastavasrn95,,66516,2257,68773
1857,,zm3d83ziu4uj,32688,32689,65377
1858,,w9ma-yjzhykj,50845,50846,101691
1859,conf/vldb/abrollmmmrtwz01,,65480,1221,66701
1860,conf/vldb/jiangslb00,,65604,1345,66949
1861,,ezwzdz7qhzoj,63063,63064,126127
1862,conf/sigmod/cluetdss98,,65422,1163,66585
1863,,lozf0ee3ruqj,62807,62808,125615
1864,,bl_vrpziipwj,42591,42592,85183
1865,conf/sigmod/jarkeqclflvv00,,65088,829,65917
1866,,rvzqmrcoq1mj,15755,15756,31511
1867,conf/sigmod/zhangmcmr02,,64826,567,65393
1868,conf/vldb/florescuhklrwcsa03,,66277,2018,68295
1869,,1ksfxi44iguj,46020,46021,92041
1870,,vnezjpi8jyij,59085,59086,118171
1871,conf/vldb/shukladnr96,,66871,2612,69483
1872,conf/sigmod/bohlenbd99,,65315,1056,66371
1873,,x2odifnoc88j,3523,3524,7047
1874,conf/vldb/orensteink95,,64305,46,64351
1875,,trw6dezeqtsj,19245,19246,38491
1876,journals/sigmod/fortehwdcvhfs99,,64695,436,65131
1877,,7ml1mmpqiooj,15807,15808,31615
1878,conf/vldb/fankhauserglmt98,,66022,1763,67785
1879,,jnwuaxumwvqj,31520,31521,63041
1880,,drwl6kpdbjej,27732,27733,55465
1881,conf/sigmod/grayhos96,,65669,1410,67079
1882,,wilhf5dfrbmj,9805,9806,19611
1883,conf/vldb/altinelbkmpr03,,66268,2009,68277
1884,conf/sigmod/bhattacharyambnhs02,,64755,496,65251
1885,,tsqbscfqtooj,35637,35638,71275
1886,conf/vldb/fukudammt96,,66075,1816,67891
1887,,b8_0dk37qcsj,27303,27304,54607
1888,,h0uuqastopuj,10172,10173,20345
1889,conf/sigmod/floresculms99,,65252,993,66245
1890,,ezlakb7ijduj,53713,53714,107427
1891,conf/sigmod/liuptbbzbhy98,,65458,1199,66657
1892,conf/vldb/shanmugasundaramgtzdn99,,65684,1425,67109
1893,,gilug9h3guuj,30894,30895,61789
1894,,fredzibzvdej,54946,54947,109893
1895,journals/tods/diaoafzf03,,65169,910,66079
1896,,mtscc-ftwcej,31761,31762,63523
1897,conf/vldb/levyssz94,,64436,177,64613
1898,conf/sigmod/chawathergw96,,65710,1451,67161
1899,,ilct5ufnhxgj,26210,26211,52421
1900,,yzbcsw2erkcj,12459,12460,24919
1901,journals/sigmod/bouloso99,,64748,489,65237
1902,,tdyw6v4cc7mj,55842,55843,111685
1903,conf/sigmod/davulcufkr99,,65192,933,66125
1904,,4_fm8lwvwhmj,63579,63580,127159
1905,conf/sigmod/jajodiassb97,,65574,1315,66889
1906,,gveqlutele8j,62257,62258,124515
1907,conf/sigmod/lakhamrajurss00,,65073,814,65887
1908,,kxgdqhvpi_sj,15434,15435,30869
1909,conf/vldb/gilbertkms02,,66495,2236,68731
1910,journals/vldb/laurentlsv01,,66748,2489,69237
1911,,ttigih9uc_yj,14435,14436,28871
1912,conf/vldb/gilbertkms01,,65294,1035,66329
1913,,9rdlhwm_4myj,12952,12953,25905
1914,conf/vldb/zimbraos98,,65912,1653,67565
1915,,1kckbfvfgymj,45343,45344,90687
1916,conf/vldb/chakravarthykak94,,64425,166,64591
1917,,l9eva_gsxrij,45468,45469,90937
1918,conf/sigmod/gunopulosktd00,,65036,777,65813
1919,,asfrockwfmgj,16166,16167,32333
1920,,or7dmj9jjdyj,50832,50833,101665
1921,conf/vldb/halversonbkkrtvwnd03,,66336,2077,68413
1922,conf/vldb/limwpvp02,,66489,2230,68719
1923,,9kl_htyqtmqj,8236,8237,16473
1924,conf/sigmod/gangulygms96,,65729,1470,67199
1925,,05zgvgyhsc0j,6449,6450,12899
1926,journals/tods/mehrotrarks98,,66613,2354,68967
1927,,tanonc5j2w8j,55737,55738,111475
1928,conf/vldb/bliujutejss98,,65846,1587,67433
1929,,obpe7jg0yhyj,38983,38984,77967
1930,conf/sigmod/benediktcffr03,,64481,222,64703
1931,,t5zdpquqfj0j,27355,27356,54711
1932,,5chw6hn64vej,46139,46140,92279
1933,conf/sigmod/huangsw94,,65970,1711,67681
1934,,fjq7col2vysj,50727,50728,101455
1935,conf/vldb/zhoulzlzjt01,,65504,1245,66749
1936,,sucjbjwvktuj,61426,61427,122853
1937,conf/vldb/sreenaths94,,64415,156,64571
1938,conf/sigmod/chenzckr01,,64862,603,65465
1939,,q49c-iex7n8j,45451,45452,90903
1940,,wcbvsi-qdtcj,36426,36427,72853
1941,journals/sigmod/labrinidisr00,,64551,292,64843
1942,,ehr3fz7f7vcj,7929,7930,15859
1943,conf/sigmod/labiowgg00,,65019,760,65779
1944,conf/sigmod/brinkhoffkss94,,66030,1771,67801
1945,,cb1kf4z7ha4j,22895,22896,45791
1946,,7-b5yxugjs0j,17299,17300,34599
1947,conf/sigmod/amer-yahiafsx03,,64693,434,65127
1948,journals/sigmod/bonnetbdl03,,66094,1835,67929
1949,,aovcrhoczucj,1184,1185,2369
1950,conf/vldb/golabo03,,66373,2114,68487
1951,,6k9fhi2pfegj,30406,30407,60813
1952,,lc5gjk5opd0j,28511,28512,57023
1953,journals/sigmod/golabo03,,66235,1976,68211
1954,journals/sigmod/theodoridisn00,,64595,336,64931
1955,,negsmylf-awj,49778,49779,99557
1956,conf/sigmod/acharyagpr99,,65307,1048,66355
1957,,s064oghlyiuj,58770,58771,117541
1958,,aryxuwgoa10j,37101,37102,74203
1959,conf/vldb/ozdenbrs94,,64427,168,64595
1960,,mc7klhmeqt8j,30437,30438,60875
1961,conf/vldb/esterkswx98,,65851,1592,67443
1962,,qcz2tythtk0j,24369,24370,48739
1963,conf/sigmod/bergstraesserbps99,,65290,1031,66321
1964,conf/vldb/goyalhss95,,64316,57,64373
1965,,2sgh4slcdl4j,13762,13763,27525
1966,,h-aqepr2evuj,3319,3320,6639
1967,conf/vldb/argeprsv98,,66007,1748,67755
1968,conf/vldb/baulierbks98,,65802,1543,67345
1969,,dnk16shm9euj,8358,8359,16717
1970,conf/sigmod/dobraggr02,,64775,516,65291
1971,,v7a9otp7ojsj,57627,57628,115255
1972,conf/vldb/pirottezmy94,,64506,247,64753
1973,,8s-sp8savqaj,5137,5138,10275
1974,conf/sigmod/buchmanndzh95,,65933,1674,67607
1975,,monblftlyg0j,33659,33660,67319
1976,journals/sigmod/gatziujsv99,,64523,264,64787
1977,,htqrjuo7gssj,29991,29992,59983
1978,conf/vldb/kaushikbns02,,66478,2219,68697
1979,,dl5ojvhk10kj,14343,14344,28687
1980,conf/vldb/agarwaladgnrs96,,66864,2605,69469
1981,,e4fu9kpfxqsj,5383,5384,10767
1982,,793xpmtdcbej,58935,58936,117871
1983,conf/vldb/pellenkoftlk97,,66166,1907,68073
1984,,ghimekzckmqj,54781,54782,109563
1985,conf/vldb/bettinijww02,,66499,2240,68739
1986,journals/vldb/chanfgr02,,66724,2465,69189
1987,,orkxhlb7dvcj,37093,37094,74187
1988,conf/vldb/netzcbf00,,65542,1283,66825
1989,,mrirfxoc8a8j,34029,34030,68059
1990,,ywkfjz_ympkj,16337,16338,32675
1991,conf/sigmod/ordonezc00,,65131,872,66003
1992,conf/sigmod/zhaodns98,,65419,1160,66579
1993,,mbc03out8yaj,57853,57854,115707
1994,conf/sigmod/ankerstbks99,,65279,1020,66299
1995,,k1zdqsronloj,44836,44837,89673
1996,,9ebkpmslc_oj,25524,25525,51049
1997,journals/vldb/gruserrzz00,,66653,2394,69047
1998,,ln1yhhg7gdgj,13925,13926,27851
1999,conf/vldb/shahabifkf00,,65575,1316,66891
2000,journals/tods/lechtenborgerv03,,65213,954,66167
2001,,94m93up4gm4j,7338,7339,14677
2002,journals/sigmod/gobler02a,,64358,99,64457
2003,,b-u4advavbkj,58346,58347,116693
2004,,gwslyejd3byj,16411,16412,32823
2005,conf/sigmod/zhangdwempmdr03,,64680,421,65101
2006,conf/vldb/schaeferbbj00,,65665,1406,67071
2007,,url:http://portal.acm.org/citation.cfm3fid3d645926.671845,6238,6239,12477
2008,conf/sigmod/zhangzptl03,,64624,365,64989
2009,,s3lelcdpztkj,53037,53038,106075
2010,,j6v2b9hn-r4j,50134,50135,100269
2011,conf/sigmod/andersonbkw98,,65522,1263,66785
2012,conf/sigmod/imielinskivb94,,65964,1705,67669
2013,,cfflplmokh4j,40367,40368,80735
2014,conf/vldb/amielbds94,,64388,129,64517
2015,,hbak02oe1gmj,36718,36719,73437
2016,conf/sigmod/gehrkegrl99,,65217,958,66175
2017,,s3neqsfcvraj,29071,29072,58143
2018,,hpcng0tpwgij,27542,27543,55085
2019,conf/vldb/tanshcr01,,65512,1253,66765
2020,conf/vldb/diwanrss96,,66062,1803,67865
2021,,hjda9on7lzoj,17077,17078,34155
2022,,vjihpbki2uaj,38417,38418,76835
2023,conf/sigmod/ramaswamyrs00,,65032,773,65805
2024,,xkvxoylg2-cj,35912,35913,71825
2025,conf/vldb/mehtad95,,64277,18,64295
2026,conf/vldb/millinerbp95,,66225,1966,68191
2027,,kyl-9cv8gloj,9246,9247,18493
2028,,u_9qwspjao4j,48033,48034,96067
2029,conf/vldb/faloutsosjs97,,66144,1885,68029
2030,,l_ekduvuoiej,44315,44316,88631
2031,journals/tods/dattavck99,,66623,2364,68987
2032,journals/tods/wangbbj97,,66611,2352,68963
2033,,nyqmkdah2egj,38584,38585,77169
2034,,c57d3rgd3icj,26794,26795,53589
2035,conf/sigmod/bettiniwbj95,,65860,1601,67461
2036,,yqxx_xeze2gj,24713,24714,49427
2037,journals/vldb/medjahedbe03,,66554,2295,68849
2038,,ms4ijoi6-34j,16591,16592,33183
2039,conf/vldb/andreiv01,,65339,1080,66419
2040,journals/sigmod/meltone01,,64422,163,64585
2041,,619anaisugej,12547,12548,25095
2042,,_uytegcmbkij,58150,58151,116301
2043,conf/vldb/zirintsiskm99,,65864,1605,67469
2044,,pi0wktymowwj,13295,13296,26591
2045,conf/sigmod/crescenzimm02,,64842,583,65425
2046,conf/vldb/mckennabht96,,66078,1819,67897
2047,,0tzatv3w05wj,55677,55678,111355
2048,,89l6j2mbe2kj,35452,35453,70905
2049,conf/vldb/sadrizza01,,65370,1111,66481
2050,,cfmtmf7blzij,6619,6620,13239
2051,conf/sigmod/trisoliniln99,,65239,980,66219
2052,,idt5wozxm-wj,3755,3756,7511
2053,conf/sigmod/gillmannww02,,64791,532,65323
2054,,jcudetapg5ij,50787,50788,101575
2055,conf/sigmod/kementsietsidisam03,,64616,357,64973
2056,,tcrfb27dxiwj,39440,39441,78881
2057,conf/vldb/bonifaticds01,,65532,1273,66805
2058,,1hab-tuw7n4j,36340,36341,72681
2059,conf/sigmod/hoams97,,65562,1303,66865
2060,journals/tods/schuldtabs02,,66599,2340,68939
2061,,zrqpbiio2e8j,22834,22835,45669
2062,,mot0ba0vrkcj,22168,22169,44337
2063,conf/vldb/sellisrf97,,65983,1724,67707
2064,conf/vldb/koudasmj99,,65726,1467,67193
2065,,dremtc899xcj,11514,11515,23029
2066,conf/vldb/arionbcdmp03,,66297,2038,68335
2067,,czpcerfybikj,31170,31171,62341
2068,,o81usjg2ehwj,51294,51295,102589
2069,conf/sigmod/kornackermh97,,65500,1241,66741
2070,conf/vldb/manolescufk01,,65382,1123,66505
2071,,indi0x1mjg4j,22872,22873,45745
2072,,wgrwdyy7q_8j,53360,53361,106721
2073,conf/sigmod/baulierbgghjkkmmnnrsssww99,,65241,982,66223
2074,,idfox84unhuj,9070,9071,18141
2075,conf/vldb/chakrabartirs02,,66451,2192,68643
2076,,irjv85kkvgwj,9025,9026,18051
2077,conf/vldb/alonsohst97,,65978,1719,67697
2078,conf/vldb/chenhww02,,66481,2222,68703
2079,,kgxrjzkrxzqj,60903,60904,121807
2080,journals/sigmod/fengjh01,,64631,372,65003
2081,,sut-qtwqfnkj,57525,57526,115051
2082,,9wtnlminw6aj,5546,5547,11093
2083,conf/sigmod/stoltepag03,,64618,359,64977
2084,,ckiqyzazkyej,38875,38876,77751
2085,conf/sigmod/bunemanktt02,,64664,405,65069
2086,conf/sigmod/harinarayanru96,,65792,1533,67325
2087,,qhutoleczzgj,35093,35094,70187
2088,conf/vldb/bouganimnpw03,,66313,2054,68367
2089,,5oxuo8dj6qaj,2503,2504,5007
2090,conf/vldb/stathatosrb97,,65946,1687,67633
2091,,jh2hirxpjcej,15821,15822,31643
2092,,mcdgdxsc8rcj,16522,16523,33045
2093,conf/sigmod/rodriguezr00,,65097,838,65935
2094,,ajopvudndssj,21437,21438,42875
2095,conf/vldb/browng01,,65325,1066,66391
2096,,,56578,56579,113157
2097,journals/sigmod/hanbp01,,64389,130,64519
2098,,u8cmjbajyx8j,64207,64208,128415
2099,conf/vldb/agrawalcn00,,65412,1153,66565
2100,conf/sigmod/brinmut97,,65495,1236,66731
2101,,swppkmm8sdyj,62909,62910,125819
2102,conf/sigmod/chengkp03,,64548,289,64837
2103,,kst-pqp2ilyj,53504,53505,107009
2104,journals/vldb/mehrotraks97,,66680,2421,69101
2105,,6xxswnrusk4j,18999,19000,37999
2106,,hypa8on4pqsj,18377,18378,36755
2107,conf/sigmod/agrawales03,,64529,270,64799
2108,,di-ejdz_abyj,17021,17022,34043
2109,conf/sigmod/gangulygr03,,64612,353,64965
2110,,u0w9w7ycszwj,12048,12049,24097
2111,conf/sigmod/chaudhurimn99,,65258,999,66257
2112,,5icrog_vmc0j,9078,9079,18157
2113,conf/sigmod/nestorovam98,,65408,1149,66557
2114,conf/vldb/ciacciapz97,,66171,1912,68083
2115,,cndpbkx4f2cj,25002,25003,50005
2116,,yj7olwfpr4gj,24155,24156,48311
2117,journals/tods/jimenez-perispak03,,65211,952,66163
2118,,6wjesnmzlvgj,52673,52674,105347
2119,conf/sigmod/matiasvw98,,65432,1173,66605
2120,conf/sigmod/careycnvdrsm99,,65342,1083,66425
2121,,w6roobwo3bij,7580,7581,15161
2122,,,60434,60435,120869
2123,conf/vldb/ailamakidhw99,,65776,1517,67293
2124,journals/tods/dekhtyarrs01,,66580,2321,68901
2125,,jzshif9wrikj,5326,5327,10653
2126,journals/sigmod/barbaracjw01,,64457,198,64655
2127,,asuknmvezzyj,43997,43998,87995
2128,conf/sigmod/chaudhurikn03,,64600,341,64941
2129,,es6qyfgebicj,37780,37781,75561
2130,conf/sigmod/kornackersh98,,65451,1192,66643
2131,,bv8_cduw2gmj,31654,31655,63309
2132,,0acvmjtai8qj,28422,28423,56845
2133,conf/vldb/sayalcds02,,66402,2143,68545
2134,,ofzwx8jhqvwj,52059,52060,104119
2135,conf/sigmod/libkinmw96,,65725,1466,67191
2136,,sdqzz-rnmk4j,35134,35135,70269
2137,journals/vldb/amer-yahiacls02,,66729,2470,69199
2138,,dfubu20j1oij,30904,30905,61809
2139,conf/sigmod/amer-yahiacls01,,65006,747,65753
2140,,ogh0r54bw0mj,58867,58868,117735
2141,journals/sigmod/malaikaem03,,66189,1930,68119
2142,conf/vldb/hristidisgp03,,66289,2030,68319
2143,,b2rshdd99xwj,17047,17048,34095
2144,,psoyengeh9cj,46455,46456,92911
2145,conf/sigmod/gravanocgp97,,65547,1288,66835
2146,,w3aykr4vdvwj,60914,60915,121829
2147,conf/sigmod/hope95,,65824,1565,67389
2148,conf/sigmod/zhoulp99,,65304,1045,66349
2149,,0owkmpjqpd0j,28609,28610,57219
2150,,1ecp1f8dhasj,59479,59480,118959
2151,conf/vldb/shukladn98,,66003,1744,67747
2152,,cswydorgqf4j,56707,56708,113415
2153,conf/vldb/schindlerag03,,66269,2010,68279
2154,,jcek-ywxk8uj,36891,36892,73783
2155,journals/sigmod/tiandcz02,,64485,226,64711
2156,,0ielwfnyzeyj,11987,11988,23975
2157,conf/vldb/pfoserjt00,,65613,1354,66967
2158,conf/sigmod/schleimerwa03,,64531,272,64803
2159,,ncrfjdfhomcj,10766,10767,21533
2160,,pgcirydyfg8j,2864,2865,5729
2161,journals/sigmod/calvaneseglv03,,66120,1861,67981
2162,,eltcv7moqdgj,61587,61588,123175
2163,conf/sigmod/guptamr95,,65797,1538,67335
2164,,km3wvxughhsj,41694,41695,83389
2165,conf/vldb/webersb98,,65831,1572,67403
2166,,,38344,38345,76689
2167,conf/sigmod/bersongm95,,65817,1558,67375
2168,,bfndgrz_4voj,24714,24715,49429
2169,conf/vldb/casatidgs01,,65286,1027,66313
2170,conf/sigmod/gatziugd95,,65925,1666,67591
2171,,jc39cjrwkr8j,57141,57142,114283
2172,,rkisqpbrim0j,51624,51625,103249
2173,conf/vldb/keogh02,,66491,2232,68723
2174,,fg5ee6r7xywj,6366,6367,12733
2175,conf/sigmod/chenjdtw00,,65103,844,65947
2176,journals/sigmod/medskercs95,,65029,770,65799
2177,,url:http://portal.acm.org/ft_gateway.cfm3fid3d20267326type3dpdf26coll3dguide26dl3dacm26cfid3d1111111126cftoken3d2222222,58419,58420,116839
2178,,vwd7jhlxfv0j,56737,56738,113475
2179,conf/sigmod/hinneburgkw02,,64717,458,65175
2180,journals/tods/kossmannfda00,,66584,2325,68909
2181,,8tdpahgdrggj,55392,55393,110785
2182,,wfygkyk0nvqj,50882,50883,101765
2183,journals/vldb/muthopw00,,66661,2402,69063
2184,,niuz3dc8yhmj,42300,42301,84601
2185,conf/vldb/petrovicbj03,,66321,2062,68383
2186,,ht_8iq3sz80j,38667,38668,77335
2187,conf/sigmod/arefbv95,,65854,1595,67449
2188,,bo7arxlxypqj,38271,38272,76543
2189,conf/sigmod/ipeirotisgs01,,64987,728,65715
2190,,7rn7ahvs1yuj,28816,28817,57633
2191,journals/vldb/changr03,,66541,2282,68823
2192,,8zfever1rbuj,21606,21607,43213
2193,conf/sigmod/borkards01,,64889,630,65519
2194,,r51yi7swj6ej,51086,51087,102173
2195,journals/sigmod/wolfsonsdnr95,,65104,845,65949
2196,,mfc9xsb7buqj,63575,63576,127151
2197,journals/sigmod/ballmrz02,,64498,239,64737
2198,,62uewbkyqgoj,61842,61843,123685
2199,journals/sigmod/sondt96,,64942,683,65625
2200,,my7myczeejaj,52389,52390,104779
2201,journals/vldb/mihailart02,,66713,2454,69167
2202,journals/sigmod/dreyerds94,,65173,914,66087
2203,,gcf11c7yuucj,50101,50102,100203
2204,conf/vldb/acharyagp99,,65718,1459,67177
2205,,-7tsgphin24j,45717,45718,91435
2206,conf/sigmod/dreyerds95,,65940,1681,67621
2207,,i1qu2ofseloj,42747,42748,85495
2208,journals/vldb/ramanrh00,,66747,2488,69235
2209,,cgicp6n9xzqj,42347,42348,84695
2210,,tp9ivmsazocj,39922,39923,79845
2211,journals/sigmod/sayginvc01,,64470,211,64681
2212,,btalxwt3fauj,38341,38342,76683
2213,conf/vldb/cosleylp02,,66461,2202,68663
2214,,url:http://portal.acm.org/ft_gateway.cfm3fid3d77698926type3dpdf26dl3dguide26dl3dacm26cfid3d1111111126cftoken3d2222222,37094,37095,74189
2215,journals/sigmod/mukhopadhyaygs03,,66243,1984,68227
2216,,wrhapjxb_-qj,37058,37059,74117
2217,conf/vldb/madhavanbr01,,66440,2181,68621
2218,conf/sigmod/chenrw02,,64834,575,65409
2219,,05shsigjnkkj,34727,34728,69455
2220,conf/vldb/ramanrh99,,65862,1603,67465
2221,,6up3e_wekcaj,27690,27691,55381
2222,conf/sigmod/acharyagp00,,65039,780,65819
2223,,wgwz2cnzw2yj,2312,2313,4625
2224,,ccew59ac84mj,20332,20333,40665
2225,conf/vldb/acharyafz96,,66056,1797,67853
2226,,7y1dnkciifqj,11246,11247,22493
2227,conf/vldb/sattlergs03,,66312,2053,68365
2228,,y7icku_j4wsj,7514,7515,15029
2229,journals/vldb/tenienteo95,,66806,2547,69353
2230,conf/sigmod/berchtoldbbkk97,,65507,1248,66755
2231,,bmkgn7aighyj,23352,23353,46705
2232,,8m2rlld3dlqj,54406,54407,108813
2233,conf/sigmod/kaushikbnk02,,64648,389,65037
2234,conf/vldb/abiteboulacemm99,,65789,1530,67319
2235,,oyotbj4m7jyj,30604,30605,61209
2236,,v7byawkfczmj,53119,53120,106239
2237,conf/vldb/gantilr00,,65643,1384,67027
2238,,qknjf3ugncmj,40196,40197,80393
2239,journals/tods/gibbonsmp02,,65197,938,66135
2240,,bojkipcpixkj,38551,38552,77103
2241,conf/sigmod/al-khalifayj03,,64522,263,64785
2242,conf/vldb/viglasnb03,,66358,2099,68457
2243,,ggx9ls25ohwj,20218,20219,40437
2244,,jgdpgbpmdr4j,18956,18957,37913
2245,conf/vldb/manegoldbk00,,65619,1360,66979
2246,,gp3ld61i__kj,14197,14198,28395
2247,conf/vldb/velegrakismp03,,66364,2105,68469
2248,journals/sigmod/ooist03,,66203,1944,68147
2249,,gpjvvutm6h8j,1739,1740,3479
2250,,kub7xvwh30aj,45263,45264,90527
2251,journals/sigmod/taninbs96,,65009,750,65759
2252,conf/sigmod/freirehrrs02,,64781,522,65303
2253,,1p-q7eoflwij,6170,6171,12341
2254,conf/vldb/bunemandhow95,,66234,1975,68209
2255,,95lncs7v35yj,30427,30428,60855
2256,,qn1appigzmmj,24546,24547,49093
2257,conf/vldb/yangkl97,,65927,1668,67595
2258,conf/sigmod/kalnisnopt02,,64660,401,65061
2259,,ipab8ums7qkj,7026,7027,14053
2260,,ky-2yjngtw8j,6410,6411,12821
2261,journals/tods/mayl02,,65189,930,66119
2262,,jvvfcenxbmkj,61261,61262,122523
2263,conf/vldb/marians03,,66335,2076,68411
2264,conf/vldb/carinoj98,,65914,1655,67569
2265,,lf2ausiwko4j,24993,24994,49987
2266,conf/sigmod/lis98,,65453,1194,66647
2267,,vxg-4kp7ffej,12430,12431,24861
2268,conf/sigmod/wolfsonsxzc99,,65229,970,66199
2269,,4dbcedwsluqj,39298,39299,78597
2270,,q_a8y8ky9wkj,27569,27570,55139
2271,conf/sigmod/doppelhammerhkk97,,65565,1306,66871
2272,journals/sigmod/bernsteinbcdfgghhjlmnpsu98,,64644,385,65029
2273,,syu5w-3uffaj,6662,6663,13325
2274,conf/sigmod/subramanianv98,,65404,1145,66549
2275,,kxwymz2agnqj,56101,56102,112203
2276,,14vyjj0mnbmj,53461,53462,106923
2277,conf/sigmod/larsong03,,64697,438,65135
2278,journals/sigmod/jukicnv03,,66183,1924,68107
2279,,er43urfx-hcj,48801,48802,97603
2280,conf/vldb/chahkk01,,65392,1133,66525
2281,,vyoa5uqsj6aj,47430,47431,94861
2282,,ndmocxlpq9qj,46685,46686,93371
2283,journals/vldb/chirkovahs02,,66731,2472,69203
2284,,uaq-tj0j4nkj,39387,39388,78775
2285,conf/sigmod/singhtw94,,66066,1807,67873
2286,journals/vldb/derrmp94,,66812,2553,69365
2287,,a-qmcfr5yjyj,36452,36453,72905
2288,conf/sigmod/melnikrb03,,64637,378,65015
2289,,wfjewtey2ncj,22342,22343,44685
2290,,27-p8x0mjfcj,22118,22119,44237
2291,conf/vldb/shatdalkn94,,64434,175,64609
2292,,rpfgpoaanuqj,21677,21678,43355
2293,journals/sigmod/normanzt96,,64907,648,65555
2294,conf/sigmod/sionap03,,64526,267,64793
2295,,_l0dhcpfaxmj,26869,26870,53739
2296,conf/vldb/meopc96,,66073,1814,67887
2297,,opm5vltzqtaj,54072,54073,108145
2298,conf/sigmod/kanthrsb99,,65346,1087,66433
2299,,ypflbrvjfjoj,49294,49295,98589
2300,conf/sigmod/tatarinovvbssz02,,64785,526,65311
2301,,gywmopwa7mwj,34855,34856,69711
2302,,x3whlhvq-sej,63515,63516,127031
2303,conf/vldb/cabrerarh95,,66221,1962,68183
2304,journals/vldb/ramamrithamc96,,66768,2509,69277
2305,,xbpaz5ahfv0j,62940,62941,125881
2306,conf/sigmod/krishnanvi96,,65731,1472,67203
2307,,8tfa4enyqkqj,61367,61368,122735
2308,conf/sigmod/sagonassw94,,66072,1813,67885
2309,,xc8keoert9sj,58356,58357,116713
2310,,enyoi4xt7n0j,57866,57867,115733
2311,journals/sigmod/koksalad98,,64892,633,65525
2312,conf/sigmod/wangwyy02,,64758,499,65257
2313,,drp1ifn7znkj,57717,57718,115435
2314,,mrwlgquelnsj,56889,56890,113779
2315,conf/vldb/gups00,,65594,1335,66929
2316,conf/sigmod/sagonassw94a,,66115,1856,67971
2317,,ndgblldnegaj,52011,52012,104023
2318,,uem5wxlou0wj,5076,5077,10153
2319,journals/vldb/ramamurthyds03,,66545,2286,68831
2320,journals/vldb/harderst99,,66638,2379,69017
2321,,kgykfmrfspaj,38973,38974,77947
2322,journals/tods/chrysanthisr94,,66567,2308,68875
2323,,q2yp1ewkhtcj,32929,32930,65859
2324,,ewoqo00bufoj,32029,32030,64059
2325,conf/sigmod/agrawalk03,,64536,277,64813
2326,,g7hdbo4gcn4j,3137,3138,6275
2327,conf/vldb/senkulkt02,,66387,2128,68515
2328,journals/vldb/chandrasekaranf03,,66716,2457,69173
2329,,b9r9u3owrkcj,27441,27442,54883
2330,,lv0bggwzgeoj,27001,27002,54003
2331,conf/sigmod/doandh01,,64990,731,65721
2332,,dewdhtzzywyj,20625,20626,41251
2333,conf/vldb/amirkn01,,66438,2179,68617
2334,journals/vldb/agrawalhk03,,66717,2458,69175
2335,,ndkjpugy_k4j,16346,16347,32693
2336,conf/sigmod/stonebrakerh01,,64912,653,65565
2337,,opmsehfy-xoj,14936,14937,29873
2338,conf/vldb/sistlayll95,,64371,112,64483
2339,,httnmhcjy-oj,13851,13852,27703
2340,conf/sigmod/forlizzigns00,,65057,798,65855
2341,,jw1juc-aqxoj,6035,6036,12071
2342,conf/vldb/konigw99,,65749,1490,67239
2343,,6hmffrhcspaj,12849,12850,25699
2344,,mnut46wjzaqj,63427,63428,126855
2345,conf/sigmod/chandrasekarancdfhhkmrs03,,64691,432,65123
2346,,4qtu0-tw0icj,56303,56304,112607
2347,conf/sigmod/bornhovdakmpr03,,64558,299,64857
2348,conf/vldb/claussenkmp97,,66179,1920,68099
2349,,eytvjjcb5wkj,38535,38536,77071
2350,journals/vldb/braumandlckk00,,66655,2396,69051
2351,,snwxbtd7kk8j,26450,26451,52901
2352,conf/sigmod/papadiastse95,,65847,1588,67435
2353,,pogzlkv_bisj,53041,53042,106083
2354,,xsaovu54vl4j,62329,62330,124659
2355,conf/sigmod/yangwyh02,,64805,546,65351
2356,journals/tods/polyzoisg94,,66568,2309,68877
2357,,lol0yu6h4vaj,6194,6195,12389
2358,,tjdmwbcxmtgj,58289,58290,116579
2359,journals/tods/ioannidisr95,,66518,2259,68777
2360,conf/sigmod/chawatheg97,,65586,1327,66913
2361,,5o88bum19waj,48162,48163,96325
2362,,eqswwzde45wj,46950,46951,93901
2363,conf/sigmod/wangjly03,,64459,200,64659
2364,conf/vldb/ashwingg02,,66460,2201,68661
2365,,yijojdugxxkj,46853,46854,93707
2366,conf/sigmod/grossmanhq95,,65942,1683,67625
2367,,z_kxgqsn0w0j,43136,43137,86273
2368,,jchizlbsts0j,3985,3986,7971
2369,conf/vldb/bernsteinps99,,65773,1514,67287
2370,conf/sigmod/wangpfy03,,64524,265,64789
2371,,jpnxw9l7pxgj,31770,31771,63541
2372,,s3bawcaka-ej,30359,30360,60719
2373,conf/vldb/jiangwl03,,66359,2100,68459
2374,journals/tods/krishnakumarb94,,66571,2312,68883
2375,,8zjedobud_qj,30090,30091,60181
2376,conf/vldb/kumarka97,,65975,1716,67691
2377,,ehtwppk6no8j,19033,19034,38067
2378,,aaqedfkjwn8j,13856,13857,27713
2379,conf/sigmod/chaudhuridy95,,65876,1617,67493
2380,conf/vldb/kietzrs97,,66149,1890,68039
2381,,l4k3lawc-jgj,1008,1009,2017
2382,conf/vldb/zengbnn01,,65328,1069,66397
2383,,3tivnlierrkj,28195,28196,56391
2384,conf/sigmod/popadst00,,65053,794,65847
2385,,gawckiipptej,54568,54569,109137
2386,conf/sigmod/goyalhkms96,,65763,1504,67267
2387,,uucmu_hkf2kj,62675,62676,125351
2388,,q0ovw6quk3mj,1886,1887,3773
2389,conf/vldb/duttadmrt00,,65426,1167,66593
2390,,7setnikjovej,49970,49971,99941
2391,conf/vldb/matiasvw00,,65454,1195,66649
2392,,rfeoa75jjsij,43496,43497,86993
2393,journals/vldb/fungkl03,,66548,2289,68837
2394,,kraz7idmeoqj,42686,42687,85373
2395,conf/vldb/polyzotisg02,,66494,2235,68729
2396,conf/vldb/meekpk03,,66285,2026,68311
2397,,cr1ikufse1wj,40707,40708,81415
2398,conf/sigmod/polyzotisg02,,64800,541,65341
2399,,obftdyvjb4gj,37952,37953,75905
2400,,7br3wxwzrq4j,30434,30435,60869
2401,conf/sigmod/barclaysg00,,65105,846,65951
2402,journals/sigmod/bichlersz98,,64651,392,65043
2403,,fqnda5cjapaj,21995,21996,43991
2404,,bsladx5r0hqj,21812,21813,43625
2405,conf/sigmod/galindo-legariaj01,,64948,689,65637
2406,conf/vldb/iwerksss03,,66378,2119,68497
2407,,4b_lhcns0woj,20367,20368,40735
2408,conf/vldb/menglla03,,66299,2040,68339
2409,,_dopwa3qwoej,18597,18598,37195
2410,,c2pgxbssafcj,7162,7163,14325
2411,conf/sigmod/raozml02,,64747,488,65235
2412,conf/sigmod/luoehn02,,64645,386,65031
2413,,7p7mpmvibryj,26747,26748,53495
2414,,x9bmozxole8j,61594,61595,123189
2415,conf/vldb/dagevillez02,,66405,2146,68551
2416,,,38073,38074,76147
2417,conf/sigmod/woelkbjotu95,,65820,1561,67381
2418,conf/vldb/lirs99,,65734,1475,67209
2419,,bf44yxvb6eaj,38329,38330,76659
2420,,vhxikkg8owyj,53476,53477,106953
2421,conf/vldb/mahnkems02,,66420,2161,68581
2422,conf/sigmod/paparizosacjlnpswwy03,,64682,423,65105
2423,,hupdchjyd44j,21069,21070,42139
2424,journals/vldb/harrisr96,,66789,2530,69319
2425,,s8x6zjxc9oaj,60186,60187,120373
2426,conf/sigmod/babycy01,,64996,737,65733
2427,,rnonn5hwsroj,56246,56247,112493
2428,,h95306-8rjej,55134,55135,110269
2429,conf/sigmod/yumwl01,,64961,702,65663
2430,conf/vldb/gardarinst96,,66059,1800,67859
2431,,ohr5iqwpuyyj,45904,45905,91809
2432,,g9y0kau_uhqj,45298,45299,90597
2433,conf/sigmod/ramaswamyk95,,65853,1594,67447
2434,journals/tods/wandsw99,,66631,2372,69003
2435,,pytokfsgdxyj,4510,4511,9021
2436,journals/sigmod/labrinidism01,,64450,191,64641
2437,,url:http://portal.acm.org/ft_gateway.cfm3fid3d60388626type3dpdf26dl3dguide26dl3dacm26cfid3d1111111126cftoken3d2222222,40927,40928,81855
2438,journals/sigmod/nobles95,,65122,863,65985
2439,,rrvcd6hkhasj,40408,40409,80817
2440,journals/vldb/fengylh02,,66704,2445,69149
2441,,uxh3r2hfboaj,37264,37265,74529
2442,conf/sigmod/hillyers96,,65673,1414,67087
2443,,v-pwj8k5ztej,34783,34784,69567
2444,,v0rd-1nzjmyj,26784,26785,53569
2445,conf/vldb/xinhlw03,,66375,2116,68491
2446,,ysc3v2lu3m8j,2401,2402,4803
2447,journals/vldb/chidlovskiib00,,66652,2393,69045
2448,journals/sigmod/andersons94,,65240,981,66221
2449,,adk2is_xwtoj,21089,21090,42179
2450,,dsl0gt8egr0j,16712,16713,33425
2451,journals/tods/caldersnw02,,65199,940,66139
2452,conf/vldb/jarkekl00,,65598,1339,66937
2453,,6c3xqz-_hduj,15087,15088,30175
2454,conf/vldb/bratsbergh01,,65520,1261,66781
2455,,x-oqarjjgccj,14801,14802,29603
2456,,4asel4haaq4j,10660,10661,21321
2457,conf/sigmod/blottrs96,,65783,1524,67307
2458,,jjusph63bz0j,12603,12604,25207
2459,conf/sigmod/bressangfjhklmpqss97,,65650,1391,67041
2460,conf/vldb/abiteboulaaachhmmmmstv99,,65886,1627,67513
2461,,zhcrzbcoweaj,19447,19448,38895
2462,,bxnzc8mn_joj,29033,29034,58067
2463,conf/sigmod/agrawalcfghiimmss94,,66111,1852,67963
2464,conf/vldb/chienvztz02,,66479,2220,68699
2465,,uumeakw_ffuj,8445,8446,16891
2466,conf/sigmod/shahc01,,64914,655,65569
2467,,2wgov6yh4yij,6247,6248,12495
2468,,tbunzudusfyj,61065,61066,122131
2469,conf/vldb/wangzl03,,66316,2057,68373
2470,,u0o8vpy7l4kj,57952,57953,115905
2471,conf/sigmod/zaharioudakisc97,,65556,1297,66853
2472,,i_yprpvq45qj,54298,54299,108597
2473,conf/sigmod/olstonwl01,,64893,634,65527
2474,conf/vldb/chatziantoniour96,,66246,1987,68233
2475,,46fvybhr0woj,462,463,925
2476,,aixofjpvvpuj,45921,45922,91843
2477,conf/sigmod/chaudhurin98a,,65489,1230,66719
2478,journals/tods/cuiww00,,66572,2313,68885
2479,,ywdxpb_76z0j,4291,4292,8583
2480,,xdddto9n_pwj,38212,38213,76425
2481,conf/vldb/hagejpst03,,66279,2020,68299
2482,conf/sigmod/ligs02,,64783,524,65307
2483,,dzzqgw2tj-mj,2418,2419,4837
2484,,u03oqbb0y-oj,21460,21461,42921
2485,conf/sigmod/moleskyr95,,65836,1577,67413
2486,,srcbkhnifl8j,14793,14794,29587
2487,journals/sigmod/karadimitriout97,,64972,713,65685
2488,conf/vldb/pitourac99,,65793,1534,67327
2489,,6vu-vxcdsfsj,10011,10012,20023
2490,journals/sigmod/schmidtwkfcmb01,,64394,135,64529
2491,,fc8y9x82jqaj,57344,57345,114689
2492,,bdn03rzhuqej,38158,38159,76317
2493,conf/sigmod/radekebbekkn95,,65843,1584,67427
2494,conf/vldb/bohannonlrsss97,,66136,1877,68013
2495,,gzk2n5eq0pqj,27104,27105,54209
2496,conf/vldb/stanoiraa01,,66437,2178,68615
2497,,sbpuq0l7kugj,28056,28057,56113
2498,journals/vldb/stonebrakeralpsssy96,,66788,2529,69317
2499,,dwgxdmgufd4j,32021,32022,64043
2500,journals/sigmod/conradhhkrss99,,64745,486,65231
2501,,nmehi0tiwgaj,44260,44261,88521
2502,conf/vldb/shanmugasundaramsbclpr00,,65448,1189,66637
2503,,_bdp5t8ssuoj,917,918,1835
2504,conf/vldb/baulierbgjgkkmmnnrss98,,65796,1537,67333
2505,,vq41ltuxmruj,41480,41481,82961
2506,conf/vldb/risheyaclmvsv00,,65590,1331,66921
2507,,0wymhga_bt4j,54206,54207,108413
2508,conf/sigmod/quasswghlmnrrauw96,,65750,1491,67241
2509,,ob7qyk3hkiej,6466,6467,12933
2510,conf/vldb/karayannidistspmrfeb02,,66382,2123,68505
2511,,9kipvaodknyj,12872,12873,25745
2512,,ionxl_rg2_cj,24253,24254,48507
2513,journals/sigmod/meltonmjksz01,,64625,366,64991
2514,,oh5xzwjwc6aj,21474,21475,42949
2515,journals/tods/jajodiasss01,,66595,2336,68931
2516,conf/sigmod/barufghjpw95,,65830,1571,67401
2517,,c60kjg_xvm0j,61429,61430,122859
2518,,beu_llku9nmj,36510,36511,73021
2519,conf/sigmod/avnurhlorrrw98,,65444,1185,66629
2520,conf/vldb/nathdkgks03,,66310,2051,68361
2521,,pf6ew_ykyyyj,25303,25304,50607
2522,conf/vldb/panramohamv02,,66407,2148,68555
2523,,f9fe5nfpk6mj,10171,10172,20343
2524,,tasynkdiafwj,40788,40789,81577
2525,conf/vldb/tatbulczcs03,,66356,2097,68453
2526,,sipdbj3sob4j,23827,23828,47655
2527,conf/sigmod/shenoyhsbbs00,,65074,815,65889
2528,conf/sigmod/nglhm99,,65227,968,66195
2529,,yemauugizlcj,2880,2881,5761
2530,conf/sigmod/patelyktnbhrlekgdn97,,65595,1336,66931
2531,,0inumfzsq50j,45734,45735,91469
2532,,url:http://portal.acm.org/citation.cfm3fid3d271095,38694,38695,77389
2533,journals/sigmod/jajodiabbkmsw97,,64788,529,65317
2534,conf/sigmod/maddenh02,,64727,468,65195
2535,,nxakcefucduj,57437,57438,114875
2536,conf/sigmod/fungsg02,,64736,477,65213
2537,,_h4-zecasp0j,54127,54128,108255
2538,journals/sigmod/abeltk97,,64968,709,65677
2539,,yk-yqvaixekj,52851,52852,105703
2540,conf/vldb/limwv03,,66351,2092,68443
2541,,apjnwochluwj,35979,35980,71959
2542,journals/sigmod/vassiliadiss99,,64516,257,64773
2543,,egaraswvbruj,25080,25081,50161
2544,,yrnhcmqsuvoj,19641,19642,39283
2545,conf/sigmod/ivesfflw99,,65208,949,66157
2546,,tsvyx-eqvykj,18707,18708,37415
2547,journals/tods/liudl02,,66598,2339,68937
2548,conf/vldb/rosenthals94,,64449,190,64639
2549,,nfuwsbxtcncj,17438,17439,34877
2550,,jquww88-2_0j,13409,13410,26819
2551,conf/sigmod/yangyw00,,65168,909,66077
2552,,xcp3p-hk8bmj,55523,55524,111047
2553,conf/vldb/diligenticlgg00,,65588,1329,66917
2554,journals/vldb/doanmddh03,,66553,2294,68847
2555,,hme1bte68dyj,57378,57379,114757
2556,conf/vldb/bohannonfhrrs02,,66434,2175,68609
2557,,zyfyg0fczesj,14974,14975,29949
2558,,1j26mbtxds0j,41965,41966,83931
2559,conf/vldb/carneyccclsstz02,,66475,2216,68691
2560,conf/vldb/menglywcr98,,65877,1618,67495
2561,,ecppzbn2eaij,5635,5636,11271
2562,,ezos-ycisrsj,58133,58134,116267
2563,conf/vldb/dillkmrst01,,65292,1033,66325
2564,,o-trhfwhkm8j,20010,20011,40021
2565,conf/sigmod/oconnelliswabcclpww96,,65616,1357,66973
2566,journals/sigmod/ramamrithamsstx96,,64936,677,65613
2567,,kezam71rts0j,3706,3707,7413
2568,conf/sigmod/hellersteina00,,65051,792,65843
2569,,gsb6dnkfbmoj,9472,9473,18945
2570,,w8o7pgtygtyj,64192,64193,128385
2571,conf/vldb/jagadishkns99,,65694,1435,67129
2572,conf/vldb/poosalai96,,66114,1855,67969
2573,,ntlgms3lqnej,59184,59185,118369
2574,conf/sigmod/chenr94,,65984,1725,67709
2575,,4hhh-d__bksj,56122,56123,112245
2576,conf/vldb/yang95,,66192,1933,68125
2577,,lr_kq9szly8j,56022,56023,112045
2578,journals/vldb/jagadishkns00,,66741,2482,69223
2579,,gtxc02ejjcgj,53215,53216,106431
2580,,negc_a7qqnmj,52331,52332,104663
2581,conf/vldb/poosalai97,,66156,1897,68053
2582,,tmxkkrdxvkqj,51042,51043,102085
2583,journals/sigmod/yang95,,65045,786,65831
2584,,umrivnvioj0j,50108,50109,100217
2585,conf/vldb/ioannidisp99,,65728,1469,67197
2586,,3csfflevvimj,44638,44639,89277
2587,conf/vldb/ipeirotisg02,,66490,2231,68721
2588,,gxhaggajwzkj,4335,4336,8671
2589,journals/vldb/barbarai95,,66793,2534,69327
2590,,bv21ujezuwaj,42525,42526,85051
2591,conf/sigmod/ioannidisp95,,65808,1549,67357
2592,conf/vldb/jonscherd94,,64325,66,64391
2593,,1r21ho7j9sqj,36504,36505,73009
2594,,f0t3kimkbgcj,33904,33905,67809
2595,conf/sigmod/ramanh02,,64795,536,65331
2596,conf/vldb/lohmanl02,,66403,2144,68547
2597,,jc-tppzlpuej,32672,32673,65345
2598,journals/tods/eiterlls01,,66589,2330,68919
2599,,ltwqvb8e7sij,31009,31010,62019
2600,,egvbpvtoammj,28779,28780,57559
2601,conf/vldb/brinkhoffk94,,64419,160,64579
2602,journals/tods/yang99,,66630,2371,69001
2603,,y6glsjhyxfcj,26867,26868,53735
2604,,9pjwqppvlqwj,23459,23460,46919
2605,conf/vldb/wangzl99,,65755,1496,67251
2606,,8ppmw6a0xfkj,12249,12250,24499
2607,conf/vldb/ramanh01,,65306,1047,66353
2608,,dnvhtz7tmywj,1104,1105,2209
2609,conf/sigmod/berchtoldk97,,65628,1369,66997
2610,conf/sigmod/morpaincfp96,,65767,1508,67275
2611,,98umdgwqrhcj,52551,52552,105103
2612,,paltniturbcj,48133,48134,96267
2613,journals/vldb/bohmany97,,66675,2416,69091
2614,,vshqbbpnqiuj,8496,8497,16993
2615,conf/sigmod/livnyrbcdlmw97a,,65581,1322,66903
2616,,rmyorcw6qn8j,54670,54671,109341
2617,conf/vldb/srinivasandfcjyktdb00,,65626,1367,66993
2618,,w_fowuavk0kj,46426,46427,92853
2619,journals/vldb/fiebighkmnsw02,,66728,2469,69197
2620,,jubkwsufbbcj,4248,4249,8497
2621,conf/vldb/carneyczrcs03,,66288,2029,68317
2622,journals/sigmod/shanmugasundaramskkvnt01,,64441,182,64623
2623,,wtjy5xqucpsj,37911,37912,75823
2624,,uqi8etf3k7sj,2827,2828,5655
2625,conf/sigmod/livnyrbcdlmw97,,65592,1333,66925
2626,,qz24tffnhuoj,21320,21321,42641
2627,conf/sigmod/maddenfhh03,,64627,368,64995
2628,,ab6midvdzhaj,20482,20483,40965
2629,conf/sigmod/chencppstm00,,65148,889,66037
2630,conf/vldb/bouguettayaemo01,,65537,1278,66815
2631,,n-ta57d7ydcj,3449,3450,6899
2632,,eyohvek12p0j,34033,34034,68067
2633,journals/vldb/agrawalajl95,,66799,2540,69339
2634,,,1820,1821,3641
2635,conf/sigmod/agrawalasy97,,65601,1342,66943
2636,conf/vldb/dittrichstw02,,66483,2224,68707
2637,,egcgejikcgaj,55563,55564,111127
2638,,nbu59lk7jjyj,49228,49229,98457
2639,conf/sigmod/shatdaln95,,65732,1473,67205
2640,,vwbm4eeefnmj,487,488,975
2641,journals/vldb/filetolpam03,,66551,2292,68843
2642,,xufwwhmof6ij,31970,31971,63941
2643,conf/sigmod/goldsteinl01,,64923,664,65587
2644,,zshfczjwfqqj,30911,30912,61823
2645,conf/sigmod/cherniackz96,,65768,1509,67277
2646,journals/sigmod/phataksss96,,64935,676,65611
2647,,url:http://portal.acm.org/ft_gateway.cfm3fid3d38189726type3dpdf26dl3dportal26dl3dacm26cfid3d1111111126cftoken3d2222222,30708,30709,61417
2648,,kzffjieudw4j,30009,30010,60019
2649,journals/vldb/rafieim02,,66709,2450,69159
2650,,3y1e-h-fdc0j,29922,29923,59845
2651,conf/vldb/ramakrishnanr96,,66873,2614,69487
2652,conf/vldb/cherniackz98,,65852,1593,67445
2653,,so_h9oer6lsj,29800,29801,59601
2654,journals/tods/guosw96,,66524,2265,68789
2655,,v8ls_tys6mgj,26613,26614,53227
2656,,ug0yk0qhilmj,16699,16700,33399
2657,conf/vldb/daynesc02,,66381,2122,68503
2658,journals/sigmod/roantrees02,,64384,125,64509
2659,,xfror_g4_uoj,16585,16586,33171
2660,,80t8-ddj8osj,16365,16366,32731
2661,conf/vldb/brodiec99,,65700,1441,67141
2662,conf/sigmod/chungms02,,64650,391,65041
2663,,n8tscfmebtwj,15425,15426,30851
2664,,s6tmgrguq1ij,15221,15222,30443
2665,journals/sigmod/domenigd99,,64726,467,65193
2666,,pjtgp4aqt00j,15136,15137,30273
2667,journals/vldb/jiange98,,66647,2388,69035
2668,journals/sigmod/mattosd94,,65251,992,66243
2669,,hhucea7de6yj,14728,14729,29457
2670,,1nzsxf_zwf4j,14359,14360,28719
2671,conf/vldb/niermanj02,,66384,2125,68509
2672,conf/sigmod/brodskysce99,,65308,1049,66357
2673,,jnbo-gbtmacj,11404,11405,22809
2674,conf/sigmod/christophidescs00,,65111,852,65963
2675,,dqhbayratyij,42877,42878,85755
2676,,3lzo6p8x-n4j,41710,41711,83421
2677,conf/sigmod/bilirisdgjr94,,65966,1707,67673
2678,,74d4yidcxfcj,5599,5600,11199
2679,journals/vldb/ferrariaabc02,,66708,2449,69157
2680,,vuu_dcecrxaj,21824,21825,43649
2681,conf/vldb/gutierrezpst94,,64345,86,64431
2682,conf/vldb/ailamakidhs01,,65289,1030,66319
2683,,gujropj89tqj,32517,32518,65035
2684,journals/tods/hjaltasons99,,66632,2373,69005
2685,,xuojnqoartsj,922,923,1845
2686,conf/vldb/rosss97,,65930,1671,67601
2687,,,8421,8422,16843
2688,,ev27auqiecuj,60800,60801,121601
2689,conf/sigmod/bumbulisb02,,64742,483,65225
2690,,rnntyncghloj,60496,60497,120993
2691,conf/vldb/bernsteind94,,64442,183,64625
2692,conf/vldb/madhavanh03,,66367,2108,68475
2693,,ujcyoqks6bcj,55358,55359,110717
2694,,ww6duvl80ryj,50310,50311,100621
2695,conf/vldb/kumaranh03,,66342,2083,68425
2696,,sfb17fi4mzsj,45191,45192,90383
2697,conf/sigmod/deshpandengs03a,,64689,430,65119
2698,,wivjneqewzmj,43198,43199,86397
2699,conf/sigmod/agrawalw00,,65055,796,65851
2700,,huqbq_9ohcgj,41383,41384,82767
2701,conf/sigmod/mumickp94,,66006,1747,67753
2702,journals/tods/hjaltasons03,,65171,912,66083
2703,,9wan9spnuayj,40799,40800,81599
2704,conf/sigmod/deshpandengs03,,64573,314,64887
2705,,fu6zoukexe8j,38068,38069,76137
2706,conf/sigmod/kimck01,,64934,675,65609
2707,,eyi-oulriz8j,33959,33960,67919
2708,,ospjva6ad1sj,30372,30373,60745
2709,conf/sigmod/riedelfgn00,,65068,809,65877
2710,conf/vldb/kounevb02,,66501,2242,68743
2711,,mq4clanqtdqj,27611,27612,55223
2712,,iw5byr098o4j,20132,20133,40265
2713,journals/sigmod/barbaras97,,64806,547,65353
2714,conf/sigmod/viglasn02,,64713,454,65167
2715,,2aeb_pbp7lcj,18745,18746,37491
2716,,krlel-n4ce8j,18636,18637,37273
2717,conf/vldb/matthess94,,64488,229,64717
2718,journals/vldb/hjaltasons02,,66706,2447,69153
2719,,fh41dtwf_jaj,18490,18491,36981
2720,,3mwwuz_ornyj,15916,15917,31833
2721,conf/sigmod/hjaltasons98,,65416,1157,66573
2722,conf/vldb/haasnss95,,64280,21,64301
2723,,x70y3qatl40j,14198,14199,28397
2724,conf/sigmod/choals03,,64684,425,65109
2725,,madjh9lcsysj,5179,5180,10359
2726,conf/vldb/choals02,,66492,2233,68725
2727,,_-jzt1couz8j,44370,44371,88741
2728,journals/tods/formicagm98,,66614,2355,68969
2729,,ptcmzsfkyrsj,8799,8800,17599
2730,,zapmw7wx5-aj,17926,17927,35853
2731,conf/vldb/nicklasgs03,,66322,2063,68385
2732,,zbzo-4fuiwuj,54222,54223,108445
2733,conf/vldb/lakshmananpz03,,66315,2056,68371
2734,conf/sigmod/lakshmananpz03a,,64706,447,65153
2735,,4sj3mlpggvqj,37620,37621,75241
2736,conf/sigmod/lakshmananpz03,,64517,258,64775
2737,,rnu93tfkkd4j,1238,1239,2477
2738,conf/vldb/srivastavadjl96,,66060,1801,67861
2739,,01zvdudf4waj,28536,28537,57073
2740,journals/sigmod/stolfolcfe01,,64454,195,64649
2741,,lvipwxkn4yaj,18710,18711,37421
2742,,hrtoevpkaa0j,24947,24948,49895
2743,conf/vldb/eleftherioubcdhlppabdddgjhlrsvw03,,66325,2066,68391
2744,journals/sigmod/cerikklosv00,,64534,275,64809
2745,,nlbw09unfmsj,22740,22741,45481
2746,,h4hha7dqdsaj,9873,9874,19747
2747,conf/vldb/ludasahergm00,,65576,1317,66893
2748,journals/vldb/harderr96,,66776,2517,69293
2749,,pwxipx5la7gj,9994,9995,19989
2750,conf/vldb/yana94,,64462,203,64665
2751,,8j5i7yjqnnaj,9763,9764,19527
2752,,mcufkbwcwiij,9393,9394,18787
2753,conf/vldb/careyk98,,65833,1574,67407
2754,conf/vldb/davisong94,,64491,232,64723
2755,,fn8ww3y4fjkj,9032,9033,18065
2756,conf/sigmod/chengmv02,,64776,517,65293
2757,,iqv3eplopp4j,61264,61265,122529
2758,journals/sigmod/papianiwdn99,,64754,495,65249
2759,,hxmneecigx8j,59279,59280,118559
2760,conf/vldb/johnsonm98,,65814,1555,67369
2761,,efynrwkk_t0j,54755,54756,109511
2762,,pz2vrtdxq1cj,5130,5131,10261
2763,journals/tods/bellnns96,,66525,2266,68791
2764,conf/vldb/urhanf01,,65363,1104,66467
2765,,0-fuxurm1fqj,48583,48584,97167
2766,,chmpculihzoj,46559,46560,93119
2767,journals/sigmod/medeirosp94,,65265,1006,66271
2768,,28gz8m1zpvyj,46313,46314,92627
2769,conf/vldb/keimh99,,65678,1419,67097
2770,,pkku82iyp9ej,44352,44353,88705
2771,conf/sigmod/berchtoldk98,,65368,1109,66477
2772,,oodaqqph_zsj,41350,41351,82701
2773,journals/sigmod/fifeg03,,66228,1969,68197
2774,,s6tmnzkgmxwj,40165,40166,80331
2775,journals/vldb/swamis95,,66795,2536,69331
2776,,4egmtiywbruj,40068,40069,80137
2777,conf/sigmod/gibbonsm98,,65439,1180,66619
2778,,kpu-guh7cckj,34161,34162,68323
2779,journals/vldb/leew94,,66821,2562,69383
2780,,o4ucgdem7vyj,32418,32419,64837
2781,conf/vldb/shafera97,,66127,1868,67995
2782,,2l-ufpdof3uj,31482,31483,62965
2783,conf/vldb/georgeh98,,65998,1739,67737
2784,,czvyfze-kj0j,31419,31420,62839
2785,conf/vldb/shegalovwbl02,,66415,2156,68571
2786,journals/sigmod/ciliab02,,64289,30,64319
2787,,y1hvgtopekij,23454,23455,46909
2788,,c9imfvgrsvaj,21407,21408,42815
2789,conf/sigmod/hinneburgk99,,65245,986,66231
2790,,jvthmgx_uoqj,18398,18399,36797
2791,conf/vldb/galaniswjd03,,66290,2031,68321
2792,journals/sigmod/hansonn99,,64759,500,65259
2793,,b5urdgkyrcmj,17489,17490,34979
2794,conf/sigmod/sistlaw95,,65867,1608,67475
2795,,ko3fcq57_rkj,16491,16492,32983
2796,,qcnvlnwyp6cj,14514,14515,29029
2797,conf/sigmod/ilyasrlgl03,,64475,216,64691
2798,conf/vldb/ghoshpsh02,,66470,2211,68681
2799,,2dloojusneij,14436,14437,28873
2800,conf/sigmod/davisong95,,65804,1545,67349
2801,,96srvgndmmoj,13459,13460,26919
2802,conf/vldb/seiferts02,,66401,2142,68543
2803,,1vehuogtmzmj,11492,11493,22985
2804,,ommfvfvpt6mj,11112,11113,22225
2805,journals/vldb/rahmb01,,66750,2491,69241
2806,,pvutzwbcxlaj,10950,10951,21901
2807,conf/sigmod/wynblattn01,,64967,708,65675
2808,conf/vldb/chenjlp03,,66337,2078,68415
2809,,bgcx_nzkm4wj,8693,8694,17387
2810,journals/tods/lakshmananlrs97,,66610,2351,68961
2811,,ubyn6paxexwj,48673,48674,97347
2812,,l7vxp-dxbukj,64160,64161,128321
2813,conf/vldb/triantafilloup97,,66121,1862,67983
2814,,_hnid_qlddaj,47743,47744,95487
2815,conf/vldb/lakshmananph02,,66394,2135,68529
2816,conf/sigmod/gillmannwsww00,,65063,804,65867
2817,,l61_1tegblyj,23913,23914,47827
2818,,6ej6a2y_u1ij,25159,25160,50319
2819,conf/vldb/yuslj02,,66493,2234,68727
2820,,obbdfgqnedqj,61243,61244,122487
2821,conf/vldb/aboulnagaan01,,65351,1092,66443
2822,,byj0lvrijnkj,32276,32277,64553
2823,journals/vldb/garofalakisos98,,66644,2385,69029
2824,,4owpoyyttp4j,26171,26172,52343
2825,journals/tods/sistlawys98,,66627,2368,68995
2826,conf/vldb/haaskwy97,,66172,1913,68085
2827,,u09wdb3gik4j,12013,12014,24027
2828,,jnv4w3tkpxmj,673,674,1347
2829,conf/sigmod/kuhnts94,,66105,1846,67951
2830,,w1icm8iuwaej,27485,27486,54971
2831,journals/sigmod/hummerlw02,,64290,31,64321
2832,,69kmxg9nrzkj,477,478,955
2833,conf/vldb/dodjjr98,,66016,1757,67773
2834,conf/sigmod/godfreyse98,,65428,1169,66597
2835,,f5cqkpuxl0kj,17416,17417,34833
2836,,xcrkdhbiub8j,31565,31566,63131
2837,journals/vldb/suhhhlwlpll01,,66762,2503,69265
2838,,qhrpe-xalomj,6864,6865,13729
2839,conf/sigmod/wangzs95,,65945,1686,67631
2840,conf/sigmod/chaudhurign02,,64753,494,65247
2841,,y461ynb2gecj,30578,30579,61157
2842,journals/sigmod/norriebsw94,,65184,925,66109
2843,,q6yvjjgd1uqj,6758,6759,13517
2844,,0u8r8mjwgkaj,60669,60670,121339
2845,conf/sigmod/koudass97,,65553,1294,66847
2846,,3fo2448hzgwj,60249,60250,120499
2847,journals/vldb/singhals97,,66676,2417,69093
2848,,vburomkymqyj,55612,55613,111225
2849,conf/vldb/marathes97,,66048,1789,67837
2850,conf/vldb/lutd95,,64273,14,64287
2851,,qx-uykxvk7ej,49865,49866,99731
2852,journals/tods/zaharioudakiscf97,,66607,2348,68955
2853,,nauckadkoekj,46861,46862,93723
2854,conf/sigmod/careyfz94,,65972,1713,67685
2855,,en1nfwjxnoij,45268,45269,90537
2856,conf/vldb/setzerz94,,64409,150,64559
2857,,1tmw1moczqij,44663,44664,89327
2858,,gihrmj3vbsaj,43511,43512,87023
2859,conf/vldb/sevcikk96,,66080,1821,67901
2860,,4zlh-tex9m4j,42364,42365,84729
2861,conf/sigmod/pengc03,,64623,364,64987
2862,journals/sigmod/keetonph98,,64844,585,65429
2863,,6mtrlheclpej,37297,37298,74595
2864,journals/vldb/marathes02,,66712,2453,69165
2865,,z6jeyoarzmsj,37282,37283,74565
2866,conf/sigmod/kangn03,,64638,379,65017
2867,,abztkd0e9luj,33712,33713,67425
2868,,todimgxv4vmj,30938,30939,61877
2869,conf/sigmod/seidlk98,,65420,1161,66581
2870,,ac19z_yoctuj,26595,26596,53191
2871,conf/vldb/hellersteinnp95,,66223,1964,68187
2872,journals/tods/korths94,,66566,2307,68873
2873,,w40itklpweqj,24585,24586,49171
2874,conf/vldb/seidlk97,,65971,1712,67683
2875,,lzgfmx7pdckj,19180,19181,38361
2876,conf/vldb/gaos03,,66368,2109,68477
2877,,bepwgiqr6r4j,15405,15406,30811
2878,,erskdzxp1jcj,13297,13298,26595
2879,conf/sigmod/achyutunion96,,65682,1423,67105
2880,conf/vldb/wufsp00,,65464,1205,66669
2881,,xojbafbtdvcj,12903,12904,25807
2882,,ws4ljty1ff8j,10834,10835,21669
2883,conf/vldb/mankum02,,66486,2227,68713
2884,,ult4nmnmjp8j,33747,33748,67495
2885,conf/vldb/bouganimcddgs99,,65890,1631,67521
2886,,chcpylibpr4j,4526,4527,9053
2887,conf/sigmod/kempermps94,,66046,1787,67833
2888,journals/tods/chomickitb01,,66593,2334,68927
2889,,mqgslx1jbpsj,63259,63260,126519
2890,,t3ngiit3tbsj,63231,63232,126463
2891,conf/vldb/lubbersgj03,,66377,2118,68495
2892,,,38761,38762,77523
2893,journals/sigmod/kokkotosips95,,65054,795,65849
2894,conf/sigmod/selfridgesw96,,65687,1428,67115
2895,,v2wysmw3ti4j,64225,64226,128451
2896,conf/sigmod/slivinskasjs01,,64858,599,65457
2897,,oavbm_vepr8j,60993,60994,121987
2898,,xtpss2k_puij,43602,43603,87205
2899,journals/sigmod/slivinskasjs02,,64300,41,64341
2900,,aym35wwvdlqj,31898,31899,63797
2901,conf/sigmod/tsuruacmnr98,,65474,1215,66689
2902,,y799jsppkkej,1533,1534,3067
2903,conf/vldb/agrawallss95,,66226,1967,68193
2904,journals/vldb/medjahedbbne03,,66720,2461,69181
2905,,vtvf3hshlvij,16912,16913,33825
2906,conf/sigmod/changg99,,65316,1057,66373
2907,,8yt1mba9-wqj,35224,35225,70449
2908,conf/vldb/changg00,,65421,1162,66583
2909,,fiughhczl-4j,22437,22438,44875
2910,journals/tods/chenhm95,,66522,2263,68785
2911,,po6sfdvgt5qj,13356,13357,26713
2912,,p4q8x9umngkj,9693,9694,19387
2913,conf/vldb/chenggkllqs99,,65873,1614,67487
2914,,dvn0led5jlaj,18426,18427,36853
2915,conf/sigmod/vriesmnk02,,64768,509,65277
2916,,vuy9y49gqxgj,32103,32104,64207
2917,conf/sigmod/abadicccceghmrsstxyz03,,64539,280,64819
2918,,jvz9jwtn72qj,8318,8319,16637
2919,conf/sigmod/lomett99,,65276,1017,66293
2920,journals/vldb/mehtad97,,66775,2516,69291
2921,,zppqmpnftqij,62617,62618,125235
2922,,v9xuvirmveej,62079,62080,124159
2923,conf/sigmod/kabrad98,,65403,1144,66547
2924,,b7ixewtlihaj,6149,6150,12299
2925,conf/sigmod/markll02,,64824,565,65389
2926,,jf30ixlsrauj,61074,61075,122149
2927,journals/vldb/kabrad99,,66648,2389,69037
2928,,7j1pkfzfgnyj,60451,60452,120903
2929,conf/vldb/yif00,,65468,1209,66677
2930,,su2xs1mvb40j,6006,6007,12013
2931,conf/vldb/hammelp02,,66504,2245,68749
2932,conf/sigmod/galindo-legaria94,,66049,1790,67839
2933,,ies59h5efhwj,58494,58495,116989
2934,conf/vldb/iyerw94,,64444,185,64629
2935,,5smjvum1kayj,50974,50975,101949
2936,journals/sigmod/jacobs99,,64518,259,64777
2937,,3-iisyjlwlkj,50527,50528,101055
2938,conf/vldb/zhangl97,,65952,1693,67645
2939,,qgopit06clej,49619,49620,99239
2940,,maqivsd2vomj,48023,48024,96047
2941,journals/tods/karpsp03,,65216,957,66173
2942,conf/sigmod/grossmanq94,,66103,1844,67947
2943,,yjqdbenw5woj,4571,4572,9143
2944,conf/vldb/luon01,,65390,1131,66521
2945,,trwsf77xowsj,44545,44546,89091
2946,,aypwuksukvoj,31730,31731,63461
2947,journals/vldb/haascls97,,66668,2409,69077
2948,conf/sigmod/hsiaon00,,65077,818,65895
2949,,iy5wls4jsg0j,30154,30155,60309
2950,,zjhaebjyahaj,28657,28658,57315
2951,conf/vldb/zhangl98,,65923,1664,67587
2952,conf/sigmod/zadorozhnyrvub02,,64654,395,65049
2953,,xme1380_4e4j,6461,6462,12923
2954,conf/vldb/shashab02,,66447,2188,68635
2955,,3hunvguxtzej,32567,32568,65135
2956,,fro4fx_q6gij,4794,4795,9589
2957,conf/vldb/careyksss00,,65567,1308,66875
2958,journals/vldb/vaghanirksslh94,,66814,2555,69369
2959,,b3e3_clrrryj,3547,3548,7095
2960,conf/vldb/ankerstbks98,,65856,1597,67453
2961,,dblgmjx7uj8j,50955,50956,101911
2962,,zadltkygasqj,52025,52026,104051
2963,journals/vldb/jagadishaclnppswwy02,,66727,2468,69195
2964,,9rjezsgswxyj,63269,63270,126539
2965,conf/vldb/gingrasl98,,65837,1578,67415
2966,,7jsbx3h3cvuj,42054,42055,84109
2967,conf/vldb/gyssensl97,,66050,1791,67841
2968,journals/sigmod/tatarinovimhsddkmm03,,66207,1948,68155
2969,,0jphnhlrgooj,14915,14916,29831
2970,conf/vldb/bernsteinhssz97,,65981,1722,67703
2971,,l2c8xblcsicj,16703,16704,33407
2972,conf/sigmod/rajagopalanml98,,65360,1101,66461
2973,,wo6veelixasj,62227,62228,124455
2974,conf/vldb/cherniackfz01,,66443,2184,68627
2975,,49ewg8vzsxuj,35560,35561,71121
2976,,nxvdy_qqsd4j,11014,11015,22029
2977,journals/vldb/candanls00,,66656,2397,69053
2978,conf/sigmod/hacigumusilm02,,64646,387,65033
2979,,nmgexe-jrd0j,59339,59340,118679
2980,,64iwa-ziprcj,3132,3133,6265
2981,journals/sigmod/snodgrassaabcdegjkkkllrsss94,,65181,922,66103
2982,,l7glyh7ltuqj,711,712,1423
2983,conf/vldb/tiand03,,66362,2103,68465
2984,journals/sigmod/bertinoeh03,,66252,1993,68245
2985,,4m-wmwu5igyj,62379,62380,124759
2986,journals/vldb/lichh01,,66738,2479,69217
2987,,tw8-f4saqb0j,59775,59776,119551
2988,,cgouj7dogcwj,56167,56168,112335
2989,conf/vldb/ouzzaniab94,,64339,80,64419
2990,conf/sigmod/bargal99,,65299,1040,66339
2991,,qgxyk7bjqomj,49290,49291,98581
2992,journals/tods/castanoafp98,,66624,2365,68989
2993,,x7wtr1g63qej,46349,46350,92699
2994,,dvnochunv7mj,45142,45143,90285
2995,journals/sigmod/darwend95,,65091,832,65923
2996,conf/sigmod/yangm97,,65573,1314,66887
2997,,xrtlycyfktwj,44728,44729,89457
2998,,ojoqrhgd-qwj,42258,42259,84517
2999,conf/vldb/casatis00,,65551,1292,66843
3000,,nbhs2btx-gkj,3926,3927,7853
3001,conf/vldb/huangjr97,,66164,1905,68069
3002,,hej1z4q_xxmj,380,381,761
3003,conf/vldb/schoning98,,66029,1770,67799
3004,conf/sigmod/guptas03,,64620,361,64981
3005,,6ditjpvnxaqj,35222,35223,70445
3006,,tzbiz9zhdtkj,34903,34904,69807
3007,conf/vldb/ninkhr99,,65760,1501,67261
3008,journals/sigmod/bertinoeh01,,64629,370,64999
3009,,rba70p6sqqyj,33914,33915,67829
3010,,bn8s7u5t9saj,33847,33848,67695
3011,journals/tods/graefec95,,66515,2256,68771
3012,journals/tods/jacoxs03,,65205,946,66151
3013,,ujd_9yazctuj,31619,31620,63239
3014,conf/sigmod/coleg94,,66009,1750,67759
3015,,z_w8jz203suj,241,242,483
3016,conf/vldb/jagadishls99,,65683,1424,67107
3017,,5d1r2md-7mkj,2181,2182,4363
3018,conf/vldb/chavdaw97,,66158,1899,68057
3019,,e9aspvycdlmj,20715,20716,41431
3020,journals/vldb/kellerb96,,66769,2510,69279
3021,,tvoqzpeehv8j,1498,1499,2997
3022,,ey7mbh6idqij,24772,24773,49545
3023,conf/sigmod/liskovacdggmms96,,65780,1521,67301
3024,journals/sigmod/drewhkklllsw95,,65112,853,65965
3025,,9fcjjh5vhn8j,404,405,809
3026,,6gxdj4jzuokj,52664,52665,105329
3027,conf/vldb/shengbdm02,,66413,2154,68567
3028,conf/sigmod/szalaygtkmrsv02,,64815,556,65371
3029,,1tkwkmyczayj,13334,13335,26669
3030,,_uajdh22y_ej,21349,21350,42699
3031,conf/sigmod/flokstraks94,,66061,1802,67863
3032,journals/vldb/abadicccclstz03,,66542,2283,68825
3033,,gbvnsfes4p8j,23065,23066,46131
3034,journals/sigmod/urbandg96,,64956,697,65653
3035,,url:http://portal.acm.org/ft_gateway.cfm3fid3d38189226type3dpdf26dl3dguide26dl3dacm26cfid3d1111111126cftoken3d2222222,7528,7529,15057
3036,conf/vldb/hinneburgak00,,65600,1341,66941
3037,,1ambq2rmgmoj,53969,53970,107939
3038,journals/sigmod/jenningsnf98,,64665,406,65071
3039,,yizvv5kvdb4j,49413,49414,98827
3040,conf/sigmod/simmensm96,,65618,1359,66977
3041,,xvp8s4k0bg4j,31508,31509,63017
3042,conf/vldb/aggarwalhwy03,,66340,2081,68421
3043,,szlqycesmpgj,25379,25380,50759
3044,conf/sigmod/zhaodn97,,65496,1237,66733
3045,,ywlogdtgg-sj,2400,2401,4801
3046,conf/vldb/agrawalpwz95,,64359,100,64459
3047,,x_ykbvlfyp8j,41256,41257,82513
3048,,rkngp2gmotuj,51507,51508,103015
3049,journals/vldb/templetonhmb95,,66808,2549,69357
3050,conf/vldb/careycnvdrsm99,,65680,1421,67101
3051,,jpmllvmmnkaj,12907,12908,25815
3052,,fqrvkpwzd3kj,63837,63838,127675
3053,journals/tods/lakshmananss01,,66603,2344,68947
3054,,micx2kygfkij,37432,37433,74865
3055,conf/sigmod/libkn03,,64574,315,64889
3056,conf/vldb/lakshmananss99,,65668,1409,67077
3057,,h5bvepneohqj,34603,34604,69207
3058,,iayjhuqv_qmj,34516,34517,69033
3059,conf/vldb/gravanoijkms01,,65361,1102,66463
3060,journals/vldb/linjf94,,66820,2561,69381
3061,,vmxfql7lhkoj,8785,8786,17571
3062,,8l5_ekzcch8j,809,810,1619
3063,journals/sigmod/sommergb02,,64489,230,64719
3064,,vho2go6vjysj,63118,63119,126237
3065,journals/vldb/berchtoldkk97,,66673,2414,69087
3066,,xwyu2jwif_kj,41371,41372,82743
3067,journals/vldb/manegoldbk00,,66740,2481,69221
3068,,hwbmsp8-fxcj,2551,2552,5103
3069,conf/vldb/hoels95,,64299,40,64339
3070,conf/vldb/manegoldbk02,,66473,2214,68687
3071,,kb9zbekvnzoj,22519,22520,45039
3072,conf/sigmod/lic95,,65951,1692,67643
3073,,yjpi5nbjmvyj,20926,20927,41853
3074,,rkay1azaecoj,19848,19849,39697
3075,journals/vldb/diazj97,,66692,2433,69125
3076,,id1cvsqurbaj,16244,16245,32489
3077,conf/vldb/hoels94,,64416,157,64573
3078,,o0rvk0gfmbej,14804,14805,29609
3079,conf/vldb/lic94,,64400,141,64541
3080,conf/sigmod/rundensteinerclcznjlw99,,65303,1044,66347
3081,,sadcqzhmqgej,34036,34037,68073
3082,conf/vldb/galindo-legariajww03,,66281,2022,68303
3083,,3fcnsaxb9raj,23121,23122,46243
3084,journals/sigmod/arenaskkkmm03,,66201,1942,68143
3085,,bivrk7mru4qj,6720,6721,13441
3086,conf/sigmod/ambiteabkmmmpt98,,65447,1188,66635
3087,,ie-ue2bdgz8j,8808,8809,17617
3088,,f6ko8zvwypuj,61833,61834,123667
3089,journals/vldb/hansoncdertx98,,66696,2437,69133
3090,,yq90bysvqbsj,7799,7800,15599
3091,conf/sigmod/adalibss98,,65349,1090,66439
3092,,c8rlbwkcgicj,7379,7380,14759
3093,conf/sigmod/leekotm00,,65099,840,65939
3094,conf/vldb/levyro96,,66841,2582,69423
3095,,e_vupqi8-xij,9780,9781,19561
3096,journals/vldb/torpjs00,,66666,2407,69073
3097,,wr5pri-igqsj,57621,57622,115243
3098,journals/sigmod/chientz01,,64401,142,64543
3099,,cjbpi3tcswsj,368,369,737
3100,journals/vldb/chientz02,,66723,2464,69187
3101,,j4wcclzqy0oj,32682,32683,65365
3102,journals/sigmod/hasanmv96,,64993,734,65727
3103,,blbjffkqjdij,32100,32101,64201
3104,conf/vldb/chientz01,,65381,1122,66503
3105,,ewcz_yjfqjcj,20967,20968,41935
3106,,um1zozyrjnij,13708,13709,27417
3107,conf/vldb/haberil95,,64357,98,64455
3108,conf/sigmod/dehaantco03,,64560,301,64861
3109,,gyybygpb63sj,41431,41432,82863
3110,,cehaaltq4s8j,48996,48997,97993
3111,conf/vldb/dewittklpy94,,64430,171,64601
3112,conf/sigmod/labiozwggw97,,65633,1374,67007
3113,,uzpyy9xrpgyj,11626,11627,23253
3114,,hn2manngz9sj,40657,40658,81315
3115,journals/sigmod/pitouraapsv03,,66148,1889,68037
3116,,gld2wlkywpsj,41389,41390,82779
3117,journals/vldb/ozsupsilm95,,66784,2525,69309
3118,journals/sigmod/alonsocim95,,65107,848,65955
3119,,5llepa4wqmej,9642,9643,19285
3120,conf/vldb/lakshmananjn00,,65653,1394,67047
3121,,1n7ay641yyaj,23769,23770,47539
3122,conf/sigmod/bohrerbbcfhkkmnrrsuuw97,,65541,1282,66823
3123,,oulazpewkmqj,55113,55114,110227
3124,,efyvck07awmj,63353,63354,126707
3125,conf/sigmod/candanllha01,,64878,619,65497
3126,,vqboz3t4n4aj,63207,63208,126415
3127,journals/tods/franklincl97,,66604,2345,68949
3128,,mvbchqwgfawj,62475,62476,124951
3129,conf/vldb/zhour03,,66348,2089,68437
3130,conf/vldb/gardaringt96,,66052,1793,67845
3131,,4nkqwzc5a_wj,59806,59807,119613
3132,conf/sigmod/zhour02,,64778,519,65297
3133,,,59154,59155,118309
3134,journals/vldb/ailamakidh02,,66700,2441,69141
3135,,j9mefw0vdjaj,55961,55962,111923
3136,journals/vldb/wangw01,,66737,2478,69215
3137,,4ehvzhcqvdmj,51579,51580,103159
3138,journals/vldb/huntai02,,66701,2442,69143
3139,,liyp5oadwbmj,50748,50749,101497
3140,,zmk02pxd4oej,41632,41633,83265
3141,journals/sigmod/groskyfs94,,65242,983,66225
3142,,aerucf7ibqyj,38483,38484,76967
3143,conf/sigmod/houz95,,65811,1552,67363
3144,journals/tods/brighthp94,,66564,2305,68869
3145,,bhvvo_njxucj,3268,3269,6537
3146,journals/tods/subrahmanian94,,66563,2304,68867
3147,,sltzn9o1_wuj,28419,28420,56839
3148,,umko2kgqjwwj,18455,18456,36911
3149,conf/vldb/gardaringt95,,66241,1982,68223
3150,journals/vldb/whangkw94,,66816,2557,69373
3151,,glsoywdwiq8j,17134,17135,34269
3152,,0gt_dhqk5roj,16,17,33
3153,conf/vldb/huntai01,,65394,1135,66529
3154,,pafedpwj8tgj,15602,15603,31205
3155,conf/vldb/coopersfhs01,,65406,1147,66553
3156,,dfolezmoeaej,37832,37833,75665
3157,conf/sigmod/lakshmanannhp99,,65269,1010,66279
3158,conf/vldb/huebschhllss03,,66363,2104,68467
3159,,7y9somiiag0j,50194,50195,100389
3160,,tybrsgkj1a0j,22267,22268,44535
3161,journals/vldb/kamelws94,,66817,2558,69375
3162,conf/vldb/schieferkblf98,,66041,1782,67823
3163,,1latgst5o_ej,53451,53452,106903
3164,,uveodmvtqrmj,38980,38981,77961
3165,conf/sigmod/poosalaihs96,,65784,1525,67309
3166,,3oxzs395vdcj,62982,62983,125965
3167,conf/sigmod/seshadrihplrsss96,,65721,1462,67183
3168,,ywwvqngcpdej,49966,49967,99933
3169,conf/sigmod/cruzalrz97,,65579,1320,66899
3170,journals/sigmod/marchilpt03,,66257,1998,68255
3171,,9dgfu6xalrwj,46683,46684,93367
3172,,xx_3v0k3v6qj,32253,32254,64507
3173,journals/vldb/sivasankaranstpr96,,66791,2532,69323
3174,conf/sigmod/rundensteinerwyd02,,64836,577,65413
3175,,7mfxaadbq2ej,2591,2592,5183
3176,conf/sigmod/rundensteinerccso00,,65187,928,66115
3177,,url:http://portal.acm.org/ft_gateway.cfm3fid3d33549626type3dpdf26dl3dguide26dl3dacm26cfid3d1111111126cftoken3d2222222,14350,14351,28701
3178,,edq4m7genzoj,17454,17455,34909
3179,conf/vldb/guntzerbk00,,65608,1349,66957
3180,conf/vldb/grustkt03,,66379,2120,68499
3181,,25xrkml_4bsj,36209,36210,72419
3182,,lclvyrb7vjoj,33015,33016,66031
3183,journals/sigmod/ulusoyb96,,64924,665,65589
3184,conf/sigmod/wilschutfa95,,65857,1598,67455
3185,,vgoftdxyhz0j,43710,43711,87421
3186,conf/sigmod/hellerstein94,,66044,1785,67829
3187,,nn0lzb8rupej,835,836,1671
3188,journals/tods/hellerstein98,,66615,2356,68971
3189,,q8m4m7oxssaj,6475,6476,12951
3190,conf/sigmod/oriaoily00,,65067,808,65875
3191,,xduda920uhmj,63949,63950,127899
3192,,rp6i1ua3ryqj,61053,61054,122107
3193,conf/vldb/bargap95,,66233,1974,68207
3194,conf/vldb/raor99,,65781,1522,67303
3195,,tv4rtr2z-i8j,53415,53416,106831
3196,conf/sigmod/draperhw01,,64946,687,65633
3197,,surgdemfssuj,52941,52942,105883
3198,,mfpbk62edyqj,49520,49521,99041
3199,conf/sigmod/garofalakisi96,,65779,1520,67299
3200,conf/sigmod/gaow02,,64770,511,65281
3201,,pzteszecfnqj,46902,46903,93805
3202,,wlsximaxglqj,44808,44809,89617
3203,conf/sigmod/raor98,,65462,1203,66665
3204,conf/sigmod/chengm01,,64974,715,65689
3205,,iuydb53vog0j,31246,31247,62493
3206,journals/sigmod/doanpk95,,65144,885,66029
3207,,c0tsepqrwwmj,23375,23376,46751
3208,journals/tods/stolboushkint98,,66616,2357,68973
3209,,znwlup8hmkuj,22078,22079,44157
3210,journals/sigmod/nascimentosp03,,66178,1919,68097
3211,,g3qwq2t08sej,1042,1043,2085
3212,,c3qptremhgaj,30179,30180,60359
3213,conf/sigmod/possskl02,,64816,557,65373
3214,journals/tods/bozkayao99,,66628,2369,68997
3215,,cekbswc_c6uj,40043,40044,80087
3216,conf/sigmod/bozkayao97,,65599,1340,66939
3217,,gizvbo_lu2ij,27048,27049,54097
3218,,xa9knostv4cj,49149,49150,98299
3219,conf/sigmod/josifovskishl02,,64810,551,65361
3220,,cvggymrkr2sj,2409,2410,4819
3221,conf/vldb/schmidtwkcmb02,,66404,2145,68549
3222,conf/vldb/liulbhts03,,66276,2017,68293
3223,,pahzkao7m-sj,41223,41224,82447
3224,conf/sigmod/shennshs03,,64556,297,64853
3225,,ljrswir3rhaj,33630,33631,67261
3226,,cha3zvfbfdsj,63945,63946,127891
3227,conf/sigmod/gerber95,,65909,1650,67559
3228,,8n1uizmm4vmj,7248,7249,14497
3229,conf/vldb/luonew03,,66365,2106,68471
3230,journals/sigmod/clementinif00,,64561,302,64863
3231,,9_gtdtekeysj,6434,6435,12869
3232,conf/vldb/chanffgr02,,66390,2131,68521
3233,,zfi7xbuonjaj,6646,6647,13293
3234,,rpwdtumq6_qj,6607,6608,13215
3235,conf/vldb/jagadishmn99,,65730,1471,67201
3236,conf/sigmod/browncl96,,65716,1457,67173
3237,,h4a7nuwyxtqj,54152,54153,108305
3238,journals/vldb/liangoy00,,66640,2381,69021
3239,,ikw-en98lywj,39377,39378,78755
3240,conf/sigmod/rinfretoo01,,64855,596,65451
3241,,pyqtmrpg24yj,38508,38509,77017
3242,,q8il-aztmcgj,19161,19162,38323
3243,journals/vldb/deybs96,,66777,2518,69295
3244,,l-qhisxclxcj,16061,16062,32123
3245,conf/vldb/levyms94,,64395,136,64531
3246,journals/tods/deysb99,,66578,2319,68897
3247,,luijugqk6q4j,13041,13042,26083
3248,conf/sigmod/hellersteinn96,,65771,1512,67283
3249,,_hdcldpyum0j,10614,10615,21229
3250,journals/vldb/kieslingssd94,,66826,2567,69393
3251,,bvfryoianjuj,27708,27709,55417
3252,,knv3bo45nj4j,17663,17664,35327
3253,conf/vldb/teisseirepc94,,64406,147,64553
3254,,iknohdqey18j,2957,2958,5915
3255,conf/sigmod/acharyagpr99a,,65256,997,66253
3256,,jfkafzcmjgij,32746,32747,65493
3257,conf/sigmod/tatarinovihw01,,64927,668,65595
3258,conf/vldb/chencfgjmtw99,,65762,1503,67265
3259,,hq3w65us8dkj,22102,22103,44205
3260,conf/sigmod/cherniackz98,,65395,1136,66531
3261,,_wjzsvydrr8j,32748,32749,65497
3262,conf/sigmod/hungyk96,,65695,1436,67131
3263,,bti28rjbppwj,21529,21530,43059
3264,conf/sigmod/garofalakisg02,,64809,550,65359
3265,,6eac2cmjsmaj,9540,9541,19081
3266,,1o-uy922lquj,51926,51927,103853
3267,conf/vldb/ngy94,,64509,250,64759
3268,,0opfkuylwgej,51333,51334,102667
3269,conf/vldb/dor02,,66506,2247,68753
3270,,ft4sfn-z7guj,4515,4516,9031
3271,conf/vldb/sistlayh94,,64501,242,64743
3272,,knzz_bkga00j,43005,43006,86011
3273,journals/sigmod/leec00,,64582,323,64905
3274,conf/sigmod/pangcl94,,66034,1775,67809
3275,,bemsu5ebf30j,37382,37383,74765
3276,,k7zpsuksfysj,31390,31391,62781
3277,conf/sigmod/afratilu01,,64903,644,65547
3278,journals/sigmod/nascimento03,,66222,1963,68185
3279,,url:http://portal.acm.org/citation.cfm3fid3d776985.77699626dl3dportal26dl3dacm26idx3d77698526part3dperiodical26wanttype3dperiodical26title3dacm2520sigmod2520record26cfid3d1111111126cftoken3d2222222,31316,31317,62633
3280,,bse2se70omyj,27261,27262,54523
3281,conf/vldb/leehjt03,,66370,2111,68481
3282,,sggrbo99ajgj,17762,17763,35525
3283,journals/vldb/knorrnt00,,66665,2406,69071
3284,,nu5nhxl6wxqj,17760,17761,35521
3285,journals/vldb/lir99,,66639,2380,69019
3286,,url:http://www.springerlink.com/index/85d6lycwb48dwbkw.pdf,13413,13414,26827
3287,journals/vldb/ngs98,,66646,2387,69033
3288,conf/vldb/pottingerb03,,66262,2003,68265
3289,,q6phdav3sg4j,10774,10775,21549
3290,,kaza2ebctguj,59645,59646,119291
3291,journals/tods/mumickfpr96,,66521,2262,68783
3292,conf/sigmod/wangsszzw00,,65087,828,65915
3293,,caplzan57x4j,19597,19598,39195
3294,conf/sigmod/hwanglymmgcss94,,66089,1830,67919
3295,,awah9gleftaj,44060,44061,88121
3296,,wr0r0js5j6oj,43583,43584,87167
3297,conf/vldb/ramasamypnk00,,65617,1358,66975
3298,,vezxtigxnywj,13537,13538,27075
3299,conf/sigmod/breunigkns00,,65113,854,65967
3300,conf/vldb/darfjst96,,66250,1991,68241
3301,,gkbm-prdcswj,48520,48521,97041
3302,,wucxmf9g52gj,40178,40179,80357
3303,conf/vldb/changr02,,66476,2217,68693
3304,conf/sigmod/changh02,,64803,544,65347
3305,,4zxrx5k-yssj,29993,29994,59987
3306,,if5vzpt-qiaj,9822,9823,19645
3307,journals/vldb/ioannidisnss97,,66678,2419,69097
3308,journals/vldb/verykiosme03,,66719,2460,69179
3309,,khdp4spnnpoj,9381,9382,18763
3310,,3olpubhfatsj,52983,52984,105967
3311,journals/sigmod/kuokfw98,,64871,612,65483
3312,conf/sigmod/krollw94,,65976,1717,67693
3313,,zd_8s13rnroj,4108,4109,8217
3314,conf/vldb/desslochm97,,66161,1902,68063
3315,,cjtifow-owcj,40816,40817,81633
3316,,ldnawc5srmij,31861,31862,63723
3317,conf/vldb/carinoo98,,66031,1772,67803
3318,journals/sigmod/changgkrs98,,64840,581,65421
3319,,url:http://portal.acm.org/ft_gateway.cfm3fid3d29060726type3dpdf26dl3dportal26dl3dacm26cfid3d1111111126cftoken3d2222222,53126,53127,106253
3320,,c-kalb26vykj,38606,38607,77213
3321,conf/vldb/rothoh99,,65759,1500,67259
3322,,b201qeqnlnkj,48992,48993,97985
3323,journals/sigmod/cabreralm01,,64458,199,64657
3324,conf/vldb/jagadishkmpss98,,65849,1590,67439
3325,,0iins8bibsuj,45954,45955,91909
3326,,zt5ck1prgf0j,7913,7914,15827
3327,journals/vldb/tsatalossi96,,66764,2505,69269
3328,conf/sigmod/lamcknh01,,64943,684,65627
3329,,8hdqohfff48j,61942,61943,123885
3330,conf/sigmod/jonssonfs98,,65466,1207,66673
3331,,5fb1l1mygisj,55382,55383,110765
3332,,xr2rguuzt-gj,55081,55082,110163
3333,conf/vldb/steenhagenabb94,,64423,164,64587
3334,conf/vldb/eicklergk95,,66180,1921,68101
3335,,63qhlg57qssj,2165,2166,4331
3336,conf/sigmod/aggarwalpwyp99,,65163,904,66067
3337,,g3dx_rta26mj,25421,25422,50843
3338,conf/sigmod/lumss95,,65819,1560,67379
3339,,kk87yanai1aj,45259,45260,90519
3340,,l78oeiel4zsj,46631,46632,93263
3341,conf/sigmod/ooitzglllnswz03,,64700,441,65141
3342,journals/sigmod/winslettcdhzz02,,64334,75,64409
3343,,url:http://portal.acm.org/ft_gateway.cfm3fid3d60188126type3dpdf26dl3dguide26dl3dacm26cfid3d1111111126cftoken3d2222222,51636,51637,103273
3344,conf/sigmod/jonkers95,,65969,1710,67679
3345,,rg4uoutwgacj,27258,27259,54517
3346,,6uycfczoodoj,24965,24966,49931
3347,journals/tods/baekgaardm95,,66513,2254,68767
3348,,kenwbobilmwj,6645,6646,13291
3349,journals/sigmod/snodgrass02b,,66850,2591,69441
3350,conf/sigmod/geneserethkd97,,65625,1366,66991
3351,,2nl65vp7bxuj,54024,54025,108049
3352,,ymlukojrxmcj,53616,53617,107233
3353,conf/vldb/ngh94,,64332,73,64405
3354,,jelnwotiy9kj,53391,53392,106783
3355,conf/vldb/ioannidis03,,66326,2067,68393
3356,,m-l6e98xxosj,48836,48837,97673
3357,journals/sigmod/snodgrass03,,66244,1985,68229
3358,,pmrthjyk66cj,47117,47118,94235
3359,conf/sigmod/fernandez94,,66055,1796,67851
3360,,cakcskxfocoj,45431,45432,90863
3361,journals/sigmod/cetintemel01,,64432,173,64605
3362,,aqlslbctui4j,43262,43263,86525
3363,conf/vldb/mendelzonv00,,65634,1375,67009
3364,,vfwjdzgt9jyj,37600,37601,75201
3365,conf/vldb/orenstein98,,66036,1777,67813
3366,journals/sigmod/snodgrass94,,65176,917,66093
3367,,syvdufote_ij,3018,3019,6037
3368,,c2dh5rxnj6kj,293,294,587
3369,conf/sigmod/adaliss99,,65218,959,66177
3370,,ayei8xdoy9wj,2881,2882,5763
3371,journals/sigmod/bernstein98,,64891,632,65523
3372,,px35brwc6_ej,24762,24763,49525
3373,conf/vldb/hsulomtx02,,66427,2168,68595
3374,conf/sigmod/lassettre98,,65529,1270,66799
3375,,7p2maotr7u8j,24005,24006,48011
3376,journals/sigmod/snodgrass02,,64515,256,64771
3377,,_qopgniymxqj,22557,22558,45115
3378,,dvlv3bmgyrij,12660,12661,25321
3379,journals/tods/dyresons98,,66618,2359,68977
3380,conf/vldb/bohannongkns02,,66467,2208,68675
3381,,9bubq-tj0tuj,40331,40332,80663
3382,conf/sigmod/labioyg99,,65323,1064,66387
3383,,z5kfipj7fgmj,63202,63203,126405
3384,,hlbdfqaxdkaj,13040,13041,26081
3385,conf/sigmod/gingraslsps97,,65627,1368,66995
3386,,jygxfesks-yj,41225,41226,82451
3387,conf/vldb/ramamrithamabegp00,,65564,1305,66869
3388,conf/sigmod/bryanmclg94,,66063,1804,67867
3389,,nbu-wr3ivuij,22029,22030,44059
3390,conf/sigmod/arpaci-dusseauachp97,,65550,1291,66841
3391,,6_fvrrynxhyj,19396,19397,38793
3392,,nn0x6rmkrvwj,39910,39911,79821
3393,conf/vldb/lichpalhay01,,65318,1059,66377
3394,journals/sigmod/dogacdkoonehakkm95,,65058,799,65857
3395,,uao4t_2ylpkj,60151,60152,120303
3396,,ueaxoxn3dicj,12799,12800,25599
3397,conf/sigmod/rundensteinerkrcjm96,,65743,1484,67227
3398,,yy5hmqazrhoj,46189,46190,92379
3399,conf/sigmod/franklinjk96,,65670,1411,67081
3400,conf/sigmod/yanmhf01,,64883,624,65507
3401,,8hrwaivz2ykj,45609,45610,91219
3402,,f3-e7x12k4gj,31830,31831,63661
3403,journals/sigmod/tsotrasjs98,,64853,594,65447
3404,conf/vldb/garciall98,,65845,1586,67431
3405,,5mo7a6e0-gqj,30305,30306,60611
3406,journals/sigmod/kennedymb96,,64994,735,65729
3407,,vbytmdeyek0j,29238,29239,58477
3408,conf/vldb/balminhkpsw03,,66296,2037,68333
3409,,8xrhvinl0_0j,62109,62110,124219
3410,,v9bda55u_xmj,62581,62582,125163
3411,conf/sigmod/hanfwczk96,,65706,1447,67153
3412,,aepgxosl6yoj,13658,13659,27317
3413,conf/sigmod/parkkklpc98,,65483,1224,66707
3414,conf/sigmod/rundensteinerkzwlln99,,65224,965,66189
3415,,2xrfnjwudrsj,7515,7516,15031
3416,,cd6a4nsdnkqj,53782,53783,107565
3417,conf/vldb/pereirafjls01,,65501,1242,66743
3418,conf/vldb/altinelf00,,65450,1191,66641
3419,,sxhpvzzdrfmj,58412,58413,116825
3420,,hz_tu6kuj08j,53559,53560,107119
3421,journals/vldb/leesc01,,66732,2473,69205
3422,,hgjhr8pwnvwj,49531,49532,99063
3423,journals/sigmod/maximiliens02,,66865,2606,69471
3424,conf/vldb/hammadfae03,,66357,2098,68455
3425,,vfcfums9qtkj,47428,47429,94857
3426,conf/vldb/litwinns94,,64496,237,64733
3427,,snkwnx5wokwj,44323,44324,88647
3428,conf/vldb/natsevcslv01,,65314,1055,66369
3429,,2cytbbiwv-aj,4053,4054,8107
3430,,fz1xazokpo0j,24034,24035,48069
3431,conf/sigmod/haash99,,65254,995,66249
3432,journals/sigmod/huangkl02,,64378,119,64497
3433,,yyumt1x2wxcj,23179,23180,46359
3434,conf/sigmod/careydnags97,,65571,1312,66883
3435,,mt8q1ymvrkmj,20430,20431,40861
3436,conf/vldb/possp03,,66287,2028,68315
3437,,dyzlq4rntjwj,9835,9836,19671
3438,conf/vldb/pedersenjd00,,65593,1334,66927
3439,,bsrlp5_erfmj,63774,63775,127549
3440,,sauncbolyj8j,58254,58255,116509
3441,conf/vldb/pedersenjd99,,65733,1474,67207
3442,,om7n6h8r8coj,28950,28951,57901
3443,conf/sigmod/jagadishjot01,,64867,608,65475
3444,,klpshutxqi8j,50320,50321,100641
3445,conf/vldb/bernsteinhjrw00,,65570,1311,66881
3446,conf/vldb/garofalakisio98,,65812,1553,67365
3447,,rev4xpbic6ej,50825,50826,101651
3448,journals/sigmod/millerhhyhfp01,,64626,367,64993
3449,,0ckpoqsv-vaj,43791,43792,87583
3450,conf/vldb/kriegelps00,,65610,1351,66961
3451,,vsq0v1ulivoj,26142,26143,52285
3452,,12xrfc32pxoj,27220,27221,54441
3453,journals/sigmod/snodgrassaabcdegjkkkllrsss94a,,65222,963,66185
3454,journals/vldb/changg01,,66754,2495,69249
3455,,hyu2nw263uoj,34771,34772,69543
3456,conf/vldb/liphcaat03,,66319,2060,68379
3457,,esc19v7zgtsj,33879,33880,67759
3458,,93c5prxx5ycj,56345,56346,112691
3459,journals/sigmod/frankggjklmnpssstw99,,64746,487,65233
3460,conf/vldb/wienern95,,64311,52,64363
3461,,y1lenvpl6d8j,6361,6362,12723
3462,conf/sigmod/jagadish94,,65993,1734,67727
3463,,eh69_dcm18wj,58459,58460,116919
3464,,n9d3f0nvbcej,51429,51430,102859
3465,journals/vldb/landaust95,,66783,2524,69307
3466,conf/vldb/chawathe99,,65782,1523,67305
3467,,1-mxxsvimb8j,5016,5017,10033
3468,,dt4mxy8b2hwj,49270,49271,98541
3469,conf/sigmod/freedmand95,,65872,1613,67485
3470,,ssolrjzrmtyj,48795,48796,97591
3471,journals/vldb/danyc95,,66811,2552,69363
3472,conf/vldb/dasgupta96,,66855,2596,69451
3473,,a0c2gd1lp5qj,46830,46831,93661
3474,,rfee_mnm8iuj,41447,41448,82895
3475,conf/vldb/ooiytj01,,65510,1251,66761
3476,conf/vldb/wienern94,,64331,72,64403
3477,,pruwsoyslgcj,37718,37719,75437
3478,,jq6eiao6r0ej,33265,33266,66531
3479,conf/sigmod/blakeley96,,65612,1353,66965
3480,conf/vldb/selinger02,,66399,2140,68539
3481,,76u3c8hiwqoj,31198,31199,62397
3482,,gdfpwto83b4j,28750,28751,57501
3483,journals/tods/jagadish95,,66510,2251,68761
3484,conf/vldb/idrisgc94,,64402,143,64545
3485,,xf7tnmxlgtkj,24166,24167,48333
3486,,7eyr1qdwkg0j,23828,23829,47657
3487,conf/sigmod/hernandezs95,,65859,1600,67459
3488,,psf0s8boiz0j,22974,22975,45949
3489,journals/vldb/balkiro98,,66650,2391,69041
3490,,en_4ftimckyj,17012,17013,34025
3491,conf/sigmod/kulkarni94,,66082,1823,67905
3492,,dy6x1fday9ej,14910,14911,29821
3493,journals/sigmod/chaudhri95,,65038,779,65817
3494,,sj6piy04ebmj,14395,14396,28791
3495,conf/vldb/cotterb00,,65438,1179,66617
3496,journals/sigmod/stirling03,,66220,1961,68181
3497,,url:http://portal.acm.org/ft_gateway.cfm3fid3d77699726type3dpdf26dl3dguide26dl3dacm26cfid3d1111111126cftoken3d2222222,13952,13953,27905
3498,,humtg7hnlyaj,13853,13854,27707
3499,conf/vldb/yanglh03,,66330,2071,68401
3500,conf/sigmod/baruglmpvc99,,65383,1124,66507
3501,,mxkkjajum-oj,24380,24381,48761
3502,,_pacjtd1nbej,57582,57583,115165
3503,conf/vldb/careykrlabflopqrssuvwy01,,65476,1217,66693
3504,journals/tods/andriescpb01,,66594,2335,68929
3505,,imgwasyhkgij,14837,14838,29675
3506,conf/sigmod/careydfhmnssttwz94,,66037,1778,67815
3507,,0opbno-ofpkj,31844,31845,63689
3508,conf/sigmod/joshia01,,64985,726,65711
3509,,h9bmryknxmqj,45148,45149,90297
3510,conf/sigmod/maddenshr02,,64659,400,65059
3511,,7n7lvbccbzoj,25070,25071,50141
3512,,g8e0xirukiwj,19640,19641,39281
3513,journals/tods/lakshmananln03,,65162,903,66065
3514,conf/sigmod/mumickqm97,,65561,1302,66863
3515,,cvhvc7tusrij,57625,57626,115251
3516,conf/sigmod/ozdenrss96,,65614,1355,66969
3517,,,6951,6952,13903
3518,,qj4lzbfzjdgj,34043,34044,68087
3519,conf/vldb/popavmhf02,,66507,2248,68755
3520,conf/vldb/ilyasae02,,66410,2151,68561
3521,,nqsk3gvefp0j,63117,63118,126235
3522,conf/sigmod/hellersteinhw97,,65543,1284,66827
3523,,7dcgpqxhucmj,54685,54686,109371
3524,conf/vldb/gehanijr94,,64410,151,64561
3525,,mxyiwr2f9uyj,40340,40341,80681
3526,conf/vldb/ilyasae03,,66265,2006,68271
3527,,y385z1dxp84j,27458,27459,54917
3528,conf/vldb/garofalakisos97,,66162,1903,68065
3529,,dw_prnemqfsj,18245,18246,36491
3530,,c4xcbh6anhaj,60564,60565,121129
3531,conf/sigmod/bohmbkk01,,64861,602,65463
3532,journals/tods/olivers94,,66560,2301,68861
3533,,zaczqv37xxsj,19261,19262,38523
3534,,mnmlxfx4l-8j,38533,38534,77067
3535,conf/sigmod/hec03,,64640,381,65021
3536,,gyr0v7cfkp0j,46509,46510,93019
3537,conf/sigmod/szalaygkt00,,65035,776,65811
3538,,o9dfgi9zsloj,9743,9744,19487
3539,conf/vldb/muntzr94,,64421,162,64583
3540,,vc7jbwgn_o0j,61160,61161,122321
3541,conf/sigmod/chani98,,65353,1094,66447
3542,conf/sigmod/lor94,,66032,1773,67805
3543,,ppyotk673dwj,58152,58153,116305
3544,conf/sigmod/dewanshh94,,66023,1764,67787
3545,,gudxgx4blw8j,56493,56494,112987
3546,conf/sigmod/zaianehlcc98,,65477,1218,66695
3547,,eauaglr5ucuj,5195,5196,10391
3548,,7mtanhr8ekoj,49338,49339,98677
3549,conf/sigmod/sengarh03,,64675,416,65091
3550,,yotsugkbk44j,35864,35865,71729
3551,conf/sigmod/blakeleyp98,,65515,1256,66771
3552,,kxipdxld46gj,33707,33708,67415
3553,conf/sigmod/hsulg00,,65164,905,66069
3554,,em5eigprzfkj,27484,27485,54969
3555,conf/sigmod/lor96,,65788,1529,67317
3556,conf/vldb/chani99,,65747,1488,67235
3557,,qv20-69j6yyj,1840,1841,3681
3558,,k7rinzpidhyj,9498,9499,18997
3559,conf/sigmod/procopiucjam02,,64761,502,65263
3560,conf/vldb/vriesdba99,,65888,1629,67517
3561,,3o-ruvrsduwj,42215,42216,84431
3562,conf/vldb/fuhdcmtldrm99,,65870,1611,67481
3563,,nh2fuic6fhgj,32439,32440,64879
3564,,jpjma9unggoj,54379,54380,108759
3565,conf/vldb/deenjnnw00,,65430,1171,66601
3566,,gnjiuqvlz0uj,43231,43232,86463
3567,conf/sigmod/dogachkoondmake96,,65746,1487,67233
3568,conf/sigmod/griffinl95,,65875,1616,67491
3569,,7xa2fxbuh2cj,39430,39431,78861
3570,journals/vldb/lawlg99,,66642,2383,69025
3571,,toxrbhbbnj4j,29754,29755,59509
3572,,jn3pvb3hrzwj,57209,57210,114419
3573,conf/vldb/stohrr01,,65506,1247,66753
3574,,jsrjkrtm_3sj,24019,24020,48039
3575,journals/sigmod/poessf00,,64591,332,64923
3576,journals/sigmod/bohmr94,,65066,807,65873
3577,,gxapzwcgl78j,12481,12482,24963
3578,,fhbw320lsusj,20192,20193,40385
3579,conf/vldb/berckens01,,65399,1140,66539
3580,,4tmzho1wdwsj,30138,30139,60277
3581,conf/vldb/chenrs95,,66188,1929,68117
3582,conf/vldb/schnase00,,65552,1293,66845
3583,,odaru442nm0j,7508,7509,15017
3584,conf/sigmod/dyreson03,,64632,373,65005
3585,,uidfb3grjluj,7099,7100,14199
3586,journals/vldb/bonczk99,,66637,2378,69015
3587,,atjnxh8x_f0j,6452,6453,12905
3588,,tytl6zxq-_yj,60268,60269,120537
3589,conf/vldb/gibbons01,,65358,1099,66457
3590,,cvqyvle8w38j,60165,60166,120331
3591,conf/vldb/madnick95,,66187,1928,68115
3592,,joryedhkysmj,58480,58481,116961
3593,conf/vldb/mohanias94,,64399,140,64539
3594,,3ku_xoqyuawj,55092,55093,110185
3595,conf/vldb/rizvih02,,66386,2127,68513
3596,conf/vldb/hankinsp03,,66355,2096,68451
3597,,nsxxw_cvqpkj,50204,50205,100409
3598,conf/vldb/sripada02,,66419,2160,68579
3599,,uxm0ewcxxpij,41280,41281,82561
3600,conf/vldb/luot94,,64503,244,64747
3601,,zfxyxt4yecaj,38210,38211,76421
3602,,ujj9ogotyeej,37891,37892,75783
3603,conf/sigmod/golding95,,65894,1635,67529
3604,conf/vldb/vorugantiou99,,65791,1532,67323
3605,,itolyy7itt0j,36961,36962,73923
3606,conf/sigmod/melling94,,66064,1805,67869
3607,,j4o-xhs1qagj,36284,36285,72569
3608,,alk7huikjwaj,34734,34735,69469
3609,conf/sigmod/agarwal96,,65727,1468,67195
3610,journals/sigmod/hainaut03,,66175,1916,68091
3611,,url:http://portal.acm.org/ft_gateway.cfm3fid3d95908726type3dpdf26coll3dguide26dl3dacm26cfid3d1111111126cftoken3d2222222,27771,27772,55543
3612,conf/sigmod/bierman03,,64564,305,64869
3613,,vqcfluhwceaj,27190,27191,54381
3614,,7auag74jtdij,22867,22868,45735
3615,conf/sigmod/doherty98,,65365,1106,66471
3616,,xv1webz985mj,17459,17460,34919
3617,journals/vldb/ooitch98,,66685,2426,69111
3618,,ub6ywssjyiyj,55415,55416,110831
3619,conf/vldb/kerstenwfkbc03,,66303,2044,68347
3620,conf/sigmod/aggarwalwy99,,65200,941,66141
3621,,s9hhr-eddggj,46281,46282,92563
3622,,vpwp1w9wvhej,45050,45051,90101
3623,conf/vldb/chawathecy94,,64499,240,64739
3624,,djyvvvryntwj,38988,38989,77977
3625,journals/vldb/ngushl01,,66733,2474,69207
3626,conf/vldb/moserkk95,,64269,10,64279
3627,,53hnu_r6-jgj,35556,35557,71113
3628,,dgfx6qijox8j,41020,41021,82041
3629,journals/sigmod/barbarabfls94,,65270,1011,66281
3630,conf/sigmod/adalicps96,,65681,1422,67103
3631,,ummcsye0yckj,10581,10582,21163
3632,,w90ok0t46saj,10270,10271,20541
3633,conf/vldb/berckensw97,,65948,1689,67637
3634,conf/sigmod/saltenisjll00,,65106,847,65953
3635,,e0uypb4krcyj,62188,62189,124377
3636,,tsqbh6p4jmcj,23605,23606,47211
3637,conf/sigmod/kriegelbkps03,,64597,338,64935
3638,,bqtraooj87aj,59345,59346,118691
3639,conf/sigmod/changbclls00,,65147,888,66035
3640,conf/sigmod/shyy95,,65897,1638,67535
3641,,ojzogjlfgqij,46453,46454,92907
3642,journals/sigmod/wenlmz03,,66835,2576,69411
3643,,5kdceadgf8cj,33062,33063,66125
3644,conf/vldb/browncc94,,64335,76,64411
3645,,oayi0fkl-nqj,25689,25690,51379
3646,,o9a-15rmzosj,1456,1457,2913
3647,journals/vldb/ishakbeyogluo98,,66698,2439,69137
3648,conf/vldb/gohost99,,65775,1516,67291
3649,,hk5eoo-z7jmj,11824,11825,23649
3650,,tspou-h3a94j,50903,50904,101807
3651,conf/sigmod/kriegelmps01,,65003,744,65747
3652,,x8uc_9_izuej,14083,14084,28167
3653,conf/sigmod/embleyjn99,,65331,1072,66403
3654,conf/vldb/belloddfnswz98,,66024,1765,67789
3655,,zrmfwox1h2mj,40458,40459,80917
3656,journals/sigmod/shinm94,,65069,810,65879
3657,,hnptcgmyr80j,52265,52266,104531
3658,,yzbjs0cd6caj,50163,50164,100327
3659,journals/sigmod/jukicv97,,64817,558,65375
3660,conf/sigmod/wangcmssz94,,65959,1700,67659
3661,,zm65itnp_e4j,45001,45002,90003
3662,,jkbagqwjk2oj,36685,36686,73371
3663,journals/vldb/whited95,,66782,2523,69305
3664,conf/vldb/jensenl01,,65523,1264,66787
3665,,yudkybmdtxij,2671,2672,5343
3666,conf/vldb/marronl01,,65528,1269,66797
3667,,9z2mfdoaadij,22569,22570,45139
3668,conf/sigmod/pateld96,,65790,1531,67321
3669,,y9z2odhzsgqj,22381,22382,44763
3670,conf/sigmod/lomett03,,64570,311,64881
3671,,gidouf_jd4oj,21280,21281,42561
3672,,5xe-dqqxfi8j,18714,18715,37429
3673,conf/vldb/careyd96,,66095,1836,67931
3674,journals/sigmod/nadoh97,,64782,523,65305
3675,,yn9f4dskc9qj,18621,18622,37243
3676,,loxd8jpfhpwj,11439,11440,22879
3677,journals/sigmod/burtonm98,,64854,595,65449
3678,conf/vldb/hvasshovdbt00,,65433,1174,66607
3679,,af50lhgnd8gj,15090,15091,30181
3680,conf/sigmod/colbyklmr97,,65655,1396,67051
3681,,0fohhtws5toj,33059,33060,66119
3682,,ozrydxojqxmj,51859,51860,103719
3683,conf/sigmod/jagadishks00,,65145,886,66031
3684,,l854pheqptsj,43224,43225,86449
3685,conf/sigmod/livcahmwbchikss99,,65300,1041,66341
3686,,yerfanxw2rcj,26233,26234,52467
3687,journals/sigmod/gatziukbf98,,64868,609,65477
3688,conf/sigmod/cookkwz96,,65772,1513,67285
3689,,5mtgnlhnytgj,38230,38231,76461
3690,conf/vldb/bohmmsw01,,65386,1127,66513
3691,,uv3mhmugwdcj,52071,52072,104143
3692,,pf-rfkrw2nij,33197,33198,66395
3693,journals/sigmod/buchnerm98,,64674,415,65089
3694,,nibdzxs0tcmj,32537,32538,65075
3695,conf/sigmod/bohrerbbcfhkkmnrrsuuw97a,,65623,1364,66987
3696,,url:http://portal.acm.org/citation.cfm3fid3d333607.33361626dl3dguide26dl3dacm26idx3dj68926part3dperiodical26wanttype3dperiodical26title3dacm2520sigmod2520record26cfid3d1111111126cftoken3d2222222,23594,23595,47189
3697,journals/sigmod/gruenwaldbdgssv99,,64724,465,65189
3698,conf/vldb/martinc94,,64460,201,64661
3699,,ur6-xamj3tij,5320,5321,10641
3700,conf/vldb/chakrabartibd99,,65753,1494,67247
3701,,zmbmrunv8sqj,34861,34862,69723
3702,,non45ru6c9kj,64059,64060,128119
3703,journals/vldb/halevy01,,66715,2456,69171
3704,conf/sigmod/meseck01,,64909,650,65559
3705,,hwiingxs5i0j,56181,56182,112363
3706,conf/sigmod/aggarwaly01,,64969,710,65679
3707,,qktd5wogn-aj,55418,55419,110837
3708,journals/sigmod/halevy00,,64596,337,64933
3709,,czgymu7shcgj,53324,53325,106649
3710,conf/vldb/bowker00,,65555,1296,66851
3711,,fahjv8c1hlcj,50870,50871,101741
3712,,bbm74r5b5yoj,50802,50803,101605
3713,journals/vldb/iveshw02,,66725,2466,69191
3714,conf/sigmod/miller98,,65425,1166,66591
3715,,r0zzrejvo4uj,49855,49856,99711
3716,,etqxtcvf7k4j,49547,49548,99095
3717,journals/tods/lerner00,,66576,2317,68893
3718,journals/tods/revesz98,,66619,2360,68979
3719,,dr8s9hbwjr0j,4479,4480,8959
3720,,w9wjnfy0tdaj,42491,42492,84983
3721,conf/vldb/aggarwaly02,,66414,2155,68569
3722,conf/vldb/mattos03,,66324,2065,68389
3723,,hee1nxax5t8j,41154,41155,82309
3724,,dfsps7yoywsj,39086,39087,78173
3725,conf/sigmod/aggarwaly00,,65013,754,65767
3726,,tabfkjntlmsj,38038,38039,76077
3727,conf/sigmod/ullman03,,64540,281,64821
3728,,_7dyrijtceaj,33606,33607,67213
3729,conf/vldb/derose99,,65861,1602,67463
3730,conf/sigmod/whelan98,,65372,1113,66485
3731,,jp9levxjijaj,33210,33211,66421
3732,journals/sigmod/bohlen95,,65102,843,65945
3733,,v5p_nfxdor8j,29492,29493,58985
3734,conf/sigmod/martin94,,66002,1743,67745
3735,,ogow-rtc3fej,21043,21044,42087
3736,,k4unrsgeuuaj,20480,20481,40961
3737,conf/sigmod/brewer98,,65455,1196,66651
3738,,deej1jsf8rwj,13307,13308,26615
3739,conf/vldb/brodie03,,66301,2042,68343
3740,conf/vldb/jacobs97,,65986,1727,67713
3741,,u-98tpsji6ej,11827,11828,23655
3742,,hc9uwxju840j,17360,17361,34721
3743,journals/vldb/barbara-millag94,,66823,2564,69387
3744,,fkpcmtplo18j,17396,17397,34793
3745,conf/vldb/dyresonbj99,,65778,1519,67297
3746,journals/tods/storeycdgs97,,66617,2358,68975
3747,,nl_8pniyc-0j,44697,44698,89395
3748,journals/vldb/gutings95,,66809,2550,69359
3749,,cbhicx5w3ocj,59005,59006,118011
3750,,ymcmy4foxi8j,27496,27497,54993
3751,conf/vldb/rohmbss02,,66392,2133,68525
3752,conf/vldb/stohrmr00,,65629,1370,66999
3753,,7fcraqltneuj,51672,51673,103345
3754,,bcj32wydq0ij,62036,62037,124073
3755,conf/sigmod/sismanisdrk02,,64751,492,65243
3756,,cxnui54po5ej,1552,1553,3105
3757,conf/vldb/ludaschermp02,,66474,2215,68689
3758,,eq249ewqshmj,43210,43211,86421
3759,journals/sigmod/gerlhofkm96,,64905,646,65551
3760,conf/vldb/chungcll01,,65356,1097,66453
3761,,mjidvbttkwoj,49770,49771,99541
3762,,llarmvkaiqmj,45049,45050,90099
3763,conf/vldb/simond95,,64379,120,64499
3764,,iwzssvpc6hmj,52397,52398,104795
3765,journals/vldb/chenhy97,,66679,2420,69099
3766,,lei_rzm1ih0j,24023,24024,48047
3767,conf/sigmod/hsiaocy94,,66028,1769,67797
3768,,ywg9pluebigj,58065,58066,116131
3769,conf/vldb/viverosnr96,,66067,1808,67875
3770,,url:http://portal.acm.org/ft_gateway.cfm3fid3d56478826type3dpdf26dl3dguide26dl3dacm26cfid3d1111111126cftoken3d2222222,7607,7608,15215
3771,conf/sigmod/hellersteinw02,,64723,464,65187
3772,conf/vldb/sindonitabfgmppt01,,65497,1238,66735
3773,,0zdxnl9cqysj,15267,15268,30535
3774,,wj_vcy3mmekj,17022,17023,34045
3775,journals/sigmod/jensenceghj94,,65253,994,66247
3776,,mqokidcr2oij,42878,42879,85757
3777,conf/vldb/bohlenss96,,66069,1810,67879
3778,,shdqqrfj3bmj,45282,45283,90565
3779,conf/vldb/garofalakisg01,,66429,2170,68599
3780,conf/vldb/berchtoldkk96,,66092,1833,67925
3781,,ndkvnp4rrvaj,16757,16758,33515
3782,conf/sigmod/iveslpst00,,65183,924,66107
3783,,rtnpqb22ggcj,32482,32483,64965
3784,conf/vldb/millerhh00,,65648,1389,67037
3785,,rqg_slyumymj,20340,20341,40681
3786,,jxpqwiuxhvwj,44084,44085,88169
3787,conf/vldb/blokwzpakj01,,65321,1062,66383
3788,journals/sigmod/possasmcr00,,64609,350,64959
3789,,7szp78iyfdqj,17952,17953,35905
3790,,umm1k4nod2ij,56691,56692,113383
3791,conf/sigmod/raobg96,,65795,1536,67331
3792,conf/sigmod/cruzj99,,65221,962,66183
3793,,vxmwu21-7hmj,60872,60873,121745
3794,,c-mp8r47zvij,56519,56520,113039
3795,conf/vldb/leewms02,,66395,2136,68531
3796,,vwss71_kqx8j,47717,47718,95435
3797,conf/vldb/yanl95,,66239,1980,68219
3798,,,45411,45412,90823
3799,conf/vldb/haasb03,,66272,2013,68285
3800,,ffqc9xpgfrsj,38477,38478,76955
3801,conf/sigmod/langs01,,64906,647,65553
3802,conf/sigmod/choic02,,64807,548,65355
3803,,d8a4umappicj,37986,37987,75973
3804,,7kc8fo78d6sj,22923,22924,45847
3805,journals/vldb/fuccm00,,66744,2485,69229
3806,,gndv1o-oekmj,15357,15358,30715
3807,conf/vldb/kangc02,,66383,2124,68507
3808,,ofxl5ksjiwcj,10868,10869,21737
3809,conf/sigmod/leewms01,,64869,610,65479
3810,,url:http://portal.acm.org/ft_gateway.cfm3fid3d20267026type3dpdf26dl3dguide26dl3dacm26cfid3d1111111126cftoken3d2222222,16238,16239,32477
3811,journals/sigmod/berrant95,,65043,784,65827
3812,conf/sigmod/kanthas98,,65398,1139,66537
3813,,4o5jtaqzf7ij,15360,15361,30721
3814,,yfttln56scuj,39406,39407,78813
3815,conf/sigmod/rothahccfstw96,,65740,1481,67221
3816,conf/vldb/tengcy03,,66341,2082,68423
3817,,wjjaznzd6paj,37195,37196,74391
3818,,6rn6hsdao-wj,58172,58173,116345
3819,conf/vldb/kiessling02,,66480,2221,68701
3820,conf/sigmod/fernandezfkls97,,65635,1376,67011
3821,,ek26aieheesj,561,562,1123
3822,conf/sigmod/guhajksy02,,64792,533,65325
3823,,z6l0wfs32iyj,53834,53835,107669
3824,conf/sigmod/bressangot00,,65157,898,66055
3825,,url:http://portal.acm.org/ft_gateway.cfm3fid3d33658726type3dpdf26dl3dguide26dl3dacm26cfid3d1111111126cftoken3d2222222,49176,49177,98353
3826,conf/vldb/parkmc02,,66465,2206,68671
3827,,wfmae47kgn4j,54968,54969,109937
3828,,liiwlw3onguj,47842,47843,95685
3829,conf/sigmod/cookwz94,,66051,1792,67843
3830,conf/sigmod/minpc03,,64628,369,64997
3831,,jjrrzt4onqmj,42318,42319,84637
3832,,kfql7lx8oqkj,18254,18255,36509
3833,journals/vldb/papazogluk97,,66682,2423,69105
3834,,rlfxee4k2p4j,18118,18119,36237
3835,conf/sigmod/moonwh02,,64757,498,65255
3836,conf/sigmod/massaripsc95,,65931,1672,67603
3837,,o2frn68p5puj,19886,19887,39773
3838,,bkff2tdykdwj,44239,44240,88479
3839,conf/vldb/bunkerccmmw01,,65364,1105,66469
3840,conf/sigmod/ioannidisl94,,66010,1751,67761
3841,,ddhnss9sisej,14344,14345,28689
3842,,iurxdvb6olaj,59641,59642,119283
3843,conf/sigmod/rossss96,,65764,1505,67269
3844,,94diegttg_oj,5080,5081,10161
3845,conf/sigmod/nglhp98,,65380,1121,66501
3846,,8yhbbspkzeoj,46434,46435,92869
3847,conf/vldb/bonczmk99,,65786,1527,67313
3848,,u04oc6osbt0j,41758,41759,83517
3849,conf/vldb/ioannidislgp96,,66245,1986,68231
3850,conf/sigmod/barbarai94,,66012,1753,67765
3851,,bmuuwjp72hwj,58303,58304,116607
3852,conf/vldb/lingll00,,65467,1208,66675
3853,,yknppsnrdb0j,13818,13819,27637
3854,conf/vldb/roths97,,65934,1675,67609
3855,,1fqr1rj4ycwj,32248,32249,64497
3856,,tlpae7zsklsj,63245,63246,126491
3857,conf/vldb/jamil97,,66146,1887,68033
3858,conf/sigmod/carey00,,65139,880,66019
3859,,x6n6ev8wnhej,62834,62835,125669
3860,,vhus7wtpuooj,56833,56834,113667
3861,journals/sigmod/david03,,66254,1995,68249
3862,,1blbgqk5zpuj,52330,52331,104661
3863,conf/vldb/slutz98,,66015,1756,67771
3864,,kkwsic5hmsuj,44852,44853,89705
3865,conf/vldb/tygar98,,65879,1620,67499
3866,journals/sigmod/klein94,,65231,972,66203
3867,,kg86hb6n1xej,44329,44330,88659
3868,,lj8ci8ald9uj,4133,4134,8267
3869,conf/sigmod/carey94,,66074,1815,67889
3870,journals/sigmod/chang03,,66833,2574,69407
3871,,b55tcvousnoj,37810,37811,75621
3872,,89why6hz22uj,37404,37405,74809
3873,conf/sigmod/hernandezmhyht01,,64875,616,65491
3874,,bwv2oys1vxsj,33083,33084,66167
3875,conf/sigmod/kimc03,,64603,344,64947
3876,,ekqpedn3kdmj,30917,30918,61835
3877,journals/sigmod/hanna95,,65037,778,65815
3878,conf/vldb/malonm97,,65973,1714,67687
3879,,ogrpbfnqtskj,22476,22477,44953
3880,conf/sigmod/leekc99,,65264,1005,66269
3881,,c-5n9qqklaej,1990,1991,3981
3882,conf/sigmod/jamil99,,65212,953,66165
3883,,z5efiutefscj,18954,18955,37909
3884,,fipjds_jm54j,12782,12783,25565
3885,conf/sigmod/lomet00,,65016,757,65773
3886,,qfd_kxyt-dsj,12175,12176,24351
3887,conf/sigmod/cohen98a,,65485,1226,66711
3888,,njycridh5e4j,10764,10765,21529
3889,conf/sigmod/olson95,,65834,1575,67409
3890,,,44758,44759,89517
3891,journals/sigmod/liu02a,,64302,43,64345
3892,conf/vldb/kornsfsp96,,66065,1806,67871
3893,,qjbxsg6_-wij,24068,24069,48137
3894,,ha3wm_i-y3yj,45661,45662,91323
3895,journals/sigmod/groskysf02,,66852,2593,69445
3896,conf/vldb/hvasshovdtbh95,,64284,25,64309
3897,,lvitsyrkl9aj,32464,32465,64929
3898,,qgr0dgmbdgij,7368,7369,14737
3899,conf/sigmod/cattell94,,66076,1817,67893
3900,conf/vldb/vermeera96,,66259,2000,68259
3901,,beddmdwb2_4j,44975,44976,89951
3902,,c__nxyn_uvwj,35122,35123,70245
3903,conf/sigmod/mcauliffecs96,,65774,1515,67289
3904,,hseozdac8zuj,49060,49061,98121
3905,journals/vldb/saltenisj02,,66711,2452,69163
3906,journals/tods/bohlenjs00,,66582,2323,68905
3907,,6eheb6kct4mj,63333,63334,126667
3908,,7lkcbme603kj,57873,57874,115747
3909,conf/vldb/knorrn99,,65765,1506,67271
3910,,wasgr87ompcj,40980,40981,81961
3911,conf/vldb/chenl03,,66350,2091,68441
3912,journals/sigmod/linp96,,64930,671,65601
3913,,mzehvksuv5qj,39747,39748,79495
3914,conf/vldb/leel99,,65675,1416,67091
3915,,szhsyfiouwaj,36443,36444,72887
3916,conf/vldb/knorrn98,,65899,1640,67539
3917,,gqvly8v1hekj,30347,30348,60695
3918,,tuvp_18tfv8j,17504,17505,35009
3919,conf/vldb/leel96,,66113,1854,67967
3920,,waivxgei8vij,39222,39223,78445
3921,conf/vldb/ozsuvu98,,65916,1657,67573
3922,,oewaz4audoqj,46901,46902,93803
3923,journals/sigmod/fowlerpnb99,,64715,456,65171
3924,conf/vldb/sripadaw94,,64433,174,64607
3925,,vqnz3sp638uj,32223,32224,64447
3926,conf/vldb/muthopw98,,65919,1660,67579
3927,,cy0zvqmnba4j,47060,47061,94121
3928,,uam2rv99rxsj,27817,27818,55635
3929,conf/sigmod/florescugkr02,,64841,582,65423
3930,,ouvzjer64pmj,23896,23897,47793
3931,conf/vldb/kiesslingk02,,66406,2147,68553
3932,,ljdsx1di81mj,7189,7190,14379
3933,conf/vldb/ooigt98,,65895,1636,67531
3934,,url:http://www.springerlink.com/index/4n8lt3xhxgcr8dlw.pdf,54046,54047,108093
3935,journals/vldb/tango00,,66746,2487,69233
3936,,1a06w64wjvcj,37456,37457,74913
3937,conf/vldb/taneo01,,65411,1152,66563
3938,conf/vldb/tango99,,65722,1463,67185
3939,,cctzvs8xd2sj,31649,31650,63299
3940,,url:http://portal.acm.org/citation.cfm3fid3d872757.872840,18677,18678,37355
3941,conf/sigmod/zuzartepmclw03,,64705,446,65151
3942,,7d59wpttkdcj,28097,28098,56195
3943,conf/sigmod/arasubbdirw03,,64694,435,65129
3944,,ido3zqocze4j,22379,22380,44759
3945,journals/vldb/chuit94,,66801,2542,69343
3946,,jtejcgogxnmj,17834,17835,35669
3947,conf/vldb/haasku99,,65689,1430,67119
3948,conf/vldb/barjapfwd94,,64350,91,64441
3949,,qhl9_kgvjcuj,62169,62170,124339
3950,conf/vldb/ozsulon01,,65385,1126,66511
3951,,qqdxmdgaamgj,4141,4142,8283
3952,,s30ixg4clfij,41620,41621,83241
3953,conf/vldb/nishiosttl01,,65322,1063,66385
3954,journals/sigmod/cheungf98,,64850,591,65441
3955,,ig7b9agtomaj,54125,54126,108251
3956,conf/sigmod/palmerf00,,65015,756,65771
3957,,cnnle97pd2sj,24479,24480,48959
3958,,uldbbxl-6q4j,17217,17218,34435
3959,journals/sigmod/abererch02,,66854,2595,69449
3960,,4nm5wr1wtpcj,55306,55307,110613
3961,conf/vldb/schoning03,,66305,2046,68351
3962,,sg7pcein2xaj,11830,11831,23661
3963,journals/sigmod/diazjpa94,,65174,915,66089
3964,conf/sigmod/bohannonmr01,,64965,706,65671
3965,,chd3-mp23f8j,13694,13695,27389
3966,conf/vldb/ozsoyogluaaouo02,,66463,2204,68667
3967,,pb3y_nggwjwj,58522,58523,117045
3968,,szzvwxivu-kj,63842,63843,127685
3969,conf/vldb/shaw98,,65821,1562,67383
3970,,gbzitcbchzqj,47499,47500,94999
3971,conf/sigmod/keim99,,65190,931,66121
3972,conf/sigmod/phann02,,64719,460,65179
3973,,llikm2gmqakj,42873,42874,85747
3974,journals/sigmod/keim96,,65005,746,65751
3975,,vkuvhzow-1yj,41138,41139,82277
3976,,9sm_ptv5pmyj,37870,37871,75741
3977,conf/sigmod/ross00,,65079,820,65899
3978,conf/sigmod/keim96,,65701,1442,67143
3979,,af9vuejor6cj,35327,35328,70655
3980,journals/tods/ross96,,66530,2271,68801
3981,,url:http://portal.acm.org/ft_gateway.cfm3fid3d23262826type3dpdf26dl3dguide26dl3dacm26cfid3d1111111126cftoken3d2222222,34924,34925,69849
3982,,j7my8rlptkmj,22499,22500,44999
3983,journals/vldb/ngc98,,66687,2428,69115
3984,conf/vldb/hess96,,66098,1839,67937
3985,,gia7489k5t4j,14140,14141,28281
3986,journals/sigmod/wade96,,64954,695,65649
3987,,aytrcxexrbkj,13311,13312,26623
3988,,ldtpybmthvwj,13,14,27
3989,conf/vldb/levy96,,66255,1996,68251
3990,conf/sigmod/cranorjss03,,64563,304,64867
3991,,nhest9adtdej,23612,23613,47225
3992,conf/vldb/jagadishnssk97,,66140,1881,68021
3993,,fzuyum7hqhqj,30222,30223,60445
3994,conf/vldb/cormodekms03,,66374,2115,68489
3995,,0zqnv8tozbwj,632,633,1265
3996,,xacnzf6rhvwj,51693,51694,103387
3997,conf/vldb/george98,,65826,1567,67393
3998,journals/sigmod/souzas99,,64712,453,65165
3999,,lsjvvyyknn0j,32558,32559,65117
4000,conf/vldb/raghavan96,,66210,1951,68161
4001,,zuvowdbv0lsj,48482,48483,96965
4002,,mgphe2z3nqyj,43935,43936,87871
4003,conf/sigmod/colbyglmt96,,65723,1464,67187
4004,,4abl38q9ih4j,1546,1547,3093
4005,conf/sigmod/libcs00,,65170,911,66081
4006,,sd2epygsgyej,50471,50472,100943
4007,conf/vldb/chakrabartigrs00,,65452,1193,66645
4008,conf/sigmod/fernandezfkls98,,65350,1091,66441
4009,,fndx0gafmb0j,7284,7285,14569
4010,conf/sigmod/consensm94,,66027,1768,67795
4011,,u7rv6laf8s8j,24400,24401,48801
4012,,mqp5jjo-npaj,25590,25591,51181
4013,journals/tods/peterso97,,66539,2280,68819
4014,conf/sigmod/deshpandersn98,,65410,1151,66561
4015,,bxb96ufphn8j,59313,59314,118627
4016,conf/sigmod/abadic02,,64832,573,65405
4017,,f2lea-rn8dsj,36365,36366,72731
4018,,qmbz3hmofh4j,58031,58032,116063
4019,conf/sigmod/larsong98,,65435,1176,66611
4020,conf/vldb/berckens96,,66832,2573,69405
4021,,,33658,33659,67317
4022,conf/vldb/bawaba03,,66286,2027,68313
4023,,zjilldhwksoj,63374,63375,126749
4024,journals/sigmod/kannankik03,,66132,1873,68005
4025,,h_tdftvsr0qj,54478,54479,108957
4026,,url:http://portal.acm.org/ft_gateway.cfm3fid3d20267226type3dpdf26dl3dguide26dl3dacm26cfid3d1111111126cftoken3d2222222,37694,37695,75389
4027,journals/sigmod/schlageterbhmsw95,,65078,819,65897
4028,,9ocraeypdhmj,59999,60000,119999
4029,journals/sigmod/erdurd02,,64287,28,64315
4030,,p5n3kkohgmgj,45659,45660,91319
4031,conf/sigmod/jagadishls99,,65281,1022,66303
4032,journals/sigmod/dunhamh95a,,65109,850,65959
4033,,cyzifxmvc1cj,43937,43938,87875
4034,,paqaz2kxfgaj,20102,20103,40205
4035,journals/sigmod/laenderrst02,,64317,58,64375
4036,conf/vldb/grovlenht98,,65829,1570,67399
4037,,sdxbxc0lieyj,27042,27043,54085
4038,journals/sigmod/ramirezsp94,,65283,1024,66307
4039,,v2wmob42gj0j,39410,39411,78821
4040,conf/sigmod/team02,,64819,560,65379
4041,,r5ojtejlopgj,34902,34903,69805
4042,,4uf5sjxgwhoj,35545,35546,71091
4043,conf/sigmod/berchtoldbk98,,65465,1206,66671
4044,,eznfj2e_pqqj,22997,22998,45995
4045,journals/sigmod/lawderk01,,64641,382,65023
4046,conf/sigmod/vitterw99,,65206,947,66153
4047,,p5ojuiow7lsj,10772,10773,21545
4048,conf/vldb/rezendes98,,65798,1539,67337
4049,,niruvmkp4r4j,33571,33572,67143
4050,conf/vldb/fuc94,,64337,78,64415
4051,,rebodjzo5y0j,59831,59832,119663
4052,conf/sigmod/chani99,,65204,945,66149
4053,,knt7yt823k8j,45953,45954,91907
4054,conf/sigmod/breunigkks01,,64852,593,65445
4055,,3et_iekogjyj,34939,34940,69879
4056,journals/sigmod/liu02,,64263,4,64267
4057,,url:http://doi.wiley.com/10.1002/ev.1000,57404,57405,114809
4058,journals/sigmod/liu02c,,66863,2604,69467
4059,,jrdsc1jkti4j,50548,50549,101097
4060,journals/sigmod/camps96,,65020,761,65781
4061,,mdj9x3en9ycj,27765,27766,55531
4062,,icg06oc9dv8j,5479,5480,10959
4063,conf/sigmod/guptalm03,,64535,276,64811
4064,conf/sigmod/ngwy01,,64988,729,65717
4065,,tshyzmlnvtoj,34220,34221,68441
4066,,ozmsjoqqftwj,17628,17629,35257
4067,journals/sigmod/lee95,,65052,793,65845
4068,journals/sigmod/kim02,,64285,26,64311
4069,,1ppb2y8x7raj,16330,16331,32661
4070,,i5neuutk3h4j,13915,13916,27831
4071,journals/tods/bohm00,,66574,2315,68889
4072,,_aec8cgkod0j,31081,31082,62163
4073,conf/vldb/ciliahb02,,66422,2163,68585
4074,journals/sigmod/coxeh96,,64991,732,65723
4075,,pqzgz7zfpdgj,64135,64136,128271
4076,,3k61gi_ld_uj,19040,19041,38081
4077,conf/vldb/leelws97,,65960,1701,67661
4078,,16yr6uv8rn8j,4130,4131,8261
4079,journals/sigmod/ludaschermm01,,64403,144,64547
4080,conf/sigmod/brinms97,,65589,1330,66919
4081,,oihyg-al8g8j,26696,26697,53393
4082,conf/vldb/careyhmw96,,66834,2575,69409
4083,,nz8zwxjboyyj,19824,19825,39649
4084,journals/sigmod/campbellem03,,66838,2579,69417
4085,,n9u28v6nztij,55583,55584,111167
4086,,ffzjxlpy6tsj,3672,3673,7345
4087,journals/sigmod/bernsteinhp00,,64617,358,64975
4088,conf/sigmod/kornjf97,,65591,1332,66923
4089,,o5t-jfvv930j,21904,21905,43809
4090,,j9byvz3ekygj,61290,61291,122581
4091,conf/sigmod/oneilq97,,65558,1299,66857
4092,journals/vldb/guting94,,66798,2539,69337
4093,,2hxodqkjpxyj,27654,27655,55309
4094,conf/vldb/ankr03,,66280,2021,68301
4095,,z9dkl1yphh8j,4782,4783,9565
4096,,vl7gy6fsooyj,6213,6214,12427
4097,conf/sigmod/dusd95,,65865,1606,67471
4098,conf/sigmod/wangscrzp97,,65630,1371,67001
4099,,chcojj8yn1sj,59390,59391,118781
4100,,k-ilq6vnmksj,29553,29554,59107
4101,conf/vldb/steinbrunnpmk95,,66230,1971,68201
4102,conf/vldb/tsatalossi94,,64484,225,64709
4103,,--1aoaagkgqj,11533,11534,23067
4104,,url:http://portal.acm.org/ft_gateway.cfm3fid3d27635026type3dpdf26dl3dguide26dl3dacm26cfid3d1111111126cftoken3d2222222,46645,46646,93291
4105,conf/sigmod/adamy98,,65359,1100,66459
4106,journals/sigmod/rishesbdoaloss95,,65137,878,66015
4107,,pgu2ew1aqkoj,54766,54767,109533
4108,,bcr9terorkqj,50618,50619,101237
4109,conf/sigmod/team99,,65284,1025,66309
4110,journals/sigmod/chen94,,65232,973,66205
4111,,url:http://portal.acm.org/ft_gateway.cfm3fid3d18746026type3dpdf26coll3dguide26dl3dacm26cfid3d1111111126cftoken3d2222222,50244,50245,100489
4112,,ip82p4qfkyej,31359,31360,62719
4113,journals/sigmod/yuencll00,,64614,355,64969
4114,,umyeczgscv4j,26178,26179,52357
4115,journals/sigmod/ulusoy95,,65119,860,65979
4116,conf/vldb/bonczrk98,,66019,1760,67779
4117,,ts5vu2enqgyj,59605,59606,119211
4118,,jtqbb9d7zkwj,6801,6802,13603
4119,conf/vldb/papadiast01,,65508,1249,66757
4120,conf/sigmod/hankk97,,65548,1289,66837
4121,,mqdtz_cuxdej,7047,7048,14095
4122,conf/sigmod/urhanfa98,,65401,1142,66543
4123,,ufjnzovcib4j,48722,48723,97445
4124,,url:http://portal.acm.org/ft_gateway.cfm3fid3d28035726type3dpdf26dl3dportal26dl3dacm26cfid3d1111111126cftoken3d2222222,61059,61060,122119
4125,conf/sigmod/chooolcgbps96,,65748,1489,67237
4126,,zc1truoddwgj,43205,43206,86411
4127,journals/sigmod/liu03,,66830,2571,69401
4128,,url:http://www.springerlink.com/index/3g9e0ycglrqfpn89.pdf,2984,2985,5969
4129,journals/vldb/ozsu03,,66721,2462,69183
4130,conf/sigmod/wu99,,65263,1004,66267
4131,,oidf-jhm9cyj,38747,38748,77495
4132,conf/sigmod/jagadishlmsv99,,65273,1014,66287
4133,,946ias3addcj,58827,58828,117655
4134,,htth8prz0dyj,60306,60307,120613
4135,conf/sigmod/bayardo98,,65391,1132,66523
4136,,7b-njdmgtwuj,22788,22789,45577
4137,journals/sigmod/shahmfh01,,64420,161,64581
4138,,my0ltfhxnr4j,14310,14311,28621
4139,journals/vldb/chuacl03,,66547,2288,68835
4140,,agbmhm_0ueij,40792,40793,81585
4141,conf/sigmod/dogacaeoadaos94,,66112,1853,67965
4142,,vmwgqlkw0nuj,40014,40015,80029
4143,journals/sigmod/kuom96,,64940,681,65621
4144,,lmv_k5t2am0j,40529,40530,81059
4145,conf/sigmod/mciverk94,,66040,1781,67821
4146,,51gkshu0cwcj,51034,51035,102069
4147,journals/sigmod/oneilg95,,65127,868,65995
4148,,_ssvlmhsusej,22821,22822,45643
4149,journals/sigmod/widom96b,,65001,742,65743
4150,conf/sigmod/salembcl00,,65108,849,65957
4151,,felmcikk2guj,46092,46093,92185
4152,,wp2_gobi-xkj,6496,6497,12993
4153,conf/sigmod/raor00,,65140,881,66021
4154,,tnxqwh3bxw0j,44331,44332,88663
4155,conf/sigmod/wodtkewwdm97,,65607,1348,66955
4156,,u8jfpcxfxicj,17752,17753,35505
4157,conf/vldb/gallersdorfern95,,64288,29,64317
4158,journals/sigmod/dongs00,,64530,271,64801
4159,,gh_hddjghbaj,2205,2206,4411
4160,journals/sigmod/bussche00,,64593,334,64927
4161,,cer66z1lh0mj,38463,38464,76927
4162,journals/sigmod/paepckegrc00,,64538,279,64817
4163,,hxfruvctvgej,11286,11287,22573
4164,conf/sigmod/team95a,,65949,1690,67639
4165,,p-jriizjxegj,10144,10145,20289
4166,,e8oik3deo6ej,55366,55367,110733
4167,conf/sigmod/motakisz97,,65664,1405,67069
4168,conf/vldb/hinneburglh03,,66354,2095,68449
4169,,xc2efrb-wrqj,53633,53634,107267
4170,,url:http://portal.acm.org/ft_gateway.cfm3fid3d77699026type3dpdf26dl3dguide26dl3dacm26cfid3d1111111126cftoken3d2222222,19182,19183,38365
4171,journals/sigmod/donofriop03,,66231,1972,68203
4172,,7xe6gp9fieej,16883,16884,33767
4173,conf/vldb/benediktcfrzz02,,66391,2132,68523
4174,,nuwrnfdpptcj,34381,34382,68763
4175,conf/sigmod/chenwz98,,65470,1211,66681
4176,,p0qht_9_nskj,33893,33894,67787
4177,journals/sigmod/liu01b,,64453,194,64647
4178,,9nlvdfcl2ysj,18835,18836,37671
4179,journals/sigmod/fernandezfls97,,64813,554,65367
4180,conf/vldb/guting94,,64342,83,64425
4181,,584tvd8f6aaj,8540,8541,17081
4182,journals/sigmod/winslett02a,,64293,34,64327
4183,,url:http://portal.acm.org/ft_gateway.cfm3fid3d56512726type3dpdf26dl3dguide26dl3dacm26cfid3d1111111126cftoken3d2222222,55547,55548,111095
4184,conf/vldb/ramamurthyds02,,66450,2191,68641
4185,,dalyofx710aj,12579,12580,25159
4186,,vtgbh3fwu58j,53420,53421,106841
4187,conf/sigmod/bosworth03,,64608,349,64957
4188,conf/vldb/pottingerl00,,65472,1213,66685
4189,,m2zv0wbf7xyj,31731,31732,63463
4190,conf/vldb/shethkmwdlpls96,,66843,2584,69427
4191,,vgeegeztvl8j,38755,38756,77511
4192,,wjtn8d8md7oj,53944,53945,107889
4193,conf/sigmod/wangtygwp02,,64738,479,65217
4194,conf/sigmod/hammergnybv97,,65646,1387,67033
4195,,pzidm429oxqj,27393,27394,54787
4196,,diwyjabnoumj,29968,29969,59937
4197,journals/sigmod/liu03a,,66181,1922,68103
4198,,x6w3sk-vb2wj,21444,21445,42889
4199,conf/vldb/kraissw97,,66174,1915,68089
4200,journals/sigmod/aberer02c,,66858,2599,69457
4201,,url:http://portal.acm.org/ft_gateway.cfm3fid3d56512926type3dpdf26dl3dguide26dl3dacm26cfid3d1111111126cftoken3d2222222,47242,47243,94485
4202,conf/sigmod/whited95,,65863,1604,67467
4203,,6sbwemr2zscj,29514,29515,59029
4204,conf/sigmod/kramer97,,65577,1318,66895
4205,,noto81qxmhqj,1894,1895,3789
4206,journals/sigmod/liu03b,,66173,1914,68087
4207,,ntqmqfgrxm4j,2222,2223,4445
4208,conf/vldb/objectivity98,,66045,1786,67831
4209,,o3fkxpccbskj,11337,11338,22675
4210,,url:http://doi.wiley.com/10.1002/tl.7700,25454,25455,50909
4211,journals/sigmod/liu03c,,66085,1826,67911
4212,,rgdmwqht30wj,3546,3547,7093
4213,conf/sigmod/kanthra02,,64812,553,65365
4214,,url:http://portal.acm.org/ft_gateway.cfm3fid3d21976626type3dpdf26dl3dguide26dl3dacm26cfid3d1111111126cftoken3d2222222,36975,36976,73951
4215,journals/sigmod/sellisv95,,65093,834,65927
4216,,skoc65ltinyj,29706,29707,59413
4217,journals/sigmod/liu01a,,64428,169,64597
4218,,63xkdndtzp8j,45310,45311,90621
4219,conf/sigmod/hanpy00,,65070,811,65881
4220,,jclqfc-1s18j,727,728,1455
4221,journals/sigmod/camps02,,64295,36,64331
4222,,bbr1xk0-hh8j,33635,33636,67271
4223,conf/sigmod/ioannidislant97,,65605,1346,66951
4224,journals/sigmod/tanakav01,,64398,139,64537
4225,,ta1hegzggrsj,41337,41338,82675
4226,journals/sigmod/yaulms99,,64733,474,65207
4227,,bhvbjw9rp3qj,33442,33443,66885
4228,,url:http://portal.acm.org/ft_gateway.cfm3fid3d60186526type3dpdf26coll3dguide26dl3dacm26cfid3d1111111126cftoken3d2222222,63908,63909,127817
4229,journals/sigmod/aberer02,,64281,22,64303
4230,journals/sigmod/liu02b,,64374,115,64489
4231,,c84rfqn_ug0j,42148,42149,84297
4232,,myw5slwdtogj,51483,51484,102967
4233,conf/vldb/kuhn03,,66304,2045,68349
4234,,daf5z861mzgj,19948,19949,39897
4235,journals/sigmod/vetterlivs00,,64559,300,64859
4236,,fskep047pbgj,31266,31267,62533
4237,conf/sigmod/fukudammt96a,,65744,1485,67229
4238,,yfjkkihvfxcj,17327,17328,34655
4239,journals/sigmod/atkinsondjps96,,64989,730,65719
4240,journals/sigmod/aberer01a,,64461,202,64663
4241,,url:http://portal.acm.org/ft_gateway.cfm3fid3d77699426type3dpdf26dl3dguide26dl3dacm26cfid3d1111111126cftoken3d2222222,37311,37312,74623
4242,,nlklgn91czgj,433,434,867
4243,journals/sigmod/shethbs99,,64677,418,65095
4244,conf/sigmod/sarawagita98,,65440,1181,66621
4245,,kt7z4mcwlryj,8357,8358,16715
4246,journals/sigmod/widom95,,65146,887,66033
4247,,do8czlfdenqj,50884,50885,101769
4248,,vgcxh5avpdgj,16291,16292,32583
4249,journals/sigmod/franklin97b,,64887,628,65515
4250,,ne4v3zrmfsqj,5322,5323,10645
4251,journals/sigmod/eisenbergm99a,,64771,512,65283
4252,,6uelfg3rgeoj,23641,23642,47283
4253,journals/sigmod/meltone02,,66846,2587,69433
4254,journals/sigmod/aberer03b,,66240,1981,68221
4255,,url:http://portal.acm.org/ft_gateway.cfm3fid3d50735326type3dpdf26dl3dportal26dl3dacm26cfid3d1111111126cftoken3d2222222,38968,38969,77937
4256,journals/sigmod/bestavros96,,64926,667,65593
4257,,q2y53ur0g6oj,9688,9689,19377
4258,journals/tods/ghandeharizadehhj96,,66528,2269,68797
4259,,url:http://www.csa.com/partners/viewrecord.php3frequester3dgs26collection3dtrd26recid3d0252444ci,6332,6333,12665
4260,journals/sigmod/widom95a,,65121,862,65983
4261,,xgdbjbatycij,31205,31206,62411
4262,,zqdbtpo9kh4j,15104,15105,30209
4263,conf/vldb/ogawa96,,66071,1812,67883
4264,journals/sigmod/tsotrask96,,64947,688,65635
4265,,url:http://www.springerlink.com/index/mg76ehfrc3cmwl1x.pdf,7023,7024,14047
4266,,_cil6uzfntsj,53050,53051,106101
4267,journals/sigmod/segev94,,65259,1000,66259
4268,journals/sigmod/aberer03d,,66137,1878,68015
4269,,url:http://portal.acm.org/ft_gateway.cfm3fid3d63742426type3dpdf26coll3dguide26dl3dacm26cfid3d1111111126cftoken3d2222222,39689,39690,79379
4270,journals/sigmod/franklin98,,64857,598,65455
4271,,zmw_rq3s6vgj,38666,38667,77333
4272,,6kiyvzshbvej,51638,51639,103277
4273,conf/vldb/norvag99,,65724,1465,67189
4274,,url:http://www.roc.noaa.gov/news/vol1is4.pdf,5264,5265,10529
4275,journals/sigmod/segev94a,,65220,961,66181
4276,,url:http://portal.acm.org/ft_gateway.cfm3fid3d95907826type3dpdf26dl3dguide26dl3dacm26cfid3d1111111126cftoken3d2222222,38803,38804,77607
4277,journals/sigmod/aberer02b,,64377,118,64495
4278,conf/sigmod/adelberg98,,65436,1177,66613
4279,,ut0h0hcwlyuj,21711,21712,43423
4280,conf/sigmod/hammond99,,65344,1085,66429
4281,,,43704,43705,87409
4282,journals/tods/litwinn96,,66535,2276,68811
4283,,ekvrxzdxw0aj,29884,29885,59769
4284,conf/sigmod/carinokkb01,,64970,711,65681
4285,,a9hff_bwih4j,16134,16135,32269
4286,,qx5or09jmmwj,19974,19975,39949
4287,conf/sigmod/cuiots03,,64579,320,64899
4288,,url:http://portal.acm.org/ft_gateway.cfm3fid3d87283726type3dpdf26dl3dportal26dl3dacm26cfid3d1111111126cftoken3d2222222,56093,56094,112187
4289,conf/sigmod/gotok03,,64592,333,64925
4290,conf/vldb/sizovgt03,,66318,2059,68377
4291,,ubqpxbplmcaj,31209,31210,62419
4292,journals/vldb/kemperk95,,66805,2546,69351
4293,,5cz1gtcb5z4j,4704,4705,9409
4294,conf/vldb/jagatheesanmpw03,,66445,2186,68631
4295,,inqysb8bkkkj,20640,20641,41281
4296,,wn-4rn5hfnwj,61692,61693,123385
4297,conf/vldb/veltricv01,,65312,1053,66365
4298,,fxcxfe4m1ruj,42231,42232,84463
4299,journals/tods/tendickm94,,66559,2300,68859
4300,,w64miuscsl8j,54214,54215,108429
4301,journals/tods/clifforddijs97,,66537,2278,68815
4302,conf/vldb/ferrandinamzfm95,,64265,6,64271
4303,,ulg4pc4-auoj,35617,35618,71235
4304,conf/sigmod/kennamer98,,65527,1268,66795
4305,,url:http://portal.acm.org/citation.cfm3fid3d276304.27637326dl3dportal26dl3dacm26type3dseries26idx3d27630426part3dproceedings26wanttype3dproceedings26title3dinternational2520conference2520on2520management2520of2520data26cfid3d1111111126cftoken3d2222222,64012,64013,128025
4306,,ibg3vuolfuwj,44720,44721,89441
4307,journals/sigmod/bollkb98,,64661,402,65063
4308,journals/sigmod/gamaches95,,65056,797,65853
4309,,vqgfvx71hgqj,45668,45669,91337
4310,journals/tods/mokne96,,66520,2261,68781
4311,,spirnjknmayj,47473,47474,94947
4312,,uat2hy6421uj,3606,3607,7213
4313,journals/sigmod/gaffney96,,64958,699,65657
4314,journals/tods/aikenhw95,,66508,2249,68757
4315,,u8zlwhxgtxyj,56282,56283,112565
4316,,tpkccl5rvr0j,40749,40750,81499
4317,conf/sigmod/stonebraker98,,65357,1098,66455
4318,conf/sigmod/danielsddehjjlsss94,,66068,1809,67877
4319,,flnhwvfqnbij,53395,53396,106791
4320,journals/vldb/shyyasl96,,66767,2508,69275
4321,,cz5jzqyhb1mj,5388,5389,10777
4322,conf/vldb/meier95,,64373,114,64487
4323,,c_lenwvj88aj,39082,39083,78165
4324,,hi2kgqdo39gj,16962,16963,33925
4325,conf/sigmod/litwins00,,65092,833,65925
4326,journals/vldb/desslochhmmt98,,66699,2440,69139
4327,,4d2hqe6fxxej,30388,30389,60777
4328,,i83l_b0knogj,60351,60352,120703
4329,conf/vldb/guptam96,,66206,1947,68153
4330,journals/vldb/dewittnsv96,,66790,2531,69321
4331,,wtuhfc-d3twj,13844,13845,27689
4332,journals/sigmod/atzenimm97,,64774,515,65289
4333,,hdq-mlh3fcmj,12868,12869,25737
4334,conf/vldb/chaudhuris96,,66086,1827,67913
4335,,4maerpilrq8j,29265,29266,58531
4336,conf/vldb/zellerk02,,66396,2137,68533
4337,,uiwrekzndvqj,33786,33787,67573
4338,,ripwkrkho0mj,12693,12694,25387
4339,conf/vldb/lindsay95,,64307,48,64355
4340,,cy_fe935wmaj,64143,64144,128287
4341,conf/sigmod/gionisgk01,,64931,672,65603
4342,journals/sigmod/pitourab95,,65138,879,66017
4343,,klm6iritvpcj,63472,63473,126945
4344,journals/vldb/krivokapickg99,,66643,2384,69027
4345,,a8qzgxwldiyj,39165,39166,78331
4346,,0rabcpwwapqj,38646,38647,77293
4347,conf/vldb/niekh03,,66320,2061,68381
4348,conf/sigmod/mankurl99,,65260,1001,66261
4349,,x94gde70zn0j,23818,23819,47637
4350,conf/sigmod/chaudhurin98,,65355,1096,66451
4351,,ehm4ocdja9yj,40575,40576,81151
4352,conf/sigmod/faloutsosl95,,65803,1544,67347
4353,,vbvo-db6wiij,11144,11145,22289
4354,journals/tods/lium96,,66531,2272,68803
4355,,tnx5vnrhhxmj,13714,13715,27429
4356,,fohottsetiwj,49581,49582,99163
4357,journals/vldb/grefenva01,,66714,2455,69169
4358,journals/tods/gutingbejlsv00,,66577,2318,68895
4359,,curcjr2xhe0j,32652,32653,65305
4360,journals/sigmod/ouksels99,,64698,439,65137
4361,,s-lynzs1k70j,19931,19932,39863
4362,,jw7lrqwx_goj,50110,50111,100221
4363,conf/vldb/hasanm94,,64397,138,64535
4364,,eo0jhvplgj0j,9709,9710,19419
4365,journals/vldb/sheikholeslamicz00,,66663,2404,69067
4366,,dvmroct52koj,46749,46750,93499
4367,conf/sigmod/hanfhcc94,,66091,1832,67923
4368,conf/vldb/colletcs94,,64391,132,64523
4369,,iap8eg0sm8oj,28747,28748,57495
4370,journals/sigmod/bawaccdggkmssvy03,,66208,1949,68157
4371,,7gjji63flyyj,33452,33453,66905
4372,conf/sigmod/abiteboulcm95,,65815,1556,67371
4373,,dakoa4ew-poj,16369,16370,32739
4374,conf/sigmod/barbosamkl02,,64831,572,65403
4375,,ueknwqce3nij,24670,24671,49341
4376,journals/sigmod/shethm02,,66857,2598,69455
4377,,b_axrpz8j5ej,5563,5564,11127
4378,,aydb4g2eigwj,55546,55547,111093
4379,journals/vldb/chakrabartidar98,,66686,2427,69113
4380,,dos7nkmuyygj,55693,55694,111387
4381,journals/tods/cerifpt95,,66512,2253,68765
4382,,bcuo4_yr2p0j,55451,55452,110903
4383,conf/sigmod/fukudammt96,,65697,1438,67135
4384,journals/sigmod/smitho99,,64704,445,65149
4385,,,3331,3332,6663
4386,journals/sigmod/anyanwus02,,64370,111,64481
4387,,lodgufllvsaj,6001,6002,12003
4388,,nacqw8qespaj,58147,58148,116295
4389,conf/vldb/x00a,,65446,1187,66633
4390,journals/sigmod/quixsj02,,64492,233,64725
4391,,bro3xort66mj,47736,47737,95473
4392,,rf3edu2oncej,27036,27037,54073
4393,journals/vldb/benzakend95,,66785,2526,69311
4394,,zqcrmih6jo4j,19494,19495,38989
4395,conf/sigmod/babugr01,,64941,682,65623
4396,journals/sigmod/christoffelpsl98,,64647,388,65035
4397,,mnvk8schyf0j,8979,8980,17959
4398,,fw9j2v5gnumj,52259,52260,104519
4399,journals/tods/scioresr94,,66561,2302,68863
4400,,mxkjwollhlyj,12050,12051,24101
4401,conf/vldb/faloutsosms96,,66248,1989,68237
4402,conf/sigmod/missikofft94,,66106,1847,67953
4403,,nxnsfctbgwaj,10365,10366,20731
4404,journals/sigmod/gottlobkp03,,66249,1990,68239
4405,,pk09a5emsooj,1569,1570,3139
4406,journals/tods/raschidl96,,66532,2273,68805
4407,,rupu2pcfa8cj,52052,52053,104105
4408,journals/vldb/soffers98,,66690,2431,69121
4409,,lg_cpuqrdxsj,47952,47953,95905
4410,journals/vldb/combip01,,66739,2480,69219
4411,,8yoyzqtogyoj,30313,30314,60627
4412,,_fksziytb2aj,62726,62727,125453
4413,journals/sigmod/maelbranckeo95,,65128,869,65997
4414,conf/vldb/lakshmiz98,,66013,1754,67767
4415,,qmxb6eku-pyj,4119,4120,8239
4416,journals/sigmod/bunemanru97,,64975,716,65691
4417,,lgczxe4ljkij,56788,56789,113577
4418,,url:http://portal.acm.org/citation.cfm3fid3d984382.98438626coll3dguide26dl3dacm26idx3dj68926part3dperiodical26wanttype3dperiodical26title3dacm2520sigmod2520record26cfid3d1111111126cftoken3d2222222,14897,14898,29795
4419,journals/sigmod/aberer03,,66872,2613,69485
4420,journals/sigmod/grefen02,,64502,243,64745
4421,,ltuevapeagmj,53646,53647,107293
4422,,r7v6jfpfvxcj,43750,43751,87501
4423,journals/sigmod/ozsu02a,,64336,77,64413
4424,journals/sigmod/widom96a,,65027,768,65795
4425,,a2faj5hwf0gj,33947,33948,67895
4426,,url:http://portal.acm.org/citation.cfm3fid3d1084805.1084832,30679,30680,61359
4427,journals/sigmod/snodgrass03a,,66829,2570,69399
4428,,5zyw-o353y4j,12158,12159,24317
4429,journals/sigmod/widom96,,64920,661,65581
4430,,bkutithotx8j,107,108,215
4431,journals/tods/konopnickis98,,66620,2361,68981
4432,,akczkwvwbqwj,0,1,1
4433,,ixkfithoadoj,1,2,3
4434,,3bxllb4wwcij,2,3,5
4435,,d2wwxwkmex4j,3,4,7
4436,,czcx-aqpjccj,4,5,9
4437,,dmhfvnsdyd4j,5,6,11
4438,,97wrwopnankj,6,7,13
4439,,xsv97kddzu8j,7,8,15
4440,,vj0-a5roktij,8,9,17
4441,,6tkmb5go9eoj,9,10,19
4442,,im0sihx8socj,10,11,21
4443,,izk60fjmujqj,11,12,23
4444,,upwen_-pd-sj,12,13,25
4445,,173qccip5coj,14,15,29
4446,,i3mrumui5o0j,15,16,31
4447,,6wr9qvjwwy4j,17,18,35
4448,,ynwfl9rufuij,18,19,37
4449,,k9_rzib4rkoj,19,20,39
4450,,qomfqwrnsvgj,20,21,41
4451,,0biwb8rt4omj,21,22,43
4452,,xlslbg3-jycj,22,23,45
4453,,v-6clxsz9doj,23,24,47
4454,,hm920cbvn1wj,24,25,49
4455,,rgzk3sg-rnqj,26,27,53
4456,,r3sce4vukg0j,27,28,55
4457,,7b7kcnju4j8j,28,29,57
4458,,wgtob7imnlyj,29,30,59
4459,,d2qifuxz3zqj,30,31,61
4460,,pvuehhayz88j,31,32,63
4461,,pg9txzucqzcj,32,33,65
4462,,foh6ansdfxkj,33,34,67
4463,,url:http://portal.acm.org/citation.cfm3fid3d110307.110302,34,35,69
4464,,_-p7foutceij,35,36,71
4465,,zpog6km-mgoj,36,37,73
4466,,x28i9elj9kij,37,38,75
4467,,k_qoxjijwpqj,38,39,77
4468,,l8wnex0wesaj,39,40,79
4469,,pl5drujtg88j,40,41,81
4470,,ejmfgnekip8j,41,42,83
4471,,aelk1vrnz40j,42,43,85
4472,,2ktuhuz4z6qj,43,44,87
4473,,htf9akxllv8j,44,45,89
4474,,ohxtdo0px1cj,45,46,91
4475,,oyulndgbshgj,46,47,93
4476,,rz1wfgingfoj,47,48,95
4477,,78plrdpbt8sj,48,49,97
4478,,oc6sjkjsqh8j,49,50,99
4479,,jgmegwjzy4gj,50,51,101
4480,,vuuzuzvrntsj,51,52,103
4481,,r7nwb5ja0v4j,52,53,105
4482,,qsmbg2pmas0j,53,54,107
4483,,nn73c1worb8j,54,55,109
4484,,ni6q3ow1x1aj,55,56,111
4485,,hgo-3lytaooj,56,57,113
4486,,tgnfob_k6wwj,57,58,115
4487,,ei9esmn5czwj,58,59,117
4488,,url:http://www.csa.com/partners/viewrecord.php3frequester3dgs26collection3dtrd26recid3d2147016ci,59,60,119
4489,,uwedxtelprmj,60,61,121
4490,,zknfv086qlyj,61,62,123
4491,,s_0_4qyx9w0j,62,63,125
4492,,ctg34fdmmuoj,63,64,127
4493,,xcdkclpj9gkj,64,65,129
4494,,ba8ekd7mqvgj,65,66,131
4495,,eettbmdfg94j,66,67,133
4496,,8hecbymbiq0j,67,68,135
4497,,tl5mfdkmyeuj,68,69,137
4498,,akjwrjf08k0j,69,70,139
4499,,tjou0w77vq4j,70,71,141
4500,,pvzuvkec4jwj,71,72,143
4501,,aputfxq8rr0j,72,73,145
4502,,eskg9q0qkyaj,73,74,147
4503,,hftb0dapcc4j,74,75,149
4504,,qzjeeu1-zx8j,75,76,151
4505,,pqcipsrqcwmj,76,77,153
4506,,p6pzqupvofmj,77,78,155
4507,,qeee1ve37tqj,78,79,157
4508,,url:http://www.csa.com/partners/viewrecord.php3frequester3dgs26collection3dtrd26recid3dn7626882ah,79,80,159
4509,,5ke8pei0ygyj,80,81,161
4510,,aec4rmzehpuj,81,82,163
4511,,yrhcyfnlu_kj,82,83,165
4512,,97vsqvps6bgj,83,84,167
4513,,v95a5wsijwmj,84,85,169
4514,,rclvo9hzby8j,85,86,171
4515,,g4ry1knyqjwj,86,87,173
4516,,53h7hihiy_oj,87,88,175
4517,,jvtiv8ysaayj,88,89,177
4518,,gepxbbgtup8j,89,90,179
4519,,idbpfmg04zmj,90,91,181
4520,,8uzb1ih-royj,91,92,183
4521,,cybln4lzawcj,92,93,185
4522,,cccoxyn-tjej,93,94,187
4523,,evmosockte4j,94,95,189
4524,,pwzqj15aekgj,95,96,191
4525,,kijv9lwn70ej,96,97,193
4526,,m7up_b3a8ygj,98,99,197
4527,,glljcrlsddsj,99,100,199
4528,,ki-hiv-7nzsj,100,101,201
4529,,izdxhqrw9ayj,101,102,203
4530,,j2goicgwxb4j,102,103,205
4531,,eff15b-myzoj,103,104,207
4532,,avgtdrlrxukj,104,105,209
4533,,6kzn4cd0zwaj,105,106,211
4534,,ln_zzswbnosj,106,107,213
4535,,9lexpgz6k5qj,108,109,217
4536,,hbtklk8srraj,109,110,219
4537,,url:http://www.csa.com/partners/viewrecord.php3frequester3dgs26collection3dtrd26recid3da8622976ah,110,111,221
4538,,kxnvnkltpfqj,111,112,223
4539,,url:http://www.springerlink.com/index/xv80363546u051u2.pdf,112,113,225
4540,,bpdmg5ipu9kj,113,114,227
4541,,5wiluvdexv0j,114,115,229
4542,,yvpk-m9_u-aj,115,116,231
4543,,hvwz2rxao5uj,116,117,233
4544,,yakpvc1qgaij,117,118,235
4545,,3umqgg34ohyj,118,119,237
4546,,ahyawwao2roj,119,120,239
4547,,bejlx2x8bzkj,120,121,241
4548,,k2lfzst_ncoj,121,122,243
4549,,bmsonqxqp80j,122,123,245
4550,,bkvmjx7abn0j,123,124,247
4551,,4ezsmz6_1g0j,124,125,249
4552,,uufs74kwonaj,125,126,251
4553,,mdr5xbswwwoj,126,127,253
4554,,ihgqccrqsqkj,127,128,255
4555,,i3sxq8ebkdyj,128,129,257
4556,,uc4eaqqmxu0j,129,130,259
4557,,url:http://portal.acm.org/ft_gateway.cfm3fid3d110120426type3dpdf,130,131,261
4558,,cuc4o67unuyj,131,132,263
4559,,pahgk5h9_4kj,132,133,265
4560,,y81qtjgbuykj,133,134,267
4561,,mqg5svjwscoj,134,135,269
4562,,anv3icmngqyj,135,136,271
4563,,gudvtijp9pcj,136,137,273
4564,,hyp3zqesqhoj,137,138,275
4565,,ugckixpzzzij,138,139,277
4566,,xg3zaydt_hcj,139,140,279
4567,,pscxi8veb-oj,140,141,281
4568,,nx7ddvxatogj,141,142,283
4569,,qpdh4xvumbwj,142,143,285
4570,,42whesd5rl8j,143,144,287
4571,,2hq1heki1_4j,144,145,289
4572,,nm4mm1zjfj8j,145,146,291
4573,,url:http://www.springerlink.com/index/g17323245151166v.pdf,146,147,293
4574,,k6zu6bla8ggj,147,148,295
4575,,hxq_qo69y1cj,148,149,297
4576,,n9_cfmtousyj,149,150,299
4577,,awu_prmgynuj,150,151,301
4578,,bgadjxyzdhaj,151,152,303
4579,,j2y-zn-ac5yj,152,153,305
4580,,k-z4in4kmtqj,153,154,307
4581,,tvp1tqpytdkj,154,155,309
4582,,w1clohbjhdsj,155,156,311
4583,,mvfxtmmgragj,156,157,313
4584,,isw9z4pis0yj,157,158,315
4585,,qn_jwgpnoo4j,158,159,317
4586,,oozb-r3gutmj,159,160,319
4587,,jetfkz0cmxej,160,161,321
4588,,jytarxfimecj,161,162,323
4589,,eqf1i1bl7gij,162,163,325
4590,,mkihmkxtxbqj,163,164,327
4591,,dr0i1_otjdgj,164,165,329
4592,,8k19hgog2k8j,165,166,331
4593,,jrhhvf7f7rwj,167,168,335
4594,,ypekq2d1drgj,168,169,337
4595,,95qbei1e_raj,169,170,339
4596,,fhpfmac1rzyj,170,171,341
4597,,cj3wl4feuvmj,171,172,343
4598,,qfr8jzoqi6qj,172,173,345
4599,,2acfls1ipwqj,173,174,347
4600,,npg51orapbkj,174,175,349
4601,,krvgtxcnppuj,175,176,351
4602,,_r8p8xq2z-aj,176,177,353
4603,,rymtnzrenusj,177,178,355
4604,,grcvf_oakxwj,178,179,357
4605,,qppuo7m3a7cj,179,180,359
4606,,syoqnsarascj,180,181,361
4607,,7k21pbtcnp0j,181,182,363
4608,,gk7-d_nfqmej,182,183,365
4609,,rdp2y3zxvywj,183,184,367
4610,,etrstil1c-qj,184,185,369
4611,,jey4mndwsggj,185,186,371
4612,,jwvaywgpqnuj,186,187,373
4613,,aum8wzjhddgj,187,188,375
4614,,fhkbonshy9ej,188,189,377
4615,,6axscuggjkoj,189,190,379
4616,,d3jizcfceeuj,190,191,381
4617,,cmjuhr6u_ouj,192,193,385
4618,,u6sum1c_ocwj,193,194,387
4619,,ueabvmdvnf4j,194,195,389
4620,,9f4uvdainlaj,195,196,391
4621,,drh9kspqnuwj,196,197,393
4622,,clb3srivqumj,197,198,395
4623,,-2eto4zqjpoj,198,199,397
4624,,t4yqfwvjwkwj,199,200,399
4625,,1qeunakihq4j,200,201,401
4626,,hzuepajpfcmj,201,202,403
4627,,ttr0t1yr0u4j,203,204,407
4628,,dar5f1gmkwij,204,205,409
4629,,euj67_3e0d0j,205,206,411
4630,,ntdj8nekyi4j,206,207,413
4631,,j3izlktse0ij,207,208,415
4632,,vqzaqakocvej,208,209,417
4633,,z0oxmvqb5pij,209,210,419
4634,,hx8p7bn5tvsj,210,211,421
4635,,0gry-lst84sj,211,212,423
4636,,ve4m6atfr5gj,212,213,425
4637,,mjxz-bykbtwj,213,214,427
4638,,zz3uou7rykej,214,215,429
4639,,xul-tmyacgkj,215,216,431
4640,,lnbspjvfvgmj,216,217,433
4641,,1kgxvzcb5awj,217,218,435
4642,,extoza-15lij,218,219,437
4643,,w7gdvdu7lmqj,219,220,439
4644,,is6ujl13ktgj,220,221,441
4645,,_fieoaxm3skj,221,222,443
4646,,url:http://adsabs.harvard.edu/abs/1976infph..16..125z,222,223,445
4647,,am5wjul7tzkj,223,224,447
4648,,092qznpamycj,224,225,449
4649,,6zkxlk72ub4j,225,226,451
4650,,url:http://portal.acm.org/citation.cfm3fdoid3d263690.264343,226,227,453
4651,,ar7icaf1g8kj,227,228,455
4652,,asihf3hepwqj,228,229,457
4653,,x2pe6k7uezqj,229,230,459
4654,,wsn2olnrk6mj,230,231,461
4655,,0ct3hfjd8wgj,231,232,463
4656,,url:http://www.springerlink.com/index/rr8l7kjh03740042.pdf,232,233,465
4657,,url:http://www.csa.com/partners/viewrecord.php3frequester3dgs26collection3dtrd26recid3d20021214033592mt26recid3da7642818ah,233,234,467
4658,,-4mc6wz-vkqj,234,235,469
4659,,7eag6wnw6fkj,235,236,471
4660,,aiamppqvsbuj,236,237,473
4661,,9lxfdyugrryj,237,238,475
4662,,1j-tl6dypzyj,238,239,477
4663,,xdwk2yxbbruj,239,240,479
4664,,bfliygzlfsoj,240,241,481
4665,,vjzuzf2xxb4j,242,243,485
4666,,gt-77zkb8loj,243,244,487
4667,,ayqdzpfxqjaj,244,245,489
4668,,sfubo7atigcj,245,246,491
4669,,jvkjdubut8kj,246,247,493
4670,,xndzzbpyicmj,247,248,495
4671,,yz8u5ihaylaj,248,249,497
4672,,8pk3snsuldej,249,250,499
4673,,6e6gzgzatrej,250,251,501
4674,,0wvmayv_p5kj,251,252,503
4675,,url:http://portal.acm.org/citation.cfm3fid3d30113.3011526dl3dportal26dl3dacm26cfid3d1111111126cftoken3d2222222,252,253,505
4676,,n0276nr35fgj,253,254,507
4677,,e7h04svx7v8j,254,255,509
4678,,woijejdfzy4j,255,256,511
4679,,ei0vrkds9pcj,257,258,515
4680,,rd-kmjcxk3wj,258,259,517
4681,,p64hqj4riqqj,259,260,519
4682,,annzb6gr7hkj,260,261,521
4683,,ul-ngyuiuk8j,261,262,523
4684,,56u_bp4y6joj,262,263,525
4685,,4ii5ntwqhiyj,263,264,527
4686,,bn5h0ibqbnwj,264,265,529
4687,,bwf9aiao9egj,265,266,531
4688,,x2sukngm4taj,266,267,533
4689,,9evihtb1x8sj,267,268,535
4690,,dkd7jqnh-fwj,268,269,537
4691,,c2vj3tdfwkej,269,270,539
4692,,url:http://adsabs.harvard.edu/abs/1974phdt........51s,270,271,541
4693,,de5dzrbrkquj,271,272,543
4694,,np13j8s06xyj,272,273,545
4695,,xikchsdw3coj,273,274,547
4696,,2rnjhkliq9cj,274,275,549
4697,,joy5e_b55gaj,275,276,551
4698,,zrbmwsu4a7qj,276,277,553
4699,,01zricnplwoj,277,278,555
4700,,gczfuzekoiaj,278,279,557
4701,,diyllgicuzqj,279,280,559
4702,,dzhpil1bbacj,280,281,561
4703,,dbh6rpnaztoj,281,282,563
4704,,sxka8bjooh4j,282,283,565
4705,,qo9uigny9wgj,283,284,567
4706,,cbvujpvkwf0j,284,285,569
4707,,hdoq_vyjdacj,285,286,571
4708,,vx6-plyp9zgj,286,287,573
4709,,kzblbzq7nuwj,287,288,575
4710,,siua2f9f91ej,288,289,577
4711,,y0vn0e_bjjsj,289,290,579
4712,,has6tnivceij,290,291,581
4713,,i-fmtpvlukej,291,292,583
4714,,clox1kvd37uj,292,293,585
4715,,jiq89znuk5yj,294,295,589
4716,,0nbpdn8x5a0j,295,296,591
4717,,wp8mppuwztcj,296,297,593
4718,,djdl6u89jt4j,297,298,595
4719,,tr_rawv-6smj,298,299,597
4720,,kl4jpdyjdakj,299,300,599
4721,,la1bik2hfmej,300,301,601
4722,,txo56jdklaoj,301,302,603
4723,,ufc3hekkon4j,302,303,605
4724,,9jprzsfte2cj,303,304,607
4725,,fqyijwlbarmj,304,305,609
4726,,rvcmfaqhwz0j,305,306,611
4727,,tgmoy2x-o9wj,306,307,613
4728,,bd6ohi2eajaj,307,308,615
4729,,l8qjgtxfbxsj,308,309,617
4730,,fp7ytnqpu9ej,309,310,619
4731,,mcw9smq_mt4j,310,311,621
4732,,r_10vw3cqlkj,311,312,623
4733,,w2p_uyy3bgaj,312,313,625
4734,,-icmy5q7-00j,313,314,627
4735,,4_fqg3zts3ij,314,315,629
4736,,7gzs66ffgq8j,315,316,631
4737,,,316,317,633
4738,,lewjvfvyy98j,317,318,635
4739,,wq-ongpsrdmj,318,319,637
4740,,08qdvcelxwwj,319,320,639
4741,,ip1kedzupyyj,320,321,641
4742,,lasbncpjmpyj,321,322,643
4743,,te4hourugxsj,322,323,645
4744,,vomrs1iylhqj,323,324,647
4745,,g_hkspvqerej,324,325,649
4746,,ire7kl3ccqcj,325,326,651
4747,,uai7mrs_hqwj,326,327,653
4748,,aczmgm5isxsj,327,328,655
4749,,r_eb2_bftqoj,328,329,657
4750,,nbfug9vgfqaj,329,330,659
4751,,aqoopqnkdraj,330,331,661
4752,,url:http://www.springerlink.com/index/t3p88243322727mj.pdf,331,332,663
4753,,url:http://ieeexplore.ieee.org/iel1/2206/1846/00050604.pdf3farnumber3d50604,332,333,665
4754,,1-x1p8ntssaj,333,334,667
4755,,uiaj9bt1wukj,334,335,669
4756,,wx6cd9g_ejgj,335,336,671
4757,,qu_ix5kfwioj,336,337,673
4758,,o7oufmpw9dwj,337,338,675
4759,,g8idrkwfaqqj,338,339,677
4760,,mrxahi3pqgaj,339,340,679
4761,,a41k5lrqftwj,340,341,681
4762,,ix9hkgzu-nqj,341,342,683
4763,,wr9g-gkj1uuj,342,343,685
4764,,pgtqz6aswryj,343,344,687
4765,,kyvjpqwh2p8j,344,345,689
4766,,5ddv_kksyeyj,345,346,691
4767,,xl9mz-yyr-wj,346,347,693
4768,,srcmuuo3-bej,347,348,695
4769,,url:http://www.csa.com/partners/viewrecord.php3frequester3dgs26collection3dtrd26recid3d0116696ci,348,349,697
4770,,ysc9ewrfrcej,349,350,699
4771,,6giwh3tc64qj,350,351,701
4772,,3szuihn5-goj,351,352,703
4773,,8jhe9ef3btuj,352,353,705
4774,,url:http://portal.acm.org/citation.cfm3fid3d30120.30124,353,354,707
4775,,jnth9ihzfdqj,354,355,709
4776,,8gc5_pgfnpij,355,356,711
4777,,ukyclilrdlwj,356,357,713
4778,,usc5w5b3s_ij,357,358,715
4779,,7w05tsbkqmcj,358,359,717
4780,,xqpmijpkbaej,359,360,719
4781,,xagphbdrgqmj,360,361,721
4782,,ujutlayjzqcj,361,362,723
4783,,ddto_cj4teyj,362,363,725
4784,,1bwvgqroojgj,363,364,727
4785,,url:http://portal.acm.org/ft_gateway.cfm3fid3d102755826type3dpdf,364,365,729
4786,,lsa4_cv5roaj,365,366,731
4787,,url:http://ieeexplore.ieee.org/iel5/9193/29143/01314551.pdf3farnumber3d1314551,366,367,733
4788,,3ljnftstk5kj,367,368,735
4789,,laj36pget1aj,369,370,739
4790,,z2ygimbsu7uj,370,371,741
4791,,j0_cq1g7sasj,371,372,743
4792,,uryjy7lnkauj,372,373,745
4793,,wjd01qhcjvcj,373,374,747
4794,,ifn4xgrce_0j,374,375,749
4795,,movy5aulv5yj,375,376,751
4796,,sajryutq0qqj,376,377,753
4797,,f1qumdwr1gaj,377,378,755
4798,,swz4p1njrbcj,378,379,757
4799,,0xp1yi4xpkgj,379,380,759
4800,,rra1h9bvdikj,381,382,763
4801,,v5jqcf2hrkej,382,383,765
4802,,toejow9qjymj,383,384,767
4803,,emw2zfdyz2wj,384,385,769
4804,,id_01grs2wwj,385,386,771
4805,,0klipvrbmtej,386,387,773
4806,,mc7dagp3gtoj,387,388,775
4807,,8kltakm4ahij,388,389,777
4808,,2vxwyrpxhzsj,389,390,779
4809,,eizqofl2jlkj,390,391,781
4810,,ng1p4qxvf7ej,391,392,783
4811,,awhs1su8h-8j,392,393,785
4812,,f6l4eo3zqxmj,393,394,787
4813,,ivzaazehycoj,394,395,789
4814,,_gggrrl38tgj,395,396,791
4815,,url:http://adsabs.harvard.edu/abs/1978rael...23q1189o,396,397,793
4816,,ax8-169bmwsj,397,398,795
4817,,xmfygcbvxm0j,398,399,797
4818,,po9arhus_baj,399,400,799
4819,,lscrcdc0pgkj,400,401,801
4820,,2lcoypnxfbmj,401,402,803
4821,,url:http://adsabs.harvard.edu/abs/1976phdt.......124s,402,403,805
4822,,7im5gbdx4xyj,403,404,807
4823,,url:http://pubs.acs.org/cgi-bin/abstract.cgi/achre4/2005/38/i10/abs/ar050040d.html,405,406,811
4824,,mf-mrjgpc14j,406,407,813
4825,,c4eles4vk1ej,407,408,815
4826,,56wrfv0ec-qj,408,409,817
4827,,u_knlj37tmmj,409,410,819
4828,,vvnpa4fhvmij,410,411,821
4829,,6azuepu008kj,411,412,823
4830,,wklf2io9jdij,412,413,825
4831,,gj_7cql0d70j,413,414,827
4832,,pqyilupv_fyj,414,415,829
4833,,numgkbju1jkj,415,416,831
4834,,y-ui3j0axlwj,416,417,833
4835,,402gy6xttgmj,417,418,835
4836,,gymnkskewcwj,418,419,837
4837,,2tvjo0a0oskj,419,420,839
4838,,ux8y6eiqxd8j,420,421,841
4839,,wig9kgdvp9ij,421,422,843
4840,,qxeotzcmabqj,422,423,845
4841,,lvuwionoyccj,423,424,847
4842,,ny-qeoixwjuj,424,425,849
4843,,vouo6t_or8uj,425,426,851
4844,,jqqellap2suj,426,427,853
4845,,gii3pwlwdmwj,427,428,855
4846,,jwegiego4ycj,428,429,857
4847,,2emlbdsxzwgj,429,430,859
4848,,91iu-xarikcj,430,431,861
4849,,y8hma1zze6sj,431,432,863
4850,,tnngbqotybaj,432,433,865
4851,,6cjpbw-m96ej,434,435,869
4852,,ymjwxy5nkhkj,435,436,871
4853,,fuebuynd2bwj,436,437,873
4854,,_7orm2thjaej,437,438,875
4855,,28w6awq-c4oj,438,439,877
4856,,twgzjhra_skj,439,440,879
4857,,prwyk3dndbmj,440,441,881
4858,,sxd0gz-epskj,441,442,883
4859,,1dnehgrozduj,442,443,885
4860,,5dcptekz8saj,443,444,887
4861,,vlesufn0l6mj,444,445,889
4862,,udwyudakb4uj,445,446,891
4863,,w3zvgcjjnxsj,446,447,893
4864,,url:http://portal.acm.org/citation.cfm3fid3d335224,447,448,895
4865,,ko9mbagqqlqj,448,449,897
4866,,azgenr45zmoj,449,450,899
4867,,uen3x_kdpi4j,450,451,901
4868,,qkn4lcn_ge0j,451,452,903
4869,,taqe9frq4quj,452,453,905
4870,,0jych0e5nzkj,453,454,907
4871,,p6zcwuhfgd0j,454,455,909
4872,,rb5nnj5kviij,455,456,911
4873,,6r1snq9khxaj,456,457,913
4874,,dijiwhahwg8j,457,458,915
4875,,mhw6ctq9zzcj,458,459,917
4876,,rqboreoi-tsj,459,460,919
4877,,foruo1peowaj,460,461,921
4878,,url:http://www.springerlink.com/index/gj461198440332l2.pdf,461,462,923
4879,,,463,464,927
4880,,qrf5ih3ojpcj,464,465,929
4881,,hk_2w16ghyaj,465,466,931
4882,,a-5q8iqybvqj,466,467,933
4883,,qrwjhlwimlyj,467,468,935
4884,,6uk30fl35hwj,468,469,937
4885,,url:http://portal.acm.org/ft_gateway.cfm3fid3d102470326type3dpdf,469,470,939
4886,,tbe3r1gfwjuj,470,471,941
4887,,kjvq3fafc-ij,471,472,943
4888,,wy8jbulhkbqj,472,473,945
4889,,5lw-_yalz-oj,473,474,947
4890,,w6vtzrvazv8j,474,475,949
4891,,wyuphbb-0gaj,475,476,951
4892,,url:http://portal.acm.org/citation.cfm3fid3d144111.144147,476,477,953
4893,,fzjkvbkqlfkj,478,479,957
4894,,coteavkuo74j,479,480,959
4895,,url:http://www.springerlink.com/index/l22781t60477677p.pdf,480,481,961
4896,,vvivi2dln9aj,481,482,963
4897,,tp6vv_q_xvej,482,483,965
4898,,url:http://portal.acm.org/ft_gateway.cfm3fid3d109962826type3dpdf,483,484,967
4899,,n8aallt0c8oj,484,485,969
4900,,oqz4p5iv-g0j,485,486,971
4901,,5fgxmmqqeykj,486,487,973
4902,,aevsyzeq4toj,488,489,977
4903,,lof87fhwtkmj,489,490,979
4904,,uqn3b_isnksj,490,491,981
4905,,l6t_li7xqaej,491,492,983
4906,,oi8quvdwtdsj,492,493,985
4907,,0vmsc0oib2kj,493,494,987
4908,,wmnyir3wl_qj,494,495,989
4909,,blt38bs62q8j,495,496,991
4910,,m1da2stifzgj,496,497,993
4911,,vasz2m_3vaqj,497,498,995
4912,,nxyaoolvv64j,498,499,997
4913,,eenqblyvu2uj,499,500,999
4914,,30fogpmj6fij,500,501,1001
4915,,tj6kk-hvalsj,501,502,1003
4916,,pjsjnz4zvaej,502,503,1005
4917,,teuduhydavcj,503,504,1007
4918,,30fmb9_zbm0j,504,505,1009
4919,,rjceozr3ahkj,505,506,1011
4920,,url:http://www.csa.com/partners/viewrecord.php3frequester3dgs26collection3dtrd26recid3d20021212014823mt26recid3da8012618ah,506,507,1013
4921,,lhzrnnfrgdcj,507,508,1015
4922,,mksenkaqmhqj,508,509,1017
4923,,da8yfpooruij,509,510,1019
4924,,vxmawtwd3l8j,510,511,1021
4925,,url:http://www.csa.com/partners/viewrecord.php3frequester3dgs26collection3dtrd26recid3d200111010695mt26recid3da0032617ah,511,512,1023
4926,,3w0fgutu1-kj,512,513,1025
4927,,url:http://portal.acm.org/ft_gateway.cfm3fid3d102758326type3dpdf,513,514,1027
4928,,url:http://portal.acm.org/ft_gateway.cfm3fid3d110121626type3dpdf,514,515,1029
4929,,k1cvtrlwl_wj,515,516,1031
4930,,jekyy-cxux0j,516,517,1033
4931,,454eqqmrnsyj,517,518,1035
4932,,6baf2dwrexej,518,519,1037
4933,,fa8rkqrn-xgj,519,520,1039
4934,,iqqrzbxbalcj,520,521,1041
4935,,lyi-e67p5akj,521,522,1043
4936,,zldmwysmh-0j,522,523,1045
4937,,pb_ozcuc2wsj,523,524,1047
4938,,cwqudi6c6hcj,524,525,1049
4939,,5j4et-rfprmj,525,526,1051
4940,,xkq3w_8n154j,526,527,1053
4941,,y0ljnytjmvmj,527,528,1055
4942,,eghucgt4zqcj,528,529,1057
4943,,sinvx-uhfvij,529,530,1059
4944,,vjmne4j5bmkj,530,531,1061
4945,,qdqi_qzyy10j,531,532,1063
4946,,url:http://portal.acm.org/ft_gateway.cfm3fid3d110117726type3dpdf,532,533,1065
4947,,kpl4pmkqsvwj,533,534,1067
4948,,sb31pnoiomcj,534,535,1069
4949,,aqvgcgnpqp4j,535,536,1071
4950,,rhxirsqkm5aj,536,537,1073
4951,,ssu5skdzxrej,537,538,1075
4952,,j71gm5zkroyj,538,539,1077
4953,,az_npio5fdqj,539,540,1079
4954,,ttmy152c3vyj,540,541,1081
4955,,3emea-5frx8j,541,542,1083
4956,,x8s3qppxggyj,542,543,1085
4957,,1pxtzlcllk8j,543,544,1087
4958,,wv5fslqb43yj,544,545,1089
4959,,url:http://portal.acm.org/citation.cfm3fid3d234286.1057819,545,546,1091
4960,,kvqhf7ncofwj,546,547,1093
4961,,uq3ruldajfyj,547,548,1095
4962,,0ldzxnm8mmqj,548,549,1097
4963,,kd19tvhlpjaj,549,550,1099
4964,,7rfiyu2r4-kj,550,551,1101
4965,,url:http://www.csa.com/partners/viewrecord.php3frequester3dgs26collection3dtrd26recid3d8204540536md,551,552,1103
4966,,mxacmnkeibwj,552,553,1105
4967,,,553,554,1107
4968,,o_smlr3bfbmj,554,555,1109
4969,,mkrtrerh0syj,555,556,1111
4970,,ma1qbricxraj,556,557,1113
4971,,tp6zd0gyj6wj,557,558,1115
4972,,scfhae4a8yaj,558,559,1117
4973,,uwmznfvtjqsj,559,560,1119
4974,,5dvx31bucfej,560,561,1121
4975,,wbowwh5gqbuj,562,563,1125
4976,,wqcnvihl8lwj,563,564,1127
4977,,fmblth2of3ij,564,565,1129
4978,,qwxp6sgieksj,565,566,1131
4979,,89ylidkavn0j,566,567,1133
4980,,lmumlubod_8j,567,568,1135
4981,,ar8qus-3kaqj,568,569,1137
4982,,eurfl0dtnlej,569,570,1139
4983,,5ptaphkla1oj,570,571,1141
4984,,d1f1uq41ae8j,571,572,1143
4985,,0snaco8196ej,572,573,1145
4986,,t-_9eoisjmgj,573,574,1147
4987,,fsb01jihbqqj,574,575,1149
4988,,url:http://www.csa.com/partners/viewrecord.php3frequester3dgs26collection3dtrd26recid3d0014631ci,575,576,1151
4989,,ozvlrcwaj3cj,576,577,1153
4990,,dvhljegyvouj,577,578,1155
4991,,a2-cplsejxqj,578,579,1157
4992,,gmi6eh8pcnkj,579,580,1159
4993,,bslb7ei7oawj,580,581,1161
4994,,o4k4hktgjlmj,581,582,1163
4995,,qaotk_zx3awj,582,583,1165
4996,,skzx_na5ueaj,583,584,1167
4997,,c5r7cwfq0icj,585,586,1171
4998,,faa0fnceme0j,587,588,1175
4999,,dcnbjtu6p90j,588,589,1177
5000,,biui8xtinqej,589,590,1179
5001,,mvdi5c2m95sj,590,591,1181
5002,,a5dijd9bbl8j,591,592,1183
5003,,url:http://doi.wiley.com/10.1002/ace.31,592,593,1185
5004,,a2vpfbuljcuj,593,594,1187
5005,,hiz-2-msanaj,594,595,1189
5006,,vgyoako9oesj,595,596,1191
5007,,k8feoyyepl8j,596,597,1193
5008,,i-2p22dkyzgj,597,598,1195
5009,,ecvvppg0h2mj,598,599,1197
5010,,jb9ogc1qqayj,599,600,1199
5011,,zhtkwo0u5tyj,600,601,1201
5012,,qtsey_1q5yuj,601,602,1203
5013,,gfgskwujxo8j,602,603,1205
5014,,letduqe6lmgj,603,604,1207
5015,,0lahcm-lcjij,604,605,1209
5016,,kzqcbqwupmaj,605,606,1211
5017,,bzlkf_yqciyj,606,607,1213
5018,,ow2iifojum0j,607,608,1215
5019,,32hcxogdm8ej,608,609,1217
5020,,cscaezbocigj,609,610,1219
5021,,wc7thzna0hgj,610,611,1221
5022,,cjlbnzs51oaj,611,612,1223
5023,,y8ywce-kbmgj,612,613,1225
5024,,,613,614,1227
5025,,gllxyaippkij,614,615,1229
5026,,7vb5n4byx9cj,615,616,1231
5027,,url:http://doi.wiley.com/10.1002/he.76,616,617,1233
5028,,rl018_dxtqwj,617,618,1235
5029,,e9mwd5nmnuqj,618,619,1237
5030,,lx43m93lphcj,619,620,1239
5031,,msdor1yogkcj,620,621,1241
5032,,wn1gluwtqgqj,621,622,1243
5033,,yhjxxctseugj,622,623,1245
5034,,lwze_ntd__uj,623,624,1247
5035,,j_hnhohfyykj,624,625,1249
5036,,ve97_p9rjogj,625,626,1251
5037,,rcahzzaahqcj,626,627,1253
5038,,c1hln78wvnuj,627,628,1255
5039,,ucd3zdtavdij,628,629,1257
5040,,ipq5dgaqs94j,629,630,1259
5041,,gwvmt46wdooj,630,631,1261
5042,,s7s2j-qgkrkj,631,632,1263
5043,,ebiof2uxyboj,633,634,1267
5044,,2cnjfaduqt4j,634,635,1269
5045,,n85swxicwvgj,635,636,1271
5046,,nqhb6cyu7rmj,636,637,1273
5047,,lgpotmosi9gj,637,638,1275
5048,,bzlpjmdzd5uj,638,639,1277
5049,,-r42fmhetdij,639,640,1279
5050,,sxo1ryvvzfoj,640,641,1281
5051,,m_hwk8x773ij,641,642,1283
5052,,cldkmfhnozmj,642,643,1285
5053,,3-kjew_km2ij,643,644,1287
5054,,ffygyjh6inoj,644,645,1289
5055,,3f8i6gqnp6uj,645,646,1291
5056,,38vz_jxcwv0j,646,647,1293
5057,,stisg0td5zuj,647,648,1295
5058,,jweirbn3psuj,648,649,1297
5059,,jlzv21qakdoj,649,650,1299
5060,,ng26eplzpwwj,650,651,1301
5061,,djevzkkg84yj,651,652,1303
5062,,fpkyfxipfbuj,652,653,1305
5063,,pkukr5auesoj,653,654,1307
5064,,yrtmrji7lcaj,654,655,1309
5065,,thlxmqqaxjij,656,657,1313
5066,,x3m140zmamgj,657,658,1315
5067,,v--r0nh61uwj,658,659,1317
5068,,tofkqzy9prgj,659,660,1319
5069,,1tmiw7l9hcgj,660,661,1321
5070,,c3832pwq-f4j,661,662,1323
5071,,jcxmp9zo-_wj,662,663,1325
5072,,ajg3gyq22j8j,663,664,1327
5073,,fw5xfuh15osj,664,665,1329
5074,,fgrch7xeemsj,665,666,1331
5075,,ctlgohqzvrwj,666,667,1333
5076,,zzhw78zpoq8j,667,668,1335
5077,,qp0jzsobacgj,668,669,1337
5078,,vzuvxh5l1kuj,669,670,1339
5079,,yzy4plakiksj,670,671,1341
5080,,ii149haufkcj,671,672,1343
5081,,url:http://portal.acm.org/ft_gateway.cfm3fid3d109960026type3dpdf,672,673,1345
5082,,qx58cl7yx1ij,674,675,1349
5083,,br97rv-r0s0j,675,676,1351
5084,,crswtfcy9dij,676,677,1353
5085,,hvj0rxxsyw8j,677,678,1355
5086,,afr5jqqucfmj,678,679,1357
5087,,url:http://portal.acm.org/citation.cfm3fid3d1084805.1084817,679,680,1359
5088,,wpqud82rspyj,680,681,1361
5089,,gt0ietfxq2gj,681,682,1363
5090,,98wnotdfxscj,682,683,1365
5091,,d6fnpqiuqnwj,683,684,1367
5092,,0vt-mcddgywj,684,685,1369
5093,,da91q3uhag4j,685,686,1371
5094,,m0abl9muzygj,686,687,1373
5095,,hbm5fifm1y4j,687,688,1375
5096,,uwcxu0ojbjoj,688,689,1377
5097,,fdpauj3gbekj,689,690,1379
5098,,ulejsj9fn5gj,690,691,1381
5099,,eztmalgbk40j,691,692,1383
5100,,vqdja8ibnzoj,692,693,1385
5101,,rpmvea9cc80j,693,694,1387
5102,,5bewf7kpl88j,694,695,1389
5103,,upop6k5m-bkj,695,696,1391
5104,,hjvqq1f9drgj,696,697,1393
5105,,j4c0nouirdkj,697,698,1395
5106,,6stflric-a8j,698,699,1397
5107,,1146ficae50j,699,700,1399
5108,,nreqsoaie44j,700,701,1401
5109,,kbza_qpscucj,701,702,1403
5110,,1btlnbfxiaij,702,703,1405
5111,,d5t54nekom4j,703,704,1407
5112,,aab6fcx2fegj,705,706,1411
5113,,k4cgobrxx_0j,706,707,1413
5114,,vtk5mxdp0d4j,707,708,1415
5115,,uqklpnctb0cj,708,709,1417
5116,,biuzsi1xe84j,709,710,1419
5117,,dol7ythorkqj,710,711,1421
5118,,vjozrvlkdjij,712,713,1425
5119,,hqhnldeftioj,713,714,1427
5120,,p3-pbz0dpxcj,714,715,1429
5121,,nx9bcndwjfkj,715,716,1431
5122,,quqr_n2ccqej,716,717,1433
5123,,aoflfvfq8woj,717,718,1435
5124,,vayncrmswcmj,718,719,1437
5125,,hnzupxiigzmj,719,720,1439
5126,,40mh__7xofkj,720,721,1441
5127,,au8mkdgl5qmj,721,722,1443
5128,,mcds-k71qpuj,722,723,1445
5129,,xbvjhtrcf74j,723,724,1447
5130,,l0rvrqhabfej,724,725,1449
5131,,ccbwftc4mqmj,725,726,1451
5132,,url:http://www.springerlink.com/index/q43210876k7583p2.pdf,726,727,1453
5133,,xfvxgpi7zkij,728,729,1457
5134,,i5dytwrz5m4j,729,730,1459
5135,,wsigow-1_k4j,730,731,1461
5136,,pwvakmyycrmj,731,732,1463
5137,,5hpvrmah7kmj,732,733,1465
5138,,onlybp6saasj,733,734,1467
5139,,yakfs8b4o4uj,734,735,1469
5140,,url:http://ieeexplore.ieee.org/iel5/2193/3608/00129232.pdf3farnumber3d129232,735,736,1471
5141,,yd6gkkypqaej,736,737,1473
5142,,xa1ewp_p9hej,737,738,1475
5143,,kgenpnupn2wj,738,739,1477
5144,,_bvjzacwqnij,739,740,1479
5145,,qp644dcdxsgj,740,741,1481
5146,,i34i53qjb9mj,741,742,1483
5147,,vcd2ednjrs4j,742,743,1485
5148,,qlphhc8lcj8j,743,744,1487
5149,,,744,745,1489
5150,,sen4i1hf9toj,745,746,1491
5151,,sa7tnywdhpaj,746,747,1493
5152,,kmnxgu8lngej,747,748,1495
5153,,axpibugemksj,748,749,1497
5154,,x14tk9hxi44j,749,750,1499
5155,,peb7jzqdmvkj,750,751,1501
5156,,url:http://portal.acm.org/ft_gateway.cfm3fid3d110121026type3dpdf,751,752,1503
5157,,2tuxrrssjg8j,752,753,1505
5158,,egrewwwndl8j,753,754,1507
5159,,tcx3oc9-jjij,754,755,1509
5160,,4wu7ptxrnimj,755,756,1511
5161,,9geq1clrbeuj,756,757,1513
5162,,yi03tvebykuj,757,758,1515
5163,,0pxb_vnzudsj,758,759,1517
5164,,ro0mbgz4svej,759,760,1519
5165,,a-thblsdrqqj,760,761,1521
5166,,url:http://www.csa.com/partners/viewrecord.php3frequester3dgs26collection3dtrd26recid3d8810g2c0231ec,761,762,1523
5167,,05t0i_mevbqj,762,763,1525
5168,,haigk_xi3b4j,763,764,1527
5169,,iljhdgb7flij,764,765,1529
5170,,lx3ffuqdgbcj,765,766,1531
5171,,on4hgvibekej,766,767,1533
5172,,_ntogxr-e7uj,767,768,1535
5173,,kr7-mfvqbr8j,768,769,1537
5174,,zdullb847p8j,769,770,1539
5175,,5wylqqp8yzcj,770,771,1541
5176,,4dgu1wgyoduj,771,772,1543
5177,,wcmocnj_tp0j,772,773,1545
5178,,dqijgndpshcj,773,774,1547
5179,,7znuuiir3igj,774,775,1549
5180,,wubaxvkwzk8j,775,776,1551
5181,,rr-i8bc7kxej,776,777,1553
5182,,sysstwxcsf8j,777,778,1555
5183,,ekddtpywjnkj,778,779,1557
5184,,8lyrmzx8tosj,779,780,1559
5185,,vnw-vb97r8gj,780,781,1561
5186,,5ep0lkiwzmaj,781,782,1563
5187,,o3szzzuxcx0j,782,783,1565
5188,,url:http://portal.acm.org/ft_gateway.cfm3fid3d109966726type3dpdf,783,784,1567
5189,,url:http://www.ingentaconnect.com/content/els/08830355/2001/00000035/00000002/art00020,784,785,1569
5190,,joecx3qyniyj,785,786,1571
5191,,jky3lo_oe5gj,786,787,1573
5192,,3cdcbxaq11yj,787,788,1575
5193,,bywa-yoecbqj,788,789,1577
5194,,jjhabnbyh5qj,789,790,1579
5195,,wfy4m36qftwj,790,791,1581
5196,,cixqcxoxzvuj,791,792,1583
5197,,7wr9m6i7axij,792,793,1585
5198,,rpawxzbum_oj,793,794,1587
5199,,vyf8anubccmj,794,795,1589
5200,,rhuqpae4luoj,795,796,1591
5201,,e5-ctg05dkuj,796,797,1593
5202,,5fckuag8a-gj,797,798,1595
5203,,url:http://portal.acm.org/ft_gateway.cfm3fid3d101775526type3dpdf,798,799,1597
5204,,p7ueixilqwwj,799,800,1599
5205,,3ep-8uwgbzij,800,801,1601
5206,,ultmzsoof4gj,801,802,1603
5207,,url:http://portal.acm.org/citation.cfm3fid3d354384.35454326dl3dguide26dl3dacm26type3dseries26idx3dseries31626part3dproceedings26wanttype3dproceedings26title3dinternational2520multimedia2520conference26cfid3d1111111126cftoken3d2222222,802,803,1605
5208,,cxcxcb-8z0gj,803,804,1607
5209,,sj-wndz6pxoj,804,805,1609
5210,,vdq3tmdyikej,805,806,1611
5211,,b1gs8kz09xcj,806,807,1613
5212,,awcs6gdrjhsj,807,808,1615
5213,,flaguscuio8j,808,809,1617
5214,,rzxygka_rc4j,810,811,1621
5215,,url:http://www.csa.com/partners/viewrecord.php3frequester3dgs26collection3dtrd26recid3da8622969ah,811,812,1623
5216,,cq8vyqnah3uj,812,813,1625
5217,,xlv2cdiuyq8j,813,814,1627
5218,,sbptaqgbfjcj,814,815,1629
5219,,terxluujmboj,815,816,1631
5220,,tmahmr2fbvcj,816,817,1633
5221,,acmqodgegp0j,817,818,1635
5222,,381calj3b34j,818,819,1637
5223,,url:http://portal.acm.org/ft_gateway.cfm3fid3d109967226type3dpdf,819,820,1639
5224,,url:http://portal.acm.org/ft_gateway.cfm3fid3d102759426type3dpdf,820,821,1641
5225,,jls5p7zuhp0j,821,822,1643
5226,,1a-k91qpcggj,822,823,1645
5227,,knniekshkd0j,823,824,1647
5228,,qvftp35o6gaj,824,825,1649
5229,,ybzivxfsgd8j,825,826,1651
5230,,snftnjwydwej,826,827,1653
5231,,io7hizoo6kaj,827,828,1655
5232,,ct4k09akk8uj,828,829,1657
5233,,8ql1zogttpqj,829,830,1659
5234,,cehzpbrqqgwj,830,831,1661
5235,,hbyp8kt8kroj,831,832,1663
5236,,zahfut4bkmkj,832,833,1665
5237,,1u-fxqiz6lej,833,834,1667
5238,,npjq74tquryj,834,835,1669
5239,,soyddssykfoj,836,837,1673
5240,,vq2rymykvxij,837,838,1675
5241,,twbcesst_7sj,838,839,1677
5242,,e_x6puugdyaj,839,840,1679
5243,,url:http://www.csa.com/partners/viewrecord.php3frequester3dgs26collection3dtrd26recid3d20021212029380mt26recid3da7340050ah,840,841,1681
5244,,uy8motvpkosj,842,843,1685
5245,,ceogwcjyks8j,843,844,1687
5246,,5o3uba2vizwj,844,845,1689
5247,,url:http://portal.acm.org/citation.cfm3fid3d354384.35454126dl3dguide26dl3dacm26type3dseries26idx3dseries31626part3dproceedings26wanttype3dproceedings26title3dinternational2520multimedia2520conference26cfid3d1111111126cftoken3d2222222,845,846,1691
5248,,kvycxlcno1cj,846,847,1693
5249,,maud5ijmxtkj,847,848,1695
5250,,csxe3rg0j9ij,849,850,1699
5251,,_khrton1gymj,850,851,1701
5252,,uxf537hiz0qj,851,852,1703
5253,,9wzib7weazcj,852,853,1705
5254,,ybmb2pvyutgj,853,854,1707
5255,,cadxutzhttqj,854,855,1709
5256,,yheuousc5g0j,855,856,1711
5257,,0vjt7172hiij,856,857,1713
5258,,xou3t0lqfdcj,857,858,1715
5259,,url:http://doi.wiley.com/10.1002/tl.155,858,859,1717
5260,,vet1ro-6xouj,859,860,1719
5261,,td7gubft3cqj,860,861,1721
5262,,yk4p2ndktz0j,861,862,1723
5263,,kjhpq3lcgb0j,862,863,1725
5264,,vqtl9bzyqscj,863,864,1727
5265,,fnzsp9lmtt4j,864,865,1729
5266,,kbeenni53yuj,865,866,1731
5267,,xrq-oldjzccj,866,867,1733
5268,,ngocn-0pjquj,867,868,1735
5269,,apu0iggundaj,868,869,1737
5270,,lhb5vacxzxuj,869,870,1739
5271,,vxbhdufquwyj,870,871,1741
5272,,eacfpk6x16kj,871,872,1743
5273,,29xzhod5g8cj,872,873,1745
5274,,,873,874,1747
5275,,ff0akfw7q0wj,874,875,1749
5276,,st381f-y5nsj,875,876,1751
5277,,jopsogorqnoj,876,877,1753
5278,,dsxfhd9ejkaj,877,878,1755
5279,,o94ruzbd9twj,878,879,1757
5280,,6ynkvhnxouaj,879,880,1759
5281,,mafbmthcgraj,880,881,1761
5282,,j4emrubyisij,881,882,1763
5283,,wvxxtf9byqmj,882,883,1765
5284,,bkoaxojuppqj,883,884,1767
5285,,fqfrkkspbaij,884,885,1769
5286,,1nxocdwhmrsj,885,886,1771
5287,,url:http://www.csa.com/partners/viewrecord.php3frequester3dgs26collection3dtrd26recid3d8606720238md,886,887,1773
5288,,lwvs05_lcmuj,887,888,1775
5289,,8g5mky4zkfwj,888,889,1777
5290,,ep4gxptrfucj,889,890,1779
5291,,_5isfqxn0guj,890,891,1781
5292,,sqzb6iiqvzwj,891,892,1783
5293,,oy6h0wfbz3kj,892,893,1785
5294,,_swzuva-bfgj,893,894,1787
5295,,rbp3b6jt6m4j,894,895,1789
5296,,8pgeajrtmw4j,895,896,1791
5297,,url:http://www.ingentaconnect.com/content/els/09505849/1999/00000041/00000013/art00045,896,897,1793
5298,,3uk8hebrizuj,897,898,1795
5299,,munigwfhkswj,898,899,1797
5300,,3cvyy0in8dcj,899,900,1799
5301,,mqqnwfiryc0j,900,901,1801
5302,,mqip6o4ar4sj,901,902,1803
5303,,url:http://doi.wiley.com/10.1002/bit.260140201,902,903,1805
5304,,8yf1cblhmuej,903,904,1807
5305,,fieb8mx6gkej,904,905,1809
5306,,nxad-c-f09gj,906,907,1813
5307,,ny7jfx7cm3sj,907,908,1815
5308,,af3vwgy3csmj,908,909,1817
5309,,xazk15alvoij,909,910,1819
5310,,qe0aumk0jesj,910,911,1821
5311,,u1fs1izi1gwj,911,912,1823
5312,,qfuh1wl8cuij,912,913,1825
5313,,rmqk7ftu_lyj,913,914,1827
5314,,pch6xo6vzvmj,914,915,1829
5315,,lixipxfca6ij,915,916,1831
5316,,gd1xf8qecugj,916,917,1833
5317,,qilzd_rtvp4j,918,919,1837
5318,,hnpd3p47sy0j,919,920,1839
5319,,h6vlerb3vtuj,920,921,1841
5320,,dclqkffobgij,921,922,1843
5321,,yzap-h-oummj,923,924,1847
5322,,ehefkg-bwzaj,924,925,1849
5323,,n_e95c7siuyj,925,926,1851
5324,,vo8xg3ckrj8j,926,927,1853
5325,,ohructsjo4ej,927,928,1855
5326,,gcvmmoszn0aj,928,929,1857
5327,,bnnree6mzd4j,929,930,1859
5328,,18ffg2hc51oj,930,931,1861
5329,,t-tp8ygfogyj,931,932,1863
5330,,3vqahpx_jmoj,932,933,1865
5331,,ly790rrzlqgj,933,934,1867
5332,,9x3-wbfuw_ej,934,935,1869
5333,,sgwwplug7zij,935,936,1871
5334,,vkvkeo5gqq4j,936,937,1873
5335,,56e8hetm6ncj,937,938,1875
5336,,co8xbfgwv9ej,938,939,1877
5337,,h4wtsarorrij,939,940,1879
5338,,empd6ovmmrej,940,941,1881
5339,,cw5kqp0eknwj,941,942,1883
5340,,xek-exducywj,942,943,1885
5341,,33sc_dbtmtyj,943,944,1887
5342,,u1bheyk5xhcj,944,945,1889
5343,,0t1fqcsyv-kj,945,946,1891
5344,,vujv9jqlzqsj,946,947,1893
5345,,ze-qky1wtesj,947,948,1895
5346,,7apdnjcu3zej,948,949,1897
5347,,cyi9a5rr5p8j,949,950,1899
5348,,caoblmtt-4uj,950,951,1901
5349,,9p_jhdoerzuj,951,952,1903
5350,,vfi5aqi5qyyj,952,953,1905
5351,,gcreiwuryyij,953,954,1907
5352,,url:http://doi.wiley.com/10.1002/ace.130,954,955,1909
5353,,5qg68xubnduj,955,956,1911
5354,,eeztsaee-wej,956,957,1913
5355,,eytmynikah0j,957,958,1915
5356,,,958,959,1917
5357,,xfilphdwuiuj,959,960,1919
5358,,etpiwpnt9jkj,960,961,1921
5359,,url:http://www.blackwell-synergy.com/links/doi/10.1111/j.0033-0124.1960.125_25.x/abs/,961,962,1923
5360,,qedjofwrzuij,962,963,1925
5361,,6hcdunm0ljyj,963,964,1927
5362,,olttbkx2hnoj,964,965,1929
5363,,nafy1tjsvnoj,965,966,1931
5364,,91aclf_thqwj,966,967,1933
5365,,b7e8t-gtlymj,967,968,1935
5366,,uuvn4z2rrysj,968,969,1937
5367,,nae3cw3oqcqj,969,970,1939
5368,,6duwernsehuj,970,971,1941
5369,,fzqj4sja7cyj,971,972,1943
5370,,kimwyek4lwaj,972,973,1945
5371,,wq4xv72uovkj,973,974,1947
5372,,-4lgqwnichuj,974,975,1949
5373,,wcaf1m3hrayj,975,976,1951
5374,,vivnb1ywtxij,976,977,1953
5375,,mmqjjcqz4cwj,977,978,1955
5376,,gejyu8sjnbuj,978,979,1957
5377,,u0jwdce8m34j,979,980,1959
5378,,2vdywjpbkacj,980,981,1961
5379,,4cca6h2moloj,981,982,1963
5380,,6_hn2ydy7a4j,982,983,1965
5381,,udjwhil6auaj,983,984,1967
5382,,wvs-c5_x1-4j,984,985,1969
5383,,aes4p4aylkyj,985,986,1971
5384,,m9skv4kpg9aj,986,987,1973
5385,,mcvg0-vokkyj,987,988,1975
5386,,_csti6syz_0j,988,989,1977
5387,,surm3zi6_suj,989,990,1979
5388,,eanu3sdkxawj,990,991,1981
5389,,1j2ubl0l2umj,991,992,1983
5390,,81tq2s0igycj,992,993,1985
5391,,mzfzhewxu1uj,993,994,1987
5392,,tq4bpwyoceej,994,995,1989
5393,,sds7uwo7mj4j,995,996,1991
5394,,xtniza9m2qwj,996,997,1993
5395,,z5pvdee7caaj,997,998,1995
5396,,0mu6n8a37jqj,998,999,1997
5397,,olqumdd7-gij,999,1000,1999
5398,,g7fztq8uxboj,1000,1001,2001
5399,,rimxeukcrhaj,1001,1002,2003
5400,,6r5s9wsqsoyj,1002,1003,2005
5401,,8unpfhv3twej,1003,1004,2007
5402,,8gtv1_0l3cyj,1004,1005,2009
5403,,r1u13red9k4j,1005,1006,2011
5404,,uoo_exngniaj,1006,1007,2013
5405,,zyxytw7sx_sj,1007,1008,2015
5406,,n3dmdfviasuj,1009,1010,2019
5407,,vtzzpymljxsj,1010,1011,2021
5408,,rtnojdjz1yyj,1011,1012,2023
5409,,wi44y5qxrsoj,1012,1013,2025
5410,,0vkvsssdtbaj,1013,1014,2027
5411,,poaxrc5i_kqj,1014,1015,2029
5412,,nkzcoasejymj,1015,1016,2031
5413,,q_bibkr7il8j,1016,1017,2033
5414,,rg2aex3ey7ej,1017,1018,2035
5415,,b_uvzljb32aj,1018,1019,2037
5416,,smff0gblimqj,1019,1020,2039
5417,,url:http://ieeexplore.ieee.org/iel3/3990/11481/00547880.pdf3farnumber3d547880,1020,1021,2041
5418,,4h1ww_ndfmoj,1021,1022,2043
5419,,f-_qus8wg2oj,1022,1023,2045
5420,,gcolsyek0hij,1023,1024,2047
5421,,08qu6qnmo98j,1024,1025,2049
5422,,h3tcub0jeegj,1025,1026,2051
5423,,0jupgyhoqiej,1026,1027,2053
5424,,hcqsn0m-6mcj,1027,1028,2055
5425,,i3b8iozidnoj,1028,1029,2057
5426,,gekvdbymsd0j,1029,1030,2059
5427,,url:http://www.springerlink.com/index/q56023qg66630x13.pdf,1030,1031,2061
5428,,08jahuiohq4j,1031,1032,2063
5429,,oehmzf9bdzoj,1032,1033,2065
5430,,url:http://doi.wiley.com/10.1002/ace.7705,1034,1035,2069
5431,,dfxkdjjtfsqj,1035,1036,2071
5432,,pvr5dud7-6wj,1036,1037,2073
5433,,qlsavou-zt4j,1037,1038,2075
5434,,ku3xn0cfxi4j,1038,1039,2077
5435,,xap2yvyzyrqj,1039,1040,2079
5436,,_2mju5kqovgj,1040,1041,2081
5437,,h3lizafd9cwj,1041,1042,2083
5438,,axqopycfxqqj,1043,1044,2087
5439,,4oo57rasqyij,1044,1045,2089
5440,,url:http://portal.acm.org/ft_gateway.cfm3fid3d29059526type3dpdf26dl3dguide26dl3dacm26cfid3d1111111126cftoken3d2222222,1045,1046,2091
5441,,w_x_rk2b9tgj,1046,1047,2093
5442,,lar_tyhtfcij,1047,1048,2095
5443,,3ojh_eb68dwj,1048,1049,2097
5444,,ocmei44vmuej,1049,1050,2099
5445,,zshkythuo9ej,1050,1051,2101
5446,,mhmkp-ga6-aj,1051,1052,2103
5447,,0v8e_ij2spyj,1052,1053,2105
5448,,tr2ddfl72msj,1053,1054,2107
5449,,j1nuwc8rq04j,1054,1055,2109
5450,,gfdhjcamlayj,1055,1056,2111
5451,,url:http://www.csa.com/partners/viewrecord.php3frequester3dgs26collection3dtrd26recid3dn9210538ah,1056,1057,2113
5452,,,1057,1058,2115
5453,,9jagqpcutzoj,1058,1059,2117
5454,,gruwol51acij,1059,1060,2119
5455,,lgmmein2nduj,1060,1061,2121
5456,,url:http://portal.acm.org/ft_gateway.cfm3fid3d100771626type3dpdf,1061,1062,2123
5457,,iccdsaycmk0j,1062,1063,2125
5458,,ptxxalnzcrqj,1063,1064,2127
5459,,5n7uxfvs5aaj,1064,1065,2129
5460,,utq9k8nmtmaj,1065,1066,2131
5461,,nxxsbk34szqj,1066,1067,2133
5462,,the9s0baq5gj,1067,1068,2135
5463,,wowfv5bbp2kj,1068,1069,2137
5464,,lq48fn_xy08j,1069,1070,2139
5465,,rukwuvvlwmij,1070,1071,2141
5466,,g2x6-2g3hj0j,1071,1072,2143
5467,,aatvigmnyacj,1072,1073,2145
5468,,guxm_dcwzx0j,1073,1074,2147
5469,,skrwzzpwk-qj,1074,1075,2149
5470,,s-yfhoymgloj,1075,1076,2151
5471,,rr7ezmq0fncj,1076,1077,2153
5472,,suodbuobanej,1077,1078,2155
5473,,_kh0dnrdurqj,1078,1079,2157
5474,,lw1mg77k6_uj,1079,1080,2159
5475,,uyuwwbgwc3uj,1080,1081,2161
5476,,url:http://www.ncbi.nlm.nih.gov/entrez/query.fcgi3fcmd3dretrieve26db3dpubmed26list_uids3d1565473426dopt3dcitation,1081,1082,2163
5477,,4mau9u9dv2uj,1082,1083,2165
5478,,ygeatajclagj,1083,1084,2167
5479,,lpujhzsj7pij,1084,1085,2169
5480,,yg9js5mjbv0j,1085,1086,2171
5481,,url:http://ieeexplore.ieee.org/iel5/9217/29235/01320033.pdf3farnumber3d1320033,1086,1087,2173
5482,,mb8w6em6zi8j,1087,1088,2175
5483,,ntnnyujedzej,1088,1089,2177
5484,,url:http://www.csa.com/partners/viewrecord.php3frequester3dgs26collection3dtrd26recid3dn9210530ah,1089,1090,2179
5485,,atnszrbun_gj,1090,1091,2181
5486,,atcel4je-4sj,1091,1092,2183
5487,,3lskofklsz0j,1092,1093,2185
5488,,weqditjh6vej,1093,1094,2187
5489,,y2xmhdnrdbej,1094,1095,2189
5490,,url:http://portal.acm.org/ft_gateway.cfm3fid3d109971126type3dpdf,1095,1096,2191
5491,,9qych56nctmj,1096,1097,2193
5492,,wjti1akpff0j,1097,1098,2195
5493,,o_ec3ogewnsj,1098,1099,2197
5494,,w1eiyt5bxc4j,1099,1100,2199
5495,,c60skv5nosoj,1100,1101,2201
5496,,gcbzy6m01rqj,1101,1102,2203
5497,,3pmr76sctryj,1102,1103,2205
5498,,url:http://www.springerlink.com/index/w80l2810707344m1.pdf,1103,1104,2207
5499,,,1105,1106,2211
5500,,uhvmjkskkakj,1106,1107,2213
5501,,0f-g0pj3z3uj,1107,1108,2215
5502,,q9p9vx8fjvoj,1108,1109,2217
5503,,hh77kxhcx3ij,1109,1110,2219
5504,,otbw6du0j3wj,1110,1111,2221
5505,,mdxzejmsackj,1111,1112,2223
5506,,2r4nqqseoqwj,1112,1113,2225
5507,,8ha8o2x9l2ij,1113,1114,2227
5508,,bxtxq-cas80j,1114,1115,2229
5509,,url:http://www.csa.com/partners/viewrecord.php3frequester3dgs26collection3dtrd26recid3dn9210555ah,1115,1116,2231
5510,,ipmdnpvpvwcj,1116,1117,2233
5511,,iwo70ngjjxuj,1117,1118,2235
5512,,wn2o9txudkkj,1118,1119,2237
5513,,xfvopain2nwj,1120,1121,2241
5514,,ovfbxdgb2osj,1121,1122,2243
5515,,cuc33jvbnamj,1122,1123,2245
5516,,66eti80ophij,1123,1124,2247
5517,,sobdlwdlju0j,1124,1125,2249
5518,,dvosids4tloj,1125,1126,2251
5519,,apew8vp_8xkj,1126,1127,2253
5520,,ov7qpfaqiqej,1127,1128,2255
5521,,aphjdmv_cbij,1128,1129,2257
5522,,cwage7e49gqj,1129,1130,2259
5523,,9esu1fhujwwj,1130,1131,2261
5524,,pljmitrxvxkj,1131,1132,2263
5525,,4dv7r4ck1j8j,1132,1133,2265
5526,,m5tpcxivi4gj,1133,1134,2267
5527,,des-pslvqi4j,1134,1135,2269
5528,,v5pkl7ep4nij,1135,1136,2271
5529,,quit6gignucj,1136,1137,2273
5530,,dvjqs4y6h_gj,1137,1138,2275
5531,,jidve9v5vhsj,1138,1139,2277
5532,,qwhi3dpko_aj,1139,1140,2279
5533,,duhyv8ysmiaj,1140,1141,2281
5534,,ae7u4oytu80j,1141,1142,2283
5535,,jbjklv9sqtej,1142,1143,2285
5536,,n9srhpr6yguj,1143,1144,2287
5537,,ga3paeii_kcj,1144,1145,2289
5538,,jksan1gfbr8j,1145,1146,2291
5539,,rthodofpcw4j,1146,1147,2293
5540,,j_ph0c-e4gsj,1147,1148,2295
5541,,3wn_b-yv9dsj,1148,1149,2297
5542,,fiv4inzelo8j,1149,1150,2299
5543,,qn0buasagrsj,1150,1151,2301
5544,,awwhozfiuk4j,1151,1152,2303
5545,,oi6s-rhmr4aj,1152,1153,2305
5546,,vqzsb9ps9e8j,1153,1154,2307
5547,,url:http://portal.acm.org/citation.cfm3fid3d971697.60230126dl3dguide26dl3dacm26idx3d97169726part3dperiodical26wanttype3dperiodical26title3dacm2520sigmod2520record26cfid3d1111111126cftoken3d2222222,1154,1155,2309
5548,,hruowdhbimej,1155,1156,2311
5549,,hxmhc1q2-omj,1156,1157,2313
5550,,uyzuyvgxxruj,1157,1158,2315
5551,,qeq_gzjghokj,1158,1159,2317
5552,,jksvshqfa5kj,1159,1160,2319
5553,,7sh8njv5tzoj,1160,1161,2321
5554,,viwfdmgbi2wj,1161,1162,2323
5555,,p7rnnal06fej,1162,1163,2325
5556,,z8fr00l4enkj,1163,1164,2327
5557,,wu6-kvi_33ij,1164,1165,2329
5558,,url:http://www.ingentaconnect.com/content/els/08830355/2001/00000035/00000004/art00031,1165,1166,2331
5559,,f1hm1hj0cu8j,1166,1167,2333
5560,,ohyrjvpkdfuj,1167,1168,2335
5561,,irmqwyshnasj,1168,1169,2337
5562,,z-v0uvebpvyj,1169,1170,2339
5563,,8nbzx7j7rauj,1170,1171,2341
5564,,kuqbulhm4dwj,1171,1172,2343
5565,,tjvzmx2wiroj,1172,1173,2345
5566,,ivwpclagipcj,1173,1174,2347
5567,,kpzfm1k0bvkj,1174,1175,2349
5568,,0qmmdxdlsvij,1175,1176,2351
5569,,5bigrdemosgj,1176,1177,2353
5570,,xhh0tbkf-dgj,1177,1178,2355
5571,,hm5mzygpmk8j,1178,1179,2357
5572,,tlpkpgfmmcgj,1179,1180,2359
5573,,url:http://portal.acm.org/citation.cfm3fid3d1073204.1073322,1180,1181,2361
5574,,t-p6beesghcj,1181,1182,2363
5575,,6tenhqaycqaj,1182,1183,2365
5576,,k8h1dxxmpr4j,1183,1184,2367
5577,,o6boeksbt-uj,1185,1186,2371
5578,,awiqx2xphi0j,1186,1187,2373
5579,,uvrub-0xj2kj,1187,1188,2375
5580,,url:http://www.geography.org.uk/journals/journals.asp3farticleid3d38,1188,1189,2377
5581,,epns_khxcvkj,1189,1190,2379
5582,,1scubpktvwuj,1190,1191,2381
5583,,2amnukppn6ij,1191,1192,2383
5584,,vrpncxdr7pij,1192,1193,2385
5585,,nuosnhvb3maj,1193,1194,2387
5586,,9jm6n2g8-a4j,1194,1195,2389
5587,,hulazbb0e4mj,1195,1196,2391
5588,,apz2mcugybuj,1196,1197,2393
5589,,odtls54ndu0j,1197,1198,2395
5590,,aw-fkjehdwqj,1198,1199,2397
5591,,kwyhoo5rlj8j,1199,1200,2399
5592,,edptoa1wbe0j,1200,1201,2401
5593,,h37rgyt5p-kj,1201,1202,2403
5594,,vswsmssao4sj,1202,1203,2405
5595,,itn9anhm0a8j,1203,1204,2407
5596,,cehwiuguswkj,1204,1205,2409
5597,,r4gbifrb0c4j,1205,1206,2411
5598,,,1206,1207,2413
5599,,url:http://doi.wiley.com/10.1002/ev.1311,1207,1208,2415
5600,,fnslzpfoprqj,1208,1209,2417
5601,,8cslfocw5qsj,1209,1210,2419
5602,,rd9ubunql-qj,1210,1211,2421
5603,,erurbx5tkrcj,1211,1212,2423
5604,,khjfignqh-oj,1212,1213,2425
5605,,7b9gbbvzygyj,1213,1214,2427
5606,,l94bp5i7s8gj,1214,1215,2429
5607,,kj2m_o5kvzcj,1215,1216,2431
5608,,dyloii0ska8j,1216,1217,2433
5609,,cspzx3vg0hkj,1217,1218,2435
5610,,ljertmgqu0yj,1218,1219,2437
5611,,p23sbfjoii8j,1219,1220,2439
5612,,1mugeyzttpuj,1220,1221,2441
5613,,wycqmiqwzbmj,1221,1222,2443
5614,,cth4ilmvvuoj,1222,1223,2445
5615,,udigv5q02pgj,1223,1224,2447
5616,,vb-ji9pz98aj,1224,1225,2449
5617,,url:http://www.geography.org.uk/journals/journals.asp3farticleid3d145,1225,1226,2451
5618,,lsy_rxfeddij,1226,1227,2453
5619,,pcmqnvwncbij,1227,1228,2455
5620,,f8afimazwxqj,1228,1229,2457
5621,,3-tfztnhynqj,1229,1230,2459
5622,,xcwqarsnk4gj,1230,1231,2461
5623,,kp_3cpspgp0j,1231,1232,2463
5624,,ifla7to00boj,1232,1233,2465
5625,,9nvhlqaouguj,1233,1234,2467
5626,,llrtmov18fuj,1234,1235,2469
5627,,ovq67mipmjcj,1235,1236,2471
5628,,d5qlogqjgm8j,1236,1237,2473
5629,,zz4vxtaff3aj,1237,1238,2475
5630,,s4pbzoovdaqj,1239,1240,2479
5631,,qhhzqjwsm7kj,1240,1241,2481
5632,,qwvbknwk4s4j,1241,1242,2483
5633,,vx3zhfwtz2wj,1242,1243,2485
5634,,otx-4fyuea0j,1243,1244,2487
5635,,puanui4feqmj,1244,1245,2489
5636,,gwlqx3eo0y0j,1245,1246,2491
5637,,cnypobhlx58j,1246,1247,2493
5638,,tcpqyo9xyjkj,1247,1248,2495
5639,,gcfhdpkukykj,1248,1249,2497
5640,,c38zjmkdgfkj,1249,1250,2499
5641,,fj3gbfahafij,1250,1251,2501
5642,,dr5fts35odgj,1251,1252,2503
5643,,htmo0uwgzvoj,1252,1253,2505
5644,,ddl9s4bklyqj,1253,1254,2507
5645,,wh13p1_kd2ej,1254,1255,2509
5646,,7-3wldzms7qj,1255,1256,2511
5647,,kghugoozd2mj,1256,1257,2513
5648,,twqnwr-jfmoj,1257,1258,2515
5649,,hrwz5_50g6uj,1258,1259,2517
5650,,url:http://portal.acm.org/ft_gateway.cfm3fid3d110136926type3dpdf,1259,1260,2519
5651,,tp1dh6ec-6sj,1260,1261,2521
5652,,c8cojhakhhgj,1261,1262,2523
5653,,cyuxbylp32mj,1262,1263,2525
5654,,lak6fu5r9psj,1263,1264,2527
5655,,t988dy3zkdsj,1264,1265,2529
5656,,a7n-vcbqytsj,1265,1266,2531
5657,,jhvwab3p4zij,1266,1267,2533
5658,,f7zgbwockwyj,1267,1268,2535
5659,,prjqxqxisakj,1268,1269,2537
5660,,url:http://www.springerlink.com/index/b54rx62855483632.pdf,1269,1270,2539
5661,,fesym2dcwwuj,1270,1271,2541
5662,,ozd-0cszgo0j,1271,1272,2543
5663,,6my_ffzghtgj,1272,1273,2545
5664,,8sohtsogrycj,1273,1274,2547
5665,,6mblyheflygj,1274,1275,2549
5666,,fj7b9icfvxsj,1275,1276,2551
5667,,npryz1nlm4ij,1276,1277,2553
5668,,y6aado-vas0j,1277,1278,2555
5669,,qxtutp078_gj,1278,1279,2557
5670,,ljgwndt3-i4j,1279,1280,2559
5671,,6yvk3zcq5b4j,1280,1281,2561
5672,,oitlmxstj3wj,1281,1282,2563
5673,,url:http://www.csa.com/partners/viewrecord.php3frequester3dgs26collection3dtrd26recid3da7423811ah,1282,1283,2565
5674,,5mqeicsxuemj,1283,1284,2567
5675,,vzafqh1cr00j,1284,1285,2569
5676,,qad3ql5atwuj,1285,1286,2571
5677,,mbxw3ll2rc0j,1286,1287,2573
5678,,lmo4h0gdnkoj,1287,1288,2575
5679,,2bsk1lpncqmj,1288,1289,2577
5680,,2eenq89t2x8j,1289,1290,2579
5681,,8fzoclkcencj,1290,1291,2581
5682,,mh0xy3h8ulcj,1291,1292,2583
5683,,uwgrgxwwctuj,1292,1293,2585
5684,,vhe8b68mrz4j,1293,1294,2587
5685,,qfeufn2qs5ej,1294,1295,2589
5686,,sbvw6g1edskj,1295,1296,2591
5687,,jz0lp45it_sj,1296,1297,2593
5688,,gjek8wl0sxsj,1297,1298,2595
5689,,svgll6z7tjyj,1298,1299,2597
5690,,url:http://portal.acm.org/ft_gateway.cfm3fid3d109963626type3dpdf,1299,1300,2599
5691,,6-t8upzxseqj,1300,1301,2601
5692,,zpowg176gryj,1301,1302,2603
5693,,09tuw2my7msj,1302,1303,2605
5694,,1hwywub6m50j,1303,1304,2607
5695,,g65ptwbowhgj,1304,1305,2609
5696,,npijmh5dmsqj,1305,1306,2611
5697,,v0batc6mh64j,1306,1307,2613
5698,,jvgbocqfd04j,1307,1308,2615
5699,,url:http://www.springerlink.com/index/q78x31366106t7x5.pdf,1308,1309,2617
5700,,0-sh4h6sx-yj,1309,1310,2619
5701,,lmsudm2cxiaj,1310,1311,2621
5702,,-8imqjbbhcmj,1312,1313,2625
5703,,lbwbrvuok1yj,1313,1314,2627
5704,,43cfe2_upyij,1314,1315,2629
5705,,du5_el3mygaj,1315,1316,2631
5706,,4yz_4fnxacsj,1316,1317,2633
5707,,5fscsdtnlygj,1317,1318,2635
5708,,kh5shrcmkjcj,1318,1319,2637
5709,,zf0wxtath28j,1319,1320,2639
5710,,5qkowlzahvqj,1320,1321,2641
5711,,on4c3fewceoj,1321,1322,2643
5712,,xni0p7c1esmj,1322,1323,2645
5713,,dmgxu3c4o2uj,1323,1324,2647
5714,,_w2zvj-6vsaj,1324,1325,2649
5715,,kni3oos0uyij,1325,1326,2651
5716,,ufqoim9ee0kj,1326,1327,2653
5717,,hswgrvtwh5wj,1327,1328,2655
5718,,i_x6vhw8nzkj,1328,1329,2657
5719,,ye64txcja3kj,1329,1330,2659
5720,,k8jj7bgn3_4j,1330,1331,2661
5721,,zxwsa-bvjraj,1331,1332,2663
5722,,4p5iyri-tngj,1332,1333,2665
5723,,4joho5h0uucj,1333,1334,2667
5724,,y4arokcdi2ej,1334,1335,2669
5725,,abkmvt_ytfqj,1335,1336,2671
5726,,url:http://journals.iucr.org/c/issues/1998/01/00/ta1185/ta1185.pdf,1336,1337,2673
5727,,6xazkga_aewj,1337,1338,2675
5728,,f0wrdgmo1gaj,1338,1339,2677
5729,,k4kypk9f5jij,1339,1340,2679
5730,,wbafcnjcclcj,1340,1341,2681
5731,,h70drnedccyj,1341,1342,2683
5732,,81k1fo8it-gj,1342,1343,2685
5733,,nf4-jhg6-iuj,1343,1344,2687
5734,,24ywcdkvtoaj,1344,1345,2689
5735,,4whlolkvcs8j,1345,1346,2691
5736,,jn_ywgbfgykj,1346,1347,2693
5737,,fhj4q2ymls8j,1347,1348,2695
5738,,8obrgoa2pbmj,1348,1349,2697
5739,,t3d0ejozfpcj,1349,1350,2699
5740,,dxqjkjjwn1yj,1350,1351,2701
5741,,4yp1eneqht8j,1351,1352,2703
5742,,jiq9_nrdbw0j,1352,1353,2705
5743,,bmi9lvwp7qyj,1353,1354,2707
5744,,cqhyzqempzsj,1354,1355,2709
5745,,okcdpzsz7x8j,1355,1356,2711
5746,,iwhwgrtfm8aj,1356,1357,2713
5747,,rlnjco_98wwj,1357,1358,2715
5748,,u-moyjdyzqij,1358,1359,2717
5749,,url:http://www.csa.com/partners/viewrecord.php3frequester3dgs26collection3dtrd26recid3dn9210572ah,1359,1360,2719
5750,,zc15-wrsmswj,1360,1361,2721
5751,,h7ppg2rnm4yj,1361,1362,2723
5752,,txia-wva-hgj,1362,1363,2725
5753,,nn8a0rhnbfaj,1363,1364,2727
5754,,,1365,1366,2731
5755,,7yobdpjqhv0j,1366,1367,2733
5756,,ug0wsufcymij,1367,1368,2735
5757,,fz9ezdqfajsj,1368,1369,2737
5758,,m4bf2usi6cyj,1369,1370,2739
5759,,bug9s2llxaoj,1370,1371,2741
5760,,kweir421vr8j,1371,1372,2743
5761,,q0-yvzoum30j,1372,1373,2745
5762,,a216rfg4xeaj,1373,1374,2747
5763,,zdgb_z7mid4j,1374,1375,2749
5764,,mkods8hfvfaj,1375,1376,2751
5765,,cdolak6_4a8j,1376,1377,2753
5766,,dpcw8yqophkj,1377,1378,2755
5767,,6ivdh8wzmcsj,1378,1379,2757
5768,,cyzjrhjbibsj,1379,1380,2759
5769,,9jbtxn0k8mmj,1380,1381,2761
5770,,fracd0jywa8j,1381,1382,2763
5771,,vgiu-e-qtwkj,1382,1383,2765
5772,,1utkwaif27ij,1383,1384,2767
5773,,njviso7v6qij,1384,1385,2769
5774,,t4cmsei8gjcj,1385,1386,2771
5775,,lxvogvof4-4j,1386,1387,2773
5776,,xb_iaumwc_aj,1387,1388,2775
5777,,wdy8sdutjykj,1388,1389,2777
5778,,mu6zpjwhtcej,1389,1390,2779
5779,,i-ifpovbkfaj,1390,1391,2781
5780,,w0prxdqd7lkj,1391,1392,2783
5781,,fw97feiob_uj,1392,1393,2785
5782,,0jiaj3pxnakj,1393,1394,2787
5783,,xq97bcd6z2ij,1394,1395,2789
5784,,jp4qx5pfykoj,1395,1396,2791
5785,,_-fkvdrzrxej,1397,1398,2795
5786,,iws7dfgycyej,1398,1399,2797
5787,,fc2vyo3yrroj,1399,1400,2799
5788,,e_7quwf30m8j,1400,1401,2801
5789,,5pb8x5twiz8j,1401,1402,2803
5790,,kkiu3tkybmwj,1402,1403,2805
5791,,uylkjk2i3_uj,1403,1404,2807
5792,,zdtqndpb26mj,1404,1405,2809
5793,,illgaic6ddoj,1405,1406,2811
5794,,n-esas4s9xcj,1406,1407,2813
5795,,cg3zydxdqacj,1407,1408,2815
5796,,6-iy6vuwchqj,1408,1409,2817
5797,,url:http://www.csa.com/partners/viewrecord.php3frequester3dgs26collection3dtrd26recid3d0309614ci,1409,1410,2819
5798,,nkkmkd_5jwwj,1410,1411,2821
5799,,k5kwc1ckmrwj,1411,1412,2823
5800,,nnmsydj0rtoj,1412,1413,2825
5801,,28pigg7owc0j,1413,1414,2827
5802,,fhz-icempfoj,1414,1415,2829
5803,,dwfktnbxho4j,1415,1416,2831
5804,,shwurjmdtqyj,1416,1417,2833
5805,,zqhlwuwx0ccj,1417,1418,2835
5806,,v2n_id_y3r4j,1418,1419,2837
5807,,pjqqeevgawsj,1419,1420,2839
5808,,3spaa09dcdwj,1420,1421,2841
5809,,f8ef0cot0h8j,1421,1422,2843
5810,,dp4pntlwwcgj,1422,1423,2845
5811,,jsusizvjmnwj,1423,1424,2847
5812,,8ixsp2rxmgcj,1424,1425,2849
5813,,hpodixgcfhej,1425,1426,2851
5814,,_fnrqsd-huej,1426,1427,2853
5815,,galnpb9s1ewj,1427,1428,2855
5816,,rpfhn-oujpcj,1428,1429,2857
5817,,l7kc1qg6ogej,1429,1430,2859
5818,,,1430,1431,2861
5819,,e0m02a57qmij,1431,1432,2863
5820,,wqzidzzs09oj,1432,1433,2865
5821,,kp45bofncmoj,1433,1434,2867
5822,,klsxet7gkckj,1434,1435,2869
5823,,1j81txjmzoaj,1435,1436,2871
5824,,url:http://www.csa.com/partners/viewrecord.php3frequester3dgs26collection3denv26recid3d8913246,1436,1437,2873
5825,,c5fzxohpes0j,1437,1438,2875
5826,,fphjuoyja8kj,1438,1439,2877
5827,,qm9qatozdpuj,1439,1440,2879
5828,,rtmpvz4_bxmj,1440,1441,2881
5829,,zgvc_svbejaj,1441,1442,2883
5830,,xmmjeuyay4uj,1442,1443,2885
5831,,vib3uvvcersj,1443,1444,2887
5832,,epyrt6tr3l0j,1444,1445,2889
5833,,afwoq4jfrbgj,1445,1446,2891
5834,,x8eem-e3ircj,1446,1447,2893
5835,,lldgcdzszzuj,1447,1448,2895
5836,,rmfk2zwkuagj,1448,1449,2897
5837,,li1oratovngj,1449,1450,2899
5838,,oacfelqmw0cj,1450,1451,2901
5839,,el_iocbjhjyj,1451,1452,2903
5840,,2yxnwqy2wx4j,1452,1453,2905
5841,,fhnl-_uusxyj,1453,1454,2907
5842,,umlcbelxsoaj,1454,1455,2909
5843,,okbw-pfidhqj,1455,1456,2911
5844,,rai0frcm6xkj,1457,1458,2915
5845,,vp7eqvltbauj,1458,1459,2917
5846,,bnkp_mxjtpcj,1459,1460,2919
5847,,yhu9xlgww1kj,1460,1461,2921
5848,,i0kbb-n-ef8j,1461,1462,2923
5849,,9helch8mlfij,1462,1463,2925
5850,,_jmdbouk7j0j,1463,1464,2927
5851,,qmgmqih7_gij,1464,1465,2929
5852,,a-jbsi9num8j,1465,1466,2931
5853,,xswljn64eh4j,1466,1467,2933
5854,,_09-ce4h5bkj,1467,1468,2935
5855,,mumcljidaboj,1468,1469,2937
5856,,p18-svleqvej,1469,1470,2939
5857,,m3qkdcefirmj,1470,1471,2941
5858,,plwvbdnfcamj,1471,1472,2943
5859,,lpuertjd6dqj,1472,1473,2945
5860,,oqbrharxinaj,1473,1474,2947
5861,,lbhdtfakdpqj,1474,1475,2949
5862,,8ymbnjpnb_wj,1475,1476,2951
5863,,6vofhwyqpqwj,1476,1477,2953
5864,,dypuuc_4qraj,1477,1478,2955
5865,,8-rnrc2bj8oj,1478,1479,2957
5866,,zya3qdsvgygj,1479,1480,2959
5867,,v5fyzzeycryj,1480,1481,2961
5868,,s5xmayyfojsj,1481,1482,2963
5869,,b-ugy5zb0z4j,1482,1483,2965
5870,,qgdyjio3tbaj,1483,1484,2967
5871,,qk9bmzw3otgj,1484,1485,2969
5872,,krm_iqczlwsj,1485,1486,2971
5873,,33grxq1frbaj,1486,1487,2973
5874,,mdwubezm8jyj,1487,1488,2975
5875,,sukwplzhehmj,1488,1489,2977
5876,,9cybwyoqlaoj,1489,1490,2979
5877,,ntgwxfmvscyj,1490,1491,2981
5878,,uqmv53py38ej,1491,1492,2983
5879,,rxwzpunv4kmj,1492,1493,2985
5880,,url:http://www.csa.com/partners/viewrecord.php3frequester3dgs26collection3dtrd26recid3dn9210489ah,1493,1494,2987
5881,,uvsqo1tb5bkj,1494,1495,2989
5882,,__yo1ce_akcj,1495,1496,2991
5883,,ky07xq_woq4j,1496,1497,2993
5884,,zu1rt16mpjcj,1497,1498,2995
5885,,8rf9ihgvpquj,1499,1500,2999
5886,,xjpduaqd1pkj,1500,1501,3001
5887,,oh83tkzdt4cj,1501,1502,3003
5888,,xegkiffqc_ej,1502,1503,3005
5889,,dmfifea9jimj,1503,1504,3007
5890,,iej0ympcpiqj,1504,1505,3009
5891,,6gwmptehvosj,1505,1506,3011
5892,,5mbqs0-rzbij,1506,1507,3013
5893,,ct4dwcysbc4j,1507,1508,3015
5894,,uf4ikz6bd_ij,1508,1509,3017
5895,,fj0oabpbfuaj,1509,1510,3019
5896,,xtfcz806wqej,1510,1511,3021
5897,,k-hgzqinr1qj,1511,1512,3023
5898,,8qxuw67wq8sj,1512,1513,3025
5899,,cmnhuozf5jaj,1513,1514,3027
5900,,k31wzjvyvgwj,1514,1515,3029
5901,,gmemjz97hzuj,1515,1516,3031
5902,,opmpa2fjelwj,1516,1517,3033
5903,,vyp0myw6iosj,1517,1518,3035
5904,,iaolraqtwmej,1518,1519,3037
5905,,hmiklqovefoj,1519,1520,3039
5906,,wkewby_uqxij,1520,1521,3041
5907,,wk5tramjbwej,1521,1522,3043
5908,,h182qsvlt7oj,1522,1523,3045
5909,,sikkssdji1uj,1523,1524,3047
5910,,8iqiboimnnmj,1524,1525,3049
5911,,ce-udbze15sj,1525,1526,3051
5912,,p2g7w3hjackj,1526,1527,3053
5913,,i7biiwltsmej,1527,1528,3055
5914,,xv-acm6j6wwj,1528,1529,3057
5915,,cpif8tgftpgj,1529,1530,3059
5916,,wrf6lxze-kij,1530,1531,3061
5917,,mfbnuescdbqj,1531,1532,3063
5918,,3fjosz6ktwmj,1532,1533,3065
5919,,osmocalkokcj,1534,1535,3069
5920,,62ilwgoowycj,1535,1536,3071
5921,,66yainqq000j,1536,1537,3073
5922,,wwdbnahl3omj,1537,1538,3075
5923,,b7bz0zxdzqqj,1538,1539,3077
5924,,9kdx96gzdjgj,1539,1540,3079
5925,,ikgd2xg9fhcj,1540,1541,3081
5926,,qmlj0zlhghij,1541,1542,3083
5927,,rb-uealhmdej,1542,1543,3085
5928,,i9zeycz7zagj,1543,1544,3087
5929,,qljig-4ahluj,1544,1545,3089
5930,,axxdtek9q7ij,1545,1546,3091
5931,,f_4ixnytjsqj,1547,1548,3095
5932,,u_kmk6sdsfoj,1548,1549,3097
5933,,5cafgmhl5gkj,1549,1550,3099
5934,,vye8zgnnq5mj,1550,1551,3101
5935,,lim-c8z1u6cj,1551,1552,3103
5936,,5-eztabfyb8j,1553,1554,3107
5937,,o6fer2uwriij,1554,1555,3109
5938,,rmtegxaxhkij,1555,1556,3111
5939,,f60e8vo9qm0j,1556,1557,3113
5940,,beuevcudgmmj,1557,1558,3115
5941,,pvc77suc7roj,1558,1559,3117
5942,,nmewvrpplnsj,1559,1560,3119
5943,,k_boktxthvsj,1560,1561,3121
5944,,g0fowyluk-cj,1561,1562,3123
5945,,8narhnbhofmj,1562,1563,3125
5946,,mh3s3e7-hhgj,1563,1564,3127
5947,,dtygwxv48dsj,1564,1565,3129
5948,,rtxud8p2z6yj,1565,1566,3131
5949,,cvsxo8nt76gj,1566,1567,3133
5950,,a6pekw0uljgj,1567,1568,3135
5951,,a8piclxiztij,1568,1569,3137
5952,,pz4bpuwthaqj,1570,1571,3141
5953,,iv5zacqcl0cj,1571,1572,3143
5954,,rfoidq1yw1kj,1572,1573,3145
5955,,url:http://www.csa.com/partners/viewrecord.php3frequester3dgs26collection3dtrd26recid3dn9210432ah,1573,1574,3147
5956,,p1ja2vegxcej,1574,1575,3149
5957,,dgzp6stwvvyj,1575,1576,3151
5958,,url:http://portal.acm.org/ft_gateway.cfm3fid3d110120026type3dpdf,1576,1577,3153
5959,,rdvttu9dzcyj,1577,1578,3155
5960,,oclahkchimqj,1578,1579,3157
5961,,iu5gdskx0hmj,1579,1580,3159
5962,,url:http://doi.wiley.com/10.1002/ev.1617,1580,1581,3161
5963,,keamnbgzuquj,1581,1582,3163
5964,,di2svw1etcoj,1582,1583,3165
5965,,kpj2nagze6oj,1583,1584,3167
5966,,twgkfvel0ugj,1584,1585,3169
5967,,ypiwiw0dxtej,1585,1586,3171
5968,,onu8i3kheeoj,1586,1587,3173
5969,,rynpxmojymmj,1587,1588,3175
5970,,gm2frrpevcyj,1588,1589,3177
5971,,1crxpyjmct8j,1589,1590,3179
5972,,3znslb-uh3cj,1590,1591,3181
5973,,beti2eiivamj,1591,1592,3183
5974,,nngjsmkscz4j,1592,1593,3185
5975,,km9czijawjkj,1593,1594,3187
5976,,9qfo-thslh8j,1595,1596,3191
5977,,hw3xs4bkenyj,1596,1597,3193
5978,,kwlo8n7audwj,1597,1598,3195
5979,,uej7wqr17wij,1598,1599,3197
5980,,2zr6riajxzij,1599,1600,3199
5981,,trrbs19rxpcj,1600,1601,3201
5982,,i4igqtopegwj,1601,1602,3203
5983,,rb9-jquv19yj,1602,1603,3205
5984,,url:http://www.geography.org.uk/journals/journals.asp3farticleid3d43,1603,1604,3207
5985,,bs1etbv7gcsj,1604,1605,3209
5986,,mh2lc6l9gwaj,1605,1606,3211
5987,,8b-ky_3fxlkj,1606,1607,3213
5988,,kdu3i-vb5ukj,1607,1608,3215
5989,,vp2wiw9vcvgj,1608,1609,3217
5990,,v7bxbxllrj4j,1609,1610,3219
5991,,d0z0bdnbnfcj,1610,1611,3221
5992,,fkn1cmyi7ocj,1611,1612,3223
5993,,xe8bm1yiqdij,1612,1613,3225
5994,,cvyk-3v6njgj,1613,1614,3227
5995,,w_oxiq-br70j,1614,1615,3229
5996,,tgs5i-le_guj,1615,1616,3231
5997,,ndogkin6uckj,1616,1617,3233
5998,,qz8imlm7dwcj,1617,1618,3235
5999,,hswdgziwxo8j,1618,1619,3237
6000,,48ypkagekisj,1619,1620,3239
6001,,_7wlvev8c4wj,1620,1621,3241
6002,,6dxsdexq1raj,1621,1622,3243
6003,,url:http://portal.acm.org/citation.cfm3fid3d197206.197257,1622,1623,3245
6004,,ayskls2x6woj,1623,1624,3247
6005,,hr4lhaxvy3cj,1624,1625,3249
6006,,twf4pc7i7yoj,1625,1626,3251
6007,,qkksmn9z_4uj,1626,1627,3253
6008,,oycwmhbxjyej,1627,1628,3255
6009,,ukw2dj7rrcmj,1628,1629,3257
6010,,j84yor_tmaej,1629,1630,3259
6011,,bnkoxughdkqj,1630,1631,3261
6012,,nwvtugxiieij,1631,1632,3263
6013,,cjgzdpvwqoij,1632,1633,3265
6014,,oeyjrz6sowuj,1633,1634,3267
6015,,vafph9wkmw0j,1634,1635,3269
6016,,url:http://www.csa.com/partners/viewrecord.php3frequester3dgs26collection3dtrd26recid3dn9210416ah,1635,1636,3271
6017,,hg1sjgdghtcj,1636,1637,3273
6018,,cpdbnmmwwb8j,1637,1638,3275
6019,,smyqexgnsuaj,1638,1639,3277
6020,,tbajbqfoc1mj,1639,1640,3279
6021,,k9dmc387oowj,1640,1641,3281
6022,,1aqgv8sibhwj,1641,1642,3283
6023,,ikytm4fi95gj,1642,1643,3285
6024,,fzgpvqtxneuj,1643,1644,3287
6025,,url:http://portal.acm.org/citation.cfm3fid3d902482,1644,1645,3289
6026,,ct1xlnoiegej,1645,1646,3291
6027,,dfoqjzmghagj,1646,1647,3293
6028,,mz5gby52tqkj,1647,1648,3295
6029,,mnqlc3rxq2kj,1648,1649,3297
6030,,bvdwvlc1ozej,1649,1650,3299
6031,,o4ysjroxvmuj,1650,1651,3301
6032,,brf9qq0jrf8j,1651,1652,3303
6033,,u5x62kk1yu4j,1652,1653,3305
6034,,j9jqfg3qz00j,1653,1654,3307
6035,,umkuy4dfvjkj,1654,1655,3309
6036,,23qwszc7vecj,1655,1656,3311
6037,,ehv3m64jj0cj,1656,1657,3313
6038,,by-kw6s719mj,1657,1658,3315
6039,,mihktyyokhgj,1658,1659,3317
6040,,v03zvnvqwfwj,1659,1660,3319
6041,,zozd1mqst5ej,1660,1661,3321
6042,,k9u2qdlbw0uj,1661,1662,3323
6043,,dv4du7iis40j,1662,1663,3325
6044,,6n2-0xojwv4j,1663,1664,3327
6045,,ytj_bll8yrej,1664,1665,3329
6046,,o8rntnfeivoj,1665,1666,3331
6047,,msurywwjniyj,1666,1667,3333
6048,,cw8_jvuxhrmj,1667,1668,3335
6049,,6e-kt3bmgeoj,1668,1669,3337
6050,,55uod0-9_oej,1669,1670,3339
6051,,5nwaws0ispwj,1670,1671,3341
6052,,dlaojwwn5zsj,1671,1672,3343
6053,,hykelbalwo8j,1672,1673,3345
6054,,url:http://portal.acm.org/ft_gateway.cfm3fid3d109956526type3dpdf,1673,1674,3347
6055,,nkzp0bscrwij,1674,1675,3349
6056,,dg6umul5c0wj,1675,1676,3351
6057,,url:http://portal.acm.org/citation.cfm3fid3d192593.19741426dl3dportal26dl3dacm26type3dseries26idx3d19259326part3dproceedings26wanttype3dproceedings26title3dinternational2520multimedia2520conference26cfid3d1111111126cftoken3d2222222,1676,1677,3353
6058,,enu_kg3zbxmj,1677,1678,3355
6059,,enut75mqk8sj,1678,1679,3357
6060,,url:http://www.csa.com/partners/viewrecord.php3frequester3dgs26collection3dtrd26recid3da8622980ah,1679,1680,3359
6061,,e5hyqf3hqaqj,1680,1681,3361
6062,,3vwis1_4db0j,1682,1683,3365
6063,,gyc0d8ojbqmj,1683,1684,3367
6064,,uz2ifedrceqj,1684,1685,3369
6065,,49djlx2s2jmj,1685,1686,3371
6066,,papzmte9kfuj,1686,1687,3373
6067,,dsf-ukhbe64j,1687,1688,3375
6068,,mi0eqxwtuwej,1688,1689,3377
6069,,iw7fjpahuyej,1689,1690,3379
6070,,hhit1o-yjjwj,1690,1691,3381
6071,,l3hn9qhhcxij,1691,1692,3383
6072,,zgytjqgvd2cj,1692,1693,3385
6073,,fjv_dyxzz9mj,1693,1694,3387
6074,,c5qxysfk-3kj,1694,1695,3389
6075,,zml3wojc7uaj,1695,1696,3391
6076,,8quyl3yqdq4j,1696,1697,3393
6077,,hqfhxhghyesj,1697,1698,3395
6078,,fgwp0k0eygqj,1698,1699,3397
6079,,,1699,1700,3399
6080,,vw5yzgwajh4j,1700,1701,3401
6081,,ahqd_gq0dcyj,1701,1702,3403
6082,,nquvnqb6l8yj,1702,1703,3405
6083,,pev4dq_ec2ej,1703,1704,3407
6084,,g4n691ayoymj,1704,1705,3409
6085,,1vwlrxw3nsmj,1705,1706,3411
6086,,yctpdasm30oj,1706,1707,3413
6087,,qxdwplcq6hsj,1707,1708,3415
6088,,l8rv43k3yamj,1708,1709,3417
6089,,qdkkrktpk-0j,1709,1710,3419
6090,,flbdlqqyoasj,1710,1711,3421
6091,,t4pya3exawqj,1711,1712,3423
6092,,xzt1kisqpd8j,1712,1713,3425
6093,,nemocwbwicmj,1713,1714,3427
6094,,rvbhwiscrlqj,1714,1715,3429
6095,,xv2g0dpwclsj,1715,1716,3431
6096,,u4gx7mjfjhoj,1716,1717,3433
6097,,iuqv1mkkwqyj,1717,1718,3435
6098,,url:http://portal.acm.org/citation.cfm3fid3d582250.582269,1718,1719,3437
6099,,ryyvz4-sdemj,1719,1720,3439
6100,,l8cy7c4a9csj,1720,1721,3441
6101,,3-ncqnplrruj,1721,1722,3443
6102,,t6immpserz8j,1722,1723,3445
6103,,udanr9pedmwj,1723,1724,3447
6104,,5-bc0rnzzlgj,1724,1725,3449
6105,,fzniaq4apmkj,1725,1726,3451
6106,,cukc0xldil0j,1726,1727,3453
6107,,qxb1zk4bh4kj,1727,1728,3455
6108,,vsbql2qbf8uj,1728,1729,3457
6109,,fszckdmw9xsj,1729,1730,3459
6110,,fyxytm4hihuj,1730,1731,3461
6111,,tj0zcmafkwqj,1731,1732,3463
6112,,samffl98cvuj,1732,1733,3465
6113,,qy85ipvmhl0j,1733,1734,3467
6114,,0qcblsolmmej,1734,1735,3469
6115,,frrqkhz98caj,1735,1736,3471
6116,,tuatqtbl0kej,1736,1737,3473
6117,,wcq8m2arc7oj,1737,1738,3475
6118,,v8dxbbqaylgj,1738,1739,3477
6119,,zb_u0fz5q68j,1740,1741,3481
6120,,0mbw4mfpey4j,1741,1742,3483
6121,,bi68bm0miqkj,1742,1743,3485
6122,,url:http://doi.wiley.com/10.1002/ev.1263,1743,1744,3487
6123,,hf6d0-swspcj,1744,1745,3489
6124,,lqnxsklnywkj,1745,1746,3491
6125,,du_1aueqatij,1746,1747,3493
6126,,u4jddk_jzryj,1747,1748,3495
6127,,bcszmiskgtqj,1748,1749,3497
6128,,cssetsukg3oj,1749,1750,3499
6129,,4parjti6ybcj,1750,1751,3501
6130,,8j28deouckqj,1751,1752,3503
6131,,hiwjlbl108qj,1752,1753,3505
6132,,6zpxck0skjwj,1753,1754,3507
6133,,fsmeffr2wiwj,1754,1755,3509
6134,,j4y2gx7rwg0j,1756,1757,3513
6135,,url:http://portal.acm.org/citation.cfm3fid3d192593.19742726dl3dguide26dl3dacm26type3dseries26idx3d19259326part3dproceedings26wanttype3dproceedings26title3dinternational2520multimedia2520conference26cfid3d1111111126cftoken3d2222222,1757,1758,3515
6136,,vebgn92r1v4j,1758,1759,3517
6137,,yzgs3xp4n2cj,1759,1760,3519
6138,,_dw16ur5rzgj,1760,1761,3521
6139,,pznajpzld7cj,1761,1762,3523
6140,,1ysuocyiwawj,1762,1763,3525
6141,,gxgcdpuctgwj,1763,1764,3527
6142,,8vrqllwv-6oj,1764,1765,3529
6143,,tiywapvcnscj,1765,1766,3531
6144,,k7ps5x3brhsj,1766,1767,3533
6145,,fbkxsuuplnsj,1767,1768,3535
6146,,url:http://www.csa.com/partners/viewrecord.php3frequester3dgs26collection3dtrd26recid3dn9210385ah,1768,1769,3537
6147,,sfjznjjom-wj,1769,1770,3539
6148,,8widxbd-hrgj,1770,1771,3541
6149,,eudlhkzqpv4j,1771,1772,3543
6150,,url:http://www.csa.com/partners/viewrecord.php3frequester3dgs26collection3dtrd26recid3d200131005367ce,1772,1773,3545
6151,,url:http://portal.acm.org/ft_gateway.cfm3fid3d110196026type3dpdf,1773,1774,3547
6152,,v9n_jr2savqj,1774,1775,3549
6153,,15pso-bn_kyj,1775,1776,3551
6154,,ihlybsp29a0j,1776,1777,3553
6155,,s070x0bxncqj,1777,1778,3555
6156,,url:http://portal.acm.org/ft_gateway.cfm3fid3d102758826type3dpdf,1778,1779,3557
6157,,g2wvj3ygg_qj,1779,1780,3559
6158,,1gkwfbgpmwkj,1780,1781,3561
6159,,dab0a105jokj,1781,1782,3563
6160,,rwhfltploquj,1782,1783,3565
6161,,iujijneg508j,1783,1784,3567
6162,,lmxii4fb9vgj,1784,1785,3569
6163,,zdsdi-cnw2ij,1785,1786,3571
6164,,,1786,1787,3573
6165,,t3mkdwwmnl8j,1787,1788,3575
6166,,aczo57lf-4sj,1788,1789,3577
6167,,7iu-jfdvezqj,1789,1790,3579
6168,,oi8cxkfvq2mj,1790,1791,3581
6169,,vek_d378fb4j,1791,1792,3583
6170,,r58_pt-og78j,1792,1793,3585
6171,,url:http://www.csa.com/partners/viewrecord.php3frequester3dgs26collection3denv26recid3d8913265,1793,1794,3587
6172,,6alqwzxngsqj,1794,1795,3589
6173,,rpblr1nytsgj,1795,1796,3591
6174,,m40hrn_jlt8j,1796,1797,3593
6175,,1buznx9y9sij,1797,1798,3595
6176,,hor3-kekg1yj,1798,1799,3597
6177,,slkormr8opaj,1799,1800,3599
6178,,url:http://doi.wiley.com/10.1002/ace.168,1800,1801,3601
6179,,hd0dj1eusvij,1801,1802,3603
6180,,1yu4fwhivmqj,1802,1803,3605
6181,,url:http://portal.acm.org/citation.cfm3fid3d34347.34350,1803,1804,3607
6182,,ukqdpowpodgj,1804,1805,3609
6183,,5geyoixmhgkj,1805,1806,3611
6184,,ibzyrqsd-osj,1807,1808,3615
6185,,9wtjvlqshc8j,1808,1809,3617
6186,,v1dc_djmwcuj,1809,1810,3619
6187,,xnnnbierdqij,1810,1811,3621
6188,,mchh635sj-0j,1811,1812,3623
6189,,,1812,1813,3625
6190,,qjhzy4ueg7gj,1813,1814,3627
6191,,vzcz-ux6h7uj,1814,1815,3629
6192,,0awbuvvgaq8j,1815,1816,3631
6193,,kdhzwvr5z-ej,1816,1817,3633
6194,,rnmbv4e85pmj,1817,1818,3635
6195,,jro_hzijhaqj,1818,1819,3637
6196,,url:http://doi.wiley.com/10.1002/tl.170,1819,1820,3639
6197,,rryvv2hxrgcj,1821,1822,3643
6198,,7d0uz-s1o2qj,1822,1823,3645
6199,,gasia6hk1hyj,1823,1824,3647
6200,,jawgg4onw0sj,1824,1825,3649
6201,,zt5nzszfs1ej,1825,1826,3651
6202,,tlkdh9getvyj,1826,1827,3653
6203,,url:http://www.springerlink.com/index/rv67p1j713229350.pdf,1827,1828,3655
6204,,2sbrzw-nfx8j,1828,1829,3657
6205,,swiszcwftokj,1829,1830,3659
6206,,n6obfqputksj,1830,1831,3661
6207,,huglydaafpaj,1831,1832,3663
6208,,htkjszxbqm0j,1832,1833,3665
6209,,2eq2oc2bdnsj,1833,1834,3667
6210,,aznvuk7hryqj,1834,1835,3669
6211,,movkwmzffpkj,1835,1836,3671
6212,,sh-e7oorhvmj,1836,1837,3673
6213,,kxvolqccuvij,1837,1838,3675
6214,,a9ikyomridsj,1838,1839,3677
6215,,sx3ksdg3njwj,1839,1840,3679
6216,,kgwtl6jkqd4j,1841,1842,3683
6217,,8nbqws6fadmj,1842,1843,3685
6218,,rhrvvudjg2yj,1843,1844,3687
6219,,1akmdtkxufaj,1844,1845,3689
6220,,url:http://portal.acm.org/ft_gateway.cfm3fid3d100760626type3dpdf,1845,1846,3691
6221,,url:http://doi.wiley.com/10.1002/he.10607,1846,1847,3693
6222,,xikh6kp7nm0j,1847,1848,3695
6223,,lycorpn_wkaj,1848,1849,3697
6224,,xmnt4zuxbfkj,1849,1850,3699
6225,,sek1mryo-yqj,1850,1851,3701
6226,,an51vigwlhaj,1851,1852,3703
6227,,dfs5e7hfsycj,1852,1853,3705
6228,,ubqumyols_0j,1853,1854,3707
6229,,miubkxlrikuj,1854,1855,3709
6230,,url:http://portal.acm.org/ft_gateway.cfm3fid3d110194026type3dpdf,1855,1856,3711
6231,,pdwir88-wgmj,1856,1857,3713
6232,,ueipomadmmuj,1857,1858,3715
6233,,sd-2dlhkhroj,1858,1859,3717
6234,,b2ro8vuqau4j,1859,1860,3719
6235,,ec65op56bawj,1860,1861,3721
6236,,tvpbh4tm7cqj,1861,1862,3723
6237,,dbosqlxx4mkj,1862,1863,3725
6238,,url:http://doi.wiley.com/10.1002/anie.198308120,1863,1864,3727
6239,,tq8m8qozjo8j,1864,1865,3729
6240,,jwx8bg0ycysj,1865,1866,3731
6241,,zvxu_zoa7q8j,1866,1867,3733
6242,,cabsl_3wycgj,1867,1868,3735
6243,,1gboyxahumsj,1868,1869,3737
6244,,v4rdmbyb_sij,1869,1870,3739
6245,,1h81a_w9ruyj,1870,1871,3741
6246,,url:http://www.springerlink.com/index/l27507pu24708861.pdf,1871,1872,3743
6247,,url:http://doi.wiley.com/10.1002/(sici)1521-3757(19990301)111:5253c710::aid-ange710253e3.0.co3b2-2,1872,1873,3745
6248,,vlkkxugg6hkj,1873,1874,3747
6249,,g_szzvnr5c0j,1875,1876,3751
6250,,zqjvnwoyrxej,1876,1877,3753
6251,,w4ry_izmxgkj,1877,1878,3755
6252,,xfxdvliipeqj,1878,1879,3757
6253,,juuirr5uug4j,1879,1880,3759
6254,,k2tbkdaulwkj,1880,1881,3761
6255,,wq-lsyiw8msj,1881,1882,3763
6256,,sjyol_flmmsj,1882,1883,3765
6257,,sg6dnculuw8j,1883,1884,3767
6258,,v_lwqu5gc6ej,1884,1885,3769
6259,,fkckidv1iiij,1885,1886,3771
6260,,wgy37gguigcj,1887,1888,3775
6261,,ge1kr6uvnzcj,1888,1889,3777
6262,,wzrjjfyiiquj,1889,1890,3779
6263,,hdi8hksdrv0j,1890,1891,3781
6264,,peg34mxyr-gj,1891,1892,3783
6265,,mwnpckbw99uj,1892,1893,3785
6266,,wo3luoeiwooj,1893,1894,3787
6267,,avygnvp-encj,1895,1896,3791
6268,,ss99c0gvjygj,1896,1897,3793
6269,,tbqup5r7t68j,1897,1898,3795
6270,,cax-vc3qdnij,1898,1899,3797
6271,,znl2kecjxgoj,1899,1900,3799
6272,,9zprnfusgdgj,1900,1901,3801
6273,,a8v7cyglgyqj,1901,1902,3803
6274,,q6ilngrrmwij,1902,1903,3805
6275,,llw6zabrmmej,1903,1904,3807
6276,,gdvexd9mfcsj,1904,1905,3809
6277,,d-zrxdi5txoj,1905,1906,3811
6278,,biwrjz4wscij,1906,1907,3813
6279,,arixvrmop94j,1907,1908,3815
6280,,advsjazhcc8j,1908,1909,3817
6281,,rulr1vgrdtaj,1909,1910,3819
6282,,u7la2_zaqtyj,1910,1911,3821
6283,,krewziyn9ayj,1911,1912,3823
6284,,yh9iq5yopzij,1912,1913,3825
6285,,nnu9a_5tjzkj,1913,1914,3827
6286,,sk8zkxahtxmj,1914,1915,3829
6287,,g5tfyecup9qj,1915,1916,3831
6288,,gduamuxcknyj,1916,1917,3833
6289,,wb_-7kkajhuj,1917,1918,3835
6290,,cx_zlinfrdaj,1918,1919,3837
6291,,aqockd6cvzsj,1919,1920,3839
6292,,ma63fmenehyj,1920,1921,3841
6293,,zbwnhsw5ehkj,1921,1922,3843
6294,,crlhanq3diyj,1922,1923,3845
6295,,jbfedxfd2asj,1923,1924,3847
6296,,r6zsisobrxqj,1924,1925,3849
6297,,6qhvvqwdafsj,1925,1926,3851
6298,,qoaebsfngdej,1926,1927,3853
6299,,s1ohpmeo8f0j,1927,1928,3855
6300,,vrito-njkp4j,1928,1929,3857
6301,,ewkvczjark0j,1929,1930,3859
6302,,gkwyjdaxr7sj,1930,1931,3861
6303,,wdmmf7xvxjij,1931,1932,3863
6304,,kipt0ddskuej,1932,1933,3865
6305,,dyknaem4j2oj,1933,1934,3867
6306,,emfejtati08j,1934,1935,3869
6307,,tq8dyo1sqkwj,1935,1936,3871
6308,,wx3l4pjld2kj,1936,1937,3873
6309,,f0knbjvyb-qj,1937,1938,3875
6310,,4_klvnejiw4j,1938,1939,3877
6311,,xtjlyfnbghaj,1939,1940,3879
6312,,smz8khpcf98j,1940,1941,3881
6313,,e3l2sljy-bgj,1941,1942,3883
6314,,bxcuqvbhlzkj,1942,1943,3885
6315,,eh7zob7emoyj,1943,1944,3887
6316,,fyek_kcb-qkj,1944,1945,3889
6317,,aaivfreyb3mj,1945,1946,3891
6318,,1iujfoztyngj,1946,1947,3893
6319,,ygxb9aba4wuj,1947,1948,3895
6320,,ljyqe88bxdgj,1948,1949,3897
6321,,8_7a0ecpp9cj,1949,1950,3899
6322,,u6peli1fokgj,1950,1951,3901
6323,,jzhjigaxr5qj,1951,1952,3903
6324,,vtbk-oipklgj,1952,1953,3905
6325,,lrjm5nzw4swj,1953,1954,3907
6326,,akw6g8fklkkj,1954,1955,3909
6327,,kiszv2qyaasj,1955,1956,3911
6328,,jffrmqra-zcj,1956,1957,3913
6329,,0xbcsmia6hij,1957,1958,3915
6330,,zcqyl0adzycj,1958,1959,3917
6331,,2zl43oc0sfyj,1959,1960,3919
6332,,yjh3lqj6kyqj,1960,1961,3921
6333,,iofpnc3kjeoj,1961,1962,3923
6334,,nagjm91eg6kj,1962,1963,3925
6335,,,1963,1964,3927
6336,,igjxacrpum4j,1964,1965,3929
6337,,vnenpxouamwj,1965,1966,3931
6338,,ukys2ztacvwj,1966,1967,3933
6339,,facomd-sugcj,1967,1968,3935
6340,,593venkv2j8j,1968,1969,3937
6341,,9y8wuarov-qj,1970,1971,3941
6342,,m_ottwt6d3kj,1971,1972,3943
6343,,gwag9sivzwmj,1972,1973,3945
6344,,v_fihsjhyhmj,1973,1974,3947
6345,,yia7fhhmdgqj,1974,1975,3949
6346,,rmta8uqqh68j,1975,1976,3951
6347,,1ywnamhlbpaj,1976,1977,3953
6348,,69qxwskxtfyj,1977,1978,3955
6349,,v0evzlk3wmij,1978,1979,3957
6350,,3r5shnb_tt8j,1979,1980,3959
6351,,48sqih3iajuj,1980,1981,3961
6352,,lez0bthdlx4j,1981,1982,3963
6353,,9dfhslg_iyuj,1982,1983,3965
6354,,8ec1ibh8mzkj,1983,1984,3967
6355,,hszyv719hbaj,1984,1985,3969
6356,,ohho92vu2joj,1985,1986,3971
6357,,j5jr1kl83ecj,1986,1987,3973
6358,,udzaehooqlkj,1987,1988,3975
6359,,tkvtupajk4ij,1988,1989,3977
6360,,_cjbagdeyf8j,1989,1990,3979
6361,,t3rierzilsaj,1991,1992,3983
6362,,jv8cyh-npsuj,1992,1993,3985
6363,,4jbosakjktaj,1993,1994,3987
6364,,cmkinvdwi94j,1994,1995,3989
6365,,jjpmjdsxv5gj,1995,1996,3991
6366,,nispnjt7wuuj,1996,1997,3993
6367,,rkbvwzf70i4j,1997,1998,3995
6368,,ne5fxznwbgsj,1998,1999,3997
6369,,xbt2t9kywlwj,1999,2000,3999
6370,,,2000,2001,4001
6371,,cetwsngyjmoj,2001,2002,4003
6372,,fwco2loznsoj,2002,2003,4005
6373,,fegsorem-tsj,2003,2004,4007
6374,,8w6mv9i7qloj,2004,2005,4009
6375,,oalx0rvqqlij,2005,2006,4011
6376,,tubml2yxkaqj,2006,2007,4013
6377,,oyn8kyjyyjij,2007,2008,4015
6378,,woz4at12ojkj,2008,2009,4017
6379,,6pmyrhqe09yj,2009,2010,4019
6380,,c-xbs2dwv4ej,2010,2011,4021
6381,,ykdfko6optsj,2011,2012,4023
6382,,g3pmn7dlqqcj,2012,2013,4025
6383,,dlfym0wucgij,2013,2014,4027
6384,,ngilxkyn08mj,2014,2015,4029
6385,,xv8exyj6wyqj,2015,2016,4031
6386,,8vp0mle7nmuj,2016,2017,4033
6387,,x-qdtszm6l4j,2017,2018,4035
6388,,url:http://www.csa.com/partners/viewrecord.php3frequester3dgs26collection3dtrd26recid3d0132834ci,2018,2019,4037
6389,,sbcfcrkxwpkj,2019,2020,4039
6390,,m56yyoq23emj,2020,2021,4041
6391,,re6lyzpjajej,2021,2022,4043
6392,,ukj9vxlqzm4j,2022,2023,4045
6393,,cpxlaxoxz0wj,2023,2024,4047
6394,,8k15fjvup_cj,2024,2025,4049
6395,,gssm0sodsjgj,2025,2026,4051
6396,,dgdir52nqngj,2026,2027,4053
6397,,mxqjesr9nlwj,2027,2028,4055
6398,,iu7ejfviyvgj,2028,2029,4057
6399,,zxvnv4o293wj,2029,2030,4059
6400,,cbxkqg23dsij,2030,2031,4061
6401,,gzjipb5ameoj,2031,2032,4063
6402,,rh68dfgqfs4j,2032,2033,4065
6403,,b5khe35cr28j,2033,2034,4067
6404,,0my0nr6oejkj,2034,2035,4069
6405,,vgpbp0in_raj,2035,2036,4071
6406,,qklyeeifw24j,2036,2037,4073
6407,,vyfdmks4sbcj,2037,2038,4075
6408,,url:http://doi.ieeecomputersociety.org/10.1109/tkde.2004.1269673,2038,2039,4077
6409,,cf4rjhkj7xkj,2039,2040,4079
6410,,b6-zhfa02tgj,2040,2041,4081
6411,,shwfxrfbzygj,2041,2042,4083
6412,,s9hocfxah5gj,2042,2043,4085
6413,,69qmnrswrqej,2043,2044,4087
6414,,df8s-n_5u3ej,2044,2045,4089
6415,,url:http://portal.acm.org/ft_gateway.cfm3fid3d106132426type3dpdf,2045,2046,4091
6416,,bpma30mbzaij,2046,2047,4093
6417,,fbdztuwxgr8j,2047,2048,4095
6418,,ptn_o-11tmmj,2048,2049,4097
6419,,2xfd-5x-cmsj,2049,2050,4099
6420,,ekzgciaxlkij,2050,2051,4101
6421,,jx63meaw52oj,2051,2052,4103
6422,,apkrvvy4ah8j,2052,2053,4105
6423,,bgu2exin07mj,2053,2054,4107
6424,,nlhq-srsc1uj,2054,2055,4109
6425,,fm7yhqbxhikj,2055,2056,4111
6426,,3wvnkllncmej,2056,2057,4113
6427,,15lvzq6ly2wj,2057,2058,4115
6428,,j1vebc6m9tcj,2058,2059,4117
6429,,rkunsp2vkj0j,2059,2060,4119
6430,,sbqvqmujzmgj,2060,2061,4121
6431,,sgokksrdkyaj,2061,2062,4123
6432,,svjmpzi7ax0j,2062,2063,4125
6433,,9jfesvxdpuwj,2063,2064,4127
6434,,l8c4fiah1iej,2064,2065,4129
6435,,mxidxlvxakaj,2065,2066,4131
6436,,wjrzrnrzl4kj,2066,2067,4133
6437,,f1lxhy2ke28j,2067,2068,4135
6438,,pxgtkczl6gkj,2068,2069,4137
6439,,43owrtdvakqj,2069,2070,4139
6440,,zayvdiuxzguj,2070,2071,4141
6441,,spvlvxbltwcj,2071,2072,4143
6442,,va9uz3wwfraj,2072,2073,4145
6443,,hcbvmarqsvij,2073,2074,4147
6444,,8a9qwrxutgyj,2074,2075,4149
6445,,x0qrn4ivegoj,2075,2076,4151
6446,,k54c3yeb3mkj,2076,2077,4153
6447,,weqaj82dw8sj,2077,2078,4155
6448,,sjb0yuuzmp8j,2078,2079,4157
6449,,yvcqcdive2kj,2079,2080,4159
6450,,fnthcghpm48j,2080,2081,4161
6451,,6i-ekpbptgsj,2081,2082,4163
6452,,i_vf660_kxsj,2082,2083,4165
6453,,edxhju4gmqkj,2083,2084,4167
6454,,5mnanpipljoj,2084,2085,4169
6455,,aj9pqxewrduj,2085,2086,4171
6456,,fubigo23fyaj,2086,2087,4173
6457,,vzc2krp7ecmj,2087,2088,4175
6458,,9drlywyeup8j,2088,2089,4177
6459,,uvd5yrxkj7sj,2089,2090,4179
6460,,xtltptj_viaj,2090,2091,4181
6461,,fdxfd0ezl1ej,2091,2092,4183
6462,,9m4jmien5rgj,2092,2093,4185
6463,,uo0hn1ohvd0j,2093,2094,4187
6464,,mdm5rltdgeqj,2094,2095,4189
6465,,3m8zaaagungj,2095,2096,4191
6466,,ihpilg_mcdoj,2096,2097,4193
6467,,7ppascayopkj,2097,2098,4195
6468,,_nodyv-nhjmj,2098,2099,4197
6469,,9k6lz9g-9jsj,2099,2100,4199
6470,,4gvpejqwl2uj,2100,2101,4201
6471,,okhdmusnbgej,2101,2102,4203
6472,,yfhlwevw26oj,2102,2103,4205
6473,,zrnjidrou-wj,2103,2104,4207
6474,,ce5yszlmetij,2104,2105,4209
6475,,my_habco13qj,2105,2106,4211
6476,,e3s4oftebqwj,2106,2107,4213
6477,,zyurlajbafmj,2107,2108,4215
6478,,rpcr3flfna0j,2108,2109,4217
6479,,0pyitsoykoqj,2109,2110,4219
6480,,w7rfp0aiad0j,2110,2111,4221
6481,,i2gueu4cqymj,2111,2112,4223
6482,,jglxozlbh5mj,2112,2113,4225
6483,,ksoslftobpoj,2114,2115,4229
6484,,rajz70mitsoj,2115,2116,4231
6485,,q_t3rfr4zxkj,2116,2117,4233
6486,,qhalgy5h1lqj,2117,2118,4235
6487,,url:http://portal.acm.org/citation.cfm3fid3d637411.63743226coll3dguide26dl3dacm26type3dissue26idx3dj68926part3dperiodical26wanttype3dperiodical26title3dacm2520sigmod2520record26cfid3d1111111126cftoken3d2222222,2118,2119,4237
6488,,kj8d3evjm4oj,2119,2120,4239
6489,,wrilvppoo2qj,2120,2121,4241
6490,,dsjywcdcj2wj,2121,2122,4243
6491,,0hqq6ifpztcj,2122,2123,4245
6492,,dkqqjtr-vimj,2123,2124,4247
6493,,hikvz3zlftyj,2124,2125,4249
6494,,b-qwtej8payj,2125,2126,4251
6495,,on29t6idzlaj,2126,2127,4253
6496,,f9a3p_lsyfcj,2127,2128,4255
6497,,q7thvv-qqsyj,2128,2129,4257
6498,,7nl1xaccf-0j,2129,2130,4259
6499,,refkyrvukcmj,2130,2131,4261
6500,,elcp-kjboquj,2131,2132,4263
6501,,y2e6xu-ypzuj,2132,2133,4265
6502,,url:http://www.ingentaconnect.com/content/els/13891286/2002/00000038/00000004/art00263,2133,2134,4267
6503,,on7trd3cjt8j,2134,2135,4269
6504,,c6brmzy6imcj,2135,2136,4271
6505,,,2136,2137,4273
6506,,ze8fryhgijgj,2137,2138,4275
6507,,_pjwp11t_y8j,2138,2139,4277
6508,,wokzxvmr1iej,2139,2140,4279
6509,,dbiruyrs1oyj,2140,2141,4281
6510,,hnvhpppqfeij,2141,2142,4283
6511,,wuaylc5jf1wj,2142,2143,4285
6512,,phgdbfiuhuyj,2143,2144,4287
6513,,tearnukrit8j,2144,2145,4289
6514,,61sndwrufs8j,2145,2146,4291
6515,,cjgyqwelaagj,2146,2147,4293
6516,,cawoustkix0j,2147,2148,4295
6517,,hqgwvn2m1gqj,2148,2149,4297
6518,,mlwnqz1iroaj,2149,2150,4299
6519,,5xp5yp_rwiuj,2150,2151,4301
6520,,xe5p8d_xcvgj,2151,2152,4303
6521,,lyt-xi_y5noj,2152,2153,4305
6522,,z3slreq1y00j,2154,2155,4309
6523,,mvtlkpfveuij,2155,2156,4311
6524,,rim829mbwqsj,2156,2157,4313
6525,,fdh9bzqvt6qj,2157,2158,4315
6526,,xnv4gpvh50ej,2158,2159,4317
6527,,x-m9dfh7pvsj,2159,2160,4319
6528,,yelijacvdw4j,2160,2161,4321
6529,,mk_fd5qwsjcj,2161,2162,4323
6530,,zlj_ktacokaj,2163,2164,4327
6531,,mw9h6gn3znqj,2164,2165,4329
6532,,_w_vvbq0ylij,2166,2167,4333
6533,,4ftgnb9cz4yj,2167,2168,4335
6534,,vkjfplawdxyj,2168,2169,4337
6535,,kcc_wreeqrkj,2169,2170,4339
6536,,5paq_it_xtsj,2170,2171,4341
6537,,r7k9puhsrscj,2171,2172,4343
6538,,l0w27c1c3nwj,2172,2173,4345
6539,,cpa5qwyirr4j,2173,2174,4347
6540,,wf_gdzpkcnqj,2174,2175,4349
6541,,zmzvpfqlpoyj,2175,2176,4351
6542,,fbsgfez3uzuj,2176,2177,4353
6543,,y_1hupy_lg4j,2177,2178,4355
6544,,josgahrxcywj,2178,2179,4357
6545,,0h7bbsiclomj,2179,2180,4359
6546,,4msurp_ebxwj,2180,2181,4361
6547,,,2182,2183,4365
6548,,erugpyevlssj,2183,2184,4367
6549,,3cfnthgpt-kj,2184,2185,4369
6550,,wkse61wcwiyj,2185,2186,4371
6551,,qljg-62keymj,2186,2187,4373
6552,,5y_l1wlpo04j,2187,2188,4375
6553,,jfo57_vwkfuj,2188,2189,4377
6554,,8kah3gzmf5gj,2189,2190,4379
6555,,swxdc1ncafoj,2190,2191,4381
6556,,8nevciuocusj,2191,2192,4383
6557,,mesxppt8ctkj,2192,2193,4385
6558,,g55uvpfyndmj,2193,2194,4387
6559,,ufvf0meoih4j,2194,2195,4389
6560,,rxfhrc3mi1mj,2195,2196,4391
6561,,3d9vcrctvlaj,2196,2197,4393
6562,,eigl670_sxqj,2197,2198,4395
6563,,_p0bmqbwplaj,2198,2199,4397
6564,,ljsuniq-hp8j,2199,2200,4399
6565,,wmymucfsfksj,2200,2201,4401
6566,,3wjt4fyx4koj,2201,2202,4403
6567,,kx7epb_k0kij,2202,2203,4405
6568,,epqcx_cjzpkj,2203,2204,4407
6569,,l_jaxq9jwegj,2204,2205,4409
6570,,trkhgr1dxcij,2206,2207,4413
6571,,u-u8m8mmin0j,2207,2208,4415
6572,,ayh2ny_fsygj,2208,2209,4417
6573,,j3bobn0lqwmj,2209,2210,4419
6574,,rl3ifwvvadyj,2210,2211,4421
6575,,mabkylbkgwuj,2211,2212,4423
6576,,zwgso3kf0fmj,2212,2213,4425
6577,,0v4aumswvukj,2213,2214,4427
6578,,2y2aw_xrafsj,2214,2215,4429
6579,,res2mtfmkaej,2215,2216,4431
6580,,z0lfixedr_aj,2216,2217,4433
6581,,y_g3saj6anmj,2217,2218,4435
6582,,krojrlxf8u0j,2218,2219,4437
6583,,hyrdoaogjeaj,2219,2220,4439
6584,,k4-_prtn_zkj,2220,2221,4441
6585,,url:http://portal.acm.org/citation.cfm3fid3d983055.98305626coll3dguide26dl3dacm26idx3dj68926part3dperiodical26wanttype3dperiodical26title3dacm2520sigmod2520record26cfid3d1111111126cftoken3d2222222,2221,2222,4443
6586,,t-wixgilijsj,2223,2224,4447
6587,,ktgnigccxdqj,2224,2225,4449
6588,,ovssdcbjspoj,2225,2226,4451
6589,,zwtpxp19r58j,2226,2227,4453
6590,,url:http://api.ingentaconnect.com/content/bpl/area/2001/00000033/00000001/art00010,2227,2228,4455
6591,,wndzgr95ipij,2228,2229,4457
6592,,zg4mr1q7uygj,2229,2230,4459
6593,,tw6vhm4zdhsj,2230,2231,4461
6594,,honylhoowr4j,2231,2232,4463
6595,,lrxvevjj0ggj,2232,2233,4465
6596,,txeljgwzkumj,2233,2234,4467
6597,,0qkvgjdl7okj,2234,2235,4469
6598,,ssgabgw9wtsj,2235,2236,4471
6599,,qhhfrgc4m6oj,2236,2237,4473
6600,,anaq2j41ts0j,2237,2238,4475
6601,,url:http://links.jstor.org/sici3fsici3d0146-4949(196624252f21)7253a1253c85253aalosta253e2.0.co253b2-a,2238,2239,4477
6602,,2j-x_daqspuj,2239,2240,4479
6603,,ypub4cgk4z0j,2240,2241,4481
6604,,_2qzluz1fqij,2241,2242,4483
6605,,wqtttu2qckqj,2242,2243,4485
6606,,3hfyllt5ryej,2243,2244,4487
6607,,uzbodxflaxoj,2244,2245,4489
6608,,gqilcooj5egj,2245,2246,4491
6609,,p3zykt7tkvij,2246,2247,4493
6610,,4jq8u2ufnjkj,2247,2248,4495
6611,,gp1u8pct608j,2248,2249,4497
6612,,hzg-dhx5r_yj,2249,2250,4499
6613,,wxeu2urlmxcj,2250,2251,4501
6614,,url:http://adsabs.harvard.edu/abs/1978phdt........22e,2251,2252,4503
6615,,mfz8y6blfcoj,2252,2253,4505
6616,,8poza2mhm8ij,2253,2254,4507
6617,,h9yuokqdbl8j,2254,2255,4509
6618,,ub8tctms6b8j,2255,2256,4511
6619,,hwptjxsao_0j,2256,2257,4513
6620,,2wk39jy-yeaj,2257,2258,4515
6621,,zqdrrjcxex0j,2258,2259,4517
6622,,ufvza9irr5aj,2259,2260,4519
6623,,0w6br4qlbxqj,2260,2261,4521
6624,,url:http://links.jstor.org/sici3fsici3d0146-4949(196323)4253a3253c367253ap1apv253e2.0.co253b2-s,2261,2262,4523
6625,,y0lzfp0kaicj,2262,2263,4525
6626,,bio4hpwxo48j,2263,2264,4527
6627,,glhlrttaaxij,2264,2265,4529
6628,,ruiu2rbdcjoj,2265,2266,4531
6629,,xbvkhsd4e2ej,2266,2267,4533
6630,,fwo-8ns6ixqj,2267,2268,4535
6631,,b7vw7gg-2koj,2268,2269,4537
6632,,psf6ckxkanuj,2269,2270,4539
6633,,wofcvszaum0j,2270,2271,4541
6634,,jqvqgl96aikj,2271,2272,4543
6635,,wxq_lhmgjn8j,2272,2273,4545
6636,,ja14sixdqrcj,2273,2274,4547
6637,,q_gszdbrx4cj,2274,2275,4549
6638,,xhdxmkabocej,2275,2276,4551
6639,,zvzgj4ivc28j,2276,2277,4553
6640,,wt6gxrrressj,2277,2278,4555
6641,,ztxggizvghkj,2278,2279,4557
6642,,0dbji3ynzzqj,2279,2280,4559
6643,,3q6tpowtqxoj,2280,2281,4561
6644,,o4bv4m_szcuj,2281,2282,4563
6645,,qnbfdze--oqj,2282,2283,4565
6646,,1eg7to7vfhwj,2283,2284,4567
6647,,eiosmc2jpx4j,2284,2285,4569
6648,,g4zjavmtoboj,2285,2286,4571
6649,,srmcggupuqwj,2286,2287,4573
6650,,url:http://www.ingentaconnect.com/content/els/13891286/2001/00000037/00000002/art00209,2288,2289,4577
6651,,url:http://www.extenza-eps.com/woi/doi/abs/10.5555/bilc.2005.1.st_lucia.297,2289,2290,4579
6652,,z2joa3ssqmqj,2290,2291,4581
6653,,url:http://portal.acm.org/citation.cfm3fid3d264344,2291,2292,4583
6654,,ahuoubuqz0oj,2292,2293,4585
6655,,nlqncyxlxfuj,2293,2294,4587
6656,,k3s-ilryjpoj,2294,2295,4589
6657,,kpmmtlmlcvij,2296,2297,4593
6658,,fgcj6rawlqcj,2297,2298,4595
6659,,url:http://portal.acm.org/citation.cfm3fid3d984549.98455326dl3dguide26dl3dguide26idx3d98454926part3dperiodical26wanttype3dperiodical26title3dacm2520sigmod2520record26cfid3d1111111126cftoken3d2222222,2298,2299,4597
6660,,twn4uer2twuj,2299,2300,4599
6661,,1runmtft4x8j,2300,2301,4601
6662,,efqu_vfel_0j,2301,2302,4603
6663,,k0b6_d3et2ij,2302,2303,4605
6664,,2jn9qjagdggj,2303,2304,4607
6665,,zt7_n7c7gl4j,2304,2305,4609
6666,,7tqacsvvbu4j,2305,2306,4611
6667,,rrov-tantuyj,2306,2307,4613
6668,,nvgi7ptv0yij,2307,2308,4615
6669,,-6i3fdly6q0j,2308,2309,4617
6670,,jb_fdn2630oj,2309,2310,4619
6671,,pqsiw_egorwj,2310,2311,4621
6672,,7vsnnrxb2xkj,2311,2312,4623
6673,,ed8eh4p2vbmj,2313,2314,4627
6674,,lnk9xsoxbvcj,2314,2315,4629
6675,,uj2ixhn9_haj,2315,2316,4631
6676,,di_v0vb6784j,2316,2317,4633
6677,,url:http://www.springerlink.com/index/fv3vue2j6jelha7u.pdf,2317,2318,4635
6678,,sya_enlzrjkj,2318,2319,4637
6679,,yyn03jmz3bcj,2319,2320,4639
6680,,xbomhheuouwj,2320,2321,4641
6681,,ay5skgxlojyj,2321,2322,4643
6682,,,2322,2323,4645
6683,,url:http://portal.acm.org/ft_gateway.cfm3fid3d110118226type3dpdf,2323,2324,4647
6684,,url:http://portal.acm.org/ft_gateway.cfm3fid3d108373926type3dpdf,2324,2325,4649
6685,,tj3bzfyqctyj,2325,2326,4651
6686,,ne98q_haa_kj,2326,2327,4653
6687,,lrlc0ufm5ryj,2327,2328,4655
6688,,9l3vdgrjqh4j,2328,2329,4657
6689,,eq5opzevjzaj,2329,2330,4659
6690,,y9-onpm17c8j,2330,2331,4661
6691,,edalc3s11yqj,2331,2332,4663
6692,,kn3g2d6hk4yj,2332,2333,4665
6693,,5dhjde0skzgj,2333,2334,4667
6694,,url:http://doi.wiley.com/10.1002/he.10709,2334,2335,4669
6695,,e32va7phxcoj,2335,2336,4671
6696,,0dcwllsmcaij,2336,2337,4673
6697,,tjof58zwbv8j,2337,2338,4675
6698,,y5odak_2nmyj,2338,2339,4677
6699,,6t1ugralblyj,2339,2340,4679
6700,,icnyeknuuqij,2340,2341,4681
6701,,jnki8s93n4mj,2341,2342,4683
6702,,wyg2yncij2kj,2342,2343,4685
6703,,xgpvkxu2qgkj,2343,2344,4687
6704,,9geqg82yca4j,2344,2345,4689
6705,,q21hprspqvqj,2345,2346,4691
6706,,j4jbhr3edpmj,2346,2347,4693
6707,,ymg_luvjn9kj,2347,2348,4695
6708,,htreh9_zagyj,2348,2349,4697
6709,,uf-z2vptu6sj,2349,2350,4699
6710,,lozxdkvbhe4j,2350,2351,4701
6711,,bm8ezisufq4j,2351,2352,4703
6712,,jr_fm8rxgpij,2352,2353,4705
6713,,mztzjubuqxwj,2353,2354,4707
6714,,hh51a__rjqkj,2354,2355,4709
6715,,rvifhivafjsj,2355,2356,4711
6716,,url:http://portal.acm.org/citation.cfm3fid3d376284,2356,2357,4713
6717,,_2q_qaexd1ij,2357,2358,4715
6718,,zjlvmdtdbdyj,2358,2359,4717
6719,,oubxi6imujkj,2359,2360,4719
6720,,zqz1myxs4pqj,2360,2361,4721
6721,,m2tzhxcid3ej,2361,2362,4723
6722,,k9hlhv5jqygj,2362,2363,4725
6723,,uaqi5c0jeywj,2363,2364,4727
6724,,lsuwmakljr8j,2364,2365,4729
6725,,fhwjm0v_yp8j,2365,2366,4731
6726,,cpmrosemg5ej,2366,2367,4733
6727,,hqytuzsdnx8j,2367,2368,4735
6728,,url:http://portal.acm.org/ft_gateway.cfm3fid3d14140126type3dpdf,2368,2369,4737
6729,,url:http://portal.acm.org/ft_gateway.cfm3fid3d108370326type3dpdf,2369,2370,4739
6730,,y9jcmjpkr98j,2370,2371,4741
6731,,h-p77tz8pv0j,2371,2372,4743
6732,,0ll9hcfght8j,2372,2373,4745
6733,,url:http://www.geocities.com/researchtriangle/thinktank/4423/informefinalproyectouba-cs2826-99.pdf,2373,2374,4747
6734,,owddr46esowj,2374,2375,4749
6735,,url:http://portal.acm.org/citation.cfm3fid3d592192.592247,2375,2376,4751
6736,,dd0_gi74jcqj,2376,2377,4753
6737,,mext6z0n7iuj,2377,2378,4755
6738,,qrbf_nfncioj,2378,2379,4757
6739,,soartk36avij,2379,2380,4759
6740,,bntbapekwpaj,2380,2381,4761
6741,,srojbd-_t2wj,2381,2382,4763
6742,,v5kk5evq_eoj,2382,2383,4765
6743,,ackxq4dcbc4j,2383,2384,4767
6744,,oyyu06jkqk0j,2384,2385,4769
6745,,afkhl1i3l9aj,2385,2386,4771
6746,,dpg-5top2ckj,2386,2387,4773
6747,,xn5wxtbf5aaj,2387,2388,4775
6748,,c4qbbeclxwej,2388,2389,4777
6749,,t-urtud9csyj,2389,2390,4779
6750,,jcphf21_7fij,2390,2391,4781
6751,,0jpjrpuncoyj,2391,2392,4783
6752,,bnx1x5rngc8j,2392,2393,4785
6753,,d2lh-gnlpzwj,2393,2394,4787
6754,,cq-9a794ujkj,2394,2395,4789
6755,,xjuminypx38j,2395,2396,4791
6756,,gye3_h9dbk0j,2396,2397,4793
6757,,fefufy99oeoj,2397,2398,4795
6758,,a2dof9g4bgkj,2398,2399,4797
6759,,karfw3t9aeej,2399,2400,4799
6760,,kozps8bmys4j,2402,2403,4805
6761,,jrurkqa38xij,2403,2404,4807
6762,,kdmdmzzrwr0j,2404,2405,4809
6763,,u4v7mxt7yg0j,2405,2406,4811
6764,,deqgeimew90j,2406,2407,4813
6765,,id2scu7jwlej,2407,2408,4815
6766,,url:http://pubs.acs.org/cgi-bin/abstract.cgi/achre4/2005/38/i06/abs/ar040082m.html,2408,2409,4817
6767,,p0qq5h77nd4j,2410,2411,4821
6768,,url:http://portal.acm.org/citation.cfm3fid3d1083592.1083692,2411,2412,4823
6769,,mt1h9hm3fnkj,2412,2413,4825
6770,,fzkpwewdfocj,2413,2414,4827
6771,,lckydsb-fv4j,2414,2415,4829
6772,,ymfy5iz8dhkj,2415,2416,4831
6773,,dkjopqgi8z4j,2416,2417,4833
6774,,897ntvaanacj,2417,2418,4835
6775,,ssml6ufaknoj,2419,2420,4839
6776,,qzn7xvfm0baj,2420,2421,4841
6777,,xhth3pn6spsj,2421,2422,4843
6778,,na60b-qtamqj,2422,2423,4845
6779,,05hvdda4m24j,2423,2424,4847
6780,,asczehp9uzkj,2424,2425,4849
6781,,fxohhw8nwzqj,2425,2426,4851
6782,,vz6yhlubfq4j,2426,2427,4853
6783,,hulo0jcbuimj,2427,2428,4855
6784,,fixrt0vhcmcj,2428,2429,4857
6785,,aaheajm5qhij,2429,2430,4859
6786,,w4aupcynd3gj,2430,2431,4861
6787,,wopjli0yizkj,2431,2432,4863
6788,,ma8ten5tzjcj,2432,2433,4865
6789,,uzg4dzuwxtej,2433,2434,4867
6790,,4vtie_p5bqij,2434,2435,4869
6791,,fmlkpy6bvm4j,2435,2436,4871
6792,,uwbvfpkyftkj,2436,2437,4873
6793,,tlmpfbpyqcoj,2437,2438,4875
6794,,efaypjnbwe4j,2438,2439,4877
6795,,0tg0cyzpx9kj,2439,2440,4879
6796,,url:http://portal.acm.org/citation.cfm3fid3d1083784.1083794,2440,2441,4881
6797,,_y4cgpjroewj,2441,2442,4883
6798,,uecexx3hyqsj,2442,2443,4885
6799,,url:http://portal.acm.org/ft_gateway.cfm3fid3d109972626type3dpdf,2444,2445,4889
6800,,ndcsnx4d4o8j,2445,2446,4891
6801,,bppvmrikeqaj,2446,2447,4893
6802,,url:http://pubs.acs.org/cgi-bin/abstract.cgi/achre4/2005/38/i07/abs/ar0401303.html,2447,2448,4895
6803,,trnstgrjvicj,2448,2449,4897
6804,,eutsqbxdb08j,2449,2450,4899
6805,,_fyhogqu2-mj,2450,2451,4901
6806,,hpe1oufaf_0j,2451,2452,4903
6807,,i875q3u4ld4j,2452,2453,4905
6808,,vfyksblzfk4j,2453,2454,4907
6809,,tnjwmxotorej,2454,2455,4909
6810,,taruynmwa2ij,2455,2456,4911
6811,,m-nvyo0uf_cj,2456,2457,4913
6812,,gwfu1kvty-yj,2457,2458,4915
6813,,7sppacl-f14j,2458,2459,4917
6814,,pfp0forskvmj,2459,2460,4919
6815,,tpf_uzgwqycj,2460,2461,4921
6816,,1uvpspu9qryj,2461,2462,4923
6817,,lm5-anpapqkj,2462,2463,4925
6818,,by-zz14p7kaj,2463,2464,4927
6819,,ftktwae6mq4j,2464,2465,4929
6820,,url:http://portal.acm.org/citation.cfm3fid3d171926.171965,2465,2466,4931
6821,,hdn9i8z9yd0j,2466,2467,4933
6822,,oeuzuivl3uoj,2467,2468,4935
6823,,zynpzuan33qj,2468,2469,4937
6824,,bquj4wsl4oqj,2469,2470,4939
6825,,kvq0_31llkaj,2470,2471,4941
6826,,jycuuynhzawj,2471,2472,4943
6827,,dc4juhd354uj,2472,2473,4945
6828,,frcqxxdgtj4j,2473,2474,4947
6829,,a68uahy_y_cj,2475,2476,4951
6830,,z8f2virc0a4j,2476,2477,4953
6831,,svlnc1wwpn0j,2477,2478,4955
6832,,4zfejxgyq6mj,2478,2479,4957
6833,,tlge87t39woj,2479,2480,4959
6834,,0smzwn7eu30j,2480,2481,4961
6835,,h_q1w0e7jxuj,2481,2482,4963
6836,,alj67mtkhsyj,2482,2483,4965
6837,,kfagz5mbwiqj,2483,2484,4967
6838,,c-3cry4eeasj,2484,2485,4969
6839,,ghwjyvamzesj,2485,2486,4971
6840,,8fyrxsq46aoj,2486,2487,4973
6841,,ovnki-zrsskj,2487,2488,4975
6842,,uicukukfnvej,2488,2489,4977
6843,,tla6xfh9uqmj,2489,2490,4979
6844,,aovzj8exsn4j,2490,2491,4981
6845,,qb2_lsaqbcgj,2491,2492,4983
6846,,7sbc7bgq5lwj,2492,2493,4985
6847,,ws_k5nw3gw0j,2493,2494,4987
6848,,jo7d5g9dt8sj,2494,2495,4989
6849,,mtsoasiz4lkj,2496,2497,4993
6850,,krucs1fmbdoj,2497,2498,4995
6851,,o8scozw1mwej,2499,2500,4999
6852,,yvkn6osovgwj,2500,2501,5001
6853,,bw28zaq0jdoj,2501,2502,5003
6854,,zxlqyxos4yuj,2502,2503,5005
6855,,j0ypon6abjcj,2504,2505,5009
6856,,2lmkkwaebzyj,2505,2506,5011
6857,,cxcjsypxz08j,2506,2507,5013
6858,,qvk3zypsvq4j,2507,2508,5015
6859,,uw_fxjt8uhmj,2508,2509,5017
6860,,x_ids457oq8j,2510,2511,5021
6861,,5nyron2ro30j,2511,2512,5023
6862,,uke140nuspij,2512,2513,5025
6863,,1bynmfkn2sej,2513,2514,5027
6864,,1hjnhg2ooqej,2514,2515,5029
6865,,mo0ipmq-ehoj,2515,2516,5031
6866,,tyeq_osajlaj,2517,2518,5035
6867,,wbjpwbnlqlij,2518,2519,5037
6868,,hwe3tunltzij,2519,2520,5039
6869,,cuhodubepmqj,2520,2521,5041
6870,,khzwwayhpecj,2521,2522,5043
6871,,ddiilpt42i4j,2522,2523,5045
6872,,nh9dbje8qgcj,2523,2524,5047
6873,,npp8chzygpyj,2524,2525,5049
6874,,url:http://www.springerlink.com/index/x4195622160033u6.pdf,2525,2526,5051
6875,,l90pp0bcmlgj,2526,2527,5053
6876,,wcf_vwzgymkj,2527,2528,5055
6877,,_kaudlnqpygj,2528,2529,5057
6878,,twhqi8x4h0ij,2529,2530,5059
6879,,1kuyquda_uwj,2530,2531,5061
6880,,6ivelzumcnqj,2531,2532,5063
6881,,yckf5kzrz7uj,2532,2533,5065
6882,,_an7dy9nc4aj,2533,2534,5067
6883,,qjqcxxzuamoj,2534,2535,5069
6884,,q6ifh2-ibkoj,2535,2536,5071
6885,,avgxrywj6ogj,2536,2537,5073
6886,,pirs_ymhieuj,2537,2538,5075
6887,,f14ab4viu0mj,2538,2539,5077
6888,,tyyalj6wmxwj,2539,2540,5079
6889,,p7x1zgd_bkej,2540,2541,5081
6890,,l3fawulkcaej,2541,2542,5083
6891,,vcnsj_opnsmj,2542,2543,5085
6892,,qeged-s5gpcj,2543,2544,5087
6893,,60lvs_--2nqj,2544,2545,5089
6894,,15hznrufokij,2545,2546,5091
6895,,url:http://taylorandfrancis.metapress.com/index/vmvrjenj89nuneyx.pdf,2546,2547,5093
6896,,mtgz6juiig8j,2547,2548,5095
6897,,o5qduallr2mj,2548,2549,5097
6898,,xsd4dx35an8j,2549,2550,5099
6899,,dzja0vpi39ej,2550,2551,5101
6900,,cmwlt-n9ja4j,2552,2553,5105
6901,,r1l2ifxexc4j,2553,2554,5107
6902,,iatlyw5lk8wj,2554,2555,5109
6903,,0pu8kfgd3l4j,2555,2556,5111
6904,,iugwchp2geqj,2556,2557,5113
6905,,zucow9hyvu8j,2557,2558,5115
6906,,tkqligje6y4j,2558,2559,5117
6907,,7vdfysmgzayj,2559,2560,5119
6908,,jcagoej3ihij,2560,2561,5121
6909,,31i5tq8wf9oj,2561,2562,5123
6910,,w8i1jneqqgkj,2562,2563,5125
6911,,a4hmikoulluj,2563,2564,5127
6912,,gvy1pxni468j,2564,2565,5129
6913,,x5po0pdokcqj,2565,2566,5131
6914,,cizbf2l8wuyj,2567,2568,5135
6915,,aczagbluljuj,2568,2569,5137
6916,,vvvh584hbloj,2569,2570,5139
6917,,29apzgac3f4j,2570,2571,5141
6918,,g_8nhjubgfaj,2571,2572,5143
6919,,t1c1qfsduvqj,2572,2573,5145
6920,,kku0g80fiicj,2573,2574,5147
6921,,f0-ds1tnavoj,2574,2575,5149
6922,,_f3n1odzfskj,2575,2576,5151
6923,,khxr0xyvziij,2576,2577,5153
6924,,url:http://links.jstor.org/sici3fsici3d0146-4949(196722)8253a3253c450253adt253e2.0.co253b2-y,2577,2578,5155
6925,,,2578,2579,5157
6926,,vyu9hrk30vgj,2579,2580,5159
6927,,ztqwnsprodaj,2580,2581,5161
6928,,mbyogmnlivaj,2581,2582,5163
6929,,dphaq6zase0j,2582,2583,5165
6930,,tsjimsxtqlcj,2583,2584,5167
6931,,a9r7ocyd7xij,2584,2585,5169
6932,,xyj0hg71szaj,2585,2586,5171
6933,,anhrnkgxaqoj,2586,2587,5173
6934,,stlespqwwkcj,2587,2588,5175
6935,,mmm9llekpwaj,2588,2589,5177
6936,,vsqwrjsmejsj,2589,2590,5179
6937,,f1s8iou_zkij,2590,2591,5181
6938,,hfpxylaucfmj,2592,2593,5185
6939,,s3cysm2epccj,2593,2594,5187
6940,,igvvjzbz_kaj,2594,2595,5189
6941,,pbjtxhbzekkj,2595,2596,5191
6942,,ax3h-smfpquj,2596,2597,5193
6943,,6t8l-hfv0fyj,2597,2598,5195
6944,,qdctr7wpufuj,2598,2599,5197
6945,,ogmrdemippuj,2599,2600,5199
6946,,9q4sdablyvwj,2600,2601,5201
6947,,bhpzi_f3ij4j,2601,2602,5203
6948,,zlniozahncgj,2602,2603,5205
6949,,a26f7ckv-swj,2603,2604,5207
6950,,foiwf-sobdyj,2604,2605,5209
6951,,breubxbe9d4j,2607,2608,5215
6952,,edaj6e3n3pwj,2608,2609,5217
6953,,vj7d-usr_mcj,2609,2610,5219
6954,,kzeawfyi6m4j,2610,2611,5221
6955,,i1xwhojsqpsj,2611,2612,5223
6956,,wz1oxpckjw0j,2612,2613,5225
6957,,2vziuoxgswkj,2613,2614,5227
6958,,vdnnbi6wewyj,2614,2615,5229
6959,,ruycrbul3r0j,2615,2616,5231
6960,,ib--jldjloyj,2616,2617,5233
6961,,8j19krluzuij,2617,2618,5235
6962,,u2jfznoplm8j,2618,2619,5237
6963,,gv4tfdvgxscj,2619,2620,5239
6964,,vdfdaqkqssij,2620,2621,5241
6965,,uboq74ugjioj,2621,2622,5243
6966,,imbjqijnrgqj,2622,2623,5245
6967,,ecz3kv_tfjaj,2623,2624,5247
6968,,czixpn_8vpij,2624,2625,5249
6969,,qozu69r5hdaj,2625,2626,5251
6970,,rxy-l1fcf3oj,2626,2627,5253
6971,,mjryut7haoej,2627,2628,5255
6972,,gnhhb-wby_uj,2628,2629,5257
6973,,agyaz-pqycgj,2629,2630,5259
6974,,ewo0lvwwy1yj,2630,2631,5261
6975,,j5svtaclkcyj,2631,2632,5263
6976,,xhadspozpx0j,2632,2633,5265
6977,,5nkiq7vkerwj,2633,2634,5267
6978,,migxxsj8tcwj,2634,2635,5269
6979,,dcxgofoderej,2635,2636,5271
6980,,url:http://www.ncbi.nlm.nih.gov/entrez/query.fcgi3fcmd3dretrieve26db3dpubmed26list_uids3d64130526dopt3dcitation,2636,2637,5273
6981,,c8ffvbvfoxij,2637,2638,5275
6982,,n1vvjvkmvbmj,2638,2639,5277
6983,,cbtq9odskcmj,2639,2640,5279
6984,,ygdnzjs_tm0j,2640,2641,5281
6985,,pm2nkz8az5wj,2641,2642,5283
6986,,ofjfdtoakroj,2642,2643,5285
6987,,ck8oodrqjdcj,2643,2644,5287
6988,,h2qcu9-_uykj,2644,2645,5289
6989,,url:http://portal.acm.org/ft_gateway.cfm3fid3d110751526type3dpdf,2645,2646,5291
6990,,pccxmyusjw0j,2647,2648,5295
6991,,kw-zahqw9wuj,2648,2649,5297
6992,,adaufacftmoj,2649,2650,5299
6993,,qlk1hz8vfksj,2650,2651,5301
6994,,lp9wxp7hbj4j,2651,2652,5303
6995,,p5ubgtlrgdij,2652,2653,5305
6996,,ci3-ib4umfcj,2653,2654,5307
6997,,8b_kaigxm1uj,2654,2655,5309
6998,,4lsml_vn-3yj,2655,2656,5311
6999,,vl6qono6mhaj,2656,2657,5313
7000,,kriguunsaqej,2657,2658,5315
7001,,s0ydck69-6yj,2658,2659,5317
7002,,hl7xybcevpkj,2659,2660,5319
7003,,slrc97odaoqj,2660,2661,5321
7004,,_fz5jaora3wj,2661,2662,5323
7005,,xwto9zacrpcj,2662,2663,5325
7006,,_q3wkj7zfjwj,2663,2664,5327
7007,,5nlc5insx5cj,2664,2665,5329
7008,,bvuwvwkj9csj,2665,2666,5331
7009,,v6-uebyiaiuj,2666,2667,5333
7010,,7vhze8zxlpmj,2667,2668,5335
7011,,q1ern89uze8j,2668,2669,5337
7012,,zp5rqjyjgo8j,2669,2670,5339
7013,,brzjcnzcyzaj,2670,2671,5341
7014,,sguvitm56zcj,2672,2673,5345
7015,,gj_4fhizdu0j,2673,2674,5347
7016,,url:http://www.csa.com/partners/viewrecord.php3frequester3dgs26collection3dtrd26recid3d017311540097ai,2674,2675,5349
7017,,h0q2wbgvl0yj,2675,2676,5351
7018,,eknlkc2negwj,2676,2677,5353
7019,,rgnxy_ylmiij,2677,2678,5355
7020,,6kljgzml0myj,2678,2679,5357
7021,,xc2h7fqgkfej,2679,2680,5359
7022,,2dxxpmrcdzgj,2680,2681,5361
7023,,fkt2jimzkusj,2681,2682,5363
7024,,paciwupjpwgj,2682,2683,5365
7025,,o3isulxqxtyj,2683,2684,5367
7026,,mrx0auccmuuj,2684,2685,5369
7027,,z-5f7hjxb0gj,2685,2686,5371
7028,,o56yquxwyd4j,2686,2687,5373
7029,,t3ttymohwaaj,2687,2688,5375
7030,,url:http://www.ncbi.nlm.nih.gov/entrez/query.fcgi3fcmd3dretrieve26db3dpubmed26list_uids3d74842026dopt3dcitation,2688,2689,5377
7031,,cjdc-_y5cwaj,2689,2690,5379
7032,,xg1lh5ko4lgj,2690,2691,5381
7033,,kcijzuxfivyj,2691,2692,5383
7034,,uetvqenrs0aj,2692,2693,5385
7035,,y74piivb_gmj,2693,2694,5387
7036,,mc2qynuupd4j,2694,2695,5389
7037,,ucedqhzuflcj,2695,2696,5391
7038,,vd2mpbrsqh0j,2697,2698,5395
7039,,74aglofxzu0j,2698,2699,5397
7040,,_ltubcdipfmj,2699,2700,5399
7041,,h_lkrk2jwbuj,2700,2701,5401
7042,,8glbsvvthnwj,2701,2702,5403
7043,,yvcoan13twkj,2702,2703,5405
7044,,1ryrjx_9tp0j,2703,2704,5407
7045,,7hw6tq2tg4aj,2704,2705,5409
7046,,ogxlabq_haoj,2705,2706,5411
7047,,8tudnizakogj,2706,2707,5413
7048,,url:http://portal.acm.org/ft_gateway.cfm3fid3d110191526type3dpdf,2707,2708,5415
7049,,4rivc2isii0j,2708,2709,5417
7050,,x-woxg_fbzij,2709,2710,5419
7051,,q_28fhu5z_sj,2710,2711,5421
7052,,rcpyizsv2joj,2711,2712,5423
7053,,jecbeik9osmj,2712,2713,5425
7054,,wucl1f6esuqj,2713,2714,5427
7055,,x5z4su4r5xmj,2714,2715,5429
7056,,h43toueilyaj,2715,2716,5431
7057,,efvkuukrk_oj,2716,2717,5433
7058,,caepdrtmd7sj,2717,2718,5435
7059,,0jcdc4bc0pgj,2718,2719,5437
7060,,re_si8i74igj,2719,2720,5439
7061,,jpggmrh9yigj,2720,2721,5441
7062,,gsveif7btrqj,2721,2722,5443
7063,,7sgbdgs9jfoj,2722,2723,5445
7064,,auiryslpsdmj,2723,2724,5447
7065,,n2m4k_dku-8j,2724,2725,5449
7066,,uxkjfik5tq4j,2725,2726,5451
7067,,zbedopgfn0kj,2726,2727,5453
7068,,j5txdfngl5qj,2727,2728,5455
7069,,p5su6bx79ksj,2728,2729,5457
7070,,4iteleefs9aj,2729,2730,5459
7071,,,2730,2731,5461
7072,,zfdgosx1srsj,2731,2732,5463
7073,,ip7d4nkgeogj,2732,2733,5465
7074,,mhuoedmf0n0j,2733,2734,5467
7075,,w6ght9xlt5oj,2734,2735,5469
7076,,pdn9g8kvhl8j,2735,2736,5471
7077,,eepnskwyxw0j,2736,2737,5473
7078,,mzmqkcllh28j,2737,2738,5475
7079,,5wn5kktndhkj,2738,2739,5477
7080,,qs0bruei-44j,2739,2740,5479
7081,,qv0x4gbs2dsj,2740,2741,5481
7082,,wrwx2xbqbdgj,2741,2742,5483
7083,,7isazaqxpouj,2742,2743,5485
7084,,ksjm0tk2-dwj,2743,2744,5487
7085,,wae30vix0waj,2744,2745,5489
7086,,xqxtv_zz7yaj,2745,2746,5491
7087,,ir6h-piul8mj,2746,2747,5493
7088,,azhnqrje3t8j,2747,2748,5495
7089,,kwl0vfhat4ej,2748,2749,5497
7090,,izzywqhd_k8j,2749,2750,5499
7091,,hq8kgaznn4qj,2750,2751,5501
7092,,f9dv57ns9ymj,2751,2752,5503
7093,,wggosg6mihuj,2752,2753,5505
7094,,wzbmxlwmo-wj,2753,2754,5507
7095,,edbbtlutuwyj,2754,2755,5509
7096,,fp2l-cbojuej,2755,2756,5511
7097,,url:http://portal.acm.org/citation.cfm3fid3d130298,2756,2757,5513
7098,,rd45hhafggcj,2757,2758,5515
7099,,9p3xd4bmpr4j,2758,2759,5517
7100,,yusskjd7jo8j,2759,2760,5519
7101,,ppa8ziawuhqj,2760,2761,5521
7102,,hc_vteosajcj,2761,2762,5523
7103,,cvbadevctskj,2762,2763,5525
7104,,gzkz_7wlec0j,2763,2764,5527
7105,,f7orj1chcpmj,2764,2765,5529
7106,,bw4lwzrttc8j,2765,2766,5531
7107,,kfkm90fxdbgj,2766,2767,5533
7108,,rmltyvadyj0j,2767,2768,5535
7109,,_bzfnclkpgwj,2768,2769,5537
7110,,7ei-clji2vwj,2769,2770,5539
7111,,rwiqbfvmarij,2770,2771,5541
7112,,ztk501c10_cj,2771,2772,5543
7113,,_rrmtz6wrtkj,2772,2773,5545
7114,,v_lwp8_-ouyj,2773,2774,5547
7115,,9yoxrrnzi38j,2774,2775,5549
7116,,_aus8w61gesj,2775,2776,5551
7117,,bthlg6kevvyj,2776,2777,5553
7118,,pp8khs7cct0j,2777,2778,5555
7119,,kh96ai8ia8wj,2778,2779,5557
7120,,hw7vdnilkryj,2779,2780,5559
7121,,-04aplta1nuj,2780,2781,5561
7122,,01oh0iebsr4j,2781,2782,5563
7123,,oegcpjsqy1wj,2782,2783,5565
7124,,ju8rogcqqcmj,2783,2784,5567
7125,,jreiz6ayv4ij,2784,2785,5569
7126,,xtqtfbwnsyoj,2785,2786,5571
7127,,6yglqgygp_ij,2786,2787,5573
7128,,s9kdvdh4ac8j,2787,2788,5575
7129,,bwv68w3kdpcj,2788,2789,5577
7130,,iuvocnil_eej,2789,2790,5579
7131,,yn9rlzgtooqj,2790,2791,5581
7132,,q97yjyzmwssj,2791,2792,5583
7133,,wh_yyarvvlyj,2792,2793,5585
7134,,wxfzjyqnxa8j,2793,2794,5587
7135,,kgtxyzkcwtyj,2795,2796,5591
7136,,n41_xh_8ghuj,2796,2797,5593
7137,,ointvors50oj,2797,2798,5595
7138,,bk_kmyqo3o8j,2798,2799,5597
7139,,knqio4ahzhqj,2799,2800,5599
7140,,ltdcxhdzoxkj,2800,2801,5601
7141,,3ggwnki9xj8j,2801,2802,5603
7142,,2bafas1gxwqj,2802,2803,5605
7143,,ik056r7svbyj,2803,2804,5607
7144,,aouqfnlduvuj,2804,2805,5609
7145,,p-rciy4xyyuj,2805,2806,5611
7146,,r_3niy7n55yj,2806,2807,5613
7147,,ie8of3tealuj,2807,2808,5615
7148,,x9vjyaswgdyj,2808,2809,5617
7149,,iduuqqpl1ksj,2809,2810,5619
7150,,nbw0dkgw67sj,2810,2811,5621
7151,,zmscggqaywej,2811,2812,5623
7152,,m2qxquac6tsj,2812,2813,5625
7153,,8nwed6inq1cj,2813,2814,5627
7154,,aerp5ebx2hoj,2814,2815,5629
7155,,zum5zkb2cegj,2815,2816,5631
7156,,vl2yhyzezdqj,2816,2817,5633
7157,,95harm0rb5oj,2817,2818,5635
7158,,z6p9-q5mgh8j,2818,2819,5637
7159,,tkewiq5_kyij,2819,2820,5639
7160,,7l0yddawhm0j,2820,2821,5641
7161,,dqzegt_abcyj,2821,2822,5643
7162,,4cqmu9igtcoj,2822,2823,5645
7163,,url:http://portal.acm.org/citation.cfm3fid3d335191.33548026coll3dguide26dl3dacm26idx3dj68926part3dperiodical26wanttype3dperiodical26title3dacm2520sigmod2520record26cfid3d1111111126cftoken3d2222222,2823,2824,5647
7164,,wz823oj6x3cj,2824,2825,5649
7165,,0jk5gucpw2sj,2825,2826,5651
7166,,awhtocrtthwj,2826,2827,5653
7167,,waa1snallc8j,2828,2829,5657
7168,,znj16s5hpqgj,2829,2830,5659
7169,,,2830,2831,5661
7170,,cmidn_4ctzmj,2831,2832,5663
7171,,vyn1kxjm5fyj,2832,2833,5665
7172,,uyck3gweo1qj,2833,2834,5667
7173,,rt_xm01xs5qj,2834,2835,5669
7174,,unnawisbco0j,2835,2836,5671
7175,,g_69sbfpqzej,2836,2837,5673
7176,,tavbwbknvrwj,2837,2838,5675
7177,,u315n241t6sj,2838,2839,5677
7178,,cwohmfku6w8j,2839,2840,5679
7179,,kbl6eml3amij,2840,2841,5681
7180,,dd798tkpqqej,2841,2842,5683
7181,,qb1phbpt2soj,2842,2843,5685
7182,,gbdga4lxun0j,2843,2844,5687
7183,,url:http://www.csa.com/partners/viewrecord.php3frequester3dgs26collection3denv26recid3d8913239,2844,2845,5689
7184,,clqeolt55puj,2845,2846,5691
7185,,3watociinrej,2846,2847,5693
7186,,0qrjmsdc2fyj,2847,2848,5695
7187,,gtnc2vvggsqj,2848,2849,5697
7188,,_ug0biptkxwj,2849,2850,5699
7189,,lembiodw1jwj,2850,2851,5701
7190,,oxl22gygzw4j,2851,2852,5703
7191,,arr79nerkeuj,2852,2853,5705
7192,,uajzbcssea8j,2853,2854,5707
7193,,ima7y_0rxeuj,2854,2855,5709
7194,,39_6agye8m0j,2855,2856,5711
7195,,url:http://links.jstor.org/sici3fsici3d0146-4949(196721)8253a2253c318253ab253e2.0.co253b2-l,2856,2857,5713
7196,,tyzxvrangtsj,2857,2858,5715
7197,,bdkjdw0cclwj,2858,2859,5717
7198,,y0hxub5qzkyj,2859,2860,5719
7199,,espmdmlbguej,2860,2861,5721
7200,,iupevpiddgcj,2861,2862,5723
7201,,url:http://www.csa.com/partners/viewrecord.php3frequester3dgs26collection3dtrd26recid3d0293387ci,2862,2863,5725
7202,,sq7svpyh1uyj,2863,2864,5727
7203,,oiikp2fzxjoj,2865,2866,5731
7204,,hkg0jfhvfsoj,2866,2867,5733
7205,,gz9lsaqwz7sj,2867,2868,5735
7206,,url:http://www.springerlink.com/index/p48g4975m14j7262.pdf,2868,2869,5737
7207,,lq9cls4tlmij,2869,2870,5739
7208,,dfmubmndaguj,2870,2871,5741
7209,,url:http://portal.acm.org/ft_gateway.cfm3fid3d100767926type3dpdf,2871,2872,5743
7210,,scr_irh3_kqj,2872,2873,5745
7211,,txk0fb4pkymj,2873,2874,5747
7212,,6e1tpxbxboij,2874,2875,5749
7213,,2nqddcg3udkj,2875,2876,5751
7214,,8-usisligmmj,2876,2877,5753
7215,,l_s8ckhkdsij,2877,2878,5755
7216,,_mx2ce7izuej,2878,2879,5757
7217,,0crvfnyulr4j,2879,2880,5759
7218,,gmz9z-vl0t8j,2882,2883,5765
7219,,csnldcvpku4j,2883,2884,5767
7220,,6jcptpcjzdaj,2884,2885,5769
7221,,axlbctu-vc4j,2885,2886,5771
7222,,kjsvccmapyqj,2886,2887,5773
7223,,_hgza5qg5-kj,2887,2888,5775
7224,,xyqmzdkjxeej,2888,2889,5777
7225,,spirpyz5npsj,2889,2890,5779
7226,,1uqj7t_zjswj,2890,2891,5781
7227,,url:http://doi.wiley.com/10.1002/tl.179,2891,2892,5783
7228,,nsmcro_yemej,2892,2893,5785
7229,,l5xhyqoujksj,2893,2894,5787
7230,,gos33pan8fsj,2894,2895,5789
7231,,ghsa7frkvzqj,2895,2896,5791
7232,,ouxebxtjaxej,2896,2897,5793
7233,,imbqrqkckpwj,2897,2898,5795
7234,,exfzie0hud4j,2898,2899,5797
7235,,ltn7vyz62ygj,2899,2900,5799
7236,,0ospbw-wrauj,2900,2901,5801
7237,,j8maiu6cf0ej,2901,2902,5803
7238,,t5yancqlxtmj,2902,2903,5805
7239,,bmjkyk7nlooj,2903,2904,5807
7240,,qfuy3uxbiqej,2904,2905,5809
7241,,xhos8mmblymj,2905,2906,5811
7242,,ws6aibrcqhij,2906,2907,5813
7243,,zjlo3jgdcq0j,2907,2908,5815
7244,,no4ahsogkjij,2908,2909,5817
7245,,url:http://adsabs.harvard.edu/abs/1976phdt........13s,2909,2910,5819
7246,,sfg02wokgquj,2910,2911,5821
7247,,2lqbky793jij,2911,2912,5823
7248,,aemklv9kbg8j,2912,2913,5825
7249,,06xr58hlydwj,2913,2914,5827
7250,,z7jmewwhv8sj,2914,2915,5829
7251,,2-jnvu2tipuj,2915,2916,5831
7252,,url:http://portal.acm.org/ft_gateway.cfm3fid3d106622226type3dpdf,2916,2917,5833
7253,,hmjfo295reaj,2917,2918,5835
7254,,fsjaytb95kmj,2918,2919,5837
7255,,vrilj6eptwyj,2919,2920,5839
7256,,3bea_0au2usj,2920,2921,5841
7257,,ry6mz_semqej,2921,2922,5843
7258,,url:http://adsabs.harvard.edu/abs/1982mit..repts....c,2922,2923,5845
7259,,9p26ehrk5maj,2923,2924,5847
7260,,l2wsxuxgvwyj,2924,2925,5849
7261,,bugimgtwlasj,2925,2926,5851
7262,,cc1sta6ai2wj,2926,2927,5853
7263,,ytrfs_upf-0j,2927,2928,5855
7264,,bb3nxhp-7qmj,2928,2929,5857
7265,,k2fdwsqu7v4j,2929,2930,5859
7266,,5z159tnejcej,2930,2931,5861
7267,,jmejpskpsb8j,2931,2932,5863
7268,,a23y10bkjm0j,2932,2933,5865
7269,,ayiqxybdsikj,2933,2934,5867
7270,,url:http://www.csa.com/partners/viewrecord.php3frequester3dgs26collection3dtrd26recid3d200111000456mt26recid3da0032612ah,2934,2935,5869
7271,,rkocjx5mrncj,2935,2936,5871
7272,,x7qhlfhyih0j,2936,2937,5873
7273,,y5aijnfu6jij,2937,2938,5875
7274,,299p7potq1qj,2938,2939,5877
7275,,8y-rc5nqsvwj,2939,2940,5879
7276,,ok7eopebaz4j,2940,2941,5881
7277,,ua6xidc7o1gj,2941,2942,5883
7278,,6kcah2wztrej,2942,2943,5885
7279,,eyl8gnuvxduj,2943,2944,5887
7280,,agp9vfllif0j,2944,2945,5889
7281,,aujcv1hprouj,2945,2946,5891
7282,,0xl1cvdqlvwj,2946,2947,5893
7283,,a452kfacnaej,2947,2948,5895
7284,,qncikbomqgcj,2948,2949,5897
7285,,balzphviykwj,2949,2950,5899
7286,,url:http://portal.acm.org/ft_gateway.cfm3fid3d76521926type3dpdf26dl3dguide26dl3dacm26cfid3d1111111126cftoken3d2222222,2950,2951,5901
7287,,xcj16qad00wj,2951,2952,5903
7288,,y4ctselnqmgj,2952,2953,5905
7289,,p8sxnfneh58j,2953,2954,5907
7290,,me0g94kbgbej,2954,2955,5909
7291,,qcaulqtvvbcj,2955,2956,5911
7292,,8qorevtl6ooj,2956,2957,5913
7293,,5ojaifngbf8j,2958,2959,5917
7294,,vketm4e79yij,2959,2960,5919
7295,,q5d6d90kpjcj,2960,2961,5921
7296,,-0ovj6jcs7mj,2961,2962,5923
7297,,u3uz3v0w3bkj,2962,2963,5925
7298,,ax88lzypylwj,2963,2964,5927
7299,,eypvq5rc8goj,2964,2965,5929
7300,,emoaua8xqwij,2965,2966,5931
7301,,miwdfcavb_kj,2966,2967,5933
7302,,wuechieb0swj,2967,2968,5935
7303,,ldph_uowyc8j,2968,2969,5937
7304,,url:http://portal.acm.org/ft_gateway.cfm3fid3d110131026type3dpdf,2969,2970,5939
7305,,ino1c1lm5hej,2970,2971,5941
7306,,4dyugxdsvuuj,2971,2972,5943
7307,,9pvh4amyhzmj,2972,2973,5945
7308,,url:http://www.csa.com/partners/viewrecord.php3frequester3dgs26collection3dtrd26recid3d0010660ea,2973,2974,5947
7309,,url:http://doi.wiley.com/10.1002/tl.187,2974,2975,5949
7310,,zpslvcgkfiaj,2975,2976,5951
7311,,vi_f8ie7uk0j,2976,2977,5953
7312,,koh0xcxknemj,2977,2978,5955
7313,,yoosgwyszdej,2978,2979,5957
7314,,bqeesvp1gekj,2979,2980,5959
7315,,ayx5ay5c-jqj,2980,2981,5961
7316,,kxxr-ozflmqj,2981,2982,5963
7317,,pqimqxuqyjkj,2982,2983,5965
7318,,tesgluwsoxyj,2983,2984,5967
7319,,mppeakbd-ccj,2985,2986,5971
7320,,5ugbv3uklfij,2986,2987,5973
7321,,age_gfvxx7aj,2987,2988,5975
7322,,e-0j5fkhjouj,2988,2989,5977
7323,,7veuzxgn21gj,2989,2990,5979
7324,,v50zhzvwrnmj,2990,2991,5981
7325,,uja-cmathqgj,2991,2992,5983
7326,,url:http://ieeexplore.ieee.org/iel5/35/23768/01090996.pdf3farnumber3d1090996,2992,2993,5985
7327,,rlkqblrwqhij,2993,2994,5987
7328,,xt4flnqua48j,2994,2995,5989
7329,,moyjw_l-fbwj,2995,2996,5991
7330,,eqxobb8gkkqj,2996,2997,5993
7331,,wztqw70w9q4j,2997,2998,5995
7332,,9gvrfzxiz5uj,2998,2999,5997
7333,,hdxxiq96bryj,2999,3000,5999
7334,,ufcoivkdze8j,3000,3001,6001
7335,,s62qcau8vxkj,3001,3002,6003
7336,,ewvfc8br_5cj,3002,3003,6005
7337,,6ryxyuepokqj,3003,3004,6007
7338,,sncxc7s0xcij,3004,3005,6009
7339,,6d6po7lmpl0j,3005,3006,6011
7340,,ju74aluff-uj,3006,3007,6013
7341,,ombm_6rur54j,3007,3008,6015
7342,,llivrzosw2qj,3008,3009,6017
7343,,whpuriu0-dij,3009,3010,6019
7344,,eqvhtftsgikj,3010,3011,6021
7345,,cjsksgdi8psj,3011,3012,6023
7346,,n0bjfjyufdcj,3012,3013,6025
7347,,ejawfl00frsj,3013,3014,6027
7348,,_ecqzacexr8j,3014,3015,6029
7349,,h5_cjdfvqpcj,3015,3016,6031
7350,,-4ur6g523i0j,3016,3017,6033
7351,,_jhmq-z-gowj,3017,3018,6035
7352,,9mcy8ttwh70j,3019,3020,6039
7353,,agfywlcgqvyj,3020,3021,6041
7354,,isb1jznl48oj,3021,3022,6043
7355,,k4lcigaz6i4j,3022,3023,6045
7356,,grsjszfztlyj,3023,3024,6047
7357,,6c7qza7a-noj,3024,3025,6049
7358,,quwp7jqcqn8j,3025,3026,6051
7359,,vt5lxbwweo8j,3026,3027,6053
7360,,jvcdn51gxdij,3027,3028,6055
7361,,cbyrb0dud7sj,3028,3029,6057
7362,,url:http://links.jstor.org/sici3fsici3d0146-4949(196522)6253a2253c177253aowgiro253e2.0.co253b2-p,3029,3030,6059
7363,,eugotxgttxmj,3030,3031,6061
7364,,gcs43jo-wdyj,3031,3032,6063
7365,,,3032,3033,6065
7366,,scl7yq9qwkoj,3033,3034,6067
7367,,yfrgsdmkwuyj,3034,3035,6069
7368,,brmimsc6k7uj,3035,3036,6071
7369,,mfyusydsgcmj,3036,3037,6073
7370,,vaj3zrlo8umj,3037,3038,6075
7371,,url:http://portal.acm.org/citation.cfm3fid3d171926.172013,3038,3039,6077
7372,,b73xx0snra4j,3039,3040,6079
7373,,d1rdxkp6_6yj,3040,3041,6081
7374,,9floz2a_9xmj,3041,3042,6083
7375,,mgp-m7wgruuj,3042,3043,6085
7376,,hf1hngpne_gj,3043,3044,6087
7377,,url:http://www.springerlink.com/index/t41121pp41071878.pdf,3044,3045,6089
7378,,wwqkdjlsfcuj,3045,3046,6091
7379,,w6w3hnnkvcyj,3046,3047,6093
7380,,mvz5gsjvmkwj,3047,3048,6095
7381,,7rbiai_26p8j,3048,3049,6097
7382,,us49wzjs6u0j,3049,3050,6099
7383,,,3050,3051,6101
7384,,bdpycro2ok8j,3051,3052,6103
7385,,0-g78ioxas0j,3052,3053,6105
7386,,ld6qs2g-ozoj,3053,3054,6107
7387,,wai46rqi7t8j,3054,3055,6109
7388,,url:http://www.csa.com/partners/viewrecord.php3frequester3dgs26collection3dtrd26recid3d0080818ci,3055,3056,6111
7389,,pnoir5u1ubkj,3056,3057,6113
7390,,toqkgujt00qj,3057,3058,6115
7391,,c1wxexcpfsyj,3058,3059,6117
7392,,7m8hq2zy4b0j,3059,3060,6119
7393,,lbcfccnjslsj,3060,3061,6121
7394,,tgzdrsic_7uj,3061,3062,6123
7395,,iujae2ietdgj,3062,3063,6125
7396,,to3no9vs0ikj,3063,3064,6127
7397,,exnus5t5tgkj,3064,3065,6129
7398,,url:http://adsabs.harvard.edu/abs/1981mit..repts....f,3065,3066,6131
7399,,jxclqzln5sgj,3066,3067,6133
7400,,lfahbmjhyamj,3067,3068,6135
7401,,dhazj9avzaaj,3068,3069,6137
7402,,_zrregcbxjaj,3069,3070,6139
7403,,gohierlhy74j,3070,3071,6141
7404,,v9karvijksaj,3071,3072,6143
7405,,z6matju3nsmj,3072,3073,6145
7406,,i7f4nk4g9wgj,3073,3074,6147
7407,,d_-0boso1bcj,3074,3075,6149
7408,,3vswwmvcpagj,3075,3076,6151
7409,,url:http://www.csa.com/partners/viewrecord.php3frequester3dgs26collection3dtrd26recid3d20021214040859mt26recid3da7340041ah,3076,3077,6153
7410,,pofgzajegt4j,3077,3078,6155
7411,,vj5ujcuvp1yj,3078,3079,6157
7412,,nhxrijmeudej,3079,3080,6159
7413,,x7-5eknqc2cj,3080,3081,6161
7414,,b9ey7z1gs2ij,3081,3082,6163
7415,,pgxxdqrocayj,3082,3083,6165
7416,,9rez-x5anqqj,3083,3084,6167
7417,,mihswkygr78j,3084,3085,6169
7418,,f2mmoq6crgmj,3085,3086,6171
7419,,nqhgock2oo0j,3086,3087,6173
7420,,hwpvikjd9kwj,3087,3088,6175
7421,,oyfpmlm5ycqj,3088,3089,6177
7422,,,3089,3090,6179
7423,,xnqmamvktaej,3090,3091,6181
7424,,nskcvuwu5duj,3091,3092,6183
7425,,tvosmrwaq40j,3092,3093,6185
7426,,qfy5vrbpjb8j,3093,3094,6187
7427,,yustijvrr_ij,3094,3095,6189
7428,,pgzcabl76dqj,3095,3096,6191
7429,,e5bqoqfndrqj,3096,3097,6193
7430,,iw75qyh_cesj,3097,3098,6195
7431,,gn0ooqairguj,3098,3099,6197
7432,,w4p6e5w_yxwj,3099,3100,6199
7433,,woa3bhlvqigj,3100,3101,6201
7434,,t4pztzbs4s8j,3101,3102,6203
7435,,mi5y0yq65fkj,3102,3103,6205
7436,,vgfdy2gg8ysj,3103,3104,6207
7437,,b8l78hc27qoj,3104,3105,6209
7438,,yenncta0nnoj,3105,3106,6211
7439,,knaimlorhvwj,3106,3107,6213
7440,,byaoc93glsuj,3107,3108,6215
7441,,2d-pftfmghoj,3108,3109,6217
7442,,gzz2xu0xa_yj,3109,3110,6219
7443,,gy2d6fzqeiaj,3110,3111,6221
7444,,ctedyjrdtbkj,3111,3112,6223
7445,,ejovamydttgj,3112,3113,6225
7446,,3n0a2cl2kdoj,3113,3114,6227
7447,,1l_gjl6dgdsj,3114,3115,6229
7448,,zetsla5ykmoj,3115,3116,6231
7449,,2oq3vqwsrssj,3116,3117,6233
7450,,6grha-dbqwwj,3117,3118,6235
7451,,vtx2crpjunmj,3118,3119,6237
7452,,dmcrndwoby4j,3119,3120,6239
7453,,5lbur47ewpkj,3120,3121,6241
7454,,mdox2wxt-coj,3121,3122,6243
7455,,bgbigyjaq1sj,3122,3123,6245
7456,,gimonew1zbej,3123,3124,6247
7457,,9bahtsn-3_sj,3124,3125,6249
7458,,359pjjkfnhqj,3125,3126,6251
7459,,oz5wa54qytgj,3126,3127,6253
7460,,uw_ijawcrgqj,3127,3128,6255
7461,,nv4ev-rlfvij,3128,3129,6257
7462,,otkt7jjjnjkj,3129,3130,6259
7463,,url:http://adsabs.harvard.edu/abs/1991phdt........69s,3130,3131,6261
7464,,url:http://doi.wiley.com/10.1002/tl.171,3131,3132,6263
7465,,-11qij5-_ycj,3133,3134,6267
7466,,elia2ufoquwj,3134,3135,6269
7467,,dqddlealdqkj,3135,3136,6271
7468,,5dd517rhkg8j,3136,3137,6273
7469,,rfaun_umpfqj,3138,3139,6277
7470,,1ch42dal6-oj,3139,3140,6279
7471,,sgkwfoadspoj,3140,3141,6281
7472,,url:http://portal.acm.org/citation.cfm3fid3d170105,3141,3142,6283
7473,,tjjzglcajbmj,3142,3143,6285
7474,,pi0igecpcqwj,3143,3144,6287
7475,,qdmps7pt2xej,3144,3145,6289
7476,,6skbmcfnf90j,3145,3146,6291
7477,,yukk52rxf60j,3146,3147,6293
7478,,uq6kb_z7ywgj,3147,3148,6295
7479,,0xtbi-ppm_qj,3148,3149,6297
7480,,l7mqrk2tp3oj,3149,3150,6299
7481,,url:http://www.csa.com/partners/viewrecord.php3frequester3dgs26collection3dtrd26recid3dn9210424ah,3150,3151,6301
7482,,sr1kf1fjodaj,3151,3152,6303
7483,,heicmolh9ywj,3152,3153,6305
7484,,eyzo4asncgej,3153,3154,6307
7485,,pueja_97b6yj,3154,3155,6309
7486,,-0knh5xcoguj,3155,3156,6311
7487,,6ituoubviemj,3156,3157,6313
7488,,fxnknozfbioj,3157,3158,6315
7489,,noylw_42hzqj,3158,3159,6317
7490,,ka_b_f6l3hyj,3159,3160,6319
7491,,kugpcztc3omj,3160,3161,6321
7492,,jqo2iwk-gv8j,3161,3162,6323
7493,,9ules0u4kkqj,3162,3163,6325
7494,,dr6lliyu4k0j,3163,3164,6327
7495,,tbl3dkje0jwj,3164,3165,6329
7496,,_ju14napaisj,3165,3166,6331
7497,,opyveqojhhkj,3166,3167,6333
7498,,gouz-7q2rruj,3167,3168,6335
7499,,aea2hsqjdfmj,3168,3169,6337
7500,,,3169,3170,6339
7501,,b0qwfjeefpij,3170,3171,6341
7502,,6w_4u6ca9wij,3171,3172,6343
7503,,5rdsm4borl0j,3172,3173,6345
7504,,8mtffsrd80cj,3173,3174,6347
7505,,yzjlokoaokkj,3174,3175,6349
7506,,q9_l2bqj5y4j,3175,3176,6351
7507,,ldi7rlwlek4j,3176,3177,6353
7508,,kuzvajczbucj,3177,3178,6355
7509,,url:http://portal.acm.org/ft_gateway.cfm3fid3d58239126type3dpdf26dl3dguide26dl3dguide26cfid3d1111111126cftoken3d2222222,3179,3180,6359
7510,,_anyhrnp3coj,3180,3181,6361
7511,,eqv8xwc32wmj,3181,3182,6363
7512,,calkkutqf5sj,3182,3183,6365
7513,,eaaivsc9layj,3183,3184,6367
7514,,wie86e0f_rqj,3184,3185,6369
7515,,bmvpzgfdydej,3185,3186,6371
7516,,vmnkvvcuq-yj,3186,3187,6373
7517,,t4rbejw8oxmj,3187,3188,6375
7518,,m1hmhs7lgpuj,3188,3189,6377
7519,,n00bc-yi99yj,3189,3190,6379
7520,,4ps_ifsjng4j,3190,3191,6381
7521,,na4ezx8af68j,3191,3192,6383
7522,,i3s6n-gmilqj,3192,3193,6385
7523,,vo7abwspoymj,3193,3194,6387
7524,,sm0kokxwrbqj,3194,3195,6389
7525,,vi-8gdwz-bgj,3195,3196,6391
7526,,pfkzsvrwfe4j,3196,3197,6393
7527,,_oi_jfhps5ej,3197,3198,6395
7528,,hfeqzvod9tsj,3198,3199,6397
7529,,url:http://www.springerlink.com/index/m425p134j727x72u.pdf,3199,3200,6399
7530,,1ke8l4nskz8j,3200,3201,6401
7531,,m2kphhgdryij,3201,3202,6403
7532,,0agitjqfktsj,3202,3203,6405
7533,,o8hyzig4cfqj,3203,3204,6407
7534,,782hkuqd49wj,3204,3205,6409
7535,,8dh2kx1mgtij,3205,3206,6411
7536,,3w27rba0ntuj,3206,3207,6413
7537,,ji45a23qbjyj,3207,3208,6415
7538,,vcq4eq7im0gj,3208,3209,6417
7539,,cqbpn5vxwy4j,3209,3210,6419
7540,,sb2a1zyv2l4j,3210,3211,6421
7541,,pyr9gxc-me4j,3211,3212,6423
7542,,3shigrrrl5qj,3212,3213,6425
7543,,url:http://www.csa.com/partners/viewrecord.php3frequester3dgs26collection3dtrd26recid3d155939ws26recid3d199301550073md,3213,3214,6427
7544,,vsqlfmhgao8j,3214,3215,6429
7545,,ypzxqdkonioj,3215,3216,6431
7546,,h_ykj8kquygj,3217,3218,6435
7547,,pgywgowqtmyj,3218,3219,6437
7548,,w3i8_mfdf08j,3219,3220,6439
7549,,43b8e16yzlej,3220,3221,6441
7550,,wndsgurvptej,3221,3222,6443
7551,,jxij0miqsf0j,3222,3223,6445
7552,,g15qtb-qjy0j,3223,3224,6447
7553,,j8r6yuvq45aj,3224,3225,6449
7554,,url:http://ieeexplore.ieee.org/iel2/3038/8631/00379945.pdf3farnumber3d379945,3225,3226,6451
7555,,petxvg1glkij,3226,3227,6453
7556,,ydzlddvemfyj,3227,3228,6455
7557,,p7hivxg2fa4j,3228,3229,6457
7558,,url:http://pubs.acs.org/cgi-bin/abstract.cgi/achre4/2005/38/i12/abs/ar040287v.html,3229,3230,6459
7559,,5y4hrdjuizwj,3230,3231,6461
7560,,mrmhtune6iej,3231,3232,6463
7561,,uqy439hxmegj,3232,3233,6465
7562,,r1wzekkybokj,3233,3234,6467
7563,,9cdasz2p9wsj,3234,3235,6469
7564,,url:http://links.jstor.org/sici3fsici3d0146-4949(196523)6253a3253c308253apia2522253e2.0.co253b2-m,3235,3236,6471
7565,,hadscilgpraj,3236,3237,6473
7566,,v2qfwv-frmsj,3237,3238,6475
7567,,_s0fkouqny0j,3238,3239,6477
7568,,qcmdhx3yzryj,3239,3240,6479
7569,,oeiq-tb95buj,3240,3241,6481
7570,,dxuivnfpmxgj,3241,3242,6483
7571,,sdmaxzujk00j,3242,3243,6485
7572,,uz-28qfwifaj,3243,3244,6487
7573,,bc6i92qaz0yj,3244,3245,6489
7574,,nspf_vz0ycuj,3245,3246,6491
7575,,cmcp4ralgl8j,3246,3247,6493
7576,,dfzzjlxntwoj,3247,3248,6495
7577,,f1h0j1_elisj,3248,3249,6497
7578,,esoiwzemxcej,3249,3250,6499
7579,,4h2plsrv1akj,3250,3251,6501
7580,,rb9kmmfbmcej,3251,3252,6503
7581,,iovvpkxl_b8j,3252,3253,6505
7582,,lcywimm7e3qj,3253,3254,6507
7583,,url:http://portal.acm.org/ft_gateway.cfm3fid3d102761826type3dpdf,3254,3255,6509
7584,,kdzpqrxmthwj,3255,3256,6511
7585,,r3l9pgurq3gj,3256,3257,6513
7586,,jnspiinpcsqj,3257,3258,6515
7587,,akrnu6jash0j,3258,3259,6517
7588,,qzfgi7qy1jsj,3259,3260,6519
7589,,6qzgekna5lgj,3260,3261,6521
7590,,rhzhau3q02sj,3261,3262,6523
7591,,ndbg3wrigpgj,3262,3263,6525
7592,,g23jbwx6-esj,3263,3264,6527
7593,,url:http://portal.acm.org/ft_gateway.cfm3fid3d80838526type3dpdf26dl3dguide26dl3dacm26cfid3d1111111126cftoken3d2222222,3264,3265,6529
7594,,b-ljy-oftc8j,3265,3266,6531
7595,,dnomn0y1tz8j,3266,3267,6533
7596,,gmcfpzpwmykj,3267,3268,6535
7597,,cwleleucrqcj,3269,3270,6539
7598,,frvexbqtddij,3270,3271,6541
7599,,kgxbddus4zsj,3271,3272,6543
7600,,eaykgzhsqg0j,3273,3274,6547
7601,,url:http://portal.acm.org/ft_gateway.cfm3fid3d101251926type3dpdf,3274,3275,6549
7602,,iwm2gexnqlkj,3275,3276,6551
7603,,fog28havfuyj,3276,3277,6553
7604,,xwzoolb-zmij,3277,3278,6555
7605,,zd9rjxme-kij,3278,3279,6557
7606,,sqvfyxrm9vcj,3279,3280,6559
7607,,7zorihemjicj,3280,3281,6561
7608,,eubvkzgq338j,3281,3282,6563
7609,,pqs6zikuqa0j,3282,3283,6565
7610,,alsm1_unquoj,3283,3284,6567
7611,,c3_0xbwjqeuj,3284,3285,6569
7612,,ue1-rlsfoqqj,3285,3286,6571
7613,,wpi1_a2zp6sj,3286,3287,6573
7614,,b-3q12qwrjoj,3287,3288,6575
7615,,lolcgk-91eij,3288,3289,6577
7616,,zasozxjvclmj,3289,3290,6579
7617,,hq71aa2hmw8j,3290,3291,6581
7618,,qd5wblbzin4j,3291,3292,6583
7619,,jyj1qp_gcvej,3293,3294,6587
7620,,ujsd84aylqwj,3294,3295,6589
7621,,6l5p1liywumj,3295,3296,6591
7622,,0kndsf__y_cj,3296,3297,6593
7623,,cj241f5pxoij,3297,3298,6595
7624,,0xa-sph829gj,3298,3299,6597
7625,,kkhcythe3ocj,3299,3300,6599
7626,,fcnbjt2aocyj,3300,3301,6601
7627,,7q277xk_mbij,3301,3302,6603
7628,,bsdtyynapagj,3302,3303,6605
7629,,6p5n4cuo03cj,3303,3304,6607
7630,,m1lheaesasaj,3304,3305,6609
7631,,r9y9vlhcdauj,3305,3306,6611
7632,,gxafqaqqg44j,3306,3307,6613
7633,,sdnehlhii5wj,3307,3308,6615
7634,,zfpws0en3usj,3308,3309,6617
7635,,g9figh5dun4j,3309,3310,6619
7636,,mgnzdigspnsj,3310,3311,6621
7637,,xnf3avlgesmj,3311,3312,6623
7638,,x4ujyj4ydb8j,3312,3313,6625
7639,,okwmzzzf-goj,3313,3314,6627
7640,,d6jy9iz-skgj,3314,3315,6629
7641,,g6lg_gfkkmcj,3315,3316,6631
7642,,irogu5xidi8j,3316,3317,6633
7643,,jfedpk6r9usj,3317,3318,6635
7644,,oghdejo1rgqj,3318,3319,6637
7645,,_ar1fmwbtzgj,3320,3321,6641
7646,,1xwn2q5vivyj,3321,3322,6643
7647,,u_uc8qmpv9qj,3322,3323,6645
7648,,izwxbpfz_fgj,3323,3324,6647
7649,,qqjolmt8emuj,3324,3325,6649
7650,,szcemhldeuyj,3325,3326,6651
7651,,a8isdvk6loej,3326,3327,6653
7652,,mikxvadjhhqj,3327,3328,6655
7653,,14cgu3tahtgj,3328,3329,6657
7654,,whdcfpob2swj,3329,3330,6659
7655,,dl7q_urnqjaj,3330,3331,6661
7656,,fmedo6tquewj,3332,3333,6665
7657,,pvxvrietzbyj,3333,3334,6667
7658,,uqwioljzxz4j,3334,3335,6669
7659,,vz9uepxcmkej,3335,3336,6671
7660,,orqtfwii3fej,3336,3337,6673
7661,,0grylt5ro14j,3337,3338,6675
7662,,zyhhgt8p5p8j,3338,3339,6677
7663,,fzn0t1w2-8mj,3339,3340,6679
7664,,cp_a2dfkcp8j,3340,3341,6681
7665,,v0swfcjcqoqj,3341,3342,6683
7666,,6d2fvrvqv14j,3342,3343,6685
7667,,mgxjm2zkyvqj,3343,3344,6687
7668,,v96aue1u9n0j,3344,3345,6689
7669,,7vtp4pgopagj,3345,3346,6691
7670,,uowwftofr1ej,3346,3347,6693
7671,,wzznazzo9hsj,3347,3348,6695
7672,,sxrhsq3uk_gj,3348,3349,6697
7673,,ptlvhqvy4bkj,3349,3350,6699
7674,,zx_w8gk6jzsj,3350,3351,6701
7675,,url:http://www.csa.com/partners/viewrecord.php3frequester3dgs26collection3dtrd26recid3dn9210394ah,3351,3352,6703
7676,,bifon4xyhquj,3352,3353,6705
7677,,mqosfeua8tqj,3353,3354,6707
7678,,pvf8b3ju0ogj,3354,3355,6709
7679,,t948ixuvi5sj,3355,3356,6711
7680,,ljqpynqjnemj,3356,3357,6713
7681,,dp-zdiik4nuj,3357,3358,6715
7682,,1ruc7dx0gs0j,3358,3359,6717
7683,,gipngr_7mp4j,3359,3360,6719
7684,,xcejyzq2d3cj,3360,3361,6721
7685,,eshy5nsevrwj,3361,3362,6723
7686,,2echagxkrqij,3362,3363,6725
7687,,up17yocnsfsj,3363,3364,6727
7688,,djxk7frvdugj,3364,3365,6729
7689,,ywhfhcn9z9yj,3365,3366,6731
7690,,zx9dxib8u2mj,3366,3367,6733
7691,,url:http://links.jstor.org/sici3fsici3d0146-4949(196721)8253a2253c165253ataafin253e2.0.co253b2-4,3367,3368,6735
7692,,lbdoulvkskuj,3368,3369,6737
7693,,n4ym9hkthwyj,3369,3370,6739
7694,,_vevqbtvrfcj,3370,3371,6741
7695,,32qhilqolm4j,3371,3372,6743
7696,,pd4mq54bbbaj,3372,3373,6745
7697,,gslh6mjubtej,3373,3374,6747
7698,,cdhtlz7lxz4j,3374,3375,6749
7699,,limrbeatjmqj,3375,3376,6751
7700,,_axrkdzslkaj,3376,3377,6753
7701,,zrs7dwaknyij,3377,3378,6755
7702,,bdlk5nuxha4j,3378,3379,6757
7703,,lbiby_katecj,3379,3380,6759
7704,,zynq8frmy1wj,3380,3381,6761
7705,,klexs6pnnxuj,3381,3382,6763
7706,,sagytt3uenoj,3382,3383,6765
7707,,ymleoydmopmj,3383,3384,6767
7708,,wggi1p9n4xoj,3384,3385,6769
7709,,i6wkiqczaocj,3385,3386,6771
7710,,mmeljh-oi5yj,3386,3387,6773
7711,,kkk-jgcvjwij,3387,3388,6775
7712,,w2ptollwqsoj,3388,3389,6777
7713,,pri8gsf1fgmj,3389,3390,6779
7714,,mkbnc6vkgrmj,3390,3391,6781
7715,,jlcz0mqwme4j,3391,3392,6783
7716,,ecigdul4w3gj,3392,3393,6785
7717,,lboee-zlaggj,3393,3394,6787
7718,,url:http://portal.acm.org/citation.cfm3fid3d234286.1053425,3394,3395,6789
7719,,7qsmmumkmo4j,3395,3396,6791
7720,,2w2qkhr3k3kj,3396,3397,6793
7721,,xiuzbl3p940j,3397,3398,6795
7722,,l0q2pgxyquuj,3398,3399,6797
7723,,cxi7wtbtnc4j,3399,3400,6799
7724,,url:http://www.csa.com/partners/viewrecord.php3frequester3dgs26collection3denv26recid3d8913267,3401,3402,6803
7725,,nbyfiqqaejej,3402,3403,6805
7726,,tm0evqx4i0yj,3403,3404,6807
7727,,url:http://www.csa.com/partners/viewrecord.php3frequester3dgs26collection3dtrd26recid3d200111010682mt26recid3da0032596ah,3404,3405,6809
7728,,url:http://www.csa.com/partners/viewrecord.php3frequester3dgs26collection3dtrd26recid3d017210530377xai,3405,3406,6811
7729,,gedrsfaenjaj,3407,3408,6815
7730,,w123v6mfcsej,3408,3409,6817
7731,,ofbd3gyj9rwj,3409,3410,6819
7732,,wtx6ifey7eej,3410,3411,6821
7733,,url:http://doi.wiley.com/10.1002/anie.198308881,3411,3412,6823
7734,,7u5cflsq0voj,3412,3413,6825
7735,,18aj40tccusj,3413,3414,6827
7736,,yu4r2c0abesj,3414,3415,6829
7737,,_rotkb0vlekj,3415,3416,6831
7738,,pvlp1xusvikj,3416,3417,6833
7739,,hnu2qdhbvz4j,3417,3418,6835
7740,,o3oby3fu-agj,3418,3419,6837
7741,,xi-vf4gucmoj,3419,3420,6839
7742,,azn4p4oa4xij,3420,3421,6841
7743,,i-ihplh1cqwj,3421,3422,6843
7744,,e4nrpxgg6hmj,3422,3423,6845
7745,,uvysrm52tbkj,3423,3424,6847
7746,,4tvki-xpqicj,3424,3425,6849
7747,,lnv_4hgpmsoj,3425,3426,6851
7748,,rx3ih2rrpskj,3426,3427,6853
7749,,gropvl4lhlkj,3427,3428,6855
7750,,yj44hjr2ydwj,3428,3429,6857
7751,,0jbuimnnq6ij,3429,3430,6859
7752,,wlfe2mlk2-kj,3430,3431,6861
7753,,wj5co-yauhoj,3431,3432,6863
7754,,qy81iq6f3msj,3432,3433,6865
7755,,cgdizhz1zouj,3433,3434,6867
7756,,f2iqqb4unv4j,3434,3435,6869
7757,,nylb8nbokucj,3435,3436,6871
7758,,0ys1akakpc0j,3436,3437,6873
7759,,w2z4qqiem7oj,3437,3438,6875
7760,,xjymdks-crsj,3438,3439,6877
7761,,din5ld2ehqsj,3439,3440,6879
7762,,xs86du5fbeoj,3440,3441,6881
7763,,uguxud_ctk4j,3441,3442,6883
7764,,qbwn_ybphckj,3442,3443,6885
7765,,j0fsim-lzqsj,3443,3444,6887
7766,,crpdx_psemij,3444,3445,6889
7767,,q5ew7varfeoj,3445,3446,6891
7768,,url:http://www.csa.com/partners/viewrecord.php3frequester3dgs26collection3denv26recid3d8913236,3446,3447,6893
7769,,lztslyswhfoj,3447,3448,6895
7770,,6qashnnwlluj,3448,3449,6897
7771,,othczq4bslej,3450,3451,6901
7772,,fpqjefk6feqj,3451,3452,6903
7773,,v5id_ekw-hwj,3452,3453,6905
7774,,mtnyvtolvosj,3453,3454,6907
7775,,rua97cqkat0j,3454,3455,6909
7776,,rrzmcyvog4uj,3455,3456,6911
7777,,zvykgkaev9cj,3456,3457,6913
7778,,t659k92_ihyj,3457,3458,6915
7779,,cnhmhdmw5ycj,3458,3459,6917
7780,,awhylcgrxscj,3459,3460,6919
7781,,slime4zujhej,3460,3461,6921
7782,,8b0erjcisy4j,3461,3462,6923
7783,,qifv_wsldnsj,3462,3463,6925
7784,,_8o1lwwixaqj,3463,3464,6927
7785,,acrj85u9nt4j,3464,3465,6929
7786,,hvpsbdlbrzaj,3465,3466,6931
7787,,b2tn4pr9sfmj,3466,3467,6933
7788,,ygiqglcdajgj,3467,3468,6935
7789,,pg_vvb3n9gqj,3468,3469,6937
7790,,,3469,3470,6939
7791,,ubacgf9cq2uj,3470,3471,6941
7792,,fr8nyozb2fuj,3471,3472,6943
7793,,acrgxabeinij,3472,3473,6945
7794,,5boc_epkdvkj,3473,3474,6947
7795,,,3474,3475,6949
7796,,y7dm_unjwkaj,3475,3476,6951
7797,,lixqz8qliryj,3476,3477,6953
7798,,url:http://pubs.acs.org/cgi-bin/abstract.cgi/achre4/2004/37/i12/abs/ar0401092.html,3477,3478,6955
7799,,tmwqlcsucimj,3478,3479,6957
7800,,mgtwhzttu4uj,3479,3480,6959
7801,,h-5tgzf5txgj,3480,3481,6961
7802,,79wmkziaoyoj,3481,3482,6963
7803,,nnqfxk2ltcaj,3482,3483,6965
7804,,9fycwwvhkf4j,3483,3484,6967
7805,,nqounwwd3uej,3484,3485,6969
7806,,qhygeq2jezuj,3485,3486,6971
7807,,astflujrtfij,3486,3487,6973
7808,,agvvflfr_tej,3487,3488,6975
7809,,oq5vkgmq9waj,3488,3489,6977
7810,,g8mf557nam0j,3489,3490,6979
7811,,q_pwzcd3nuuj,3490,3491,6981
7812,,qox9sjneneuj,3491,3492,6983
7813,,fcn66knnpsuj,3492,3493,6985
7814,,seahx91i2jcj,3493,3494,6987
7815,,2pbquirdudij,3494,3495,6989
7816,,aem3t-ffcqqj,3495,3496,6991
7817,,6jx5ewzolx4j,3496,3497,6993
7818,,6nofboreuy8j,3497,3498,6995
7819,,v51hoigqgikj,3498,3499,6997
7820,,fqcwwkv-q6qj,3499,3500,6999
7821,,9numn7zjhvqj,3500,3501,7001
7822,,lx0csm6_fdgj,3501,3502,7003
7823,,3qzfyiy1gawj,3502,3503,7005
7824,,x9kccdvo5g0j,3503,3504,7007
7825,,0ogk5ctnytaj,3504,3505,7009
7826,,no5adr3vc9ij,3505,3506,7011
7827,,jmrpstryizoj,3506,3507,7013
7828,,kv-yki3qvtoj,3507,3508,7015
7829,,qnb3ttb9v3qj,3508,3509,7017
7830,,4hy4zlogvukj,3509,3510,7019
7831,,bb9qnm5aur8j,3510,3511,7021
7832,,bdr09fs5e1ij,3511,3512,7023
7833,,wyezoaxfckwj,3512,3513,7025
7834,,zmazb54pysaj,3513,3514,7027
7835,,uwgrvnax720j,3514,3515,7029
7836,,7hdrorkrrqqj,3515,3516,7031
7837,,oclgpntqxisj,3516,3517,7033
7838,,pu2nykuoacwj,3517,3518,7035
7839,,ixmuitbbdlyj,3518,3519,7037
7840,,mds424tyzswj,3519,3520,7039
7841,,kh-ijpxzrf0j,3520,3521,7041
7842,,rd0qhgmk1r0j,3521,3522,7043
7843,,4sfo45irm1oj,3522,3523,7045
7844,,utxmqufi8rwj,3524,3525,7049
7845,,gie4vf89kbkj,3525,3526,7051
7846,,odsy0ehpphij,3526,3527,7053
7847,,xzbzmf4p2cij,3527,3528,7055
7848,,syboc1m_xm4j,3528,3529,7057
7849,,ccapycvh6jkj,3529,3530,7059
7850,,lbvrmb7p_50j,3530,3531,7061
7851,,hb-za0wx-fsj,3531,3532,7063
7852,,pou-vu06ir8j,3532,3533,7065
7853,,lqq_jeullwwj,3533,3534,7067
7854,,9_3j-qmihx0j,3534,3535,7069
7855,,qigegwdmpdkj,3535,3536,7071
7856,,7iux2bgtrlaj,3536,3537,7073
7857,,v2vqtyky9rqj,3537,3538,7075
7858,,ho97h3dfgqqj,3538,3539,7077
7859,,eiev9avucy0j,3539,3540,7079
7860,,iem4y8shrfej,3540,3541,7081
7861,,rw1pg2lu860j,3541,3542,7083
7862,,jyquv-xahekj,3542,3543,7085
7863,,id0wpbqtwikj,3543,3544,7087
7864,,boldjunex8sj,3544,3545,7089
7865,,7ay6p_mh1jij,3545,3546,7091
7866,,n-kmddfjabej,3548,3549,7097
7867,,zdvgq6k6ybsj,3549,3550,7099
7868,,iqbtiwguxryj,3550,3551,7101
7869,,d-v2yjqaw4aj,3551,3552,7103
7870,,d6bljtxz15ej,3552,3553,7105
7871,,9zapkerge7gj,3553,3554,7107
7872,,feer9cgldsmj,3554,3555,7109
7873,,cmk4xahkg9cj,3555,3556,7111
7874,,url:http://adsabs.harvard.edu/abs/1976scom.nasa..315b,3556,3557,7113
7875,,la6oxja3xw4j,3557,3558,7115
7876,,hykl0qkx8hcj,3558,3559,7117
7877,,pyar0arvtiwj,3559,3560,7119
7878,,ofgptz0_8nkj,3560,3561,7121
7879,,hyztsjez5huj,3561,3562,7123
7880,,z5jfjbgav_wj,3562,3563,7125
7881,,8qafmlfnnr0j,3563,3564,7127
7882,,ghacfaaiosej,3564,3565,7129
7883,,8zc070p6ya0j,3565,3566,7131
7884,,url:http://doi.wiley.com/10.1002/ace.8505,3566,3567,7133
7885,,cprqdtv3-m8j,3567,3568,7135
7886,,nzvn5jigijqj,3568,3569,7137
7887,,c-jfbwvbspkj,3569,3570,7139
7888,,lsujaehhxtaj,3570,3571,7141
7889,,d9i-sdjopsoj,3571,3572,7143
7890,,hhvujbhsnf8j,3572,3573,7145
7891,,douxq3f3is0j,3573,3574,7147
7892,,0znuxu2tdacj,3574,3575,7149
7893,,fjyuoyudggcj,3575,3576,7151
7894,,ooqqv_lgvxgj,3576,3577,7153
7895,,nctcll_a_f4j,3577,3578,7155
7896,,tgrl9nbb6oyj,3578,3579,7157
7897,,s_urhji-6cmj,3579,3580,7159
7898,,l5gboakbh1aj,3580,3581,7161
7899,,ifjwvzqhrcwj,3581,3582,7163
7900,,lxsholjmguwj,3582,3583,7165
7901,,vv-psytak04j,3583,3584,7167
7902,,r-0pf3jmtvaj,3584,3585,7169
7903,,qiv1ju2suaej,3585,3586,7171
7904,,j1makxctucyj,3586,3587,7173
7905,,url:http://portal.acm.org/citation.cfm3fid3d192593.19733926dl3dguide26dl3dacm26type3dseries26idx3d19259326part3dproceedings26wanttype3dproceedings26title3dinternational2520multimedia2520conference26cfid3d1111111126cftoken3d2222222,3587,3588,7175
7906,,ut-1et8rfhcj,3588,3589,7177
7907,,y1w2e3n58zkj,3589,3590,7179
7908,,xtpxgclfbeej,3590,3591,7181
7909,,url:http://www.csa.com/partners/viewrecord.php3frequester3dgs26collection3denv26recid3d7108396,3591,3592,7183
7910,,hxjxh1xlm9ij,3592,3593,7185
7911,,d9jlnfp7_p4j,3593,3594,7187
7912,,eezdihfsgomj,3594,3595,7189
7913,,8a82yry4vg8j,3595,3596,7191
7914,,vncsnecmf1uj,3596,3597,7193
7915,,gy0lqk54m1sj,3597,3598,7195
7916,,ix9bmnzispij,3598,3599,7197
7917,,5u18flgjt84j,3599,3600,7199
7918,,jfnr7kpnyxaj,3600,3601,7201
7919,,_ztbk7g-o7wj,3601,3602,7203
7920,,rxzfcqogdjgj,3602,3603,7205
7921,,2hyvwkknjouj,3603,3604,7207
7922,,if7mtb094dgj,3604,3605,7209
7923,,liul6zpvegqj,3605,3606,7211
7924,,url:http://links.jstor.org/sici3fsici3d0146-4949(196124)2253a1253c31253agotsr253e2.0.co253b2-0,3607,3608,7215
7925,,0dxsyhtu2oqj,3608,3609,7217
7926,,kafs7qntn58j,3609,3610,7219
7927,,mjinopv9bcsj,3610,3611,7221
7928,,rnvzky9ddxgj,3611,3612,7223
7929,,eh7al-0lhq0j,3612,3613,7225
7930,,jndd_blmcpgj,3613,3614,7227
7931,,umfyrstwrraj,3614,3615,7229
7932,,cunvts52ljkj,3615,3616,7231
7933,,n8zgjk5ylaej,3616,3617,7233
7934,,url:http://www.springerlink.com/index/tx55n550p815vr75.pdf,3617,3618,7235
7935,,ec20c97dbk0j,3618,3619,7237
7936,,flhbrkgdz-ij,3619,3620,7239
7937,,nqaf5czbelgj,3620,3621,7241
7938,,l5z9nidvubej,3621,3622,7243
7939,,ergwqh2cuhoj,3622,3623,7245
7940,,kcugnrpq8uij,3623,3624,7247
7941,,cte2bi3xvo8j,3624,3625,7249
7942,,1b7shttssykj,3625,3626,7251
7943,,sug4qeocz3gj,3626,3627,7253
7944,,yen-qg1-otsj,3627,3628,7255
7945,,yfbrih_qluoj,3628,3629,7257
7946,,a5djjme9uaij,3629,3630,7259
7947,,0snfx8h_ajuj,3630,3631,7261
7948,,a0rvdr2jeikj,3631,3632,7263
7949,,,3632,3633,7265
7950,,hi5avvm1bzsj,3633,3634,7267
7951,,ctznfxpl2lsj,3634,3635,7269
7952,,cyr0mud7wwcj,3635,3636,7271
7953,,9bcz743aba8j,3636,3637,7273
7954,,t0znpfmmkjmj,3637,3638,7275
7955,,waxecjnpwngj,3638,3639,7277
7956,,bt_dicnabyyj,3639,3640,7279
7957,,_edhm4bq8b0j,3640,3641,7281
7958,,itzfkeupvscj,3641,3642,7283
7959,,kdxkq47tgowj,3642,3643,7285
7960,,vc7dwydpismj,3643,3644,7287
7961,,hpq2yteu1sej,3644,3645,7289
7962,,yj0invxdbh8j,3645,3646,7291
7963,,znacxzbhw_ij,3646,3647,7293
7964,,zunsxwsbgoej,3647,3648,7295
7965,,mqswvwsitmsj,3648,3649,7297
7966,,ihqga0pjr48j,3649,3650,7299
7967,,a8wi3lvjyv8j,3650,3651,7301
7968,,ds9oohzzmyej,3651,3652,7303
7969,,iu1cjdpvt6cj,3652,3653,7305
7970,,mrbepj_vgv8j,3653,3654,7307
7971,,jk41czmmbw0j,3654,3655,7309
7972,,wafy0er_xewj,3655,3656,7311
7973,,chfca5bkuhwj,3656,3657,7313
7974,,6k-vnuiy2zmj,3657,3658,7315
7975,,uajm6jwehlyj,3658,3659,7317
7976,,eeguqveauaqj,3659,3660,7319
7977,,y_n5ksz0posj,3660,3661,7321
7978,,dnqovyeuo2aj,3661,3662,7323
7979,,j1h2230budcj,3662,3663,7325
7980,,nys1xhitvtsj,3663,3664,7327
7981,,url:http://www.csa.com/partners/viewrecord.php3frequester3dgs26collection3dtrd26recid3dn9210439ah,3664,3665,7329
7982,,lztrtazu29mj,3665,3666,7331
7983,,url:http://doi.wiley.com/10.1002/(sici)1521-3773(19980504)37:8253c1131::aid-anie1131253e3.3.co3b2-j,3666,3667,7333
7984,,isy2-ikc3soj,3667,3668,7335
7985,,sswhvnbzybgj,3668,3669,7337
7986,,sxiduovpweej,3669,3670,7339
7987,,url:http://portal.acm.org/citation.cfm3fid3d325405.325439,3670,3671,7341
7988,,zpbtxdzddxgj,3671,3672,7343
7989,,7twlpoyjedqj,3673,3674,7347
7990,,1pi-vdjbmp0j,3674,3675,7349
7991,,1uhqggaynyej,3675,3676,7351
7992,,jqaza3mmmakj,3676,3677,7353
7993,,ycwp1obzmdwj,3677,3678,7355
7994,,e8l5enlbpfqj,3678,3679,7357
7995,,url:http://www.springerlink.com/index/l56m40v76870h0w6.pdf,3679,3680,7359
7996,,gpz5l8fizqyj,3680,3681,7361
7997,,1hvainpqwzgj,3681,3682,7363
7998,,tecwwrvmx9mj,3682,3683,7365
7999,,tb5br5h12aaj,3683,3684,7367
8000,,zsl0j4i75iqj,3684,3685,7369
8001,,xqjjabfcfm0j,3685,3686,7371
8002,,ptkolemy8laj,3687,3688,7375
8003,,jhkz8w_ajcaj,3688,3689,7377
8004,,lngesvrvsygj,3689,3690,7379
8005,,oapeshfdoukj,3690,3691,7381
8006,,,3691,3692,7383
8007,,url:http://www.csa.com/partners/viewrecord.php3frequester3dgs26collection3dtrd26recid3dn9210560ah,3692,3693,7385
8008,,w5ydmlyywduj,3693,3694,7387
8009,,d0a8lxfrezwj,3694,3695,7389
8010,,zqe8uitib2aj,3695,3696,7391
8011,,ijl4kwvq3z8j,3696,3697,7393
8012,,zazc0gkbpnsj,3697,3698,7395
8013,,c2zh5urvdwij,3698,3699,7397
8014,,j3tw1kqn79mj,3699,3700,7399
8015,,rvdwvfmt3mij,3700,3701,7401
8016,,canj7hrqk2oj,3701,3702,7403
8017,,affybfsmxamj,3702,3703,7405
8018,,url:http://doi.ieeecs.org/10.1109/wpdrts.1996.557650,3703,3704,7407
8019,,a6zqy2zhw1uj,3704,3705,7409
8020,,g-ibiihurnyj,3705,3706,7411
8021,,uvxbn_l6iauj,3707,3708,7415
8022,,mo5fmwfcytwj,3708,3709,7417
8023,,b3zadnxyf_4j,3709,3710,7419
8024,,shv2zquchhkj,3710,3711,7421
8025,,url:http://portal.acm.org/citation.cfm3fid3d1086228.1086237,3711,3712,7423
8026,,atusomh8ry4j,3712,3713,7425
8027,,53vdiwp3l-gj,3713,3714,7427
8028,,xxqgxxrlk5ej,3714,3715,7429
8029,,ioayjabtu_4j,3715,3716,7431
8030,,xy58d3ql2aaj,3716,3717,7433
8031,,rxe-zmo8fssj,3717,3718,7435
8032,,_ubgoibe-uoj,3718,3719,7437
8033,,6gurc_3xtawj,3719,3720,7439
8034,,cxdsoiju--mj,3720,3721,7441
8035,,qjsqzia5jcuj,3721,3722,7443
8036,,bdev7qfno8ij,3722,3723,7445
8037,,toblfwbwljyj,3723,3724,7447
8038,,kjukzvxgnc4j,3724,3725,7449
8039,,j7m6-by2-b0j,3725,3726,7451
8040,,yxzqq4rvijaj,3726,3727,7453
8041,,gayguzirr-aj,3727,3728,7455
8042,,biwnrbdncumj,3728,3729,7457
8043,,dlibsjfzymoj,3729,3730,7459
8044,,gnrhumowzbij,3730,3731,7461
8045,,mkmpwsbaqsoj,3731,3732,7463
8046,,jbhjh25c60ej,3732,3733,7465
8047,,ycxidg9xeyqj,3733,3734,7467
8048,,f1aawsff8tcj,3734,3735,7469
8049,,8nafea1gjqaj,3735,3736,7471
8050,,w4kvcetlowaj,3736,3737,7473
8051,,7oty-ccohjkj,3737,3738,7475
8052,,17_j1zn75dej,3738,3739,7477
8053,,c75nog1fvp8j,3739,3740,7479
8054,,kyyjq-jrcn0j,3740,3741,7481
8055,,6ru_z_sx1egj,3741,3742,7483
8056,,url:http://portal.acm.org/ft_gateway.cfm3fid3d108372326type3dpdf,3742,3743,7485
8057,,r2nrdek_bgwj,3743,3744,7487
8058,,c5jb2yhdgscj,3744,3745,7489
8059,,xtxvoci0vauj,3745,3746,7491
8060,,zzpdhav9eqgj,3746,3747,7493
8061,,rovnc1d7mtsj,3747,3748,7495
8062,,mchdr-84fqwj,3748,3749,7497
8063,,irvv35fueqij,3749,3750,7499
8064,,szg3swguiocj,3750,3751,7501
8065,,nd1zp6e6b5ij,3751,3752,7503
8066,,hov18rabhwij,3752,3753,7505
8067,,nhdqjkuvtuuj,3753,3754,7507
8068,,wncubqgzn-uj,3754,3755,7509
8069,,0mttdfrqp0ej,3756,3757,7513
8070,,x2eg2l8n6haj,3757,3758,7515
8071,,olygfp7vcrwj,3758,3759,7517
8072,,ewx8jphlii8j,3759,3760,7519
8073,,weohznuppmyj,3760,3761,7521
8074,,plmvxn-pefgj,3761,3762,7523
8075,,gpqhl6nfnk8j,3762,3763,7525
8076,,nc1s-hya6ssj,3763,3764,7527
8077,,ub6ks5ew4acj,3764,3765,7529
8078,,_y7t1ezwifwj,3765,3766,7531
8079,,kglo2rfxgwkj,3766,3767,7533
8080,,url:http://doi.wiley.com/10.1002/ev.1582,3767,3768,7535
8081,,lh0ea5mq7gaj,3768,3769,7537
8082,,p0xub9x6siyj,3769,3770,7539
8083,,stkugywgbd8j,3770,3771,7541
8084,,url:http://portal.acm.org/ft_gateway.cfm3fid3d15689126type3dpdf26coll3dguide26dl3dacm26cfid3d1111111126cftoken3d2222222,3771,3772,7543
8085,,ye5i7ypsh9yj,3772,3773,7545
8086,,kg2db-50skaj,3773,3774,7547
8087,,wb6irxph9pmj,3774,3775,7549
8088,,brxqfw_k8oej,3775,3776,7551
8089,,1cvolqxkmasj,3776,3777,7553
8090,,d-r0p-gy0yej,3777,3778,7555
8091,,fjzhomionwyj,3778,3779,7557
8092,,pz7oi1nory4j,3779,3780,7559
8093,,y1mlzau4_xoj,3780,3781,7561
8094,,uhfaabqpz6cj,3781,3782,7563
8095,,osjqcowvkxqj,3782,3783,7565
8096,,cnfcqtkvmoqj,3783,3784,7567
8097,,lf1-9nonre0j,3784,3785,7569
8098,,f8mvqywdkp4j,3785,3786,7571
8099,,d3un6pfcirej,3786,3787,7573
8100,,u8qni2okz10j,3788,3789,7577
8101,,eiqizryil24j,3789,3790,7579
8102,,qjhmfalp1jqj,3790,3791,7581
8103,,8u1lcroncuoj,3791,3792,7583
8104,,giqkv68wtzij,3792,3793,7585
8105,,6nsti829umcj,3793,3794,7587
8106,,rvjjhuofovqj,3794,3795,7589
8107,,_hhpczhckf4j,3795,3796,7591
8108,,jsztvgt4cgij,3796,3797,7593
8109,,kpxozc1ld5kj,3797,3798,7595
8110,,bmhkaeaxvnej,3798,3799,7597
8111,,ilb9g_eggrqj,3799,3800,7599
8112,,9gi-nw9wjtgj,3800,3801,7601
8113,,url:http://adsabs.harvard.edu/abs/1992mit..reptq....k,3801,3802,7603
8114,,8vwef0wl18ej,3802,3803,7605
8115,,bhagho4m1y0j,3803,3804,7607
8116,,i__j0rn5j6qj,3804,3805,7609
8117,,xzhg2pgpwxwj,3805,3806,7611
8118,,a-olnk5ncxwj,3806,3807,7613
8119,,uvltoy49ap0j,3807,3808,7615
8120,,url:http://doi.wiley.com/10.1002/tl.117,3808,3809,7617
8121,,axvj2z9m_xsj,3809,3810,7619
8122,,eandvxwycqgj,3810,3811,7621
8123,,07c4ta2iqw0j,3811,3812,7623
8124,,wemfmxzc-jyj,3813,3814,7627
8125,,nytto93j0jej,3814,3815,7629
8126,,url:http://portal.acm.org/citation.cfm3fid3d115302,3815,3816,7631
8127,,ttmtbqntolaj,3816,3817,7633
8128,,0drjtfpitckj,3817,3818,7635
8129,,arhnophrt3mj,3818,3819,7637
8130,,rmcxfskhic8j,3819,3820,7639
8131,,3nckxv7wmgqj,3820,3821,7641
8132,,jgdisphdrlkj,3821,3822,7643
8133,,l5msc3omfgkj,3822,3823,7645
8134,,hfnyy0pfe1mj,3823,3824,7647
8135,,oauxkeljneyj,3824,3825,7649
8136,,gnprjrxsbbyj,3825,3826,7651
8137,,ofblhfpruc0j,3826,3827,7653
8138,,d2-swscqaywj,3827,3828,7655
8139,,nqiq6homfq0j,3828,3829,7657
8140,,yzlphoiii8kj,3829,3830,7659
8141,,cku3ujoxb7ej,3830,3831,7661
8142,,l1ovfz1cngoj,3831,3832,7663
8143,,kyq-m7lsqqsj,3832,3833,7665
8144,,0zbsvvbqpmkj,3833,3834,7667
8145,,982oehxjpu8j,3834,3835,7669
8146,,axp1rmp_l80j,3835,3836,7671
8147,,ppwk50q_5bej,3836,3837,7673
8148,,q-lofadld7yj,3837,3838,7675
8149,,_dtqcpu4ndkj,3838,3839,7677
8150,,6t7stvsfygkj,3839,3840,7679
8151,,rfhioohsipuj,3840,3841,7681
8152,,eyd_tgpfsumj,3841,3842,7683
8153,,cm2juhonqdej,3842,3843,7685
8154,,url:http://portal.acm.org/citation.cfm3fid3d226963,3843,3844,7687
8155,,ngn4gfkoamwj,3844,3845,7689
8156,,fwmnkpxskpwj,3845,3846,7691
8157,,o4meaah7ps0j,3846,3847,7693
8158,,nhxhsuh9l5mj,3847,3848,7695
8159,,0n8f74qvpfaj,3848,3849,7697
8160,,l8km-cpd_2qj,3849,3850,7699
8161,,url:http://ieeexplore.ieee.org/iel5/2193/2088/00057637.pdf3farnumber3d57637,3850,3851,7701
8162,,url:http://doi.wiley.com/10.1002/ace.55,3851,3852,7703
8163,,mg3ywa-mcfmj,3852,3853,7705
8164,,qzmwjdnwiquj,3853,3854,7707
8165,,url:http://portal.acm.org/citation.cfm3fid3d39251.39254,3854,3855,7709
8166,,bmjmogf3yc4j,3855,3856,7711
8167,,qbfh4lphcxyj,3856,3857,7713
8168,,_tp5gv7ok0mj,3857,3858,7715
8169,,zdlbf--kzaej,3858,3859,7717
8170,,zqxeetsr8-oj,3859,3860,7719
8171,,url:http://www.csa.com/partners/viewrecord.php3frequester3dgs26collection3denv26recid3d7708929,3860,3861,7721
8172,,kn2cbnbgk4sj,3861,3862,7723
8173,,eo_-gccyo_4j,3862,3863,7725
8174,,url:http://www.springerlink.com/index/gu53m10932406457.pdf,3863,3864,7727
8175,,ass8zavbik4j,3864,3865,7729
8176,,ueljlfhu_gkj,3865,3866,7731
8177,,kfc57zvfwwmj,3866,3867,7733
8178,,pvsnebhfokqj,3867,3868,7735
8179,,bqltsxrqmsej,3868,3869,7737
8180,,,3869,3870,7739
8181,,ynas3sl5jyoj,3870,3871,7741
8182,,ivmt_9voze8j,3871,3872,7743
8183,,v6xudewk7b8j,3872,3873,7745
8184,,5zuo_0_x2twj,3873,3874,7747
8185,,0wx6zckqbdkj,3874,3875,7749
8186,,fwnnxebny4ij,3875,3876,7751
8187,,ykx565n8srkj,3876,3877,7753
8188,,c4gkz02f-qkj,3877,3878,7755
8189,,url:http://www.csa.com/partners/viewrecord.php3frequester3dgs26collection3dtrd26recid3d090120ws26recid3d8201460025md26recid3d018112310150xai,3878,3879,7757
8190,,cci9ftln_v4j,3879,3880,7759
8191,,gzcnijfzfraj,3880,3881,7761
8192,,jpusldyoriaj,3881,3882,7763
8193,,rrxrr6thbhmj,3882,3883,7765
8194,,isussvthvouj,3883,3884,7767
8195,,7ppvcjbcu9kj,3884,3885,7769
8196,,rnrg8xw2snoj,3885,3886,7771
8197,,otxdte56bmmj,3886,3887,7773
8198,,f8g3kqjkmysj,3887,3888,7775
8199,,url:http://portal.acm.org/citation.cfm3fid3d48360.48365,3888,3889,7777
8200,,a-pd7cqyt3kj,3889,3890,7779
8201,,h32jolo99wuj,3890,3891,7781
8202,,s_6_sib5nucj,3891,3892,7783
8203,,iqge5cresgij,3892,3893,7785
8204,,b2iwzmsbniqj,3893,3894,7787
8205,,xdc38h37icej,3894,3895,7789
8206,,ugffhqzrafsj,3895,3896,7791
8207,,pxbwpa8pq0ij,3896,3897,7793
8208,,hqvgexelia4j,3897,3898,7795
8209,,kuy0gzdsblyj,3898,3899,7797
8210,,hhtu4deuab8j,3899,3900,7799
8211,,tshdanm9mj8j,3900,3901,7801
8212,,fj3oletd7c4j,3901,3902,7803
8213,,qsbtr7ejdluj,3902,3903,7805
8214,,v2kwhri-ormj,3903,3904,7807
8215,,xvgpvb2pbzaj,3904,3905,7809
8216,,dnz5lxvd5msj,3905,3906,7811
8217,,z8yuotj4tkwj,3906,3907,7813
8218,,i7xiok4dswwj,3907,3908,7815
8219,,ildobkxhy7ej,3908,3909,7817
8220,,glk_x3b7x80j,3909,3910,7819
8221,,guvartt5n_sj,3910,3911,7821
8222,,yry6oga-cfaj,3912,3913,7825
8223,,url:http://portal.acm.org/ft_gateway.cfm3fid3d15689326type3dpdf,3913,3914,7827
8224,,kuehlnwirbsj,3914,3915,7829
8225,,n2oxpdzj2kij,3915,3916,7831
8226,,zr0xim4-nkej,3916,3917,7833
8227,,9rnzpbvcoagj,3917,3918,7835
8228,,pfjoitk4jc8j,3918,3919,7837
8229,,wkwqrcf25myj,3919,3920,7839
8230,,iw6k4ra36dcj,3920,3921,7841
8231,,url:http://portal.acm.org/citation.cfm3fid3d590133.592114,3921,3922,7843
8232,,8t1ozyyikuuj,3922,3923,7845
8233,,r0gaqzarlkqj,3923,3924,7847
8234,,xjpqmwtjlpmj,3924,3925,7849
8235,,labhhdda2aqj,3925,3926,7851
8236,,agteot-bvwuj,3927,3928,7855
8237,,nc3uxda6-fej,3928,3929,7857
8238,,1qsvnffoeq0j,3929,3930,7859
8239,,6rc0prexxi0j,3930,3931,7861
8240,,0ldgddgqx6gj,3931,3932,7863
8241,,eoto6sqtuxgj,3932,3933,7865
8242,,qz1rzdo43n8j,3933,3934,7867
8243,,ly4jf-ijt3oj,3934,3935,7869
8244,,url:http://adsabs.harvard.edu/abs/1988lsso.conf.....b,3935,3936,7871
8245,,kskgrr4ok4mj,3936,3937,7873
8246,,acidknsyrfyj,3937,3938,7875
8247,,cqovghgkdekj,3938,3939,7877
8248,,iseqm8ehgruj,3939,3940,7879
8249,,txko2vkrhkoj,3940,3941,7881
8250,,lqcsqt8nlvwj,3941,3942,7883
8251,,lkslriwu9vgj,3942,3943,7885
8252,,1dwhxwzs-csj,3943,3944,7887
8253,,ncbk5djejmej,3944,3945,7889
8254,,g-yccpypyloj,3945,3946,7891
8255,,puvbxhc5hfmj,3946,3947,7893
8256,,0gk1i-qtbiqj,3947,3948,7895
8257,,wtzukkk9igkj,3948,3949,7897
8258,,z0hujommscej,3949,3950,7899
8259,,ph5icvvo4qoj,3950,3951,7901
8260,,ie66dn0n3ncj,3951,3952,7903
8261,,lzoysywkkjuj,3952,3953,7905
8262,,nwielbagzysj,3953,3954,7907
8263,,6wn4doqjrboj,3954,3955,7909
8264,,rk3l_vbb570j,3955,3956,7911
8265,,y55xkfqjvxaj,3956,3957,7913
8266,,url:http://ieeexplore.ieee.org/iel5/69/28565/01277824.pdf3farnumber3d1277824,3957,3958,7915
8267,,zrojad1der8j,3958,3959,7917
8268,,gznzj6-tqwuj,3959,3960,7919
8269,,1zkebqslakcj,3960,3961,7921
8270,,yuccv3uxguqj,3961,3962,7923
8271,,7bbdzmp1qnoj,3962,3963,7925
8272,,vy8covdflbgj,3963,3964,7927
8273,,i0jgcjlbceej,3964,3965,7929
8274,,djechwzqzocj,3965,3966,7931
8275,,egue1qxk6gij,3966,3967,7933
8276,,mcv4685-wcsj,3967,3968,7935
8277,,f0ymtmafhxij,3968,3969,7937
8278,,xlznmu9nwd0j,3969,3970,7939
8279,,bx8xnkxdgkij,3970,3971,7941
8280,,url:http://adsabs.harvard.edu/abs/1976infph..16..207n,3971,3972,7943
8281,,url:http://doi.wiley.com/10.1002/ace.8706,3972,3973,7945
8282,,bhp7ctlohvyj,3973,3974,7947
8283,,7mumnzswfp8j,3974,3975,7949
8284,,ojopogqjgw0j,3975,3976,7951
8285,,lesnaoi3fxaj,3976,3977,7953
8286,,subcgpdw1voj,3977,3978,7955
8287,,url:http://www.springerlink.com/index/h2413503p5248666.pdf,3978,3979,7957
8288,,fupmv0lq7ecj,3979,3980,7959
8289,,wl7q-glmofej,3980,3981,7961
8290,,,3981,3982,7963
8291,,ogvuoyxyeyuj,3982,3983,7965
8292,,url:http://www.csa.com/partners/viewrecord.php3frequester3dgs26collection3dtrd26recid3d017302550021xai,3983,3984,7967
8293,,ezsraivbzj8j,3984,3985,7969
8294,,t1dmp2nl1ayj,3986,3987,7973
8295,,zokufjlsnzej,3987,3988,7975
8296,,fqtechkzkjej,3988,3989,7977
8297,,z3d7m88spduj,3989,3990,7979
8298,,zqwbi3soctqj,3990,3991,7981
8299,,enatcs89bbij,3991,3992,7983
8300,,rbz_b-stxjuj,3992,3993,7985
8301,,lawovpdchyuj,3993,3994,7987
8302,,b9aigwaz_poj,3994,3995,7989
8303,,ubyjngl-uooj,3995,3996,7991
8304,,lcwoooc8htmj,3996,3997,7993
8305,,rqmhncaktvmj,3997,3998,7995
8306,,elszq800gkqj,3998,3999,7997
8307,,x-9k9420brwj,3999,4000,7999
8308,,zgm8fne_sbgj,4000,4001,8001
8309,,n4qwpzimqv8j,4001,4002,8003
8310,,dhgt4hz-qpsj,4002,4003,8005
8311,,1_fcom4gplgj,4003,4004,8007
8312,,wjnfuqqywumj,4004,4005,8009
8313,,fvftaqkka_yj,4005,4006,8011
8314,,lnr3uwokuokj,4006,4007,8013
8315,,icx1ll7bfgoj,4007,4008,8015
8316,,nh0lsba6jwkj,4008,4009,8017
8317,,6rxmo_eq4gmj,4009,4010,8019
8318,,qccmhm7hci8j,4010,4011,8021
8319,,url:http://portal.acm.org/citation.cfm3fid3d170035.171552,4011,4012,8023
8320,,f8eaxpxqqsij,4012,4013,8025
8321,,y50tactojbcj,4013,4014,8027
8322,,vmshmepa_goj,4014,4015,8029
8323,,6kdau1eh-hmj,4015,4016,8031
8324,,9fsnxqd6xfmj,4016,4017,8033
8325,,a-xusymqedgj,4017,4018,8035
8326,,ga8jlm9cazij,4018,4019,8037
8327,,amtixmkwsmwj,4019,4020,8039
8328,,wigwapgbua0j,4020,4021,8041
8329,,dii_vi3rgruj,4021,4022,8043
8330,,url:http://www.springerlink.com/index/g453v37235382g61.pdf,4022,4023,8045
8331,,rawmksee168j,4023,4024,8047
8332,,cxtx1e5l10yj,4024,4025,8049
8333,,1dw9z-vl8gkj,4025,4026,8051
8334,,esb4-we_2cmj,4026,4027,8053
8335,,aegbj60flbej,4027,4028,8055
8336,,ok0_ezw8yu8j,4028,4029,8057
8337,,tuv0dl3dpoij,4029,4030,8059
8338,,8n9adfprt1mj,4030,4031,8061
8339,,zbovpxn_aa8j,4031,4032,8063
8340,,xatt25rskncj,4032,4033,8065
8341,,wsqqei6zlruj,4033,4034,8067
8342,,url:http://adsabs.harvard.edu/abs/1976scom.nasa..378r,4034,4035,8069
8343,,ymrnhb3rsiaj,4035,4036,8071
8344,,ingui9auxjoj,4036,4037,8073
8345,,vgzicnvhveqj,4037,4038,8075
8346,,pd6xxtbzc8ij,4038,4039,8077
8347,,0tppkec1klmj,4039,4040,8079
8348,,hlx4nfzumcaj,4040,4041,8081
8349,,kexzuoreqpkj,4041,4042,8083
8350,,a9zmjnhwnxij,4042,4043,8085
8351,,onr-pgqgbroj,4043,4044,8087
8352,,qepax_5wia4j,4044,4045,8089
8353,,fdld0km-n2ij,4045,4046,8091
8354,,lxnmvgf-gmsj,4046,4047,8093
8355,,pq0jgxdvca8j,4047,4048,8095
8356,,v9r_g8wlwgaj,4048,4049,8097
8357,,a-barmcjarsj,4049,4050,8099
8358,,ezbkmi0shtuj,4050,4051,8101
8359,,url:http://www.ingentaconnect.com/content/els/09505849/1999/00000041/00000009/art00025,4051,4052,8103
8360,,f5ii9m2wqbaj,4052,4053,8105
8361,,pro9z1z4qckj,4054,4055,8109
8362,,8ckit3dqnq0j,4055,4056,8111
8363,,g81b6xcxepoj,4056,4057,8113
8364,,y5g-dwcbztwj,4057,4058,8115
8365,,r4-jg4dl550j,4058,4059,8117
8366,,qdpu_y0zqnwj,4059,4060,8119
8367,,jg0dpsis43gj,4060,4061,8121
8368,,arrq90z_g30j,4061,4062,8123
8369,,j_nz7buelcej,4062,4063,8125
8370,,ebnflvcpeegj,4063,4064,8127
8371,,ph4a4-brtruj,4064,4065,8129
8372,,5fykxlpii7sj,4065,4066,8131
8373,,url:http://www.csa.com/partners/viewrecord.php3frequester3dgs26collection3dtrd26recid3da8622978ah,4066,4067,8133
8374,,1wzopdkiuqoj,4067,4068,8135
8375,,9wxrt8omupij,4068,4069,8137
8376,,by0tlgcqbfwj,4069,4070,8139
8377,,2wu-fgxhqlsj,4070,4071,8141
8378,,url:http://www.csa.com/partners/viewrecord.php3frequester3dgs26collection3dtrd26recid3da7212137ah,4071,4072,8143
8379,,qjolyp_c9zij,4072,4073,8145
8380,,qarwdwqsu1sj,4073,4074,8147
8381,,url:http://doi.wiley.com/10.1002/ev.1684,4074,4075,8149
8382,,zgyvqvxw4dcj,4075,4076,8151
8383,,vunmazudx38j,4076,4077,8153
8384,,k0vdc2qmzooj,4077,4078,8155
8385,,nmvnw5na9s8j,4078,4079,8157
8386,,zurtau-qzsuj,4079,4080,8159
8387,,x6w_h2hcgymj,4080,4081,8161
8388,,r6rlrt7eat8j,4081,4082,8163
8389,,uckkfmlwtnyj,4082,4083,8165
8390,,tlxzwmhkuuaj,4083,4084,8167
8391,,yxxsvfzqsu8j,4084,4085,8169
8392,,zaa7rq_uuwoj,4085,4086,8171
8393,,mrvk0bcj22mj,4086,4087,8173
8394,,qrzw2e9colaj,4087,4088,8175
8395,,my6fzv_uuxcj,4088,4089,8177
8396,,psqtngmojhaj,4089,4090,8179
8397,,_hevxd_x65ej,4090,4091,8181
8398,,b99wsbwzdvcj,4092,4093,8185
8399,,7_ierf7bcnsj,4093,4094,8187
8400,,vm1ct8jcm3sj,4095,4096,8191
8401,,bp_id4yrajoj,4096,4097,8193
8402,,eeqfxhqmiiyj,4097,4098,8195
8403,,ny9vqi7ghjgj,4098,4099,8197
8404,,c5eltb9xi0qj,4099,4100,8199
8405,,zumnvbxtedsj,4100,4101,8201
8406,,68ugxrxnehuj,4101,4102,8203
8407,,hrxwmndjc-kj,4102,4103,8205
8408,,neehbkhlx0mj,4103,4104,8207
8409,,cjq1qmk1qjmj,4104,4105,8209
8410,,c4iqcpixfs4j,4105,4106,8211
8411,,kkpipatvmkoj,4106,4107,8213
8412,,5smdfjwffvuj,4107,4108,8215
8413,,vof7flvszksj,4109,4110,8219
8414,,,4110,4111,8221
8415,,sodl7kvyaeqj,4111,4112,8223
8416,,r4-fzl9pd2wj,4112,4113,8225
8417,,ljbqj4osw6ij,4113,4114,8227
8418,,8sbyx-yqpxij,4114,4115,8229
8419,,url:http://www.csa.com/partners/viewrecord.php3frequester3dgs26collection3dtrd26recid3da8622926ah,4115,4116,8231
8420,,i3nn_pcmtrwj,4116,4117,8233
8421,,asu8e_avdyij,4117,4118,8235
8422,,0fhj7_ezbh0j,4118,4119,8237
8423,,url:http://www.csa.com/partners/viewrecord.php3frequester3dgs26collection3dtrd26recid3dn9210454ah,4120,4121,8241
8424,,msro8dmxgo4j,4121,4122,8243
8425,,hscmogyf66aj,4122,4123,8245
8426,,ix5ihd83z8cj,4123,4124,8247
8427,,whkiequs8egj,4124,4125,8249
8428,,fbb0flwp7msj,4125,4126,8251
8429,,vmfvpbhcvecj,4126,4127,8253
8430,,ffley-_2um4j,4127,4128,8255
8431,,nvqnfbmze64j,4128,4129,8257
8432,,0oj0vwma7b0j,4129,4130,8259
8433,,mmrfr3xog2qj,4131,4132,8263
8434,,url:http://portal.acm.org/ft_gateway.cfm3fid3d102760926type3dpdf,4132,4133,8265
8435,,url:http://ieeexplore.ieee.org/iel4/720/553/00013682.pdf3farnumber3d13682,4134,4135,8269
8436,,mmpm31xn2qqj,4135,4136,8271
8437,,adtusr1ybt0j,4136,4137,8273
8438,,nj4l0qmwjkgj,4137,4138,8275
8439,,vzw7odmnyrcj,4138,4139,8277
8440,,url:http://portal.acm.org/citation.cfm3fid3d1027527.1027750,4139,4140,8279
8441,,url:http://portal.acm.org/citation.cfm3fid3d500141.50026826dl3dportal26dl3dacm26type3dseries26idx3d50014126part3dproceedings26wanttype3dproceedings26title3dinternational2520multimedia2520conference26cfid3d1111111126cftoken3d2222222,4140,4141,8281
8442,,6m-fnuhweoij,4142,4143,8285
8443,,advcuqjo-rij,4143,4144,8287
8444,,2oovgc7fti0j,4144,4145,8289
8445,,p0xayvlmsbkj,4145,4146,8291
8446,,anadxqunvgkj,4146,4147,8293
8447,,t2nnz1auzbsj,4147,4148,8295
8448,,8herrt2tiukj,4148,4149,8297
8449,,imivxir6xwsj,4149,4150,8299
8450,,nqvc4vp3q6uj,4150,4151,8301
8451,,ntbjj8oty-ij,4151,4152,8303
8452,,coupwwkrgfoj,4152,4153,8305
8453,,jafqmp_67t8j,4153,4154,8307
8454,,m5pjenk5x7mj,4154,4155,8309
8455,,i5jpdzvpqduj,4155,4156,8311
8456,,wcztnsqp5fuj,4156,4157,8313
8457,,nxarkhdrmcyj,4157,4158,8315
8458,,dazrwioyk8qj,4158,4159,8317
8459,,hanvoh7fphyj,4159,4160,8319
8460,,knuvt-owvbej,4160,4161,8321
8461,,2ggiy7wupf0j,4161,4162,8323
8462,,g8vwrghwte0j,4162,4163,8325
8463,,lm9mls1xtluj,4163,4164,8327
8464,,zurnhslwihij,4164,4165,8329
8465,,pgiwvtthwqyj,4165,4166,8331
8466,,ki2t78kduumj,4166,4167,8333
8467,,wm4aozycrcij,4167,4168,8335
8468,,gth7ylcnh7kj,4168,4169,8337
8469,,url:http://journals.iucr.org/c/issues/1995/07/00/se1059/se1059.pdf,4169,4170,8339
8470,,url:http://portal.acm.org/ft_gateway.cfm3fid3d109963026type3dpdf,4170,4171,8341
8471,,zrvo8plvsp0j,4171,4172,8343
8472,,mpjewj13bicj,4172,4173,8345
8473,,gzqt0c7ca2mj,4173,4174,8347
8474,,ibkk99qrjagj,4174,4175,8349
8475,,w6gklakuetsj,4175,4176,8351
8476,,jsq-tvn93quj,4176,4177,8353
8477,,wryehhngm_oj,4177,4178,8355
8478,,q5f2xkkidi0j,4178,4179,8357
8479,,gk_eqipgnq4j,4179,4180,8359
8480,,_t42myr28nej,4180,4181,8361
8481,,x6idpoevwlaj,4181,4182,8363
8482,,rto3ejxcltwj,4182,4183,8365
8483,,9t5o3l5dczqj,4183,4184,8367
8484,,fnk_g33dbjwj,4184,4185,8369
8485,,s1ygfkywe0ij,4185,4186,8371
8486,,hvbfqcenvoij,4186,4187,8373
8487,,ijnenl1nvdcj,4187,4188,8375
8488,,yp9n1fsxvlkj,4188,4189,8377
8489,,a01sxhwiy1sj,4189,4190,8379
8490,,029jchk8wcwj,4190,4191,8381
8491,,soa6fx3gok0j,4191,4192,8383
8492,,url:http://portal.acm.org/citation.cfm3fid3d27630426dl3dacm26coll3dportal26cfid3d1111111126cftoken3d2222222,4192,4193,8385
8493,,tnpdxrra4usj,4193,4194,8387
8494,,1uax44n1ubyj,4194,4195,8389
8495,,leoljdivhzyj,4195,4196,8391
8496,,_lwzwet4ongj,4196,4197,8393
8497,,5h8bmxqcxcgj,4197,4198,8395
8498,,stdll-00ynwj,4198,4199,8397
8499,,f-sa6jil6ukj,4199,4200,8399
8500,,jpi1lv1yamqj,4200,4201,8401
8501,,gvua8jbnhpkj,4201,4202,8403
8502,,rkbcffyrgz4j,4202,4203,8405
8503,,qzza4rjkl4yj,4203,4204,8407
8504,,qzqnofwm2wyj,4204,4205,8409
8505,,ygfvjg7-17ej,4205,4206,8411
8506,,9nivlracxlij,4206,4207,8413
8507,,f6kgdsbckcaj,4207,4208,8415
8508,,doaaic3fj9ij,4208,4209,8417
8509,,abkoyfun9egj,4209,4210,8419
8510,,bys4kcgkzumj,4210,4211,8421
8511,,url:http://portal.acm.org/citation.cfm3fid3d1101149.1101205,4211,4212,8423
8512,,xwvtpcqwc8uj,4212,4213,8425
8513,,gij_h0gm9euj,4213,4214,8427
8514,,dvygb9qlk_yj,4214,4215,8429
8515,,zzzy-tt48xsj,4215,4216,8431
8516,,h6i3wckzqzuj,4216,4217,8433
8517,,i4ll2hgp0zuj,4217,4218,8435
8518,,l-wdboc6v5ij,4218,4219,8437
8519,,lmm4_4_unnoj,4219,4220,8439
8520,,chp13mp-4fsj,4220,4221,8441
8521,,lyy5ylce5wcj,4221,4222,8443
8522,,qipbgcpuimyj,4222,4223,8445
8523,,04xsbigae6aj,4223,4224,8447
8524,,ynpny4fhkkoj,4224,4225,8449
8525,,qtc4mjxhx0sj,4225,4226,8451
8526,,zkzfhthxkcwj,4226,4227,8453
8527,,_bv4gi6gkv0j,4227,4228,8455
8528,,kng5lw2bq1kj,4228,4229,8457
8529,,url:http://www.ingentaconnect.com/content/els/09505849/1996/00000038/00000005/art01060,4229,4230,8459
8530,,uyknfmqi8i0j,4230,4231,8461
8531,,y_qe3cwrza0j,4231,4232,8463
8532,,tialdctlnh4j,4232,4233,8465
8533,,yblfqeoryeaj,4234,4235,8469
8534,,fhm8-jufim4j,4235,4236,8471
8535,,ggt2lnj4llej,4236,4237,8473
8536,,dl2shzhoidoj,4237,4238,8475
8537,,dat_9q-i5tqj,4238,4239,8477
8538,,rgl1d5q1cngj,4239,4240,8479
8539,,wvleczikm_ej,4240,4241,8481
8540,,dddvxwv42x8j,4241,4242,8483
8541,,mw_asw1qzbej,4242,4243,8485
8542,,8ymeytphctyj,4243,4244,8487
8543,,ssa5n9tbjjwj,4244,4245,8489
8544,,paqqyshcrskj,4245,4246,8491
8545,,uvposq8runqj,4246,4247,8493
8546,,kk3xqsrtkwkj,4247,4248,8495
8547,,6six0zuh1x0j,4249,4250,8499
8548,,whrh--jeyz4j,4250,4251,8501
8549,,cke7hkvxvcqj,4251,4252,8503
8550,,pqiprtjwhpuj,4252,4253,8505
8551,,8dtftihun8oj,4253,4254,8507
8552,,xdt_vcqy5myj,4254,4255,8509
8553,,xtdcnbrhelaj,4255,4256,8511
8554,,cqqjxdkwzxyj,4256,4257,8513
8555,,qbyfbpegebmj,4257,4258,8515
8556,,bmjaeboelywj,4258,4259,8517
8557,,jmviqdmgrckj,4259,4260,8519
8558,,ozeiixrgs28j,4260,4261,8521
8559,,ppv8eof-uooj,4261,4262,8523
8560,,nsthk-pwy4ej,4262,4263,8525
8561,,lg-3vg1rn9sj,4263,4264,8527
8562,,pvsopy4wuecj,4264,4265,8529
8563,,url:http://portal.acm.org/citation.cfm3fid3d89482.89491,4265,4266,8531
8564,,3sg5klzbacuj,4266,4267,8533
8565,,nszzdid9vqej,4267,4268,8535
8566,,579454ilyyej,4268,4269,8537
8567,,wk1kqfxd60gj,4269,4270,8539
8568,,v9fcjrde1qgj,4270,4271,8541
8569,,avywj5-f8zij,4271,4272,8543
8570,,u9zwxsfdcggj,4272,4273,8545
8571,,ywzxrffwkecj,4273,4274,8547
8572,,6yzzojhv4_oj,4274,4275,8549
8573,,ss239ewwfouj,4275,4276,8551
8574,,okcz_nk5cbmj,4276,4277,8553
8575,,6aj9i6cnpegj,4277,4278,8555
8576,,fh3-fjsd4roj,4278,4279,8557
8577,,retgb_jfnqij,4279,4280,8559
8578,,njuodtxce88j,4280,4281,8561
8579,,ynjpmhfdmwcj,4281,4282,8563
8580,,91atvwkwqr8j,4282,4283,8565
8581,,wbw7ewh_ppej,4283,4284,8567
8582,,vlogpmjpyz0j,4284,4285,8569
8583,,url:http://portal.acm.org/citation.cfm3fid3d592192.592240,4285,4286,8571
8584,,,4286,4287,8573
8585,,2kp-sjdbrkaj,4287,4288,8575
8586,,6ll19kk5i-uj,4288,4289,8577
8587,,6wvy1bxgvpmj,4290,4291,8581
8588,,j1jljpus2s8j,4292,4293,8585
8589,,cn6l77eu9pgj,4293,4294,8587
8590,,eevlzskmrnij,4294,4295,8589
8591,,url:http://portal.acm.org/ft_gateway.cfm3fid3d95701526type3dpdf26dl3dguide26dl3dacm26cfid3d1111111126cftoken3d2222222,4295,4296,8591
8592,,c8x8zyv7heoj,4296,4297,8593
8593,,v8pakd-m2-aj,4297,4298,8595
8594,,qvljitzm2-cj,4298,4299,8597
8595,,wcvjgb90jjsj,4299,4300,8599
8596,,ysdz89ga_i8j,4300,4301,8601
8597,,dvgemebyt4oj,4301,4302,8603
8598,,3fztj2npf18j,4302,4303,8605
8599,,uzn7eig9r58j,4303,4304,8607
8600,,fvr7plwb3noj,4304,4305,8609
8601,,tzhynemimmoj,4305,4306,8611
8602,,rnybgfu0040j,4306,4307,8613
8603,,fdrnhnhp_tyj,4308,4309,8617
8604,,llag8oyvot0j,4309,4310,8619
8605,,qwm9p9y_e5qj,4310,4311,8621
8606,,url:http://doi.wiley.com/10.1002/tl.20,4311,4312,8623
8607,,cwetfluf3gij,4312,4313,8625
8608,,50jep-shnoyj,4313,4314,8627
8609,,emovamecsgij,4314,4315,8629
8610,,kfnmgryxojij,4315,4316,8631
8611,,rojysmckl2gj,4316,4317,8633
8612,,pq02tv8pj9oj,4317,4318,8635
8613,,fw0cpiqov7qj,4318,4319,8637
8614,,jkd_d3bii3qj,4319,4320,8639
8615,,i8pukjzlr8aj,4320,4321,8641
8616,,crg6odrufr0j,4321,4322,8643
8617,,9_ri86z6eukj,4322,4323,8645
8618,,bwovzsc9bfoj,4323,4324,8647
8619,,voxehnshewqj,4324,4325,8649
8620,,zr6ghdhoe3qj,4325,4326,8651
8621,,8jrcrku2mbwj,4326,4327,8653
8622,,url:http://doi.wiley.com/10.1002/ace.7904,4327,4328,8655
8623,,pm9sm49cly8j,4328,4329,8657
8624,,t6-qonqkekqj,4329,4330,8659
8625,,unlzdcqrcsoj,4330,4331,8661
8626,,atnbc2eo4bcj,4331,4332,8663
8627,,5lauk2wflccj,4332,4333,8665
8628,,twtuouetsjej,4333,4334,8667
8629,,95afy5l1crwj,4334,4335,8669
8630,,3dkslq4xbryj,4336,4337,8673
8631,,xfckl9qhtjij,4337,4338,8675
8632,,1vvrglt3lr8j,4338,4339,8677
8633,,xiaxjivaiyuj,4339,4340,8679
8634,,eobved5crywj,4340,4341,8681
8635,,url:http://doi.wiley.com/10.1002/tl.90,4341,4342,8683
8636,,b7dq6iiev-gj,4342,4343,8685
8637,,gbdrnx35i6uj,4343,4344,8687
8638,,ke0_zuwa-6qj,4344,4345,8689
8639,,b30slqvbtrwj,4345,4346,8691
8640,,url:http://portal.acm.org/citation.cfm3fid3d67793.67795,4346,4347,8693
8641,,jtjc3_27dngj,4347,4348,8695
8642,,q8_ahdo_8ouj,4348,4349,8697
8643,,obzswd7lpxaj,4349,4350,8699
8644,,9rnt6agafkoj,4350,4351,8701
8645,,yliyaaouxqkj,4351,4352,8703
8646,,url:http://portal.acm.org/ft_gateway.cfm3fid3d109968926type3dpdf,4352,4353,8705
8647,,kgtvek7hht4j,4353,4354,8707
8648,,dayokf3wy1sj,4354,4355,8709
8649,,8bwinrjv40mj,4355,4356,8711
8650,,hsaqieugj8yj,4356,4357,8713
8651,,cjguv6umuwej,4357,4358,8715
8652,,xvqmfladvmyj,4358,4359,8717
8653,,xpujbyesdm4j,4359,4360,8719
8654,,30hjodwrixgj,4360,4361,8721
8655,,cgzkf6mfhxkj,4361,4362,8723
8656,,whhfhdg_ougj,4362,4363,8725
8657,,upwidqhsejqj,4363,4364,8727
8658,,fkxlg9sl4maj,4364,4365,8729
8659,,pja8iecpdrij,4365,4366,8731
8660,,elrqjwadllwj,4366,4367,8733
8661,,sq8lgo35xkwj,4367,4368,8735
8662,,ratwmsuo6nsj,4368,4369,8737
8663,,-66rqatxenej,4369,4370,8739
8664,,y-ijjybjrccj,4370,4371,8741
8665,,oijjgpsau-8j,4371,4372,8743
8666,,965bxzmpxsoj,4372,4373,8745
8667,,u2qrb2dk5z8j,4373,4374,8747
8668,,7g6yv70vrmmj,4374,4375,8749
8669,,lwn6xyijecyj,4375,4376,8751
8670,,2-o0xqiuk2qj,4376,4377,8753
8671,,tex5gaf9mwkj,4377,4378,8755
8672,,k8owhwemaa4j,4378,4379,8757
8673,,cuajyspp3eqj,4379,4380,8759
8674,,ax0ocqu8x04j,4380,4381,8761
8675,,ghuqeancylwj,4381,4382,8763
8676,,umw_k2t7semj,4382,4383,8765
8677,,hfrmmlae-vwj,4383,4384,8767
8678,,if54wvquigej,4384,4385,8769
8679,,wbuljv3sjzqj,4385,4386,8771
8680,,1ga4a2-q-dkj,4386,4387,8773
8681,,og3oycfenyyj,4387,4388,8775
8682,,0xr1siw77xyj,4388,4389,8777
8683,,attdspsmncwj,4389,4390,8779
8684,,l9uclduenxqj,4390,4391,8781
8685,,hopegqxabtoj,4391,4392,8783
8686,,hxfldyd0h7aj,4392,4393,8785
8687,,06nwbwh10xuj,4393,4394,8787
8688,,phlzi3dh1uuj,4394,4395,8789
8689,,je2fmjdrc20j,4395,4396,8791
8690,,_c-1pvcbewuj,4396,4397,8793
8691,,gqodyhv_trgj,4397,4398,8795
8692,,xflytg19awkj,4398,4399,8797
8693,,c9wt8_40qoaj,4399,4400,8799
8694,,qrtskmkxlzcj,4400,4401,8801
8695,,wxmmbyxfru8j,4401,4402,8803
8696,,ckgw6yw9_rsj,4402,4403,8805
8697,,gepx2nyskfyj,4403,4404,8807
8698,,nqlazboyl5gj,4404,4405,8809
8699,,k5ujatqaatoj,4405,4406,8811
8700,,ou0jynv9z_uj,4406,4407,8813
8701,,w2d8zp-t7auj,4407,4408,8815
8702,,url:http://doi.wiley.com/10.1002/ace.8411,4408,4409,8817
8703,,mdjqgebsbh4j,4409,4410,8819
8704,,m3ycgtodllgj,4410,4411,8821
8705,,lvv4f2ozfxij,4411,4412,8823
8706,,url:http://adsabs.harvard.edu/abs/1976infph..16..165c,4412,4413,8825
8707,,5uc1isl7vwej,4413,4414,8827
8708,,,4414,4415,8829
8709,,drncxks0wesj,4415,4416,8831
8710,,d0urtgbkd7kj,4416,4417,8833
8711,,kp0e_2hvuvmj,4417,4418,8835
8712,,,4418,4419,8837
8713,,swo7gbnyieqj,4419,4420,8839
8714,,khwna8m1xdcj,4420,4421,8841
8715,,1opwjtmfbuwj,4421,4422,8843
8716,,xd86_nxloqij,4422,4423,8845
8717,,eu43fznasmaj,4423,4424,8847
8718,,0rjigtboep8j,4424,4425,8849
8719,,kerrnoeow2sj,4425,4426,8851
8720,,9cburmlfs1sj,4426,4427,8853
8721,,xieabfy2rzaj,4427,4428,8855
8722,,crqxeelghlaj,4428,4429,8857
8723,,je52jsdu4wej,4430,4431,8861
8724,,abbetkjrdhoj,4431,4432,8863
8725,,tcslnozhpgkj,4432,4433,8865
8726,,vh47hdkgdckj,4433,4434,8867
8727,,scczrvgihmqj,4434,4435,8869
8728,,brt6yrwkc7aj,4435,4436,8871
8729,,chuviwstw8ej,4436,4437,8873
8730,,cfyljzzf9b8j,4437,4438,8875
8731,,hyry7pbpzykj,4438,4439,8877
8732,,j4yibd0uey4j,4439,4440,8879
8733,,rsurm9r5zekj,4440,4441,8881
8734,,rrvsqi7dia0j,4441,4442,8883
8735,,lfpadwdie0aj,4442,4443,8885
8736,,457ppveulqcj,4443,4444,8887
8737,,jirlkjsrekgj,4444,4445,8889
8738,,url:http://portal.acm.org/citation.cfm3fid3d33521826dl3dacm26coll3dguide26cfid3d1111111126cftoken3d2222222,4445,4446,8891
8739,,8tjjdvlsm8uj,4446,4447,8893
8740,,_ubb-bbcmd4j,4447,4448,8895
8741,,8kj6s-7-lqyj,4448,4449,8897
8742,,etp4skqvrooj,4449,4450,8899
8743,,ceynfcb3vhsj,4450,4451,8901
8744,,z16rn39bvfej,4451,4452,8903
8745,,4bg39hmgraqj,4452,4453,8905
8746,,455gans7kvaj,4453,4454,8907
8747,,c4i3fp90vc0j,4454,4455,8909
8748,,3woipqhl8sqj,4455,4456,8911
8749,,xgldvffwi08j,4456,4457,8913
8750,,ubcljsrrzgoj,4457,4458,8915
8751,,gvvcb73zqnej,4458,4459,8917
8752,,c-bydlakg64j,4459,4460,8919
8753,,xhuy8ubawguj,4460,4461,8921
8754,,ncn0aqdyhngj,4461,4462,8923
8755,,rn6k_5khf_gj,4462,4463,8925
8756,,spnvv2ipvzwj,4463,4464,8927
8757,,n4n2mg5kuzmj,4464,4465,8929
8758,,suqxda871r8j,4465,4466,8931
8759,,8pydeocgsmyj,4466,4467,8933
8760,,wazwbvnxywqj,4467,4468,8935
8761,,xnd2zr_c-qgj,4468,4469,8937
8762,,chuvygeqdfqj,4469,4470,8939
8763,,52cxnyryobaj,4470,4471,8941
8764,,url:http://portal.acm.org/citation.cfm3fid3d974121.97412226coll3dguide26dl3dacm26type3dissue26idx3dj68926part3dperiodical26wanttype3dperiodical26title3dacm2520sigmod2520record26cfid3d1111111126cftoken3d2222222,4471,4472,8943
8765,,9c55fxnnwgwj,4472,4473,8945
8766,,7siapdxdqdmj,4473,4474,8947
8767,,_ddsh9gsewkj,4474,4475,8949
8768,,url:http://portal.acm.org/ft_gateway.cfm3fid3d108364326type3dpdf,4475,4476,8951
8769,,7zlp05xyesyj,4476,4477,8953
8770,,drnbaqjbox4j,4477,4478,8955
8771,,wo4d1-yw3uoj,4478,4479,8957
8772,,wp6qslgopzoj,4480,4481,8961
8773,,iyfz58ek5xwj,4481,4482,8963
8774,,ixjzhbig3mij,4482,4483,8965
8775,,hsqjqugj3y0j,4483,4484,8967
8776,,wtcbplra8tmj,4484,4485,8969
8777,,srhvoutqyh0j,4485,4486,8971
8778,,gui-yjmzjeuj,4486,4487,8973
8779,,hd90xxjjpokj,4487,4488,8975
8780,,odgybivctauj,4488,4489,8977
8781,,ab9gvd2hykoj,4489,4490,8979
8782,,mvunjl4uklqj,4490,4491,8981
8783,,8teo9emvlrgj,4491,4492,8983
8784,,ejm5h8epzcgj,4492,4493,8985
8785,,g060ku8hicsj,4493,4494,8987
8786,,comhqpfpanwj,4494,4495,8989
8787,,tufiar9uiryj,4495,4496,8991
8788,,x9uyzfhkuqgj,4496,4497,8993
8789,,qkom4jlqq5qj,4497,4498,8995
8790,,url:http://portal.acm.org/ft_gateway.cfm3fid3d110135126type3dpdf,4498,4499,8997
8791,,0ickhgxsqtej,4499,4500,8999
8792,,remmjx4wueaj,4500,4501,9001
8793,,ozddhhl-vukj,4501,4502,9003
8794,,xemgrsinxrkj,4502,4503,9005
8795,,ew-sfjipk9ej,4503,4504,9007
8796,,jpsweo8mlgwj,4504,4505,9009
8797,,1nqvxyedkwaj,4505,4506,9011
8798,,url:http://www.ingentaconnect.com/content/els/09505849/1996/00000038/00000001/art01039,4506,4507,9013
8799,,url:http://www.csa.com/partners/viewrecord.php3frequester3dgs26collection3dtrd26recid3d0014627ci,4507,4508,9015
8800,,szt1u8ieyduj,4508,4509,9017
8801,,wbrjekfyi8ij,4509,4510,9019
8802,,dzqbqi0aykoj,4511,4512,9023
8803,,edf9ksu49qgj,4512,4513,9025
8804,,y9cecr5idlej,4513,4514,9027
8805,,uxczo3iikoaj,4514,4515,9029
8806,,,4516,4517,9033
8807,,txchcog34w0j,4517,4518,9035
8808,,nrc83vcpsqaj,4518,4519,9037
8809,,osrgoxiq0wuj,4519,4520,9039
8810,,hteawqmz9jij,4520,4521,9041
8811,,akekql6m9x8j,4521,4522,9043
8812,,zqzv11ilshsj,4522,4523,9045
8813,,glaokgtv8v0j,4523,4524,9047
8814,,zrwh02fw0dyj,4524,4525,9049
8815,,tlpwe61jktkj,4525,4526,9051
8816,,3ps26yr7pusj,4527,4528,9055
8817,,r57re0p0keuj,4528,4529,9057
8818,,url:http://ieeexplore.ieee.org/xpl/abs_free.jsp3farnumber3d718130,4529,4530,9059
8819,,yg23cd3qzbuj,4530,4531,9061
8820,,9pe2cgixctoj,4531,4532,9063
8821,,l7xmlpqlxbij,4532,4533,9065
8822,,xpfu8wefkhkj,4533,4534,9067
8823,,_xa3koy0hd8j,4534,4535,9069
8824,,zzp3eju66twj,4535,4536,9071
8825,,eiajyjmjd1wj,4536,4537,9073
8826,,dalgjuhfaemj,4537,4538,9075
8827,,iuvd0sd8-jwj,4538,4539,9077
8828,,kl6ogrfvvtcj,4539,4540,9079
8829,,633pythgq30j,4540,4541,9081
8830,,,4541,4542,9083
8831,,co1ondh5lckj,4542,4543,9085
8832,,mlhd-hctxsuj,4543,4544,9087
8833,,pg9kegz0fbcj,4544,4545,9089
8834,,z1hqfeqnejgj,4545,4546,9091
8835,,shkdjligseoj,4546,4547,9093
8836,,url:http://links.jstor.org/sici3fsici3d0146-4949(196623)7253a3253c311253aaotaig253e2.0.co253b2-e,4547,4548,9095
8837,,bgowk5tykyej,4548,4549,9097
8838,,vdxt4np_lyoj,4549,4550,9099
8839,,dauvdaiasxqj,4550,4551,9101
8840,,mksqbmlkznqj,4551,4552,9103
8841,,cxppm69epqej,4552,4553,9105
8842,,axuaulrrr1gj,4553,4554,9107
8843,,r5puhvaiztoj,4554,4555,9109
8844,,czxie-l3szcj,4555,4556,9111
8845,,ch0ctruasqej,4556,4557,9113
8846,,yrr7nyiyctmj,4557,4558,9115
8847,,ddtsrjmtnuej,4558,4559,9117
8848,,i-eb90t_38oj,4559,4560,9119
8849,,36flzgtjt4gj,4560,4561,9121
8850,,t7haxgrpsz0j,4561,4562,9123
8851,,zjhpynaqnaaj,4562,4563,9125
8852,,u7glo1eblpyj,4563,4564,9127
8853,,aoxh6w2h-v0j,4564,4565,9129
8854,,irbsb6eq3rkj,4565,4566,9131
8855,,mw105ocva3gj,4566,4567,9133
8856,,9gxruwe4z7gj,4567,4568,9135
8857,,ycvrc0t9ozyj,4568,4569,9137
8858,,icz5hbag0toj,4569,4570,9139
8859,,ukrgonxpjmyj,4570,4571,9141
8860,,bvzhrpqmizuj,4572,4573,9145
8861,,3pfrz_cur-yj,4573,4574,9147
8862,,96lq0vdoctkj,4574,4575,9149
8863,,eqg6nwiq6fij,4575,4576,9151
8864,,9xl5khcctj4j,4576,4577,9153
8865,,24u8eq5la4wj,4577,4578,9155
8866,,hj2ikiwoyt0j,4578,4579,9157
8867,,aibnhvhkbp8j,4579,4580,9159
8868,,url:http://portal.acm.org/ft_gateway.cfm3fid3d63742526type3dpdf26dl3dguide26dl3dacm26cfid3d1111111126cftoken3d2222222,4580,4581,9161
8869,,url:http://portal.acm.org/ft_gateway.cfm3fid3d35320626type3dpdf26dl3dguide26dl3dacm26cfid3d1111111126cftoken3d2222222,4581,4582,9163
8870,,gzpjglhnmxsj,4582,4583,9165
8871,,v-cjm0s2jwwj,4583,4584,9167
8872,,eimestkc1u8j,4584,4585,9169
8873,,tym9hr_gf7mj,4585,4586,9171
8874,,ka7atqw7pvaj,4586,4587,9173
8875,,cl06_nviytqj,4587,4588,9175
8876,,mmsmzv_jydoj,4588,4589,9177
8877,,bqwffsyacqmj,4589,4590,9179
8878,,0nk87fqbfpuj,4590,4591,9181
8879,,ppg-lg76inwj,4591,4592,9183
8880,,ggo9g1wchpij,4592,4593,9185
8881,,b7dgodv-rvwj,4593,4594,9187
8882,,rlw0poby26wj,4594,4595,9189
8883,,hrhlkxm0bsyj,4595,4596,9191
8884,,huvcxjvovagj,4596,4597,9193
8885,,fgii_oxegv0j,4597,4598,9195
8886,,wbxb7wjob7cj,4598,4599,9197
8887,,jp6trlpcwvoj,4599,4600,9199
8888,,zphee9iqxsoj,4600,4601,9201
8889,,fsa72wma67kj,4601,4602,9203
8890,,34tnjkosznuj,4602,4603,9205
8891,,ukem3jw7mdij,4603,4604,9207
8892,,gc8-seq1v1sj,4604,4605,9209
8893,,aqsr768qcquj,4605,4606,9211
8894,,url:http://portal.acm.org/ft_gateway.cfm3fid3d108624126type3dpdf,4606,4607,9213
8895,,cjvdw3delx8j,4607,4608,9215
8896,,mlpjlhlhqeij,4608,4609,9217
8897,,url:http://portal.acm.org/citation.cfm3fid3d984382.98438426coll3dguide26dl3dacm26idx3dj68926part3dperiodical26wanttype3dperiodical26title3dacm2520sigmod2520record26cfid3d1111111126cftoken3d2222222,4609,4610,9219
8898,,url:http://portal.acm.org/ft_gateway.cfm3fid3d108626126type3dpdf,4610,4611,9221
8899,,mfitlogdzbaj,4611,4612,9223
8900,,mevg8whhlzoj,4612,4613,9225
8901,,xdgffbr7e14j,4613,4614,9227
8902,,ymtikp5kxxoj,4614,4615,9229
8903,,tjyvkve9-i0j,4615,4616,9231
8904,,ubhqimaww0mj,4616,4617,9233
8905,,hw5mnzyqcokj,4617,4618,9235
8906,,sko145nl9roj,4618,4619,9237
8907,,9wo54wyh_x8j,4619,4620,9239
8908,,0ecttdnka14j,4620,4621,9241
8909,,bf2wndcztnqj,4621,4622,9243
8910,,m3alnrr9qt0j,4622,4623,9245
8911,,hy8wz5d2gtej,4623,4624,9247
8912,,2l58hyzuqcuj,4624,4625,9249
8913,,kdepoim2zokj,4625,4626,9251
8914,,2r41khijquqj,4626,4627,9253
8915,,url:http://www.csa.com/partners/viewrecord.php3frequester3dgs26collection3dtrd26recid3d0804808ci,4627,4628,9255
8916,,jpzl6dinmtyj,4628,4629,9257
8917,,u5m8vnw4ohej,4629,4630,9259
8918,,xvth5from4gj,4630,4631,9261
8919,,c_l-xexxwq0j,4631,4632,9263
8920,,znl5vwqpwfej,4632,4633,9265
8921,,url:http://www.csa.com/partners/viewrecord.php3frequester3dgs26collection3dtrd26recid3dn8927822ah,4633,4634,9267
8922,,oni93qmm9hgj,4634,4635,9269
8923,,80wqpnh0eekj,4635,4636,9271
8924,,egpdviopjbcj,4637,4638,9275
8925,,url:http://www.springerlink.com/index/hj06442pl174313r.pdf,4638,4639,9277
8926,,rrct-k2xhrej,4639,4640,9279
8927,,jr9u8pwgej4j,4640,4641,9281
8928,,lpf_zzgfejuj,4641,4642,9283
8929,,uroodkg5p20j,4642,4643,9285
8930,,d5yimwcnhkmj,4643,4644,9287
8931,,ie6ftpfpjkaj,4644,4645,9289
8932,,b3znsu-zawkj,4645,4646,9291
8933,,bxhwoonatt0j,4646,4647,9293
8934,,q-wvevx1s5oj,4647,4648,9295
8935,,hl0v7ub0nxij,4648,4649,9297
8936,,0mk_qzajkhej,4649,4650,9299
8937,,mbxqzuuce4yj,4650,4651,9301
8938,,4scuheerizej,4651,4652,9303
8939,,snfnlbmdpwgj,4652,4653,9305
8940,,aa_12h1ns2yj,4653,4654,9307
8941,,7uaxy8eonguj,4654,4655,9309
8942,,cv3tb9nbtaij,4655,4656,9311
8943,,jqqolbaj_8cj,4656,4657,9313
8944,,5ysmcgully4j,4657,4658,9315
8945,,rocmewcms2wj,4658,4659,9317
8946,,9uxj2xzgt9uj,4659,4660,9319
8947,,v4a-vqiwj0sj,4660,4661,9321
8948,,mdoua-_bhq4j,4661,4662,9323
8949,,w-i02ewelsej,4662,4663,9325
8950,,toiwqrmz6zaj,4663,4664,9327
8951,,cclmqmvv84gj,4664,4665,9329
8952,,mud7elttxx8j,4665,4666,9331
8953,,48jpldoszpkj,4666,4667,9333
8954,,ws0w-u_xncuj,4667,4668,9335
8955,,ztpmhcsywhwj,4668,4669,9337
8956,,ag6dmikqcwcj,4669,4670,9339
8957,,hblhzid8xxaj,4670,4671,9341
8958,,url:http://www.ingentaconnect.com/content/els/08830355/2001/00000035/00000003/art00025,4671,4672,9343
8959,,z6rpmmsz3ikj,4672,4673,9345
8960,,uswcvcrvfoej,4673,4674,9347
8961,,0vhtbuwjcquj,4674,4675,9349
8962,,rlazczucjemj,4675,4676,9351
8963,,xdoazl6prmmj,4676,4677,9353
8964,,f6w7h-ar0voj,4677,4678,9355
8965,,kskknlij7o4j,4678,4679,9357
8966,,zquxpsssy_ej,4679,4680,9359
8967,,7kdsjmccowmj,4680,4681,9361
8968,,gs0ixjf46xmj,4681,4682,9363
8969,,url:http://pubs.acs.org/cgi-bin/abstract.cgi/achre4/asap/abs/ar020073i.html,4682,4683,9365
8970,,vy52k7gp2w0j,4683,4684,9367
8971,,j4ieleouu4cj,4684,4685,9369
8972,,16l7wdma0gsj,4685,4686,9371
8973,,fmzmgeoskzyj,4686,4687,9373
8974,,fzrpzy583jaj,4687,4688,9375
8975,,_ltwmlw7whwj,4688,4689,9377
8976,,jkvg4hc8mncj,4689,4690,9379
8977,,81mwwyshwvoj,4690,4691,9381
8978,,uv_pxocvadqj,4691,4692,9383
8979,,h4e2llux9tsj,4692,4693,9385
8980,,f4dvef2cbukj,4693,4694,9387
8981,,laddlv9x6wgj,4694,4695,9389
8982,,lbeeplmfvgmj,4695,4696,9391
8983,,uyptftpl82aj,4696,4697,9393
8984,,ndzrynttyl8j,4697,4698,9395
8985,,gxkikk1iv2sj,4698,4699,9397
8986,,1tdjt63_bgkj,4699,4700,9399
8987,,enawmjwowzwj,4700,4701,9401
8988,,uvogjol5hb0j,4701,4702,9403
8989,,cztj00lolvyj,4702,4703,9405
8990,,nwrhxzz1cc0j,4703,4704,9407
8991,,lz2kf-crhwkj,4705,4706,9411
8992,,hvdqm1pb9lkj,4706,4707,9413
8993,,ms7dl3_vqscj,4707,4708,9415
8994,,hc9_3edvopkj,4708,4709,9417
8995,,zwvzud6p3u4j,4709,4710,9419
8996,,np6nskhkjjyj,4710,4711,9421
8997,,ipgoa3yxbl4j,4711,4712,9423
8998,,pqe1vpges2gj,4712,4713,9425
8999,,wezuw_ozszij,4713,4714,9427
9000,,yiya1zamn_cj,4714,4715,9429
9001,,dgpcy-yxx2aj,4715,4716,9431
9002,,mokcn84ck7ej,4716,4717,9433
9003,,d8knxba9-gmj,4717,4718,9435
9004,,d7k3wb9zfqmj,4718,4719,9437
9005,,9vuheksrgpgj,4719,4720,9439
9006,,url:http://portal.acm.org/ft_gateway.cfm3fid3d109971826type3dpdf,4720,4721,9441
9007,,xg8e-h8a79kj,4721,4722,9443
9008,,iwowvs8--rsj,4722,4723,9445
9009,,6yb1wmjwxikj,4723,4724,9447
9010,,geypanvr-taj,4724,4725,9449
9011,,n3dsaqry-e8j,4725,4726,9451
9012,,url:http://www.csa.com/partners/viewrecord.php3frequester3dgs26collection3dtrd26recid3dn9210536ah,4726,4727,9453
9013,,3pymkhdhkaaj,4727,4728,9455
9014,,iu1soincrvaj,4728,4729,9457
9015,,0fwnweml2ksj,4729,4730,9459
9016,,hondrctaqfwj,4730,4731,9461
9017,,cwmy7dsvnewj,4731,4732,9463
9018,,dau9gkhyrqqj,4732,4733,9465
9019,,_xictbp2kg8j,4733,4734,9467
9020,,3ow1rlsiidmj,4734,4735,9469
9021,,zroccxxadp0j,4735,4736,9471
9022,,de_3pkxkhzij,4736,4737,9473
9023,,eoofl9dxv4wj,4737,4738,9475
9024,,62qp2f9c0ykj,4738,4739,9477
9025,,6hlnpt13ql0j,4739,4740,9479
9026,,-0vakiwhrrmj,4740,4741,9481
9027,,jltjav8rxlaj,4741,4742,9483
9028,,o19ipbmnbnij,4742,4743,9485
9029,,s8x4plnt4jqj,4743,4744,9487
9030,,sgsdogo0nsij,4744,4745,9489
9031,,url:http://www.springerlink.com/index/kwquklhayvew6gp7.pdf,4745,4746,9491
9032,,run5mcmyx8yj,4746,4747,9493
9033,,j25kmgbrzgoj,4747,4748,9495
9034,,mhpavmznhxuj,4748,4749,9497
9035,,bohoiqmzo0qj,4749,4750,9499
9036,,_a9qdo0chrsj,4750,4751,9501
9037,,e6sv0r4u60kj,4751,4752,9503
9038,,ooa8ij06o0ej,4752,4753,9505
9039,,d8zdetommlij,4753,4754,9507
9040,,ejryxucvjn0j,4754,4755,9509
9041,,xfzgzsyoemoj,4755,4756,9511
9042,,b-upj2s4n70j,4756,4757,9513
9043,,hmwvcwqw8gij,4757,4758,9515
9044,,w5ykcqb_5ckj,4758,4759,9517
9045,,wyh1c_blhl8j,4759,4760,9519
9046,,,4760,4761,9521
9047,,gthbhiuuqnqj,4761,4762,9523
9048,,3rlmdkigc2ij,4762,4763,9525
9049,,rifqxmuqpywj,4763,4764,9527
9050,,o9npfuopg0ej,4764,4765,9529
9051,,g7qk_u38eogj,4765,4766,9531
9052,,g_wdq5warfmj,4766,4767,9533
9053,,sw0hye_vo8gj,4767,4768,9535
9054,,27xxurvh-xej,4768,4769,9537
9055,,0dq3cgywbgyj,4769,4770,9539
9056,,mi6xfwbxz6oj,4770,4771,9541
9057,,5vrzz6dmjz4j,4771,4772,9543
9058,,cfyjjc6v1l0j,4772,4773,9545
9059,,druaec2cvrkj,4773,4774,9547
9060,,awmwar7p2k4j,4774,4775,9549
9061,,idr4suppyfqj,4775,4776,9551
9062,,ywyq7uug6z8j,4776,4777,9553
9063,,yt5y8_egwtcj,4777,4778,9555
9064,,onuqab6sm3oj,4778,4779,9557
9065,,wzvlvf7pbzkj,4779,4780,9559
9066,,b-kfshhipy4j,4780,4781,9561
9067,,url:http://portal.acm.org/citation.cfm3fid3d171926.172015,4781,4782,9563
9068,,efb9alwb57ej,4783,4784,9567
9069,,pmb-pjqvcgcj,4784,4785,9569
9070,,e0my9pww0csj,4785,4786,9571
9071,,zsmn_h9ainmj,4786,4787,9573
9072,,q1d68ypibjsj,4787,4788,9575
9073,,xdufxggftogj,4788,4789,9577
9074,,pbzpw9noq0qj,4789,4790,9579
9075,,url:http://doi.wiley.com/10.1002/ace.122,4790,4791,9581
9076,,gifzwp_icmuj,4791,4792,9583
9077,,bdkqe8u3ywej,4792,4793,9585
9078,,qwgy-rjlrfyj,4793,4794,9587
9079,,v1p9ej4e1zkj,4795,4796,9591
9080,,ysepcliaio8j,4796,4797,9593
9081,,url:http://www.ingentaconnect.com/content/els/09505849/1999/00000041/00000005/art00007,4797,4798,9595
9082,,d_bznl4-pu4j,4798,4799,9597
9083,,imyd4ew7jwqj,4799,4800,9599
9084,,scgyjb99opyj,4800,4801,9601
9085,,maipn83kwgij,4801,4802,9603
9086,,euilv2a1rx8j,4802,4803,9605
9087,,e3sceohnes8j,4803,4804,9607
9088,,c4dgoohfmq0j,4804,4805,9609
9089,,a1tykjbjrrej,4805,4806,9611
9090,,ksg-g-csjkqj,4806,4807,9613
9091,,svjquaoycx0j,4807,4808,9615
9092,,p1kyve6rthqj,4808,4809,9617
9093,,norgymfj31ej,4809,4810,9619
9094,,w8r72ygvt5wj,4810,4811,9621
9095,,yggqhpk1bwuj,4811,4812,9623
9096,,nqeliza-zqkj,4812,4813,9625
9097,,url:http://adsabs.harvard.edu/abs/1977rael...22.2420s,4813,4814,9627
9098,,f0qun69jojgj,4814,4815,9629
9099,,rh-khkksgwcj,4815,4816,9631
9100,,hl5djzfueegj,4816,4817,9633
9101,,ezmvhsh5nhej,4817,4818,9635
9102,,oymd_kppgfqj,4818,4819,9637
9103,,kdeknsxwnloj,4819,4820,9639
9104,,qdpxaovgwnqj,4820,4821,9641
9105,,cm4adskctk0j,4821,4822,9643
9106,,brnr8yohcomj,4822,4823,9645
9107,,yexzamjcougj,4823,4824,9647
9108,,8nbdk2rgoxsj,4824,4825,9649
9109,,srnvh9jihzgj,4825,4826,9651
9110,,vidx0rcmso4j,4826,4827,9653
9111,,4npcxkesrcgj,4827,4828,9655
9112,,xg1p6rocjbgj,4828,4829,9657
9113,,vl_cnrotmqcj,4829,4830,9659
9114,,oqxqx0cpc6kj,4830,4831,9661
9115,,cw5sswevj54j,4831,4832,9663
9116,,jsn2b_zmu1ej,4832,4833,9665
9117,,vsrsxd5nzsuj,4833,4834,9667
9118,,gjwn_wpai0yj,4834,4835,9669
9119,,uglvwff55mej,4835,4836,9671
9120,,bruompcpefij,4836,4837,9673
9121,,x4svr7ipsuqj,4837,4838,9675
9122,,bxak2oxe23ej,4838,4839,9677
9123,,0qvtgkeocmqj,4839,4840,9679
9124,,ytbohybibfej,4840,4841,9681
9125,,pdej2dctu9wj,4841,4842,9683
9126,,ke-cov5d1oej,4842,4843,9685
9127,,blso3xlgg7gj,4843,4844,9687
9128,,kpjadmpzjcgj,4844,4845,9689
9129,,cja0h6hwpu8j,4845,4846,9691
9130,,4qgduknyukaj,4846,4847,9693
9131,,w56wu7dxed0j,4847,4848,9695
9132,,,4848,4849,9697
9133,,nmjj0osc5myj,4849,4850,9699
9134,,mpswk2w1uqwj,4850,4851,9701
9135,,xhpvrlp1fbij,4851,4852,9703
9136,,y5g3bjv9fuyj,4852,4853,9705
9137,,url:http://www.csa.com/partners/viewrecord.php3frequester3dgs26collection3dtrd26recid3d0294191ci,4853,4854,9707
9138,,d7j7mq56k1kj,4854,4855,9709
9139,,url:http://pubs.acs.org/cgi-bin/abstract.cgi/achre4/2004/37/i05/abs/ar0200899.html,4855,4856,9711
9140,,0jjlzyj_nlqj,4856,4857,9713
9141,,y7ir2wg1phwj,4857,4858,9715
9142,,9mncwle7l8cj,4858,4859,9717
9143,,ic8zsnsmdiqj,4859,4860,9719
9144,,aqkkbwymfq8j,4860,4861,9721
9145,,jlgkqttayhej,4861,4862,9723
9146,,8h-heynpoucj,4862,4863,9725
9147,,pi6h2xfmbjoj,4863,4864,9727
9148,,pnfiwsayffaj,4864,4865,9729
9149,,m9huseyqsacj,4865,4866,9731
9150,,avfpbh_m7ssj,4866,4867,9733
9151,,,4867,4868,9735
9152,,url:http://portal.acm.org/citation.cfm3fid3d24821,4869,4870,9739
9153,,gjjbg8rtirej,4870,4871,9741
9154,,fqpi45bok2wj,4871,4872,9743
9155,,b6uftl6xosgj,4872,4873,9745
9156,,7svaqt_wxdkj,4873,4874,9747
9157,,o487tqlfpv4j,4874,4875,9749
9158,,xxkbrkzizs0j,4875,4876,9751
9159,,oorujvbvz_oj,4876,4877,9753
9160,,7s0n8ixhk8ij,4877,4878,9755
9161,,xbn_mgmds7gj,4878,4879,9757
9162,,gnptdwz1-x4j,4879,4880,9759
9163,,56axavdaaroj,4880,4881,9761
9164,,2nx1a82xd6mj,4881,4882,9763
9165,,y8myl2yt_8qj,4882,4883,9765
9166,,ls6pogqveawj,4883,4884,9767
9167,,bq_wjcwtveuj,4884,4885,9769
9168,,url:http://heart.bmjjournals.com/cgi/reprint/81/1/10.pdf,4885,4886,9771
9169,,cz5ujzv1siaj,4886,4887,9773
9170,,wweorf58snej,4887,4888,9775
9171,,bnyeiu2amwaj,4888,4889,9777
9172,,orvp2qmr4eij,4889,4890,9779
9173,,mkmqxgozuiwj,4890,4891,9781
9174,,osixj19vwsuj,4891,4892,9783
9175,,fqwwkl-fhpkj,4892,4893,9785
9176,,eyzklhwql_wj,4893,4894,9787
9177,,uceznztiidoj,4894,4895,9789
9178,,axd-wppgk6qj,4895,4896,9791
9179,,4rgs6nrivq0j,4896,4897,9793
9180,,e6jyahhktoej,4897,4898,9795
9181,,ilz1gggyi_sj,4898,4899,9797
9182,,mvnd9a2eiiaj,4899,4900,9799
9183,,6mx2h0hxmuej,4900,4901,9801
9184,,wlsyn_qqifej,4901,4902,9803
9185,,ktoypdqvc04j,4902,4903,9805
9186,,mdhlqfs_dvcj,4903,4904,9807
9187,,mcakffiztukj,4904,4905,9809
9188,,1iiuarcuzzgj,4905,4906,9811
9189,,wvkfz3rxs3oj,4906,4907,9813
9190,,luokytzq0myj,4907,4908,9815
9191,,klldjd2q-oaj,4908,4909,9817
9192,,7ykmybgquywj,4909,4910,9819
9193,,ut4y99b1094j,4910,4911,9821
9194,,37cjda_0_ggj,4911,4912,9823
9195,,0xt0iiuqp3qj,4912,4913,9825
9196,,eja79f7tfh8j,4913,4914,9827
9197,,5gpum1_ue98j,4914,4915,9829
9198,,url:http://portal.acm.org/ft_gateway.cfm3fid3d99030226type3dpdf,4915,4916,9831
9199,,wiawdkeipqqj,4916,4917,9833
9200,,51mbtnazmjij,4917,4918,9835
9201,,u19y9qi8zrmj,4918,4919,9837
9202,,evgntp5afguj,4919,4920,9839
9203,,t92enrjxqzqj,4920,4921,9841
9204,,j82sdcmczacj,4921,4922,9843
9205,,a1wna_14yeuj,4922,4923,9845
9206,,ktsybew2wmuj,4923,4924,9847
9207,,-14mrt4n3joj,4924,4925,9849
9208,,url:http://www.geography.org.uk/journals/journals.asp3farticleid3d46,4925,4926,9851
9209,,l508hxjrdjwj,4926,4927,9853
9210,,y_bzyfdnemuj,4927,4928,9855
9211,,mielpgirhawj,4928,4929,9857
9212,,lq41sodewuoj,4929,4930,9859
9213,,url:http://www.csa.com/partners/viewrecord.php3frequester3dgs26collection3dtrd26recid3d0581412ci26recid3d0581412ea,4930,4931,9861
9214,,mavx_7arv5kj,4931,4932,9863
9215,,url:http://journals.iucr.org/c/issues/1993/05/00/as1024/as1024.pdf,4932,4933,9865
9216,,iwnd5smabnyj,4933,4934,9867
9217,,7rxr0ki5s90j,4934,4935,9869
9218,,htt0i67tf24j,4935,4936,9871
9219,,kcrlikcc-68j,4936,4937,9873
9220,,gqopmcrmgjcj,4937,4938,9875
9221,,cugkyb82qywj,4938,4939,9877
9222,,url:http://www.springerlink.com/index/r10768wh22rk8l30.pdf,4939,4940,9879
9223,,hcbiovga4ocj,4940,4941,9881
9224,,8klfenw-8zmj,4941,4942,9883
9225,,ch2fsexs-soj,4942,4943,9885
9226,,zh3tav_qwaqj,4943,4944,9887
9227,,wv_vz1w5msoj,4944,4945,9889
9228,,cquwucv_4s0j,4945,4946,9891
9229,,if0p9ibx4w8j,4946,4947,9893
9230,,7cvc3fu5xboj,4947,4948,9895
9231,,uqvuejbwhf8j,4948,4949,9897
9232,,h_nbie3ie20j,4949,4950,9899
9233,,z64xi0f_ezqj,4950,4951,9901
9234,,nevspwt970mj,4951,4952,9903
9235,,wm3h3c1a8n4j,4952,4953,9905
9236,,tqtw8rpo3cmj,4953,4954,9907
9237,,n3dp98khzhkj,4954,4955,9909
9238,,q_3j9ip-zdqj,4955,4956,9911
9239,,fgcdevaamxaj,4956,4957,9913
9240,,pa-z6fmn8xyj,4957,4958,9915
9241,,zfhbwjye29gj,4958,4959,9917
9242,,oijs6tym2fgj,4959,4960,9919
9243,,gxuxc67uxc4j,4960,4961,9921
9244,,bqdhiehnqasj,4961,4962,9923
9245,,9prtp6hywf4j,4962,4963,9925
9246,,8nljynb9z2uj,4963,4964,9927
9247,,80di-yac_joj,4964,4965,9929
9248,,qph0sd4ml5ej,4965,4966,9931
9249,,otbaa7w27lij,4966,4967,9933
9250,,xeinke97qm4j,4967,4968,9935
9251,,oxgppj7hh_aj,4968,4969,9937
9252,,csjyngmlvoej,4969,4970,9939
9253,,9wzf82qeyxgj,4970,4971,9941
9254,,dcuoeib8p7ij,4971,4972,9943
9255,,nhbhxgxhmjej,4972,4973,9945
9256,,719_w2teo2sj,4973,4974,9947
9257,,mfyn14gmqlgj,4975,4976,9951
9258,,ptgehce4rh4j,4976,4977,9953
9259,,0wrcjhba2v4j,4977,4978,9955
9260,,djduxibbwx0j,4978,4979,9957
9261,,xpejfwhrcmcj,4979,4980,9959
9262,,bgtttr1_b2gj,4981,4982,9963
9263,,url:http://adsabs.harvard.edu/abs/1984rame.conf..461g,4982,4983,9965
9264,,cltjvwl1ptuj,4983,4984,9967
9265,,url:http://portal.acm.org/ft_gateway.cfm3fid3d110130026type3dpdf,4984,4985,9969
9266,,2efge-r180yj,4985,4986,9971
9267,,al0qxdqcevej,4986,4987,9973
9268,,zdrj4ggzbb4j,4987,4988,9975
9269,,t4-cwsqlyg4j,4988,4989,9977
9270,,x2_b0igpxi4j,4989,4990,9979
9271,,8ayivg77c28j,4990,4991,9981
9272,,vepq446hrz0j,4991,4992,9983
9273,,url:http://portal.acm.org/citation.cfm3fid3d64592526coll3dguide26dl3dacm26cfid3d1111111126cftoken3d2222222,4992,4993,9985
9274,,url:http://portal.acm.org/ft_gateway.cfm3fid3d102769826type3dpdf,4993,4994,9987
9275,,sxb3ebjznwaj,4994,4995,9989
9276,,ynmwegiq4dwj,4995,4996,9991
9277,,iq170i0pglaj,4996,4997,9993
9278,,mh8t7xvr5waj,4997,4998,9995
9279,,t2-a6ce_vtuj,4998,4999,9997
9280,,ttu32ocsnj4j,4999,5000,9999
9281,,,5000,5001,10001
9282,,f-smuqhklwmj,5001,5002,10003
9283,,jq1y1dktbruj,5002,5003,10005
9284,,chi-hbtz4lij,5003,5004,10007
9285,,e5bl6epnfywj,5004,5005,10009
9286,,x8qbooyfq9gj,5005,5006,10011
9287,,ychyzfgu2swj,5006,5007,10013
9288,,gfdqgs8jzdqj,5007,5008,10015
9289,,vqzahyiw0tij,5008,5009,10017
9290,,url:http://portal.acm.org/ft_gateway.cfm3fid3d110115926type3dpdf,5009,5010,10019
9291,,r3t1uovbdryj,5010,5011,10021
9292,,of_kfyffdj4j,5011,5012,10023
9293,,zlqli4d1c28j,5012,5013,10025
9294,,7uirbm-kzbsj,5013,5014,10027
9295,,b7ueac1gdayj,5014,5015,10029
9296,,doy1djmoy04j,5015,5016,10031
9297,,oneox1p8kicj,5017,5018,10035
9298,,k4pdycdsdc8j,5018,5019,10037
9299,,url:http://www.csa.com/partners/viewrecord.php3frequester3dgs26collection3dtrd26recid3d8204540533md,5019,5020,10039
9300,,r6aupwynffsj,5020,5021,10041
9301,,o3jacivmoggj,5021,5022,10043
9302,,b-2fttkdshoj,5022,5023,10045
9303,,rf1xu22trvkj,5023,5024,10047
9304,,sj8neslvdb0j,5024,5025,10049
9305,,url:http://portal.acm.org/ft_gateway.cfm3fid3d105784326type3dpdf,5026,5027,10053
9306,,e8aq3hurqmmj,5027,5028,10055
9307,,art62e0akaij,5028,5029,10057
9308,,ymp1qmtozhej,5029,5030,10059
9309,,irgpxfmqa-wj,5030,5031,10061
9310,,svqoxo9sbgsj,5031,5032,10063
9311,,n9vq5joe7n0j,5032,5033,10065
9312,,fmydv5etnvsj,5034,5035,10069
9313,,p3mrhpeuagkj,5035,5036,10071
9314,,pwf1p48hljmj,5036,5037,10073
9315,,dgfhx0xwb50j,5037,5038,10075
9316,,8iz-urm_tucj,5038,5039,10077
9317,,fgwjhfzlzrej,5039,5040,10079
9318,,6bqqo2lczuij,5040,5041,10081
9319,,8c3djwtluxyj,5041,5042,10083
9320,,l-194yrabr4j,5042,5043,10085
9321,,pijq7clf8fij,5043,5044,10087
9322,,rprpme1ilvwj,5044,5045,10089
9323,,lax8eohy-pij,5045,5046,10091
9324,,d07tuiw8cauj,5046,5047,10093
9325,,cnzidnj-ub0j,5047,5048,10095
9326,,hamhplyxftaj,5048,5049,10097
9327,,5xppfjvysyuj,5049,5050,10099
9328,,vpbywdbhxvmj,5050,5051,10101
9329,,l5tmevfwsscj,5051,5052,10103
9330,,xnxjyohh9zoj,5052,5053,10105
9331,,g2inqxjmkhkj,5053,5054,10107
9332,,8jlaubbnzcwj,5054,5055,10109
9333,,zpjh5udjquej,5055,5056,10111
9334,,zptr0txtydej,5056,5057,10113
9335,,frt7mjeutgoj,5058,5059,10117
9336,,5nivsi63hyuj,5059,5060,10119
9337,,n3r7i5yczq8j,5060,5061,10121
9338,,,5061,5062,10123
9339,,x1c-y_bfnkqj,5062,5063,10125
9340,,f-4fzjdsjo8j,5063,5064,10127
9341,,tw38p-zjhz4j,5064,5065,10129
9342,,fsrlcog3rm4j,5065,5066,10131
9343,,t7xkvfglxxcj,5066,5067,10133
9344,,znku32wsnfej,5067,5068,10135
9345,,iige_qpquq8j,5068,5069,10137
9346,,k6jbnh7yxpyj,5069,5070,10139
9347,,lpwsiy7upr8j,5070,5071,10141
9348,,prvh8qo8u3oj,5071,5072,10143
9349,,ph1zo2ug8v0j,5072,5073,10145
9350,,4s0qti783quj,5074,5075,10149
9351,,zp5l_oe_qdgj,5075,5076,10151
9352,,igzxshxp7dkj,5077,5078,10155
9353,,pby9vlqefouj,5078,5079,10157
9354,,_73f8tklsjmj,5079,5080,10159
9355,,hu9e9lbawfsj,5081,5082,10163
9356,,oirov_kau54j,5082,5083,10165
9357,,dpyljwupq9qj,5083,5084,10167
9358,,cfarsbhjrkij,5084,5085,10169
9359,,xn7tgkuqlkij,5085,5086,10171
9360,,tihiecxn2fyj,5086,5087,10173
9361,,rr9r4kuzq-4j,5087,5088,10175
9362,,wb1hum50ws0j,5088,5089,10177
9363,,5luqh21v4-yj,5089,5090,10179
9364,,rvglwgwflygj,5090,5091,10181
9365,,rhkvx00nwhaj,5091,5092,10183
9366,,snnyhwavvwsj,5092,5093,10185
9367,,zklt6mjoy64j,5093,5094,10187
9368,,n8b1afle29yj,5094,5095,10189
9369,,5k0t0fe_haej,5095,5096,10191
9370,,zx3c6wzqi9qj,5096,5097,10193
9371,,ktuegk9moyaj,5097,5098,10195
9372,,xfafu8uj6naj,5098,5099,10197
9373,,tmrbzvtkoyoj,5099,5100,10199
9374,,sgsm2pqxu9kj,5100,5101,10201
9375,,rww4et9olpaj,5101,5102,10203
9376,,ywzkq7-ta5mj,5102,5103,10205
9377,,h-khwumju80j,5103,5104,10207
9378,,vmgh1fbzyrmj,5104,5105,10209
9379,,rvoavdbr59ej,5105,5106,10211
9380,,90-udj3tjjaj,5106,5107,10213
9381,,k_o40ldi0lgj,5107,5108,10215
9382,,uve7g4ojg3oj,5108,5109,10217
9383,,9rrwn6_ct14j,5109,5110,10219
9384,,kucnz7gravij,5110,5111,10221
9385,,qnoo286zngsj,5111,5112,10223
9386,,v80r0pzvm-gj,5112,5113,10225
9387,,q-pmwi6ausyj,5113,5114,10227
9388,,oyvagoqathsj,5114,5115,10229
9389,,accaynhjftsj,5115,5116,10231
9390,,s5-yrxvudccj,5116,5117,10233
9391,,,5117,5118,10235
9392,,iamvd_yeojkj,5118,5119,10237
9393,,ezupxndfo74j,5119,5120,10239
9394,,en5mlcpg2vij,5120,5121,10241
9395,,url:http://portal.acm.org/citation.cfm3fid3d244130.24447126dl3dguide26dl3dacm26type3dseries26idx3dseries31626part3dproceedings26wanttype3dproceedings26title3dinternational2520multimedia2520conference26cfid3d1111111126cftoken3d2222222,5121,5122,10243
9396,,vdxvbayb19qj,5122,5123,10245
9397,,ph3uoclvj-wj,5123,5124,10247
9398,,a0wise3wpjwj,5124,5125,10249
9399,,ktw6cwqa3qij,5125,5126,10251
9400,,_8sdyyogx1qj,5126,5127,10253
9401,,hgvp9naof-gj,5127,5128,10255
9402,,hxfs-i59viaj,5128,5129,10257
9403,,1ur_zqh8dbmj,5129,5130,10259
9404,,9wqbo9fvtgaj,5131,5132,10263
9405,,dqf-lmanhlaj,5132,5133,10265
9406,,849zvq7xxfij,5133,5134,10267
9407,,znuhewxo2iuj,5134,5135,10269
9408,,url:http://www.csa.com/partners/viewrecord.php3frequester3dgs26collection3denv26recid3d8913249,5135,5136,10271
9409,,mualob3qoiaj,5136,5137,10273
9410,,,5138,5139,10277
9411,,sak1qa5kchej,5139,5140,10279
9412,,6-rffqh1xkaj,5140,5141,10281
9413,,3a2n_ucoa-sj,5141,5142,10283
9414,,c56whwjup_qj,5142,5143,10285
9415,,m3znucxiyfkj,5143,5144,10287
9416,,uitb5xj8qygj,5144,5145,10289
9417,,uldmc2cfhiij,5145,5146,10291
9418,,url:http://www.springerlink.com/index/u437g8311022ug61.pdf,5146,5147,10293
9419,,prvanhzgelqj,5147,5148,10295
9420,,url:http://doi.wiley.com/10.1002/he.35,5148,5149,10297
9421,,jfbny6dw2awj,5149,5150,10299
9422,,k9zzrnes9wij,5150,5151,10301
9423,,qcyboiyfp6sj,5151,5152,10303
9424,,6ed3bpkcgcwj,5152,5153,10305
9425,,qpxb65_ykt4j,5153,5154,10307
9426,,beieb85d0dyj,5154,5155,10309
9427,,hzcewwmgsw8j,5155,5156,10311
9428,,pejha-cn8vwj,5156,5157,10313
9429,,etkrtdhkdroj,5157,5158,10315
9430,,nskolxxp1y0j,5158,5159,10317
9431,,nncjigvztbej,5159,5160,10319
9432,,njrwql4jdouj,5160,5161,10321
9433,,wompthjpqt8j,5161,5162,10323
9434,,1-67hinxl_yj,5162,5163,10325
9435,,sg_yt-wvrxkj,5163,5164,10327
9436,,nuyyltr8mqij,5164,5165,10329
9437,,nnxr1dyjis8j,5165,5166,10331
9438,,kkfqdxqryasj,5166,5167,10333
9439,,zlkmdnrb0cyj,5167,5168,10335
9440,,iodyozan1l4j,5168,5169,10337
9441,,uaeki3pbcbqj,5169,5170,10339
9442,,ugw1r_3-vhqj,5170,5171,10341
9443,,ilys4zoby2cj,5171,5172,10343
9444,,cnhauphxbn8j,5172,5173,10345
9445,,z7feqxzp3kwj,5173,5174,10347
9446,,jmrgwwxfxhuj,5174,5175,10349
9447,,tpuqra6gpvcj,5175,5176,10351
9448,,vmsrdhltwusj,5176,5177,10353
9449,,_uc7061b7dkj,5177,5178,10355
9450,,gtwgcxrpoxmj,5178,5179,10357
9451,,uboebh7lk8sj,5180,5181,10361
9452,,rc38_pfnsb0j,5181,5182,10363
9453,,tyfahwdgmlcj,5182,5183,10365
9454,,xhlbbz-piwuj,5183,5184,10367
9455,,url:http://doi.wiley.com/10.1002/ev.1297,5184,5185,10369
9456,,5dgfwjfo42kj,5185,5186,10371
9457,,mcsacqyi_mqj,5186,5187,10373
9458,,tfabvx09icgj,5187,5188,10375
9459,,gzviugdxlzoj,5188,5189,10377
9460,,url:http://www.pnas.org/cgi/reprint/86/2/680.pdf,5189,5190,10379
9461,,eshjafcsycsj,5190,5191,10381
9462,,url:http://www.csa.com/partners/viewrecord.php3frequester3dgs26collection3dtrd26recid3dn9210366ah,5191,5192,10383
9463,,89aiinttphij,5192,5193,10385
9464,,oaqit7mh4ncj,5193,5194,10387
9465,,fj25pc_2h5oj,5194,5195,10389
9466,,s61cz5-1bv0j,5196,5197,10393
9467,,ort1io8inkcj,5197,5198,10395
9468,,zo8rtuk7bpej,5198,5199,10397
9469,,nan4fj2w7m4j,5199,5200,10399
9470,,,5200,5201,10401
9471,,gneicf7nwkoj,5201,5202,10403
9472,,url:http://portal.acm.org/ft_gateway.cfm3fid3d35321526type3dpdf26dl3dguide26dl3dacm26cfid3d1111111126cftoken3d2222222,5202,5203,10405
9473,,zpbbbm1pws4j,5203,5204,10407
9474,,ev55npd4-4qj,5204,5205,10409
9475,,3-tltzo06iyj,5205,5206,10411
9476,,thk36tjjjwcj,5206,5207,10413
9477,,mzncc1o3nl8j,5207,5208,10415
9478,,ifpekt8qmo4j,5208,5209,10417
9479,,u1hesfsdhloj,5209,5210,10419
9480,,fgwqrx7ry8yj,5210,5211,10421
9481,,xz4izxbii0kj,5211,5212,10423
9482,,wnf92kyz-zgj,5212,5213,10425
9483,,cnlaqlfptzyj,5213,5214,10427
9484,,wfdzneb1goij,5214,5215,10429
9485,,d0wyfx6njd0j,5215,5216,10431
9486,,qcyraumhxhwj,5216,5217,10433
9487,,dn0t6f2rhvyj,5217,5218,10435
9488,,cbdl1hypat0j,5218,5219,10437
9489,,o6ifvshghssj,5219,5220,10439
9490,,rcqqp4wxp7oj,5220,5221,10441
9491,,qoi4veyxjzoj,5221,5222,10443
9492,,nzmqstouppuj,5222,5223,10445
9493,,bskrp4gln4cj,5223,5224,10447
9494,,url:http://www.csa.com/partners/viewrecord.php3frequester3dgs26collection3dtrd26recid3d0430006ci,5224,5225,10449
9495,,_xkbpykmiscj,5225,5226,10451
9496,,zsm0gobgddsj,5226,5227,10453
9497,,xyfialaun4yj,5227,5228,10455
9498,,vupfpzhdip8j,5228,5229,10457
9499,,b5tqrnemmgkj,5229,5230,10459
9500,,pufiy0p0-imj,5230,5231,10461
9501,,eer21wqufs8j,5231,5232,10463
9502,,yurmqlrgfdgj,5232,5233,10465
9503,,xddw6kyhjk4j,5233,5234,10467
9504,,url:http://www.csa.com/partners/viewrecord.php3frequester3dgs26collection3dtrd26recid3dn7213345ah,5234,5235,10469
9505,,kqrht0fbq6uj,5235,5236,10471
9506,,cyygbeo1ukej,5236,5237,10473
9507,,dvr-a6yeu_oj,5238,5239,10477
9508,,o6js44bvqowj,5239,5240,10479
9509,,jnppc0-gepej,5240,5241,10481
9510,,33wk3d5ogacj,5241,5242,10483
9511,,rmmxkjfz3iej,5242,5243,10485
9512,,e2ucc7pvxkej,5243,5244,10487
9513,,f5p9j3dcsaej,5244,5245,10489
9514,,onh4j5jehn8j,5245,5246,10491
9515,,o5cplpcj5fqj,5246,5247,10493
9516,,ycgwlyjbrouj,5247,5248,10495
9517,,zkooj_za-rij,5248,5249,10497
9518,,vcyohmsz4fkj,5249,5250,10499
9519,,ddoqs3yhbqkj,5250,5251,10501
9520,,9yvwv-riytgj,5252,5253,10505
9521,,k13xd0uym1oj,5253,5254,10507
9522,,i2mrnoyszzsj,5254,5255,10509
9523,,sozrnuwa3vwj,5255,5256,10511
9524,,url:http://portal.acm.org/citation.cfm3fid3d244130.24420326dl3dguide26dl3dacm26type3dseries26idx3dseries31626part3dproceedings26wanttype3dproceedings26title3dinternational2520multimedia2520conference26cfid3d1111111126cftoken3d2222222,5256,5257,10513
9525,,yddoeup4euaj,5257,5258,10515
9526,,jgcn39vouskj,5258,5259,10517
9527,,_wmt4wa3tboj,5259,5260,10519
9528,,h1ft_m3t3q4j,5260,5261,10521
9529,,,5261,5262,10523
9530,,6yzfmau8nk4j,5262,5263,10525
9531,,hn2gmgi4suwj,5263,5264,10527
9532,,js18pnoxjogj,5265,5266,10531
9533,,,5266,5267,10533
9534,,k-fau6n-3jej,5267,5268,10535
9535,,y7nz7cvf3s0j,5268,5269,10537
9536,,oylemu9cugij,5269,5270,10539
9537,,z5yfg40oxxyj,5270,5271,10541
9538,,jvfmmrqugd4j,5271,5272,10543
9539,,v-pzygwhlzoj,5272,5273,10545
9540,,j38qqh9in7sj,5273,5274,10547
9541,,sodsivho1zij,5274,5275,10549
9542,,url:http://doi.wiley.com/10.1002/ace.89,5275,5276,10551
9543,,anq42mzifwmj,5276,5277,10553
9544,,nlavkcgic2ij,5277,5278,10555
9545,,0a2l_srsppqj,5278,5279,10557
9546,,9vzigrvvs4gj,5279,5280,10559
9547,,scnfphsd100j,5280,5281,10561
9548,,4gtjhrf6wg0j,5281,5282,10563
9549,,1hxakapum3kj,5282,5283,10565
9550,,4k3aqyckgqcj,5283,5284,10567
9551,,vr5bckzke2oj,5284,5285,10569
9552,,kngas4wfqlqj,5285,5286,10571
9553,,bcp4rxobjcsj,5286,5287,10573
9554,,url:http://portal.acm.org/citation.cfm3fid3d60429226dl3dacm26coll3dportal26cfid3d1111111126cftoken3d2222222,5287,5288,10575
9555,,l94paoeibvgj,5288,5289,10577
9556,,jij9mj4mefmj,5289,5290,10579
9557,,eqcjkxw7sm8j,5290,5291,10581
9558,,url:http://doi.ieeecomputersociety.org/10.1109/ijcnn.2000.860803,5291,5292,10583
9559,,n3umcsqc6tkj,5292,5293,10585
9560,,h9fo_vdqkw4j,5293,5294,10587
9561,,7twk1mfgazuj,5294,5295,10589
9562,,vry4dgjibawj,5295,5296,10591
9563,,tfty9mrveqoj,5296,5297,10593
9564,,fkl2y7ju03oj,5297,5298,10595
9565,,2yqz3pi-t8mj,5298,5299,10597
9566,,0dt69b7cntsj,5299,5300,10599
9567,,wibtpxhpehoj,5300,5301,10601
9568,,_3b1oz9-gagj,5301,5302,10603
9569,,tz-yo6jbygsj,5302,5303,10605
9570,,zchkwzev0a4j,5303,5304,10607
9571,,gi4nb1oivrgj,5304,5305,10609
9572,,zfm1wkmegqmj,5306,5307,10613
9573,,lutnzwrqxuej,5307,5308,10615
9574,,lfubjnmir8uj,5308,5309,10617
9575,,i0soz7l2pd4j,5309,5310,10619
9576,,rck23jeqfhkj,5310,5311,10621
9577,,1in4zmmebxij,5311,5312,10623
9578,,tvqdzuzpaykj,5312,5313,10625
9579,,imllsjah0vuj,5313,5314,10627
9580,,dlzh3tao7xuj,5314,5315,10629
9581,,r5fht7jnoy4j,5315,5316,10631
9582,,fnac8oew3saj,5316,5317,10633
9583,,wfj6deizyzaj,5317,5318,10635
9584,,url:http://doi.wiley.com/10.1002/he.10710,5318,5319,10637
9585,,uhz8t_i0yl0j,5319,5320,10639
9586,,cux8ghcyfcsj,5321,5322,10643
9587,,ldv_k996guyj,5323,5324,10647
9588,,u4p8nx73pecj,5324,5325,10649
9589,,url:http://doi.wiley.com/10.1002/ev.1503,5325,5326,10651
9590,,uezyouq3tcej,5327,5328,10655
9591,,li9dbagx99uj,5328,5329,10657
9592,,yfqeetn-hzmj,5329,5330,10659
9593,,mwy9nyosnicj,5330,5331,10661
9594,,id5eiugzpxgj,5331,5332,10663
9595,,7ofj3hyfkvyj,5332,5333,10665
9596,,0vp2qv72fm8j,5333,5334,10667
9597,,n210a6pbwowj,5334,5335,10669
9598,,url:http://portal.acm.org/ft_gateway.cfm3fid3d109960926type3dpdf,5335,5336,10671
9599,,z6sccyjxu74j,5336,5337,10673
9600,,q7q6pclqijqj,5337,5338,10675
9601,,m-de1qsz3laj,5338,5339,10677
9602,,cwz-rse9wagj,5339,5340,10679
9603,,c07bku0gveoj,5340,5341,10681
9604,,szifeczluouj,5341,5342,10683
9605,,pq0vtlketdmj,5342,5343,10685
9606,,umafhuq2dlqj,5343,5344,10687
9607,,url:http://www.csa.com/partners/viewrecord.php3frequester3dgs26collection3dtrd26recid3da8622955ah,5344,5345,10689
9608,,vso2usavkaoj,5345,5346,10691
9609,,jk2ekpkuuosj,5346,5347,10693
9610,,sogjjlossjqj,5347,5348,10695
9611,,v2tqalzcte4j,5348,5349,10697
9612,,guzyi58ptugj,5349,5350,10699
9613,,uv2upu3uwloj,5350,5351,10701
9614,,0bswyujc9dmj,5351,5352,10703
9615,,onfpv7ktrjaj,5352,5353,10705
9616,,kzn6km6xro8j,5353,5354,10707
9617,,klvzrfhywiej,5354,5355,10709
9618,,uuc1ho5injwj,5355,5356,10711
9619,,gjuvnw7bnioj,5356,5357,10713
9620,,xgwn3e3et54j,5357,5358,10715
9621,,rzmr5c3qrb0j,5358,5359,10717
9622,,_pthjp0spuij,5359,5360,10719
9623,,2rl9vtvifwsj,5360,5361,10721
9624,,fnmqvpvrybaj,5361,5362,10723
9625,,4fabun7nux4j,5362,5363,10725
9626,,b3q-vcr1zfyj,5363,5364,10727
9627,,hl__rgbnokgj,5364,5365,10729
9628,,0kometlfzzmj,5365,5366,10731
9629,,3jmjahkftg8j,5366,5367,10733
9630,,dzs9endw0vuj,5368,5369,10737
9631,,url:http://ieeexplore.ieee.org/iel3/3990/11481/00547854.pdf3farnumber3d547854,5369,5370,10739
9632,,qixqt_mpuh4j,5370,5371,10741
9633,,aepguksw8rqj,5372,5373,10745
9634,,zs9bnrrjiomj,5373,5374,10747
9635,,xc4yqeqfmtqj,5374,5375,10749
9636,,y9skpzksbg4j,5375,5376,10751
9637,,9rxnbm99dbyj,5376,5377,10753
9638,,crsyuss3glij,5377,5378,10755
9639,,qmnrekspapyj,5378,5379,10757
9640,,xniooxr2poyj,5379,5380,10759
9641,,hntjqwfytn8j,5380,5381,10761
9642,,xrlaccnwhlcj,5381,5382,10763
9643,,qyaqmagios4j,5382,5383,10765
9644,,-18pw9akhhkj,5384,5385,10769
9645,,g2rzed0jgvoj,5385,5386,10771
9646,,zae8nlc3ansj,5386,5387,10773
9647,,i1wc2gip4r8j,5387,5388,10775
9648,,mpqf27hqyaej,5389,5390,10779
9649,,ifrmoliaez0j,5390,5391,10781
9650,,u4rfdflobzgj,5391,5392,10783
9651,,semlyjnzpb8j,5392,5393,10785
9652,,2w5e-yd4bfyj,5393,5394,10787
9653,,l0h5ph5lnbmj,5394,5395,10789
9654,,j2gho_igqywj,5395,5396,10791
9655,,aerrukd75cuj,5396,5397,10793
9656,,f3gq8cyasxgj,5397,5398,10795
9657,,url:http://links.jstor.org/sici3fsici3d0146-4949(196024)1253a1253c13253acmamol253e2.0.co253b2-r,5398,5399,10797
9658,,6cmzqkfssnuj,5399,5400,10799
9659,,j1z0diglcsej,5400,5401,10801
9660,,anf_41ycdeej,5401,5402,10803
9661,,jyfixcwtzcoj,5402,5403,10805
9662,,url:http://pubs.acs.org/cgi-bin/abstract.cgi/achre4/2005/38/i11/abs/ar040238i.html,5403,5404,10807
9663,,bet4fen5kduj,5404,5405,10809
9664,,ywt9grsirvyj,5405,5406,10811
9665,,w_oy1siy2vcj,5406,5407,10813
9666,,asjvspjaug4j,5407,5408,10815
9667,,picpogc6wvqj,5408,5409,10817
9668,,c7y7jrx5ooaj,5409,5410,10819
9669,,n3uxkdkk7igj,5410,5411,10821
9670,,slgn_qm2vrqj,5411,5412,10823
9671,,bylwdav9sdkj,5412,5413,10825
9672,,ksvkswocsusj,5413,5414,10827
9673,,z_5dpawfq1cj,5414,5415,10829
9674,,orozmve_1eoj,5415,5416,10831
9675,,cajrhndqhnij,5416,5417,10833
9676,,reje4f8nt6cj,5417,5418,10835
9677,,nnvbtuaawrgj,5418,5419,10837
9678,,ibg9ksvm6yej,5419,5420,10839
9679,,wfimzhpivaqj,5420,5421,10841
9680,,ejvpycraudij,5421,5422,10843
9681,,uecpmcj6yd8j,5422,5423,10845
9682,,gutmevdkhxyj,5423,5424,10847
9683,,cc4w7forx9oj,5424,5425,10849
9684,,ljsh1w-qdn8j,5425,5426,10851
9685,,ldiliha20wgj,5426,5427,10853
9686,,url:http://portal.acm.org/ft_gateway.cfm3fid3d12207026type3dpdf26coll3dguide26dl3dacm26cfid3d1111111126cftoken3d2222222,5427,5428,10855
9687,,,5428,5429,10857
9688,,ju2dijht5v8j,5429,5430,10859
9689,,zsf3kn4tec4j,5430,5431,10861
9690,,mcormecrkhgj,5431,5432,10863
9691,,ftvlqua1srej,5432,5433,10865
9692,,23as1lc9-1uj,5433,5434,10867
9693,,0w5gjonzk-gj,5434,5435,10869
9694,,fqfds4f20vqj,5435,5436,10871
9695,,vbevvacm13wj,5436,5437,10873
9696,,ricsj0ohx3yj,5437,5438,10875
9697,,wpn6bblwbywj,5438,5439,10877
9698,,crdwrwax1doj,5439,5440,10879
9699,,gwuhjwfle6sj,5440,5441,10881
9700,,b-rt_0njfvyj,5441,5442,10883
9701,,oi0hnihyzdcj,5442,5443,10885
9702,,edx-hssru2gj,5443,5444,10887
9703,,qopuz_asjuaj,5444,5445,10889
9704,,bkppxzfrm5uj,5445,5446,10891
9705,,67qbnr-pwbqj,5446,5447,10893
9706,,ejceg2o7nioj,5447,5448,10895
9707,,fhtf0xc3dh4j,5448,5449,10897
9708,,mvyex81ckqqj,5449,5450,10899
9709,,xtntj3s9yr0j,5450,5451,10901
9710,,mnkxr_hix0cj,5451,5452,10903
9711,,hqbx9ntg8qmj,5452,5453,10905
9712,,blguykei7l4j,5453,5454,10907
9713,,om5xwawc2nyj,5454,5455,10909
9714,,dwkj1vb1w8qj,5455,5456,10911
9715,,okdgsoyoax0j,5456,5457,10913
9716,,_htvltpcsqwj,5457,5458,10915
9717,,pil9k46yzdsj,5458,5459,10917
9718,,y52xilgn0akj,5459,5460,10919
9719,,dai7urhzda8j,5460,5461,10921
9720,,ge6pyfvjasij,5461,5462,10923
9721,,cdsg_hxq29gj,5462,5463,10925
9722,,bkevch1ay-ej,5463,5464,10927
9723,,l2xvagxxfl8j,5464,5465,10929
9724,,iwfqatcfirej,5465,5466,10931
9725,,9xyfxyvvfe0j,5467,5468,10935
9726,,url:http://ieeexplore.ieee.org/iel1/2206/325/00006486.pdf3farnumber3d6486,5468,5469,10937
9727,,gb0jdwujd3uj,5469,5470,10939
9728,,wvuwdy8htjij,5470,5471,10941
9729,,ahu2cxmmngaj,5471,5472,10943
9730,,7ksyqnj74a4j,5472,5473,10945
9731,,url:http://portal.acm.org/citation.cfm3fid3d592206.592545,5473,5474,10947
9732,,fho6aeljmg8j,5474,5475,10949
9733,,8rosj4gbx_kj,5475,5476,10951
9734,,umc0_mfuwnyj,5476,5477,10953
9735,,xdkyt5mwvh0j,5477,5478,10955
9736,,ouw0gjvfei4j,5478,5479,10957
9737,,nnsy-yew_huj,5480,5481,10961
9738,,h2hpid-l9naj,5481,5482,10963
9739,,,5482,5483,10965
9740,,3zrirwopvkyj,5483,5484,10967
9741,,uyvarhoohj0j,5484,5485,10969
9742,,qlzpr1vxj3aj,5485,5486,10971
9743,,xzh_ardbwkyj,5486,5487,10973
9744,,espuy2jpessj,5487,5488,10975
9745,,wtgo9f1z9hkj,5488,5489,10977
9746,,klduuxxkr0ij,5489,5490,10979
9747,,qxtgmu8x4i4j,5490,5491,10981
9748,,,5491,5492,10983
9749,,axkaglzbsyij,5492,5493,10985
9750,,yieku4ik7dej,5493,5494,10987
9751,,zjqvlnfa59cj,5494,5495,10989
9752,,9m75jn0orlcj,5495,5496,10991
9753,,urqlma-c7zkj,5496,5497,10993
9754,,zzyy_muvlnaj,5497,5498,10995
9755,,b3jvy9d1scej,5498,5499,10997
9756,,l79qxgtcspoj,5499,5500,10999
9757,,fhez9ahtntij,5500,5501,11001
9758,,p1ahmtmzepmj,5501,5502,11003
9759,,pwrqooiwigwj,5502,5503,11005
9760,,unubblctcnaj,5503,5504,11007
9761,,url:http://doi.wiley.com/10.1002/ace.127,5504,5505,11009
9762,,mr0dcv49udej,5505,5506,11011
9763,,p_vv_2loy38j,5506,5507,11013
9764,,kb_tsubm5amj,5507,5508,11015
9765,,pj0aw4r5n4aj,5508,5509,11017
9766,,oefcyblwukgj,5509,5510,11019
9767,,kbtb8t9_almj,5510,5511,11021
9768,,xxd5q6p9u2wj,5511,5512,11023
9769,,cindi6mlb-8j,5512,5513,11025
9770,,jl8sj904bkgj,5513,5514,11027
9771,,y5k40vib9c4j,5514,5515,11029
9772,,dyddp61lix0j,5515,5516,11031
9773,,3jc3cvk2-t8j,5516,5517,11033
9774,,ksfulapw0x4j,5517,5518,11035
9775,,dhzo6ttgtoej,5518,5519,11037
9776,,my4balolmasj,5519,5520,11039
9777,,sfh2k57rw74j,5521,5522,11043
9778,,l4ihkv_agsmj,5522,5523,11045
9779,,wooj7anvbkwj,5523,5524,11047
9780,,url:http://portal.acm.org/citation.cfm3fid3d171926.172032,5524,5525,11049
9781,,dbmefvhiekgj,5525,5526,11051
9782,,o6bovln7xgmj,5526,5527,11053
9783,,m2ghwbrmi1kj,5527,5528,11055
9784,,bplkb-v1fykj,5528,5529,11057
9785,,9uqogpl47hej,5529,5530,11059
9786,,url:http://ieeexplore.ieee.org/xpl/abs_free.jsp3farnumber3d1320091,5530,5531,11061
9787,,yyabwc_mrqcj,5531,5532,11063
9788,,kswchobx6nuj,5532,5533,11065
9789,,ftqdtmrvwkuj,5533,5534,11067
9790,,opvjpgjxzkwj,5534,5535,11069
9791,,oqiv6or9c9cj,5535,5536,11071
9792,,ckj8nxdv8eej,5536,5537,11073
9793,,ni8mc3nen40j,5537,5538,11075
9794,,yq5liyl2km4j,5538,5539,11077
9795,,ridevtxnpaaj,5539,5540,11079
9796,,lxnxk7bm-kuj,5540,5541,11081
9797,,8npczw-qcoyj,5541,5542,11083
9798,,qkk_9yp_4e4j,5542,5543,11085
9799,,iiks6ybmpfej,5543,5544,11087
9800,,7rnwjoinaw0j,5544,5545,11089
9801,,6c9ejyqptg4j,5545,5546,11091
9802,,c2uq3am5_f8j,5547,5548,11095
9803,,8nsogakfg0qj,5548,5549,11097
9804,,zypxzwjsdcqj,5549,5550,11099
9805,,7r22ibboxfwj,5550,5551,11101
9806,,zzotayuk0wmj,5551,5552,11103
9807,,vwlbuupx7oqj,5552,5553,11105
9808,,ffmkt1wapkkj,5553,5554,11107
9809,,umr_elw0lqqj,5554,5555,11109
9810,,r08lo_20rooj,5555,5556,11111
9811,,s_zywee0ac8j,5556,5557,11113
9812,,k8lqkssvzy4j,5557,5558,11115
9813,,p4y4lrvhouoj,5558,5559,11117
9814,,xw3aafg2xkgj,5559,5560,11119
9815,,9u5edfm9staj,5560,5561,11121
9816,,fb7nxzndtkij,5561,5562,11123
9817,,v3tnvugoqf0j,5562,5563,11125
9818,,phcuvey7ftqj,5564,5565,11129
9819,,j-kmi7hkqgqj,5565,5566,11131
9820,,jofchieluhsj,5566,5567,11133
9821,,njdxwde85ayj,5567,5568,11135
9822,,pcquzxqzxdwj,5568,5569,11137
9823,,ycvtytm1bycj,5569,5570,11139
9824,,akvfuaz-0ksj,5570,5571,11141
9825,,yl_h-ijv9hoj,5571,5572,11143
9826,,ejusbrxtupgj,5572,5573,11145
9827,,0n5riryc1esj,5573,5574,11147
9828,,ekudalkahi4j,5574,5575,11149
9829,,ej4nt7uehngj,5575,5576,11151
9830,,cpmiocb2aaaj,5576,5577,11153
9831,,8e3kbyxkvkcj,5577,5578,11155
9832,,k9b1xdjmfvoj,5578,5579,11157
9833,,8j1slfcviq0j,5579,5580,11159
9834,,jxnr2nn2rd4j,5580,5581,11161
9835,,io-arejzmjgj,5582,5583,11165
9836,,hdu0nprqzuqj,5583,5584,11167
9837,,hej9ukbq4acj,5584,5585,11169
9838,,url:http://www.ingentaconnect.com/search/expand3fpub3dinfobike://els/08830355/2001/00000035/00000004/art0003726unc3d,5585,5586,11171
9839,,ybqgh_qmtswj,5586,5587,11173
9840,,4irb3p6mbdij,5587,5588,11175
9841,,ahe841b6ffsj,5588,5589,11177
9842,,y0uszkdmuvkj,5589,5590,11179
9843,,url:http://www.csa.com/partners/viewrecord.php3frequester3dgs26collection3dtrd26recid3dn9210431ah,5590,5591,11181
9844,,uwehrpovum8j,5591,5592,11183
9845,,ojtb__myf4ej,5592,5593,11185
9846,,ykpjxgx1syej,5593,5594,11187
9847,,rxqvfbczhyej,5594,5595,11189
9848,,1qeiyhrrr0gj,5595,5596,11191
9849,,0dta7gq3y3wj,5596,5597,11193
9850,,prk9wmc8mgaj,5597,5598,11195
9851,,lgxswf6die4j,5598,5599,11197
9852,,_ctrinekqlkj,5601,5602,11203
9853,,afh6rykjvgwj,5602,5603,11205
9854,,loayetf6oycj,5603,5604,11207
9855,,senmzeobmrij,5604,5605,11209
9856,,cn7s6-uyzwwj,5605,5606,11211
9857,,url:http://www.csa.com/partners/viewrecord.php3frequester3dgs26collection3dtrd26recid3d20021212028675mt26recid3da7423804ah,5606,5607,11213
9858,,m4ejll_etpij,5607,5608,11215
9859,,2hzhqa8mjbkj,5608,5609,11217
9860,,qiirro10wfoj,5609,5610,11219
9861,,cb0gw1wcdz0j,5610,5611,11221
9862,,efetdvxttaaj,5611,5612,11223
9863,,iq6y-kafuhgj,5612,5613,11225
9864,,5obg2ypt6nkj,5613,5614,11227
9865,,uxi_1ue_7z8j,5614,5615,11229
9866,,tu0on5oqw3mj,5615,5616,11231
9867,,5lru_lxk6jyj,5616,5617,11233
9868,,v5qcgtjbo9aj,5617,5618,11235
9869,,sl7kwuigftqj,5618,5619,11237
9870,,q--vbjhnniyj,5619,5620,11239
9871,,zhcenyfgeyoj,5620,5621,11241
9872,,poy1s5ng21aj,5621,5622,11243
9873,,url:http://portal.acm.org/ft_gateway.cfm3fid3d110197726type3dpdf,5622,5623,11245
9874,,aqvsko9jyfsj,5623,5624,11247
9875,,r_ajvaqn0kcj,5624,5625,11249
9876,,-0xc6e7yzcgj,5625,5626,11251
9877,,url:http://www.csa.com/partners/viewrecord.php3frequester3dgs26collection3dtrd26recid3da8622921ah,5626,5627,11253
9878,,d5xxucdt2eaj,5627,5628,11255
9879,,1ybbnvfhhi0j,5628,5629,11257
9880,,ldkf8ektq-sj,5629,5630,11259
9881,,8k1tyf2a4uaj,5630,5631,11261
9882,,ralvsjdukzsj,5631,5632,11263
9883,,agpggkek7waj,5632,5633,11265
9884,,89pqopak6xqj,5633,5634,11267
9885,,trd6vmwtzosj,5634,5635,11269
9886,,sszrzsnm_nmj,5636,5637,11273
9887,,u-vexcgl2fyj,5637,5638,11275
9888,,ftnwhz_s0qij,5638,5639,11277
9889,,url:http://www.springerlink.com/index/ku01584746270467.pdf,5639,5640,11279
9890,,sgszfhcnmfaj,5640,5641,11281
9891,,mhxz1bu2nwaj,5641,5642,11283
9892,,7abbkgnhdf8j,5642,5643,11285
9893,,qdpn-qtgceaj,5643,5644,11287
9894,,url:http://portal.acm.org/citation.cfm3fid3d110307.110303,5644,5645,11289
9895,,e7knqeltyluj,5645,5646,11291
9896,,9c9dqsb8suij,5646,5647,11293
9897,,zpjrx6trdjij,5647,5648,11295
9898,,dsda2xvt1mqj,5648,5649,11297
9899,,sn79aqh6caij,5649,5650,11299
9900,,w3swijdofo4j,5650,5651,11301
9901,,uryaclxp8h8j,5651,5652,11303
9902,,ixsjbsyxxkcj,5652,5653,11305
9903,,amsyewitcxmj,5653,5654,11307
9904,,url:http://www.csa.com/partners/viewrecord.php3frequester3dgs26collection3dtrd26recid3dn9210550ah,5654,5655,11309
9905,,spagorilibij,5655,5656,11311
9906,,oobzuyceseuj,5656,5657,11313
9907,,qfqjt7d-wzyj,5657,5658,11315
9908,,f_tqon-5rosj,5658,5659,11317
9909,,edi_1nxtemsj,5659,5660,11319
9910,,qxuxu9msljaj,5660,5661,11321
9911,,cg1dqpyy7rmj,5661,5662,11323
9912,,_p2xeu4cghcj,5662,5663,11325
9913,,48sucposvrij,5663,5664,11327
9914,,j4wtnr6vhkwj,5664,5665,11329
9915,,fewerxbn31aj,5665,5666,11331
9916,,9tl8cny9tgaj,5666,5667,11333
9917,,yg2ztbhxocuj,5667,5668,11335
9918,,sxzhwgz3bdoj,5668,5669,11337
9919,,t5zrfszpbmyj,5669,5670,11339
9920,,exdy5pd2cb8j,5670,5671,11341
9921,,ws9j5m7hkyaj,5671,5672,11343
9922,,zc_ccwub6_4j,5672,5673,11345
9923,,url:http://portal.acm.org/citation.cfm3fid3d1027527.1027563,5673,5674,11347
9924,,_1crjh6km0kj,5674,5675,11349
9925,,knehaqnaixkj,5675,5676,11351
9926,,xkdshmtcl-0j,5676,5677,11353
9927,,url:http://portal.acm.org/ft_gateway.cfm3fid3d102763126type3dpdf,5677,5678,11355
9928,,vcc9f0jhzz8j,5678,5679,11357
9929,,url:http://www.csa.com/partners/viewrecord.php3frequester3dgs26collection3dtrd26recid3dn9210543ah,5679,5680,11359
9930,,llgarsraqpwj,5680,5681,11361
9931,,ezc9jkx8vhgj,5682,5683,11365
9932,,url:http://portal.acm.org/citation.cfm3fid3d765536.765537,5683,5684,11367
9933,,rta2saiwpduj,5684,5685,11369
9934,,qk4kfo7bxvuj,5685,5686,11371
9935,,xdujlebfnroj,5686,5687,11373
9936,,za-flticsq4j,5687,5688,11375
9937,,m8hka2xziuaj,5688,5689,11377
9938,,q3djzew4dlwj,5689,5690,11379
9939,,5tb5qas1fv4j,5690,5691,11381
9940,,8svxvz9jckcj,5691,5692,11383
9941,,hfzdzz_ucssj,5692,5693,11385
9942,,40su-ix6rdyj,5693,5694,11387
9943,,x9cglegxmy0j,5694,5695,11389
9944,,07poo8ulkzqj,5696,5697,11393
9945,,mtcshz6n7loj,5697,5698,11395
9946,,85keqwp2akgj,5698,5699,11397
9947,,a36_v9h699oj,5699,5700,11399
9948,,nvu7kbieb24j,5700,5701,11401
9949,,6jeeucwt3suj,5701,5702,11403
9950,,270hbeey7m8j,5702,5703,11405
9951,,ws3cskrazqyj,5703,5704,11407
9952,,4ibzypck0i0j,5704,5705,11409
9953,,mqunu1huxa0j,5705,5706,11411
9954,,32g7-kzynqoj,5706,5707,11413
9955,,5r_dhlp3dvcj,5707,5708,11415
9956,,mmrknawgf1aj,5708,5709,11417
9957,,cxizimiggbsj,5709,5710,11419
9958,,jxvawb0ddqej,5710,5711,11421
9959,,_8-bcmisoj0j,5711,5712,11423
9960,,url:http://portal.acm.org/citation.cfm3fid3d12205826dl3dportal26dl3dacm26type3dissue26idx3dj68926part3dperiodical26wanttype3dperiodical26title3dacm2520sigmod2520record26cfid3d1111111126cftoken3d2222222,5712,5713,11425
9961,,kmf7yg1f2wij,5713,5714,11427
9962,,modqunth0skj,5714,5715,11429
9963,,m6ineubmg7gj,5715,5716,11431
9964,,9y0mzl7eqh4j,5716,5717,11433
9965,,53dwxy-xb90j,5717,5718,11435
9966,,hmavc4yrks0j,5718,5719,11437
9967,,ihljcmas2usj,5719,5720,11439
9968,,j9mdmggm46qj,5720,5721,11441
9969,,bzaxma44zwmj,5721,5722,11443
9970,,lujixuq8ypcj,5722,5723,11445
9971,,xykk80dqq2uj,5723,5724,11447
9972,,ucwylnlf-kuj,5724,5725,11449
9973,,axfb4lpukwuj,5725,5726,11451
9974,,bh7h-akyisqj,5726,5727,11453
9975,,mldmaq6a_ruj,5727,5728,11455
9976,,k5sws9ct5zqj,5728,5729,11457
9977,,,5729,5730,11459
9978,,mij6fogeyfcj,5730,5731,11461
9979,,pkevrsbvw0qj,5731,5732,11463
9980,,url:http://portal.acm.org/citation.cfm3fid3d592199.592406,5732,5733,11465
9981,,fbxgr7b7ppgj,5733,5734,11467
9982,,url:http://www.turpion.org/php/full/infoft.phtml3fjournal_id3dmc26paper_id3d204326year_id3d200426issue_id3d626fpage3d256,5734,5735,11469
9983,,c3ivnklytoij,5735,5736,11471
9984,,vp2ddhgdqm4j,5736,5737,11473
9985,,xxlodilz9ayj,5737,5738,11475
9986,,9quhe4q4mbij,5738,5739,11477
9987,,szdtfiydjg0j,5739,5740,11479
9988,,zz7e1y5zqkaj,5740,5741,11481
9989,,2zr8yenfvxcj,5741,5742,11483
9990,,r_ieugvyzsmj,5742,5743,11485
9991,,g51ax1ulj68j,5743,5744,11487
9992,,c2v5hmd--luj,5744,5745,11489
9993,,dnxa3dnpz8mj,5745,5746,11491
9994,,vdizvtzoyjaj,5746,5747,11493
9995,,url:http://portal.acm.org/citation.cfm3fid3d244461,5747,5748,11495
9996,,d91k6q-e5caj,5748,5749,11497
9997,,autsgy7y964j,5749,5750,11499
9998,,ujbeikshfucj,5750,5751,11501
9999,,l8x_r5cstrkj,5751,5752,11503
10000,,zfey2wkt-twj,5752,5753,11505
10001,,q-qzwa6vf7ej,5753,5754,11507
10002,,goyt5klymcij,5754,5755,11509
10003,,ck3yq-iovggj,5755,5756,11511
10004,,clxaawglndsj,5756,5757,11513
10005,,i6ako-jlbmgj,5757,5758,11515
10006,,kg5yo9foajgj,5758,5759,11517
10007,,xue2g4v2ajyj,5759,5760,11519
10008,,nwucrm9g8f4j,5760,5761,11521
10009,,r732snybvcij,5761,5762,11523
10010,,rltfk7ejqkcj,5762,5763,11525
10011,,url:http://links.jstor.org/sici3fsici3d0146-4949(196321252f22)4253a2253c216253aj2522aw2522a253e2.0.co253b2-0,5763,5764,11527
10012,,sphne5o91n8j,5764,5765,11529
10013,,kw0rhyonstyj,5765,5766,11531
10014,,url:http://portal.acm.org/ft_gateway.cfm3fid3d98860126type3dpdf,5766,5767,11533
10015,,wukjkyju1eqj,5767,5768,11535
10016,,crv-ln--ckaj,5768,5769,11537
10017,,c5yenagwlosj,5769,5770,11539
10018,,43--eog0heqj,5770,5771,11541
10019,,i6ijvph4rj8j,5771,5772,11543
10020,,zflhzyyswasj,5772,5773,11545
10021,,bs0ipasgnnyj,5773,5774,11547
10022,,sfjwklfkjbyj,5774,5775,11549
10023,,f5l7pbbr8foj,5775,5776,11551
10024,,944fuatnbloj,5776,5777,11553
10025,,cvwrimn8xpwj,5777,5778,11555
10026,,gzzseevoaiuj,5778,5779,11557
10027,,ycd0nt2jo4aj,5779,5780,11559
10028,,ajropxxsluuj,5780,5781,11561
10029,,url:http://portal.acm.org/citation.cfm3fid3d509278,5781,5782,11563
10030,,iaef_ijxdjuj,5782,5783,11565
10031,,url:http://portal.acm.org/ft_gateway.cfm3fid3d110192626type3dpdf,5783,5784,11567
10032,,cgfkxfz6dl4j,5784,5785,11569
10033,,ikx9qqyf_kaj,5785,5786,11571
10034,,damuvszx1t0j,5786,5787,11573
10035,,tg8firoptgej,5787,5788,11575
10036,,tz8ckel9uruj,5788,5789,11577
10037,,h126f4djjgij,5789,5790,11579
10038,,vxkisuovgk4j,5790,5791,11581
10039,,url:http://www.ingentaconnect.com/content/els/13891286/2002/00000040/00000003/art00307,5791,5792,11583
10040,,0grjnzz5m6oj,5792,5793,11585
10041,,e0ipec0xkjej,5793,5794,11587
10042,,pgzl97uzj8qj,5794,5795,11589
10043,,i3vfnsgh1iqj,5795,5796,11591
10044,,_txt2pletgwj,5796,5797,11593
10045,,hfi7tu6x3loj,5797,5798,11595
10046,,vjsontwdsacj,5798,5799,11597
10047,,a433hu4j8eaj,5799,5800,11599
10048,,v__aqxetx0sj,5800,5801,11601
10049,,arczkrv7exij,5801,5802,11603
10050,,url:http://www.springerlink.com/index/m5854148357j41j8.pdf,5802,5803,11605
10051,,3gs9gciko-sj,5803,5804,11607
10052,,jhy97c-_pyij,5804,5805,11609
10053,,5mm_wjws8wuj,5805,5806,11611
10054,,h5uupujxyv8j,5806,5807,11613
10055,,8r1ojakqwgqj,5807,5808,11615
10056,,uqqoker9yhaj,5808,5809,11617
10057,,jq4pmtjlbgqj,5809,5810,11619
10058,,jszge3vblgej,5810,5811,11621
10059,,q16jyjjaqf4j,5811,5812,11623
10060,,5hmbrj0n_uej,5812,5813,11625
10061,,1lxgegpq4gij,5813,5814,11627
10062,,kiobtawuaj8j,5814,5815,11629
10063,,n3m4rtwzhnoj,5815,5816,11631
10064,,_ihe86gkg-4j,5816,5817,11633
10065,,segrh4syv4yj,5817,5818,11635
10066,,f3yp3cd3ipij,5818,5819,11637
10067,,xrkugodxisyj,5819,5820,11639
10068,,aj7qj_bt0zoj,5820,5821,11641
10069,,tidzys279wyj,5821,5822,11643
10070,,vmrormo-43uj,5822,5823,11645
10071,,url:http://www.springerlink.com/index/ghlkxue5lj0vk6ed.pdf,5823,5824,11647
10072,,ytbrcbz3vuyj,5824,5825,11649
10073,,izaxwaftynoj,5825,5826,11651
10074,,url:http://links.jstor.org/sici3fsici3d0146-4949(196124)2253a1253c99253ajcatba253e2.0.co253b2-2,5826,5827,11653
10075,,0kp7fg2hagaj,5827,5828,11655
10076,,pckuduea88oj,5828,5829,11657
10077,,efcfbfffuyoj,5829,5830,11659
10078,,3m4uqtanhacj,5830,5831,11661
10079,,ab16kdqjtnsj,5831,5832,11663
10080,,ay6kvzlmmxmj,5832,5833,11665
10081,,hslpyzupjacj,5833,5834,11667
10082,,url:http://portal.acm.org/ft_gateway.cfm3fid3d110123726type3dpdf,5834,5835,11669
10083,,xnkt80tv_wqj,5835,5836,11671
10084,,o-ohevckicwj,5836,5837,11673
10085,,w5t47ey2tokj,5837,5838,11675
10086,,syx_hfylzmwj,5838,5839,11677
10087,,wduvclgbvucj,5839,5840,11679
10088,,rgnl5mpvnbuj,5840,5841,11681
10089,,thjlj1wtpgej,5841,5842,11683
10090,,url:http://www.csa.com/partners/viewrecord.php3frequester3dgs26collection3dtrd26recid3dn9210521ah,5842,5843,11685
10091,,,5843,5844,11687
10092,,aibv-qyb4smj,5844,5845,11689
10093,,qtptigly2ycj,5845,5846,11691
10094,,n4ibcy5yorsj,5846,5847,11693
10095,,7taupgthy1kj,5847,5848,11695
10096,,dtoqc2jodl8j,5848,5849,11697
10097,,1m7nj79abewj,5849,5850,11699
10098,,url:http://portal.acm.org/citation.cfm3fid3d50202.50227,5850,5851,11701
10099,,klzriupmrloj,5851,5852,11703
10100,,fu8rf-u3n8oj,5852,5853,11705
10101,,tz1w2ar-a34j,5853,5854,11707
10102,,taxamhhgeluj,5854,5855,11709
10103,,qrnb_07lqvmj,5855,5856,11711
10104,,ghkro0ux5bej,5856,5857,11713
10105,,qatgjnsubhuj,5857,5858,11715
10106,,mlgbfhlpkskj,5858,5859,11717
10107,,_58vionvri8j,5859,5860,11719
10108,,tw7ticuawcej,5860,5861,11721
10109,,7n0h3ra1ffsj,5861,5862,11723
10110,,1zvimmd_oboj,5862,5863,11725
10111,,pwgxahzghhwj,5863,5864,11727
10112,,agl4qseetfuj,5864,5865,11729
10113,,ynkfehvvi0wj,5865,5866,11731
10114,,1qxb5hlyoiyj,5866,5867,11733
10115,,ohxki3ggweij,5867,5868,11735
10116,,dqn8bvgr5hoj,5868,5869,11737
10117,,8quinb84i1mj,5869,5870,11739
10118,,dgkljfvgjxyj,5870,5871,11741
10119,,z5tz9vybrmij,5871,5872,11743
10120,,489saxnl9xcj,5872,5873,11745
10121,,017xqq6bzq8j,5873,5874,11747
10122,,iknd91kr9-gj,5874,5875,11749
10123,,hs8mht_flqsj,5875,5876,11751
10124,,_bhuudtegc4j,5876,5877,11753
10125,,o4hcf9oh8t0j,5877,5878,11755
10126,,fz7lxj1uckkj,5878,5879,11757
10127,,cynlkab1phaj,5879,5880,11759
10128,,url:http://www.csa.com/partners/viewrecord.php3frequester3dgs26collection3dtrd26recid3dn9210485ah,5880,5881,11761
10129,,kpe8xmuxhlkj,5881,5882,11763
10130,,9ss0k2sjsakj,5882,5883,11765
10131,,uqczijjd__sj,5883,5884,11767
10132,,yoqoz18bdycj,5884,5885,11769
10133,,ihr3opg9bigj,5885,5886,11771
10134,,w_lpj4pym6mj,5886,5887,11773
10135,,dzjjeuvv1luj,5887,5888,11775
10136,,4adj6xwnwvgj,5888,5889,11777
10137,,8igjzt2qtaoj,5889,5890,11779
10138,,72ce76esxgqj,5890,5891,11781
10139,,crz3o52ei0gj,5891,5892,11783
10140,,url:http://adsabs.harvard.edu/abs/1973phdt.........2b,5892,5893,11785
10141,,qnf6gd1sodij,5893,5894,11787
10142,,rgiri2ffn50j,5894,5895,11789
10143,,xv93v8zafpoj,5895,5896,11791
10144,,ygtcxbb9g8sj,5896,5897,11793
10145,,,5897,5898,11795
10146,,lrjpdm_z7lwj,5898,5899,11797
10147,,jgdcsigu0qoj,5899,5900,11799
10148,,lkkpp1rlofmj,5900,5901,11801
10149,,o1slgi3mviqj,5901,5902,11803
10150,,x7qrwqo-s2oj,5902,5903,11805
10151,,uo5nmjroeauj,5903,5904,11807
10152,,rgjvoizwa8uj,5904,5905,11809
10153,,kn07q8hknyoj,5905,5906,11811
10154,,jurvkzxt6tyj,5906,5907,11813
10155,,jfarcaepi2cj,5907,5908,11815
10156,,fozfh8rl3wuj,5908,5909,11817
10157,,6jvgr26ccmkj,5909,5910,11819
10158,,zaofvm9uvdoj,5910,5911,11821
10159,,eo4nt23ivhsj,5911,5912,11823
10160,,,5912,5913,11825
10161,,p5dskq-ffqyj,5913,5914,11827
10162,,b2uni7qslx8j,5914,5915,11829
10163,,url:http://portal.acm.org/citation.cfm3fid3d983070.98307226coll3dguide26dl3dacm26idx3dj68926part3dperiodical26wanttype3dperiodical26title3dacm2520sigmod2520record26cfid3d1111111126cftoken3d2222222,5915,5916,11831
10164,,kmgsrhkg4buj,5916,5917,11833
10165,,iscadjylgrcj,5917,5918,11835
10166,,fpfdz0v44kmj,5918,5919,11837
10167,,wkxk3oacp_4j,5919,5920,11839
10168,,3vw9z0ridxij,5920,5921,11841
10169,,i6jd65ianjcj,5921,5922,11843
10170,,url:http://portal.acm.org/ft_gateway.cfm3fid3d109972326type3dpdf,5922,5923,11845
10171,,gefxbdjx5hij,5923,5924,11847
10172,,azihq_ok3_mj,5924,5925,11849
10173,,siu_gbye8bcj,5925,5926,11851
10174,,ilqulu2evsuj,5926,5927,11853
10175,,fx5mxn_apkkj,5927,5928,11855
10176,,5iwwacqsbtyj,5928,5929,11857
10177,,7ahbmavsgsij,5929,5930,11859
10178,,1tmemq4km3yj,5930,5931,11861
10179,,qh5phcdpmaij,5931,5932,11863
10180,,_r06cs6puroj,5932,5933,11865
10181,,9zxjd0y9hgaj,5933,5934,11867
10182,,_6jtrvxg0aqj,5934,5935,11869
10183,,xissf6b3mgkj,5935,5936,11871
10184,,,5936,5937,11873
10185,,cjhcotvaf9aj,5937,5938,11875
10186,,nbywc7le5vmj,5938,5939,11877
10187,,54alphzbk_gj,5939,5940,11879
10188,,lez5d_iozrmj,5940,5941,11881
10189,,nslfasywcqoj,5941,5942,11883
10190,,url:http://www.csa.com/partners/viewrecord.php3frequester3dgs26collection3dtrd26recid3dn9210380ah,5942,5943,11885
10191,,url:http://journals.cambridge.org/action/displayfulltext3ftype3d126fid3d32816526jid3duhy26volumeid3d3226issueid3d0126aid3d328164,5943,5944,11887
10192,,5c1vmqdd4z8j,5944,5945,11889
10193,,iwfpdu1yaw8j,5945,5946,11891
10194,,jwg-r_dxh9aj,5946,5947,11893
10195,,n7hofw33omuj,5947,5948,11895
10196,,1tlz_catuq4j,5948,5949,11897
10197,,vanb-nfvarkj,5949,5950,11899
10198,,8ypieddgzqij,5950,5951,11901
10199,,xzgja3vodomj,5951,5952,11903
10200,,7slarmxj4yyj,5952,5953,11905
10201,,ckd_wlkbnc0j,5953,5954,11907
10202,,skrftiq9fckj,5954,5955,11909
10203,,ntvdrbfl0coj,5955,5956,11911
10204,,rm5vz_rvsjqj,5956,5957,11913
10205,,2fzl3mrdcg4j,5957,5958,11915
10206,,mwjh3h_yctij,5958,5959,11917
10207,,r3p9r0aqxjsj,5959,5960,11919
10208,,zp6pijxijwuj,5960,5961,11921
10209,,url:http://doi.wiley.com/10.1002/ev.1296,5961,5962,11923
10210,,yihmkila4ncj,5962,5963,11925
10211,,ogirdkjkpkyj,5963,5964,11927
10212,,soup983fwjoj,5964,5965,11929
10213,,clnmwzm-5acj,5965,5966,11931
10214,,bcsx4nnvy00j,5966,5967,11933
10215,,w4u1uqqsetaj,5967,5968,11935
10216,,bgl4158hd-qj,5968,5969,11937
10217,,i6n4854xq2qj,5969,5970,11939
10218,,fasfgr2gj4ij,5970,5971,11941
10219,,url:http://www.csa.com/partners/viewrecord.php3frequester3dgs26collection3dtrd26recid3d0166362ci,5971,5972,11943
10220,,anlo5j9kiqkj,5972,5973,11945
10221,,3i4_vhjb80cj,5973,5974,11947
10222,,plaztmnd4dsj,5974,5975,11949
10223,,ozu7-tpabnqj,5975,5976,11951
10224,,gxcyoo9utakj,5976,5977,11953
10225,,at6dmzyemdmj,5977,5978,11955
10226,,xvur1dpuptcj,5978,5979,11957
10227,,,5979,5980,11959
10228,,dndwc0mfutuj,5980,5981,11961
10229,,lpbdw6qcsmmj,5981,5982,11963
10230,,7zvauzbdazoj,5982,5983,11965
10231,,dem5ykv5c2oj,5983,5984,11967
10232,,d0uavrbjydij,5984,5985,11969
10233,,1c6mp1vd8juj,5986,5987,11973
10234,,sshybhdd6ncj,5987,5988,11975
10235,,1_zoeomye2wj,5988,5989,11977
10236,,url:http://portal.acm.org/ft_gateway.cfm3fid3d21977726type3dpdf26dl3dguide26dl3dacm26cfid3d1111111126cftoken3d2222222,5989,5990,11979
10237,,1idp6-6p4kyj,5990,5991,11981
10238,,uwydw5tqzbwj,5991,5992,11983
10239,,bhpekkjxlnuj,5992,5993,11985
10240,,s-pq6u62cl4j,5993,5994,11987
10241,,ukdh9nvg0raj,5994,5995,11989
10242,,87qvarng0noj,5995,5996,11991
10243,,,5996,5997,11993
10244,,hwylsjiwusgj,5997,5998,11995
10245,,j0krescr7qaj,5998,5999,11997
10246,,tqmhohpv0ggj,5999,6000,11999
10247,,ebksiiyef4mj,6000,6001,12001
10248,,eydwwazbkwwj,6002,6003,12005
10249,,url:http://www.springerlink.com/index/j820746878156186.pdf,6003,6004,12007
10250,,v0_ht86udqsj,6004,6005,12009
10251,,0m-dxwfsdycj,6005,6006,12011
10252,,w2yol1n3m_wj,6007,6008,12015
10253,,ghlz8ny9demj,6008,6009,12017
10254,,oyc7rricqlqj,6009,6010,12019
10255,,url:http://www.csa.com/partners/viewrecord.php3frequester3dgs26collection3dtrd26recid3d0250559ci,6010,6011,12021
10256,,jkxntx5wrh8j,6011,6012,12023
10257,,jyitqibuqekj,6012,6013,12025
10258,,juni9sdj6m4j,6013,6014,12027
10259,,bv5am_5dzimj,6014,6015,12029
10260,,wz1jhxu5nqsj,6015,6016,12031
10261,,acllzq9bmw0j,6016,6017,12033
10262,,ufp6pkjdtnsj,6017,6018,12035
10263,,invvk5hx67qj,6018,6019,12037
10264,,sodnkcs7hjej,6019,6020,12039
10265,,jmwurvupeyuj,6020,6021,12041
10266,,ush3lebtbl8j,6021,6022,12043
10267,,2gvcqz0e8twj,6022,6023,12045
10268,,l3api4eb1i8j,6023,6024,12047
10269,,mv6uc2vldvej,6024,6025,12049
10270,,hrsbql-jhx4j,6026,6027,12053
10271,,xzgh4737yooj,6027,6028,12055
10272,,nnsfldtzoh0j,6028,6029,12057
10273,,frhlwbcm1vcj,6029,6030,12059
10274,,jloo-yhi6ssj,6030,6031,12061
10275,,otgw0g5b6ayj,6031,6032,12063
10276,,dud-igqwrdej,6032,6033,12065
10277,,yu1vdl3w1g8j,6033,6034,12067
10278,,yjjnqlpkgfcj,6034,6035,12069
10279,,afwoivr-ltyj,6036,6037,12073
10280,,j-8v9pkbrekj,6037,6038,12075
10281,,sfofi_5ascaj,6038,6039,12077
10282,,te8hxsn4_zej,6039,6040,12079
10283,,hygz3bgrpy8j,6040,6041,12081
10284,,2efcaurevkij,6041,6042,12083
10285,,f1dipgzj0jqj,6042,6043,12085
10286,,3wwvzp1yhgej,6043,6044,12087
10287,,bfnxy_7ryz0j,6044,6045,12089
10288,,tyr9dmempocj,6045,6046,12091
10289,,dd1ksesmad0j,6046,6047,12093
10290,,kx6m-u2ynjwj,6047,6048,12095
10291,,b81mwqkrygwj,6048,6049,12097
10292,,ooiyro8bgpuj,6049,6050,12099
10293,,z-tsquz7s6oj,6050,6051,12101
10294,,gmz-5g6zbl4j,6051,6052,12103
10295,,url:http://adsabs.harvard.edu/abs/1980phdt........49g,6052,6053,12105
10296,,c-2s1u_k4buj,6053,6054,12107
10297,,url:http://www.csa.com/partners/viewrecord.php3frequester3dgs26collection3dtrd26recid3d200111010661mt26recid3da0032562ah,6054,6055,12109
10298,,yhf4pk4ujxmj,6055,6056,12111
10299,,p2r5c4xvyo4j,6056,6057,12113
10300,,_4bj4m4xbmmj,6057,6058,12115
10301,,qasqx5vk5yyj,6058,6059,12117
10302,,qrcrxtwtfxqj,6059,6060,12119
10303,,hpcvgj8rjkmj,6060,6061,12121
10304,,gruvhotoopqj,6061,6062,12123
10305,,784yygjdtdsj,6062,6063,12125
10306,,u-at_h_1exsj,6063,6064,12127
10307,,url:http://www.csa.com/partners/viewrecord.php3frequester3dgs26collection3dtrd26recid3d0014628ci,6064,6065,12129
10308,,8cxfqvydcvwj,6065,6066,12131
10309,,mrbqjiv-6ngj,6066,6067,12133
10310,,j2boszztojqj,6067,6068,12135
10311,,05dmaokb9rcj,6068,6069,12137
10312,,url:http://www.csa.com/partners/viewrecord.php3frequester3dgs26collection3dtrd26recid3d200111010708mt26recid3da0032643ah,6069,6070,12139
10313,,yasn6pppvwwj,6070,6071,12141
10314,,kywvedghaoij,6071,6072,12143
10315,,a7xtgkiajfmj,6072,6073,12145
10316,,ikkv7xdloocj,6073,6074,12147
10317,,7hqge_9ogmmj,6074,6075,12149
10318,,_knt-sypl6ej,6075,6076,12151
10319,,to6lpt0fdemj,6076,6077,12153
10320,,jk0u_putymcj,6077,6078,12155
10321,,sw-ip0i7y6cj,6078,6079,12157
10322,,oclgbjly5guj,6079,6080,12159
10323,,3zbsld220e8j,6080,6081,12161
10324,,fnr-hxbxcocj,6081,6082,12163
10325,,grf8tnwkbecj,6082,6083,12165
10326,,gu6y7mdjwmuj,6083,6084,12167
10327,,wrh4xwhwkakj,6084,6085,12169
10328,,bpv809u0y58j,6085,6086,12171
10329,,hwklkjau6w8j,6086,6087,12173
10330,,hfoh_5q0a1ej,6087,6088,12175
10331,,g5yrqcdj56qj,6088,6089,12177
10332,,pjyudoop18aj,6089,6090,12179
10333,,af8sfxd4lkkj,6090,6091,12181
10334,,ob_9jhdbnfkj,6091,6092,12183
10335,,g0hmhhl8skcj,6092,6093,12185
10336,,ntrq4xcnl1mj,6093,6094,12187
10337,,qdto1dw_c1sj,6094,6095,12189
10338,,url:http://www.csa.com/partners/viewrecord.php3frequester3dgs26collection3dtrd26recid3d200111000451mt26recid3da0032584ah,6095,6096,12191
10339,,acxtkcyexyij,6096,6097,12193
10340,,vfkoqnp73hyj,6097,6098,12195
10341,,ftxxmrhxdjej,6098,6099,12197
10342,,ya8f1jrhcewj,6099,6100,12199
10343,,boimrcrtlamj,6100,6101,12201
10344,,ahcargudz94j,6101,6102,12203
10345,,g7k1ceyguy4j,6102,6103,12205
10346,,cyzacycddqsj,6103,6104,12207
10347,,0gluxwj3okoj,6104,6105,12209
10348,,wgd8d53workj,6105,6106,12211
10349,,oepm9p6tmw4j,6106,6107,12213
10350,,tqa0pnfard4j,6108,6109,12217
10351,,5vtgckni7qwj,6109,6110,12219
10352,,i8xmaykynlgj,6110,6111,12221
10353,,e4mm-5axshcj,6111,6112,12223
10354,,hpfw-r4vzzgj,6112,6113,12225
10355,,z1b_qzktdiwj,6113,6114,12227
10356,,fa2magsn67yj,6114,6115,12229
10357,,rkhrpdcpyoyj,6115,6116,12231
10358,,uxyf1mlm3roj,6116,6117,12233
10359,,xfy5v5epl68j,6117,6118,12235
10360,,wdnq1ldykiyj,6118,6119,12237
10361,,inrue6wbqr4j,6119,6120,12239
10362,,81vbdy_72rwj,6120,6121,12241
10363,,url:http://portal.acm.org/citation.cfm3fid3d171926.171984,6121,6122,12243
10364,,8qjoen8kfuyj,6122,6123,12245
10365,,f392p7wkt2kj,6123,6124,12247
10366,,f-7_cjlpflgj,6124,6125,12249
10367,,rpsm-yziyj8j,6125,6126,12251
10368,,lcpreiavssuj,6126,6127,12253
10369,,lwxzoxyoy24j,6127,6128,12255
10370,,bpijtrktdk8j,6128,6129,12257
10371,,xhxw1b67jaej,6129,6130,12259
10372,,npdeplhdm2sj,6130,6131,12261
10373,,7hr-nd8k3hkj,6131,6132,12263
10374,,ftnsmtuadsmj,6132,6133,12265
10375,,mxr0r6otm_wj,6133,6134,12267
10376,,fypalcbwpqej,6134,6135,12269
10377,,wy27jhdbndaj,6135,6136,12271
10378,,b5kfovjfva0j,6136,6137,12273
10379,,fcrxe7vktmmj,6137,6138,12275
10380,,nk4-1iumqgij,6138,6139,12277
10381,,pcgonfdxbiqj,6139,6140,12279
10382,,2x8maixgheyj,6140,6141,12281
10383,,url:http://portal.acm.org/ft_gateway.cfm3fid3d108627226type3dpdf,6141,6142,12283
10384,,8fn-12zvmpuj,6142,6143,12285
10385,,fi6fp10pmlaj,6143,6144,12287
10386,,hwbwyakecg0j,6144,6145,12289
10387,,kgmkspprfhgj,6145,6146,12291
10388,,h3nc69tfvpij,6146,6147,12293
10389,,ooig6mwxwtcj,6147,6148,12295
10390,,cexzwit9lzcj,6148,6149,12297
10391,,qlfen5veclyj,6150,6151,12301
10392,,v4olzyqig_cj,6151,6152,12303
10393,,g9gbyehwejkj,6152,6153,12305
10394,,1hiebpd7dhoj,6153,6154,12307
10395,,n6ilcb19rtsj,6154,6155,12309
10396,,url:http://adsabs.harvard.edu/abs/2002stin...0276305o,6155,6156,12311
10397,,nxd7r_-kmcmj,6156,6157,12313
10398,,vvqpyo1w_g8j,6157,6158,12315
10399,,j-fcjs_86gyj,6158,6159,12317
10400,,7xrqxmzxxhyj,6159,6160,12319
10401,,6mam88h1voaj,6160,6161,12321
10402,,url:http://links.jstor.org/sici3fsici3d0146-4949(196223)3253a3253c15253atao2522wh253e2.0.co253b2-e,6161,6162,12323
10403,,yfvfi7frvewj,6162,6163,12325
10404,,zdvmxjf87wsj,6163,6164,12327
10405,,url:http://ieeexplore.ieee.org/iel5/69/28407/01269662.pdf3farnumber3d1269662,6164,6165,12329
10406,,qswbpog9qpoj,6165,6166,12331
10407,,up9qqitihzaj,6166,6167,12333
10408,,mntxnqmrwe8j,6167,6168,12335
10409,,8udlaswbatsj,6168,6169,12337
10410,,zkufm7za8owj,6169,6170,12339
10411,,ez2wutvkrycj,6171,6172,12343
10412,,v-6qu3ompwgj,6172,6173,12345
10413,,url:http://www.csa.com/partners/viewrecord.php3frequester3dgs26collection3dtrd26recid3dn9210400ah,6173,6174,12347
10414,,fuqwh7vxfdsj,6174,6175,12349
10415,,beh2cghgmbyj,6175,6176,12351
10416,,dphpyfj-yi8j,6176,6177,12353
10417,,uimfmu0kdlkj,6177,6178,12355
10418,,l896x8s_cpgj,6178,6179,12357
10419,,lubk9-fr60cj,6179,6180,12359
10420,,57l9pgznlyej,6180,6181,12361
10421,,c_n_byswokmj,6181,6182,12363
10422,,y55e_6oymtsj,6182,6183,12365
10423,,ynrajcj-tiij,6183,6184,12367
10424,,3twq06yyvpoj,6184,6185,12369
10425,,url:http://adsabs.harvard.edu/abs/1977phdt........47c,6185,6186,12371
10426,,eejxwsm4lyej,6186,6187,12373
10427,,dty1895q4yoj,6187,6188,12375
10428,,cljbdxi4liej,6188,6189,12377
10429,,7dxuxvozcnoj,6189,6190,12379
10430,,8nqf6yuomb8j,6190,6191,12381
10431,,pxbfm4ptksaj,6191,6192,12383
10432,,qybqef-freej,6192,6193,12385
10433,,dmdhof36i5oj,6193,6194,12387
10434,,uzgxg-pilqij,6195,6196,12391
10435,,de-wvleuwlkj,6196,6197,12393
10436,,wvsq5fvfnoij,6197,6198,12395
10437,,ktovqjderqij,6198,6199,12397
10438,,rb8lwczy5ggj,6199,6200,12399
10439,,12otj4cfsqej,6200,6201,12401
10440,,louwlj88sgkj,6201,6202,12403
10441,,97sk2a-qqykj,6202,6203,12405
10442,,-2xwdm1iu4mj,6203,6204,12407
10443,,bedwlazjmruj,6204,6205,12409
10444,,xndkylsjchij,6205,6206,12411
10445,,dqfcp6d2_fkj,6206,6207,12413
10446,,fhxqwm3kbjij,6207,6208,12415
10447,,t_sn3zbbig0j,6208,6209,12417
10448,,6ublgfyqcnij,6209,6210,12419
10449,,gy7cz7uw4qij,6210,6211,12421
10450,,c5ljxuaoqgqj,6211,6212,12423
10451,,byxmolbffwej,6212,6213,12425
10452,,imejqz0zlauj,6214,6215,12429
10453,,twsgffem2c0j,6215,6216,12431
10454,,soxfrcfg9sgj,6216,6217,12433
10455,,r3gv7di3xoej,6217,6218,12435
10456,,xzd9v9ikf54j,6218,6219,12437
10457,,mbfyfqmnigij,6219,6220,12439
10458,,pws-l_yxn8oj,6220,6221,12441
10459,,3m3-xtoe5vgj,6221,6222,12443
10460,,lfxz-cswyzyj,6222,6223,12445
10461,,6t1p7rmpvmuj,6223,6224,12447
10462,,qmqx9xyaebgj,6224,6225,12449
10463,,bjnpgz-fkaij,6225,6226,12451
10464,,xt9_rospsyoj,6226,6227,12453
10465,,tnyfp0on7bwj,6227,6228,12455
10466,,nxi88wdaxikj,6228,6229,12457
10467,,bxxksyf9mtqj,6229,6230,12459
10468,,1ncrhbvow-cj,6230,6231,12461
10469,,4wlzovrvm4qj,6231,6232,12463
10470,,ar2mbe2alboj,6232,6233,12465
10471,,7wgwl2txdcij,6233,6234,12467
10472,,mg0usopdrauj,6234,6235,12469
10473,,24bbdjoqzwoj,6235,6236,12471
10474,,doavfo7lliij,6236,6237,12473
10475,,rgrabvne1cuj,6237,6238,12475
10476,,innqdf1794aj,6239,6240,12479
10477,,o8sobehia40j,6240,6241,12481
10478,,pxpxhstwcn8j,6241,6242,12483
10479,,k27-yzcwr9gj,6242,6243,12485
10480,,haehznexz_4j,6243,6244,12487
10481,,jt2javfgppgj,6244,6245,12489
10482,,4lbbkma8-lej,6245,6246,12491
10483,,uee6nn4xjtqj,6246,6247,12493
10484,,zedznjs_vq8j,6248,6249,12497
10485,,wi9wrx2yvyoj,6249,6250,12499
10486,,t7kfcct4comj,6250,6251,12501
10487,,bqys5izuiccj,6251,6252,12503
10488,,p46jlrh6craj,6252,6253,12505
10489,,heygz5hqnhyj,6253,6254,12507
10490,,l1xeh5yc0fgj,6254,6255,12509
10491,,zaaubqmj5ygj,6255,6256,12511
10492,,udf4zv85awwj,6256,6257,12513
10493,,ibgduig19iej,6257,6258,12515
10494,,grpytazmvikj,6258,6259,12517
10495,,kszqr0exfimj,6259,6260,12519
10496,,mrh-8zanwlwj,6260,6261,12521
10497,,lmhjmpfbjo0j,6261,6262,12523
10498,,fogbitr1rlgj,6262,6263,12525
10499,,piomhxajibyj,6263,6264,12527
10500,,3j7bqimlak4j,6264,6265,12529
10501,,5ve3kvo6qzcj,6265,6266,12531
10502,,4h-2aswe4m0j,6266,6267,12533
10503,,kd-thvai1a8j,6268,6269,12537
10504,,5frsymdf_moj,6269,6270,12539
10505,,762pxajlmuoj,6270,6271,12541
10506,,ivs7_-iyjx4j,6271,6272,12543
10507,,ufpr3lx_xpuj,6272,6273,12545
10508,,gtjzd5gyalij,6273,6274,12547
10509,,9jnw_wkmzguj,6274,6275,12549
10510,,9wxsfpauz6qj,6275,6276,12551
10511,,_igo-0ztxxqj,6276,6277,12553
10512,,eothltb1ajyj,6277,6278,12555
10513,,8hgkm4hjsysj,6278,6279,12557
10514,,a57h1n3h3pgj,6279,6280,12559
10515,,i9ta0n-ybosj,6280,6281,12561
10516,,5qxvl5lkpiej,6281,6282,12563
10517,,v2kw11fktvgj,6282,6283,12565
10518,,no03urh30xgj,6283,6284,12567
10519,,hzjbkyiwofuj,6284,6285,12569
10520,,cve7wspfwhaj,6285,6286,12571
10521,,xcdryjbn7qwj,6286,6287,12573
10522,,frw0thv61qaj,6287,6288,12575
10523,,ai8zrfh9c3gj,6288,6289,12577
10524,,ddfcd6vyoo4j,6289,6290,12579
10525,,9whq60zpuaij,6290,6291,12581
10526,,bfc6xgdlvusj,6292,6293,12585
10527,,thzknzcihk4j,6293,6294,12587
10528,,dcsmg6i3p98j,6294,6295,12589
10529,,url:http://www.ncbi.nlm.nih.gov/entrez/query.fcgi3fcmd3dretrieve26db3dpubmed26list_uids3d64130326dopt3dcitation,6295,6296,12591
10530,,url:http://portal.acm.org/ft_gateway.cfm3fid3d13029026type3dpdf26dl3dportal26dl3dacm26cfid3d1111111126cftoken3d2222222,6296,6297,12593
10531,,l4ngzuciivyj,6297,6298,12595
10532,,beky6wynv_sj,6298,6299,12597
10533,,pn3fvmzglc8j,6299,6300,12599
10534,,jr23ie19t00j,6300,6301,12601
10535,,zetvucmhor8j,6301,6302,12603
10536,,54yd7pumivgj,6302,6303,12605
10537,,t-po9dmzvoaj,6303,6304,12607
10538,,jj6z2nws0icj,6304,6305,12609
10539,,g6rcusd0xrgj,6305,6306,12611
10540,,a7v0bhrrpjmj,6306,6307,12613
10541,,1954ludglaqj,6307,6308,12615
10542,,syvzcox7eqkj,6308,6309,12617
10543,,1ygubhxnzi8j,6309,6310,12619
10544,,d0ytyge1cumj,6310,6311,12621
10545,,ndo_zcq-a-mj,6311,6312,12623
10546,,ay6k7-ptueuj,6312,6313,12625
10547,,ahpkrjjejk4j,6313,6314,12627
10548,,eh_6ybdnopkj,6314,6315,12629
10549,,kcgwqjjgv2gj,6315,6316,12631
10550,,5zc39ovewdoj,6316,6317,12633
10551,,z9m7nkys5sgj,6317,6318,12635
10552,,eytvegrna4cj,6318,6319,12637
10553,,80azye9xiicj,6319,6320,12639
10554,,dqyn5u3m15yj,6320,6321,12641
10555,,kj3snefvhnsj,6321,6322,12643
10556,,hmkz4ughokyj,6322,6323,12645
10557,,30awcgbampej,6323,6324,12647
10558,,kurapm83lrgj,6324,6325,12649
10559,,rqgp2qlhhmuj,6325,6326,12651
10560,,6lusqoquqvuj,6326,6327,12653
10561,,xkiweehqnc4j,6328,6329,12657
10562,,owfvn4inlnuj,6329,6330,12659
10563,,pbjz4-uprz8j,6330,6331,12661
10564,,bhlzd9vhefyj,6331,6332,12663
10565,,t3mmtz3wsc0j,6333,6334,12667
10566,,cgknvf6wvhgj,6334,6335,12669
10567,,,6335,6336,12671
10568,,uuoriqzkluij,6336,6337,12673
10569,,n2qs3l_iknyj,6337,6338,12675
10570,,zz9ni8vjjtmj,6338,6339,12677
10571,,hulfv5xdueqj,6339,6340,12679
10572,,rkpqbti2khuj,6340,6341,12681
10573,,sq9lomhdc3gj,6341,6342,12683
10574,,url:http://doi.wiley.com/10.1002/he.51,6342,6343,12685
10575,,pwdf7x21wgcj,6343,6344,12687
10576,,brq1ldo-s_qj,6344,6345,12689
10577,,url:http://portal.acm.org/ft_gateway.cfm3fid3d101776526type3dpdf,6345,6346,12691
10578,,url:http://www.ncbi.nlm.nih.gov/entrez/query.fcgi3fcmd3dretrieve26db3dpubmed26list_uids3d37229426dopt3dcitation,6346,6347,12693
10579,,url:http://www.csa.com/partners/viewrecord.php3frequester3dgs26collection3dtrd26recid3d0052394ci26recid3d0052394ea26recid3d0052394so,6347,6348,12695
10580,,cmnmq43_frij,6348,6349,12697
10581,,_uhse-b_zfij,6349,6350,12699
10582,,_qgin022inyj,6350,6351,12701
10583,,kttciryrec8j,6351,6352,12703
10584,,pj0iwbch9cmj,6352,6353,12705
10585,,wl8z0thmpxsj,6353,6354,12707
10586,,esgkdnkho9sj,6354,6355,12709
10587,,jgv-44fa4m0j,6355,6356,12711
10588,,iruyziopndcj,6356,6357,12713
10589,,eyezbhr7_pkj,6357,6358,12715
10590,,todqmhzhrtqj,6358,6359,12717
10591,,q4mhlpeyxrij,6359,6360,12719
10592,,9mpbur3abmsj,6360,6361,12721
10593,,cvtn-iitao0j,6362,6363,12725
10594,,,6363,6364,12727
10595,,p4mca17g9uej,6364,6365,12729
10596,,dwstutu3qfwj,6365,6366,12731
10597,,url:http://doi.wiley.com/10.1002/tl.119,6367,6368,12735
10598,,mvonuwdhn2kj,6368,6369,12737
10599,,bbma79ay6s4j,6369,6370,12739
10600,,emkrffy3yrwj,6370,6371,12741
10601,,vxwlz3foim8j,6371,6372,12743
10602,,sns3lhbeqqej,6372,6373,12745
10603,,dofh7mhl2tuj,6373,6374,12747
10604,,url:http://www.csa.com/partners/viewrecord.php3frequester3dgs26collection3dtrd26recid3dn9210542ah,6374,6375,12749
10605,,iftzrwas1doj,6375,6376,12751
10606,,g4vlcbtdyt8j,6376,6377,12753
10607,,efzlz_ivpqkj,6377,6378,12755
10608,,mndfsn_ciskj,6378,6379,12757
10609,,6jrnvtfyqfwj,6379,6380,12759
10610,,dnh5uw1wwuej,6380,6381,12761
10611,,nn8azdshdquj,6381,6382,12763
10612,,pfzmykdkf4cj,6382,6383,12765
10613,,ujaiwqzfezwj,6383,6384,12767
10614,,hfdfanj01ykj,6384,6385,12769
10615,,dai5p6tfp2uj,6385,6386,12771
10616,,j8111ebswmyj,6386,6387,12773
10617,,ofgjicinwt0j,6387,6388,12775
10618,,63jibxeghw4j,6388,6389,12777
10619,,gt_wy6myf_kj,6389,6390,12779
10620,,ahi4kvj3lv8j,6390,6391,12781
10621,,qsq-rqal5l8j,6391,6392,12783
10622,,yiepyn4hdesj,6392,6393,12785
10623,,8ir6hjecax4j,6393,6394,12787
10624,,q6_m-j2byogj,6394,6395,12789
10625,,onrgybt5njgj,6395,6396,12791
10626,,arjcrfhblsqj,6396,6397,12793
10627,,8hx7eoyrxzaj,6397,6398,12795
10628,,lpli5rt-efkj,6398,6399,12797
10629,,cdjbeynxfxij,6399,6400,12799
10630,,qtb6brlbytqj,6400,6401,12801
10631,,gttfd2_x8uyj,6401,6402,12803
10632,,bkowkw9qdy0j,6402,6403,12805
10633,,8opws3cs4uoj,6403,6404,12807
10634,,luxhapn9npwj,6404,6405,12809
10635,,cmeelkdowl8j,6405,6406,12811
10636,,jpsc_gyudqaj,6406,6407,12813
10637,,3wnkslthaikj,6407,6408,12815
10638,,8eqlarkgnhwj,6409,6410,12819
10639,,d2zpsdu6d68j,6411,6412,12823
10640,,hznfzk86bmgj,6412,6413,12825
10641,,p3php7egwgej,6413,6414,12827
10642,,gkrgairds3mj,6414,6415,12829
10643,,koal7bkpqdij,6415,6416,12831
10644,,td29hrolxwsj,6416,6417,12833
10645,,vyhmvqqe-xij,6417,6418,12835
10646,,xfst5j7azw4j,6418,6419,12837
10647,,uceuf_7kwiij,6419,6420,12839
10648,,mkhxlpandqoj,6420,6421,12841
10649,,jsyimvfhh-sj,6421,6422,12843
10650,,mexb9h3xctuj,6422,6423,12845
10651,,onokv6le1zsj,6423,6424,12847
10652,,rwe62iw0w3cj,6424,6425,12849
10653,,qjvwjubqra0j,6425,6426,12851
10654,,eit_x-gmybcj,6426,6427,12853
10655,,b8d67sgawgkj,6427,6428,12855
10656,,1j8wmvvlddcj,6428,6429,12857
10657,,jq59me-bcduj,6429,6430,12859
10658,,iksvt9rulgkj,6430,6431,12861
10659,,s4gbqr3-p9uj,6431,6432,12863
10660,,wezht65xp-4j,6432,6433,12865
10661,,kqmkyw01hdkj,6433,6434,12867
10662,,url:http://portal.acm.org/citation.cfm3fid3d171926.171936,6435,6436,12871
10663,,ljhsj4_8i8ej,6436,6437,12873
10664,,k3o309xsgcuj,6437,6438,12875
10665,,33goyu7lil4j,6438,6439,12877
10666,,3ouggtahdouj,6439,6440,12879
10667,,4s0eyeiwgx8j,6440,6441,12881
10668,,lyaztdurtt8j,6441,6442,12883
10669,,5tf0eyijhf0j,6442,6443,12885
10670,,0b3mu1axjbwj,6443,6444,12887
10671,,acok8hg2pswj,6444,6445,12889
10672,,zyyibfnyd2ej,6445,6446,12891
10673,,yaua9vhadg0j,6446,6447,12893
10674,,maht88c6p3ij,6447,6448,12895
10675,,8y6scr2qxjij,6448,6449,12897
10676,,ypabzjw_fnyj,6450,6451,12901
10677,,nnjwvxmgx3ij,6451,6452,12903
10678,,bfwyrubv2zqj,6453,6454,12907
10679,,qxztqf7hdt0j,6454,6455,12909
10680,,tgtcsbzqqlaj,6455,6456,12911
10681,,0zgy3bmehnij,6456,6457,12913
10682,,w_wtdynh4xij,6457,6458,12915
10683,,c4uq38rcjk8j,6458,6459,12917
10684,,_mct-umfybej,6459,6460,12919
10685,,ve8m_5b3n9yj,6460,6461,12921
10686,,akeqiet-jtaj,6462,6463,12925
10687,,suaospj1jfaj,6463,6464,12927
10688,,zual_denzw0j,6464,6465,12929
10689,,lvs5gpa2q6wj,6465,6466,12931
10690,,rkefmcidbc4j,6467,6468,12935
10691,,ganyf76vvrqj,6468,6469,12937
10692,,iww0esroe38j,6469,6470,12939
10693,,_eats8fjkq4j,6470,6471,12941
10694,,,6471,6472,12943
10695,,cr0hwvg873gj,6472,6473,12945
10696,,iqp57ady2eqj,6473,6474,12947
10697,,boqlwcn3b4ij,6474,6475,12949
10698,,,6476,6477,12953
10699,,dhi5rvs0ew4j,6477,6478,12955
10700,,fyaddmu186mj,6478,6479,12957
10701,,gwk3zzlhygij,6479,6480,12959
10702,,k_7lz-zgp6sj,6480,6481,12961
10703,,4q4ddt12p4kj,6481,6482,12963
10704,,rjgirwe0ybyj,6482,6483,12965
10705,,ssqckq225mkj,6483,6484,12967
10706,,qyds71sjcq4j,6484,6485,12969
10707,,wifqhe5mx9cj,6485,6486,12971
10708,,iuoy4wsqdi0j,6486,6487,12973
10709,,8d3wmci8xe0j,6487,6488,12975
10710,,url:http://links.jstor.org/sici3fsici3d0146-4949(196721)8253a2253c242253a2522fatfa253e2.0.co253b2-r,6488,6489,12977
10711,,a9r0hg4_1-wj,6489,6490,12979
10712,,zkeqfbf8kzuj,6490,6491,12981
10713,,bpluzfmioqkj,6491,6492,12983
10714,,d577ozw3jqgj,6492,6493,12985
10715,,wsn8cnitwwoj,6494,6495,12989
10716,,url:http://pubs.acs.org/cgi-bin/abstract.cgi/achre4/2003/36/i09/abs/ar020268q.html,6495,6496,12991
10717,,_lcyrsj1uxej,6497,6498,12995
10718,,rf8zdcmnk4wj,6498,6499,12997
10719,,bneb9bahzp0j,6499,6500,12999
10720,,rusjdypdgq4j,6500,6501,13001
10721,,jyeose7hjh8j,6501,6502,13003
10722,,ezilpr7fmroj,6502,6503,13005
10723,,rmf3htxa_-ej,6503,6504,13007
10724,,t9-70zweql8j,6504,6505,13009
10725,,y8_zeweqkysj,6505,6506,13011
10726,,w-6oilrwhekj,6506,6507,13013
10727,,fictp3khhocj,6507,6508,13015
10728,,k2sswqqjowyj,6508,6509,13017
10729,,4hgjkmtv0vgj,6509,6510,13019
10730,,0mg2tb6hlouj,6510,6511,13021
10731,,bgptiqysajqj,6511,6512,13023
10732,,sibw9tt-xcwj,6512,6513,13025
10733,,,6513,6514,13027
10734,,e51lmqifin8j,6514,6515,13029
10735,,xplikzeomaij,6515,6516,13031
10736,,y69i08qktpmj,6516,6517,13033
10737,,7y47dsw0sewj,6517,6518,13035
10738,,mbyzozer5xyj,6518,6519,13037
10739,,ciahosgwfmkj,6519,6520,13039
10740,,yxqzcfarejyj,6520,6521,13041
10741,,ygzmgwilaz8j,6521,6522,13043
10742,,hnqpn5beqx8j,6522,6523,13045
10743,,ubqbeq2byryj,6523,6524,13047
10744,,yhuthcvjkeij,6524,6525,13049
10745,,rvppv4baxa8j,6525,6526,13051
10746,,ovkxetlfmlaj,6526,6527,13053
10747,,boorkti7380j,6527,6528,13055
10748,,6hnaa1-qzksj,6528,6529,13057
10749,,syelhn7jrqcj,6529,6530,13059
10750,,9oy9mkopyxsj,6530,6531,13061
10751,,rsf10qvvhxkj,6531,6532,13063
10752,,fobv5dpqkucj,6532,6533,13065
10753,,eynoquc8ucwj,6533,6534,13067
10754,,cwzhf0arkusj,6534,6535,13069
10755,,zyxrisclszyj,6535,6536,13071
10756,,2dty9exkfcgj,6536,6537,13073
10757,,icilz_bn0ymj,6537,6538,13075
10758,,vnjc8lq4fhaj,6538,6539,13077
10759,,t5engpgww5ej,6539,6540,13079
10760,,mqskfwazvtoj,6540,6541,13081
10761,,_cusf4sg_28j,6541,6542,13083
10762,,qxgh2yvepigj,6542,6543,13085
10763,,hlh5bb2iwv0j,6543,6544,13087
10764,,epetq54hpuuj,6544,6545,13089
10765,,goj5bgtmgmqj,6545,6546,13091
10766,,9nxln4wnb5cj,6546,6547,13093
10767,,ntaqvq6dzlgj,6547,6548,13095
10768,,iudc228pw9gj,6548,6549,13097
10769,,n2-pca8hhzuj,6549,6550,13099
10770,,1fi8ohvvvpwj,6550,6551,13101
10771,,ddapv2m3sukj,6551,6552,13103
10772,,q2kudbgycc0j,6552,6553,13105
10773,,i-jiwzc5dhuj,6553,6554,13107
10774,,omjmjonirbgj,6554,6555,13109
10775,,gz60ten2h7oj,6555,6556,13111
10776,,mfi1_mdoszej,6556,6557,13113
10777,,zumbrrqkxroj,6557,6558,13115
10778,,n_ze9izjlu4j,6558,6559,13117
10779,,kn7bdpqjuvyj,6559,6560,13119
10780,,rao_-xvw1bgj,6560,6561,13121
10781,,l4v1vevmliaj,6561,6562,13123
10782,,nlqlahnbpgwj,6562,6563,13125
10783,,wut2sdhatzcj,6563,6564,13127
10784,,yairhaufng0j,6564,6565,13129
10785,,url:http://links.jstor.org/sici3fsici3d0146-4949(196623)7253a3253c336253ap1253e2.0.co253b2-y,6565,6566,13131
10786,,c5p1h7dhbvgj,6566,6567,13133
10787,,rpp3gtldvg8j,6567,6568,13135
10788,,f6gfb1yjtaaj,6568,6569,13137
10789,,vp2ya-dgkeuj,6569,6570,13139
10790,,pb_mhqjvreej,6570,6571,13141
10791,,sogqxf1hzwkj,6571,6572,13143
10792,,vngbjxppnpgj,6572,6573,13145
10793,,tikmuaoj5bgj,6573,6574,13147
10794,,afxkd66dr_gj,6574,6575,13149
10795,,ieqibqbmzngj,6575,6576,13151
10796,,1ispvyin-yij,6576,6577,13153
10797,,buwfubrpmjcj,6577,6578,13155
10798,,moi9lhweqnwj,6578,6579,13157
10799,,pidtc3q9ljyj,6579,6580,13159
10800,,2mehxbatx9ej,6580,6581,13161
10801,,a1ajgrd4ohaj,6581,6582,13163
10802,,sdltjeqxh4ij,6582,6583,13165
10803,,mgbcpf5donuj,6583,6584,13167
10804,,lsbq-7zichgj,6584,6585,13169
10805,,2gf8krcb68kj,6585,6586,13171
10806,,6foq3o3in1cj,6586,6587,13173
10807,,k60f6622rlwj,6587,6588,13175
10808,,io-vog38he0j,6588,6589,13177
10809,,qro_yowmlsmj,6589,6590,13179
10810,,url:http://www.csa.com/partners/viewrecord.php3frequester3dgs26collection3dtrd26recid3dn9210383ah,6590,6591,13181
10811,,k6mdporvfmwj,6591,6592,13183
10812,,1wltr4mxmaaj,6592,6593,13185
10813,,eelzag_gd5aj,6593,6594,13187
10814,,bhewa5ssnfgj,6594,6595,13189
10815,,4gczg8lihuqj,6595,6596,13191
10816,,9uvis4eql0gj,6596,6597,13193
10817,,d13fnh5qba0j,6597,6598,13195
10818,,5iolws79weej,6598,6599,13197
10819,,gzfcirt1w70j,6599,6600,13199
10820,,eqeb7nzwh38j,6600,6601,13201
10821,,cqvuvnx2olgj,6601,6602,13203
10822,,u7actb0k_i0j,6602,6603,13205
10823,,hweiyjfqavuj,6603,6604,13207
10824,,ctfxiouau-cj,6604,6605,13209
10825,,tg7spa2y6gkj,6605,6606,13211
10826,,6pdihkydkc8j,6606,6607,13213
10827,,kmnm_jbadguj,6608,6609,13217
10828,,ngsm8m54ja4j,6609,6610,13219
10829,,lxdmzsf1x4cj,6610,6611,13221
10830,,fx08u-wkqa4j,6611,6612,13223
10831,,ftvekb5yvxuj,6612,6613,13225
10832,,xopiyzetvwij,6613,6614,13227
10833,,9i4ou1poeb0j,6614,6615,13229
10834,,vyqte8peitaj,6615,6616,13231
10835,,50tga4wdz6aj,6616,6617,13233
10836,,vgowe8fq48ij,6617,6618,13235
10837,,f6rc1ioxvtqj,6618,6619,13237
10838,,eox6mmzzhxuj,6620,6621,13241
10839,,g_lhde-6hraj,6621,6622,13243
10840,,9sytlgmmsycj,6622,6623,13245
10841,,vomftlbcthqj,6623,6624,13247
10842,,dumpka0-4a4j,6624,6625,13249
10843,,decupkgyceuj,6625,6626,13251
10844,,j65iyjtek-qj,6626,6627,13253
10845,,url:http://www.csa.com/partners/viewrecord.php3frequester3dgs26collection3dtrd26recid3d0132799ci,6627,6628,13255
10846,,fle1jdgelgqj,6628,6629,13257
10847,,uy7ex3-bdeuj,6629,6630,13259
10848,,vbjbsvxdzkmj,6630,6631,13261
10849,,kncxja52jz8j,6631,6632,13263
10850,,nek-xixsy4uj,6632,6633,13265
10851,,ionowutiwhcj,6633,6634,13267
10852,,35a-3yfc2amj,6634,6635,13269
10853,,l-augns9jncj,6635,6636,13271
10854,,3qxcqs_8thoj,6636,6637,13273
10855,,lhb0zsiipfsj,6637,6638,13275
10856,,vplvxruoepwj,6638,6639,13277
10857,,bglodov0nnsj,6639,6640,13279
10858,,url:http://www.ingentaconnect.com/content/bpl/area/2001/00000033/00000003/art00032,6640,6641,13281
10859,,url:http://ieeexplore.ieee.org/iel3/3990/11481/00547806.pdf3farnumber3d547806,6641,6642,13283
10860,,hup1vks7qc0j,6642,6643,13285
10861,,3nk_cm_juguj,6643,6644,13287
10862,,7nicgyl21yej,6644,6645,13289
10863,,hqqh6bxiqdwj,6647,6648,13295
10864,,url:http://portal.acm.org/citation.cfm3fid3d319463.31962326dl3dguide26dl3dacm26type3dseries26idx3d31946326part3dproceedings26wanttype3dproceedings26title3dinternational2520multimedia2520conference26cfid3d1111111126cftoken3d2222222,6648,6649,13297
10865,,21unxexl8wcj,6649,6650,13299
10866,,usbhukm0nayj,6650,6651,13301
10867,,idmd3gsenlij,6651,6652,13303
10868,,vd3bw4umt28j,6652,6653,13305
10869,,qoouwqel86uj,6653,6654,13307
10870,,ymjjam38n8sj,6654,6655,13309
10871,,og3jvkif2xij,6655,6656,13311
10872,,n4qe8t2pqp8j,6656,6657,13313
10873,,isnewwfn8jmj,6657,6658,13315
10874,,x5oge871yfkj,6658,6659,13317
10875,,k-fwgztgbpkj,6659,6660,13319
10876,,e0ehiqzf-pwj,6660,6661,13321
10877,,g2upkc22-ecj,6661,6662,13323
10878,,owgrzpyutrwj,6663,6664,13327
10879,,wdlqdse2usoj,6664,6665,13329
10880,,zaamwgtfwauj,6665,6666,13331
10881,,3nln2onotnyj,6666,6667,13333
10882,,_xerhu53uaoj,6667,6668,13335
10883,,zyz0zhug-igj,6668,6669,13337
10884,,url:http://portal.acm.org/ft_gateway.cfm3fid3d108365226type3dpdf,6669,6670,13339
10885,,url:http://www.csa.com/partners/viewrecord.php3frequester3dgs26collection3dtrd26recid3dn9210570ah,6670,6671,13341
10886,,url:http://www.csa.com/partners/viewrecord.php3frequester3dgs26collection3dtrd26recid3d0214573ci,6671,6672,13343
10887,,ql9eraljy60j,6672,6673,13345
10888,,fwpuzs2gki8j,6674,6675,13349
10889,,8zqbezyxvtij,6675,6676,13351
10890,,08ezt21wynyj,6676,6677,13353
10891,,opnpxoxwhowj,6677,6678,13355
10892,,lbc82r9_d8qj,6678,6679,13357
10893,,9kghcxhmgxkj,6679,6680,13359
10894,,5n6cgku4uvij,6680,6681,13361
10895,,xxdqlfnxh1qj,6681,6682,13363
10896,,wunqxksszvoj,6682,6683,13365
10897,,tq2uvmrp-u4j,6683,6684,13367
10898,,xl6l4yzxsfaj,6685,6686,13371
10899,,smqmlob3p4aj,6686,6687,13373
10900,,pwtxe4lb11aj,6687,6688,13375
10901,,8c5x73xztqej,6688,6689,13377
10902,,vynkbiixiekj,6689,6690,13379
10903,,tunsv-iwqowj,6690,6691,13381
10904,,qsbf32gz2eoj,6691,6692,13383
10905,,slvivsi__bcj,6692,6693,13385
10906,,qhlysuqozdmj,6693,6694,13387
10907,,e1nidl7v-wej,6694,6695,13389
10908,,4u31xd8p478j,6695,6696,13391
10909,,atkvpzcqazsj,6696,6697,13393
10910,,qrumlumsougj,6697,6698,13395
10911,,lv8cekrdnjqj,6698,6699,13397
10912,,fad9zjj7cbij,6699,6700,13399
10913,,metujycvuusj,6700,6701,13401
10914,,fvetyvbispyj,6701,6702,13403
10915,,zomht-fylyej,6702,6703,13405
10916,,v3c_ivuas34j,6703,6704,13407
10917,,ootpvbjvtayj,6704,6705,13409
10918,,eu_mtpw-9f0j,6705,6706,13411
10919,,8-bxhtwm-0kj,6706,6707,13413
10920,,jlgqex_scwij,6707,6708,13415
10921,,dz8avsmix-uj,6708,6709,13417
10922,,rl63fzqgei0j,6709,6710,13419
10923,,y6zadmce_rij,6710,6711,13421
10924,,woigwzz4tjij,6711,6712,13423
10925,,fdbpi1or5w8j,6712,6713,13425
10926,,cbsytid2lzkj,6713,6714,13427
10927,,mnepcjbo2mcj,6714,6715,13429
10928,,3eyggpma_2sj,6715,6716,13431
10929,,p76h6furbykj,6716,6717,13433
10930,,6c4q-c-st8yj,6717,6718,13435
10931,,nfqco-9causj,6718,6719,13437
10932,,url:http://portal.acm.org/ft_gateway.cfm3fid3d97414226type3dpdf26dl3dguide26dl3dacm26cfid3d1111111126cftoken3d2222222,6719,6720,13439
10933,,gc3nabtu4tkj,6721,6722,13443
10934,,rfycvb2v4woj,6722,6723,13445
10935,,4acfxyxwznij,6723,6724,13447
10936,,pihbwxtntvuj,6724,6725,13449
10937,,oksuq_8ob4sj,6725,6726,13451
10938,,url:http://doi.wiley.com/10.1002/he.11203,6726,6727,13453
10939,,frdbqzlztlkj,6727,6728,13455
10940,,4othyypmsz8j,6728,6729,13457
10941,,lqrqvgqf3dej,6729,6730,13459
10942,,url:http://pubs.acs.org/cgi-bin/abstract.cgi/achre4/2005/38/i04/abs/ar0401707.html,6730,6731,13461
10943,,pm3q5xaxlo0j,6731,6732,13463
10944,,4lmbehx0nzsj,6732,6733,13465
10945,,,6733,6734,13467
10946,,3hr4ctlj3s8j,6734,6735,13469
10947,,uxpbscafoxqj,6735,6736,13471
10948,,vgodnh5ztpkj,6736,6737,13473
10949,,qzpd2v4cqvgj,6737,6738,13475
10950,,oyi1ykbcsicj,6738,6739,13477
10951,,mf6poxfb-b8j,6739,6740,13479
10952,,9987sc-6jo8j,6740,6741,13481
10953,,k67uwb0pcy8j,6741,6742,13483
10954,,u_5yvkntr6cj,6742,6743,13485
10955,,_trzzh04yrkj,6743,6744,13487
10956,,fzutb8am2zgj,6744,6745,13489
10957,,5yshfzlmlt0j,6745,6746,13491
10958,,tqy2uibpfq4j,6746,6747,13493
10959,,3g09b2fr00wj,6747,6748,13495
10960,,uybxau8dcnkj,6748,6749,13497
10961,,xajjgvryjayj,6749,6750,13499
10962,,h2qevfsaqkuj,6750,6751,13501
10963,,sopwyfqehjqj,6751,6752,13503
10964,,n-oy_4nnoqcj,6752,6753,13505
10965,,smal3hmes0cj,6753,6754,13507
10966,,w1pyt4p21t4j,6754,6755,13509
10967,,70dv99oj9ccj,6755,6756,13511
10968,,ribd7pekafoj,6756,6757,13513
10969,,yjk9jmfec80j,6757,6758,13515
10970,,hdzbtjnunrwj,6759,6760,13519
10971,,v17vuub3yr0j,6760,6761,13521
10972,,ogd3xxeszy4j,6761,6762,13523
10973,,ws9jgjix33yj,6762,6763,13525
10974,,1pia8chmcpkj,6763,6764,13527
10975,,qmcbya3jmhqj,6764,6765,13529
10976,,thl7ehyym5mj,6765,6766,13531
10977,,qptyjgjgmwwj,6766,6767,13533
10978,,cxiuirskd0ij,6767,6768,13535
10979,,url:http://doi.ieeecomputersociety.org/10.1109/tkde.2003.1232274,6768,6769,13537
10980,,oc6vjradvasj,6769,6770,13539
10981,,pmzbnbzpgxoj,6770,6771,13541
10982,,zc7jtsj4e0mj,6771,6772,13543
10983,,brinm-lwu50j,6772,6773,13545
10984,,fveowh62kyqj,6773,6774,13547
10985,,qfmztut1ktsj,6774,6775,13549
10986,,a1_mvybrjyaj,6775,6776,13551
10987,,abjui-7ejfoj,6776,6777,13553
10988,,lcg7ltlqdxsj,6777,6778,13555
10989,,vlro0wwuy3wj,6778,6779,13557
10990,,qw1ij2pasguj,6779,6780,13559
10991,,qsjqwhf5w7oj,6780,6781,13561
10992,,fp8dl6r8_n0j,6781,6782,13563
10993,,url4ufuc9yej,6782,6783,13565
10994,,s5ncgodfyo8j,6783,6784,13567
10995,,url:http://ieeexplore.ieee.org/iel5/164/5238/00204075.pdf3farnumber3d204075,6784,6785,13569
10996,,uoyj0cbmg0aj,6785,6786,13571
10997,,ly4cqqpn8wwj,6786,6787,13573
10998,,nnlpq65d5q8j,6787,6788,13575
10999,,i5coyxnfhckj,6788,6789,13577
11000,,url:http://portal.acm.org/citation.cfm3fid3d603867.60388326dl3dguide26dl3dacm26type3dissue26idx3d60386726part3dperiodical26wanttype3dperiodical26title3dacm2520sigmod2520record26cfid3d1111111126cftoken3d2222222,6789,6790,13579
11001,,url:http://portal.acm.org/ft_gateway.cfm3fid3d108375626type3dpdf,6790,6791,13581
11002,,fnhtpfxx-zgj,6791,6792,13583
11003,,uc5rxrj0lo4j,6792,6793,13585
11004,,tnvwahvwbe8j,6793,6794,13587
11005,,52c6bp2cmpsj,6794,6795,13589
11006,,qdbnb5ojwgoj,6795,6796,13591
11007,,hawkojez3iaj,6796,6797,13593
11008,,fm3ioojmw7ej,6797,6798,13595
11009,,orvfyi6q8ggj,6798,6799,13597
11010,,b0wnn4dkd_ij,6799,6800,13599
11011,,iyqnstjsazmj,6800,6801,13601
11012,,kjnr34jtpi0j,6802,6803,13605
11013,,p_ufb9r53lmj,6803,6804,13607
11014,,ceqct0dqc08j,6804,6805,13609
11015,,url:http://adsabs.harvard.edu/abs/1991mit..reptr....w,6805,6806,13611
11016,,4i07chnxgxuj,6806,6807,13613
11017,,c0kmqek5xfsj,6807,6808,13615
11018,,brebpinoxlwj,6808,6809,13617
11019,,y8yubi0d5lsj,6809,6810,13619
11020,,awajwzclkm4j,6810,6811,13621
11021,,xhovranzbuej,6811,6812,13623
11022,,f66hcqrlmjaj,6812,6813,13625
11023,,8qo4zok_vxej,6813,6814,13627
11024,,url:http://www.kluweronline.com/article.asp3fpips3d526823326pdf3d1,6814,6815,13629
11025,,o0ajvnv4uzij,6815,6816,13631
11026,,bfucrukwtz0j,6816,6817,13633
11027,,j5ydkh6p7g4j,6817,6818,13635
11028,,vna5prj2yd4j,6818,6819,13637
11029,,flirzixfrncj,6819,6820,13639
11030,,jxqz0yry-daj,6820,6821,13641
11031,,ijy7fr6migqj,6821,6822,13643
11032,,wyl12cn6sucj,6822,6823,13645
11033,,th6ypmd8ul0j,6823,6824,13647
11034,,fboujtgdk28j,6824,6825,13649
11035,,f4w03dvh19ej,6825,6826,13651
11036,,_w84j4o2n3qj,6826,6827,13653
11037,,url:http://doi.wiley.com/10.1002/tl.177,6827,6828,13655
11038,,rjk7bcb96dij,6828,6829,13657
11039,,il1zxulu0nkj,6829,6830,13659
11040,,t54evcmqlowj,6830,6831,13661
11041,,ca1_azvusxyj,6831,6832,13663
11042,,7gpysr7yawaj,6832,6833,13665
11043,,ver_jpmxwxwj,6833,6834,13667
11044,,url:http://portal.acm.org/ft_gateway.cfm3fid3d108370826type3dpdf,6834,6835,13669
11045,,u8tehzj2xj0j,6835,6836,13671
11046,,bqzoq4wpzooj,6836,6837,13673
11047,,ktx-pxm3_dmj,6837,6838,13675
11048,,ho1-za_myj4j,6838,6839,13677
11049,,t3gxpagpqdoj,6839,6840,13679
11050,,zkrx8rc7104j,6840,6841,13681
11051,,v7pqf8m-baoj,6841,6842,13683
11052,,51jrn8j48jej,6842,6843,13685
11053,,otzhryeximcj,6843,6844,13687
11054,,5xh64tvo2kij,6844,6845,13689
11055,,0sthwlrm0bsj,6845,6846,13691
11056,,tqqhl2tpzxcj,6846,6847,13693
11057,,w-_fog4ubzoj,6847,6848,13695
11058,,2p3ntnakjd4j,6848,6849,13697
11059,,gr0bvghyfvoj,6849,6850,13699
11060,,ycujwrtrnayj,6850,6851,13701
11061,,pnkd5ijhlasj,6852,6853,13705
11062,,rifyfcmtpkmj,6853,6854,13707
11063,,tmcc2y-yhhuj,6854,6855,13709
11064,,3nhtmxintbuj,6855,6856,13711
11065,,3oea979dniwj,6856,6857,13713
11066,,_-yxa5hlnqoj,6857,6858,13715
11067,,wdbzl0sd-lmj,6858,6859,13717
11068,,fkhibahhaiyj,6859,6860,13719
11069,,x3iptum3sdsj,6860,6861,13721
11070,,,6861,6862,13723
11071,,enyclfkkzpuj,6862,6863,13725
11072,,zduemtbj_4wj,6863,6864,13727
11073,,dmna36iczl0j,6865,6866,13731
11074,,a_tga3b9dcuj,6866,6867,13733
11075,,tesnu3tup_qj,6867,6868,13735
11076,,qtt_livgcfcj,6868,6869,13737
11077,,url:http://portal.acm.org/ft_gateway.cfm3fid3d102776026type3dpdf,6869,6870,13739
11078,,v5-t1_szooaj,6870,6871,13741
11079,,jmibnh7qzzyj,6871,6872,13743
11080,,url:http://portal.acm.org/citation.cfm3fid3d382272.38241626dl3dguide26dl3dacm26idx3dj68926part3dperiodical26wanttype3dperiodical26title3dacm2520sigmod2520record26cfid3d1111111126cftoken3d2222222,6872,6873,13745
11081,,1mc5zu0goi0j,6873,6874,13747
11082,,1psqlswylr0j,6874,6875,13749
11083,,8pvcouoseiyj,6875,6876,13751
11084,,vk2dhxe23dej,6876,6877,13753
11085,,yaxwq_fbbewj,6877,6878,13755
11086,,wsmrx5csnvoj,6878,6879,13757
11087,,ykl7mil1s08j,6879,6880,13759
11088,,qow_c1yjgawj,6880,6881,13761
11089,,r6ixexn_d3mj,6881,6882,13763
11090,,vi9c-zuadl8j,6882,6883,13765
11091,,0rr2my9uxeqj,6883,6884,13767
11092,,jt-ip6o-frej,6884,6885,13769
11093,,tkqdvse1fscj,6885,6886,13771
11094,,vsbpagx4gfgj,6886,6887,13773
11095,,41xrimkjhw4j,6887,6888,13775
11096,,kykfhob9nzkj,6888,6889,13777
11097,,wl8xtchp7jej,6889,6890,13779
11098,,lwbnl19_vlsj,6890,6891,13781
11099,,zfhbvumiywoj,6891,6892,13783
11100,,xsxk4kahuykj,6892,6893,13785
11101,,_ei1gprbttej,6893,6894,13787
11102,,hu9wwnvgx5cj,6894,6895,13789
11103,,dya5gqchy0yj,6895,6896,13791
11104,,2f-9x7gpbzwj,6896,6897,13793
11105,,iyg0bps8xsaj,6897,6898,13795
11106,,mjbwy9cgik4j,6899,6900,13799
11107,,mrx6dgu__dmj,6900,6901,13801
11108,,,6901,6902,13803
11109,,,6902,6903,13805
11110,,3z8pxliim_sj,6903,6904,13807
11111,,alopzzgn3csj,6904,6905,13809
11112,,d54c7hsdseej,6905,6906,13811
11113,,vchd8vtlcmmj,6906,6907,13813
11114,,hwhi2fttg5oj,6907,6908,13815
11115,,lat-zpr7zt0j,6908,6909,13817
11116,,0-431tzcvgqj,6909,6910,13819
11117,,9hcxjv0ubwyj,6910,6911,13821
11118,,uhewyyv_wuuj,6911,6912,13823
11119,,d5jtafai6tqj,6912,6913,13825
11120,,ynky3rc_4zqj,6913,6914,13827
11121,,s3aivzg2vaij,6914,6915,13829
11122,,ebvwchpy8ccj,6915,6916,13831
11123,,jyl2qclqoxcj,6916,6917,13833
11124,,evorjvqddnoj,6917,6918,13835
11125,,2guudpb5vruj,6918,6919,13837
11126,,bywool_y1bsj,6919,6920,13839
11127,,g6fhs0vgfeij,6920,6921,13841
11128,,j1quwxjgasmj,6921,6922,13843
11129,,jydnmdbhxsyj,6922,6923,13845
11130,,7l_qt2jygryj,6923,6924,13847
11131,,vpvfmewkdjej,6924,6925,13849
11132,,gau20gpswaej,6925,6926,13851
11133,,bqh503smxl0j,6926,6927,13853
11134,,tfzk6zjqkdmj,6927,6928,13855
11135,,ff9sfytoujwj,6928,6929,13857
11136,,00jvdqdspkcj,6929,6930,13859
11137,,g3sptfr4whsj,6930,6931,13861
11138,,d981mfuotbmj,6931,6932,13863
11139,,xkarid38kgmj,6932,6933,13865
11140,,wfklohnc5z4j,6933,6934,13867
11141,,pker8puqin8j,6934,6935,13869
11142,,rjqa8odfpmwj,6935,6936,13871
11143,,44ptfb2qkvsj,6936,6937,13873
11144,,s7hdfe3f7jqj,6937,6938,13875
11145,,caswbynyiosj,6938,6939,13877
11146,,2zfhpodk43yj,6939,6940,13879
11147,,url:http://doi.wiley.com/10.1002/ace.68,6940,6941,13881
11148,,hajoaqjk9e8j,6942,6943,13885
11149,,mgojc9_5dk8j,6943,6944,13887
11150,,iugoegr-4zkj,6944,6945,13889
11151,,8flew1ni4tqj,6945,6946,13891
11152,,aq1dahfcdzgj,6946,6947,13893
11153,,tj2ucspfq6ej,6947,6948,13895
11154,,quioaa65zigj,6948,6949,13897
11155,,wa0nytklx_mj,6949,6950,13899
11156,,u-ast4qudnaj,6950,6951,13901
11157,,n4aivzmboqij,6952,6953,13905
11158,,qmbvg_ox_luj,6953,6954,13907
11159,,zykcr7fdpn8j,6954,6955,13909
11160,,d2rwtgzskw4j,6955,6956,13911
11161,,p0mrw1sdxeuj,6956,6957,13913
11162,,tkpvyvxsja8j,6957,6958,13915
11163,,e2j3ct5kidsj,6958,6959,13917
11164,,ltprwnkugayj,6959,6960,13919
11165,,9tr7gozwcsej,6960,6961,13921
11166,,sk8molrtjuwj,6961,6962,13923
11167,,url:http://doi.wiley.com/10.1002/ev.1259,6962,6963,13925
11168,,x-yqrokqivej,6963,6964,13927
11169,,o_d7buxdonsj,6965,6966,13931
11170,,o0v0mr7zmy8j,6966,6967,13933
11171,,qidepzqueyij,6967,6968,13935
11172,,b46-m4kwxywj,6968,6969,13937
11173,,deisbulz74gj,6969,6970,13939
11174,,url:http://www.csa.com/partners/viewrecord.php3frequester3dgs26collection3dtrd26recid3dn9210422ah,6970,6971,13941
11175,,rrhxbccj_t4j,6971,6972,13943
11176,,qmhevzvxbvkj,6972,6973,13945
11177,,47o3iwtfjlej,6973,6974,13947
11178,,duytf3ihhgkj,6974,6975,13949
11179,,c9u80l-9k7qj,6975,6976,13951
11180,,jsfyavnpwp0j,6976,6977,13953
11181,,iubi2ozvz8uj,6977,6978,13955
11182,,ljda1velcamj,6978,6979,13957
11183,,c0omxhwdsrij,6979,6980,13959
11184,,cuhoptgmtmgj,6980,6981,13961
11185,,y8q6uhut6wqj,6981,6982,13963
11186,,ql9hq98uhmgj,6982,6983,13965
11187,,tfc8mfbuq8ij,6983,6984,13967
11188,,yqxszswrznqj,6984,6985,13969
11189,,z1oitw8l5maj,6985,6986,13971
11190,,hqzgzlbf-gej,6986,6987,13973
11191,,n5q44rmuvnuj,6987,6988,13975
11192,,9kvnirt3vmij,6988,6989,13977
11193,,ejtgfw1ozkmj,6989,6990,13979
11194,,wmllhuemacwj,6990,6991,13981
11195,,h8v1nbexkg8j,6991,6992,13983
11196,,llgtbh3v55kj,6992,6993,13985
11197,,mv0iffkexcwj,6993,6994,13987
11198,,mf_8cigjwagj,6995,6996,13991
11199,,url:http://www.springerlink.com/index/m470447876418l50.pdf,6996,6997,13993
11200,,fqvw8m62q-8j,6997,6998,13995
11201,,2xdrxi20f-gj,6998,6999,13997
11202,,obofh2eyyrwj,6999,7000,13999
11203,,ztahbun1ldsj,7000,7001,14001
11204,,qdpyoxujtb0j,7001,7002,14003
11205,,jkhznuabyk8j,7002,7003,14005
11206,,xbwplvqsfukj,7003,7004,14007
11207,,rjc5dw5hp-0j,7004,7005,14009
11208,,w0bgyxpdhboj,7005,7006,14011
11209,,ks5qyrqdlt4j,7006,7007,14013
11210,,url:http://portal.acm.org/ft_gateway.cfm3fid3d95907426type3dpdf26dl3dguide26dl3dacm26cfid3d1111111126cftoken3d2222222,7007,7008,14015
11211,,qzg0dagyn4uj,7008,7009,14017
11212,,j2wnbmznftcj,7009,7010,14019
11213,,lkt84blgnkwj,7010,7011,14021
11214,,pvelngjqcv4j,7011,7012,14023
11215,,ia7gskbceygj,7012,7013,14025
11216,,qdd0r0gwnuaj,7013,7014,14027
11217,,k81_8sqbbk8j,7014,7015,14029
11218,,,7015,7016,14031
11219,,rjhxjmnu_9mj,7016,7017,14033
11220,,i-_ie2byk18j,7017,7018,14035
11221,,ylalw6_nahaj,7018,7019,14037
11222,,eco8thc5kncj,7019,7020,14039
11223,,bwugfajrzg4j,7020,7021,14041
11224,,mommalbwoaij,7021,7022,14043
11225,,ar6odyugbnij,7022,7023,14045
11226,,url:http://adsabs.harvard.edu/abs/1978phdt........15v,7024,7025,14049
11227,,r_bgaqwk2juj,7025,7026,14051
11228,,xdkuoesi6dcj,7027,7028,14055
11229,,p2pzlkgmo9wj,7028,7029,14057
11230,,_zytsafxdu4j,7029,7030,14059
11231,,nk04y68trq0j,7030,7031,14061
11232,,ejcjfhfy388j,7031,7032,14063
11233,,rpzadusls5mj,7032,7033,14065
11234,,2pcjnj-kqe4j,7033,7034,14067
11235,,axm76agwcekj,7034,7035,14069
11236,,vppf2hv6swkj,7035,7036,14071
11237,,wpo3r3k-ljmj,7036,7037,14073
11238,,boecyixl5aqj,7037,7038,14075
11239,,qua_3bt2xvqj,7038,7039,14077
11240,,dh4xfq1ve8mj,7039,7040,14079
11241,,eweocypf85sj,7040,7041,14081
11242,,uziupqo7-b8j,7041,7042,14083
11243,,mmac8-pfo14j,7042,7043,14085
11244,,o4ktf2wfcfoj,7043,7044,14087
11245,,0dtw15zztaij,7044,7045,14089
11246,,kwdndlocomsj,7045,7046,14091
11247,,p_z1wetdyhuj,7046,7047,14093
11248,,kw_1o5v8ot4j,7048,7049,14097
11249,,y5xzda-_elkj,7049,7050,14099
11250,,b1lxum5k_fwj,7050,7051,14101
11251,,mf9imxhxhgij,7051,7052,14103
11252,,wzx3gakgmtaj,7052,7053,14105
11253,,ukpcpqbd5hmj,7054,7055,14109
11254,,6csuzfrojiej,7056,7057,14113
11255,,kbgc5sbamjoj,7057,7058,14115
11256,,fnoaum8yuiyj,7058,7059,14117
11257,,p2fmhdofxquj,7059,7060,14119
11258,,aoyz34auktoj,7060,7061,14121
11259,,nefjscrnhmaj,7061,7062,14123
11260,,hz_r6ztgfxkj,7062,7063,14125
11261,,2ooaisiuyqmj,7063,7064,14127
11262,,54toavybq_wj,7064,7065,14129
11263,,vg7p_uhdh_kj,7065,7066,14131
11264,,g-rsk8zhlqkj,7066,7067,14133
11265,,7mma0714izkj,7067,7068,14135
11266,,l5dipkygodkj,7068,7069,14137
11267,,09mvnca-tvij,7069,7070,14139
11268,,45ntl7fz86wj,7070,7071,14141
11269,,que4v9cvspwj,7071,7072,14143
11270,,url:http://portal.acm.org/citation.cfm3fid3d171926.172020,7072,7073,14145
11271,,rhyypwqrl3qj,7073,7074,14147
11272,,eec-nqog3baj,7074,7075,14149
11273,,ah97x6qvkj0j,7075,7076,14151
11274,,n9ndxnrvmmkj,7076,7077,14153
11275,,q4lsho6nr_mj,7077,7078,14155
11276,,wkhsl_tbs60j,7078,7079,14157
11277,,omvnpzvu4z4j,7079,7080,14159
11278,,avyfiqpgbtgj,7080,7081,14161
11279,,url:http://adsabs.harvard.edu/abs/2000stin...0088615c,7081,7082,14163
11280,,dperzo81qkej,7082,7083,14165
11281,,evwaae8gtrij,7083,7084,14167
11282,,bsab4-zgxj8j,7084,7085,14169
11283,,cm209vuk17cj,7085,7086,14171
11284,,vgmyix11ltkj,7086,7087,14173
11285,,ob-cwpkggh8j,7087,7088,14175
11286,,yeg4adbh2dkj,7088,7089,14177
11287,,8zwsmfoiiioj,7089,7090,14179
11288,,rcqf57rqv5kj,7090,7091,14181
11289,,sdu0z_9uhqij,7091,7092,14183
11290,,sciaesoot9cj,7092,7093,14185
11291,,y1lxcfxtztaj,7093,7094,14187
11292,,9jmln3a2qgij,7094,7095,14189
11293,,ocq0zx66bn0j,7095,7096,14191
11294,,zyvyh-g07yqj,7096,7097,14193
11295,,cgnkkwzfhzmj,7097,7098,14195
11296,,cedkgmszwgmj,7098,7099,14197
11297,,kbflzxitdj4j,7100,7101,14201
11298,,fwlegiktwjoj,7101,7102,14203
11299,,zaci2_bia4mj,7102,7103,14205
11300,,xukkzqzyagcj,7103,7104,14207
11301,,2nmktwioqoyj,7104,7105,14209
11302,,nopm1usm3kwj,7105,7106,14211
11303,,v6natq0dkpmj,7106,7107,14213
11304,,tlcpotlzv8uj,7107,7108,14215
11305,,tf5hhc0_ip0j,7108,7109,14217
11306,,9vndpinssvej,7109,7110,14219
11307,,n01ffz8e9_0j,7110,7111,14221
11308,,ug_kbdf0gboj,7111,7112,14223
11309,,twb1rhycwekj,7112,7113,14225
11310,,url:http://portal.acm.org/ft_gateway.cfm3fid3d110119226type3dpdf,7113,7114,14227
11311,,zmiqfnocjraj,7114,7115,14229
11312,,d0a9mi81r9qj,7115,7116,14231
11313,,twxsiyailfqj,7116,7117,14233
11314,,ktbk8jv3o2yj,7117,7118,14235
11315,,bpczmp7gxdmj,7118,7119,14237
11316,,pn6ta4_5n-yj,7119,7120,14239
11317,,xhlv0mlodmcj,7120,7121,14241
11318,,gvgctummbs4j,7121,7122,14243
11319,,ypgaaegiqg8j,7122,7123,14245
11320,,aayb06bhtmoj,7123,7124,14247
11321,,oitfge3mz2gj,7124,7125,14249
11322,,6rjunq_-1iwj,7125,7126,14251
11323,,snbsm5v0qf0j,7126,7127,14253
11324,,ffllffy91vyj,7127,7128,14255
11325,,mnco4_u5i2oj,7128,7129,14257
11326,,url:http://www.csa.com/partners/viewrecord.php3frequester3dgs26collection3dtrd26recid3d2176876ci,7129,7130,14259
11327,,hjzofmip_tmj,7130,7131,14261
11328,,ao-rm03ykguj,7131,7132,14263
11329,,w9glyoiddpgj,7132,7133,14265
11330,,dwe_ba9iaq0j,7133,7134,14267
11331,,llvbko6kyzoj,7134,7135,14269
11332,,vws7vk7xqpaj,7135,7136,14271
11333,,rdv7e9_4scij,7136,7137,14273
11334,,rbdylboghz8j,7137,7138,14275
11335,,mr5qhks-bd0j,7138,7139,14277
11336,,xhrxiaoqghqj,7139,7140,14279
11337,,z1xndzycbgmj,7140,7141,14281
11338,,6qe6frxw2zkj,7141,7142,14283
11339,,url:http://ieeexplore.ieee.org/iel5/9217/29235/01320046.pdf3farnumber3d1320046,7142,7143,14285
11340,,fw3i7n_5mv4j,7143,7144,14287
11341,,j7b7tkcvk_ej,7144,7145,14289
11342,,w7b6upfoyjij,7145,7146,14291
11343,,c10wtqwcym8j,7146,7147,14293
11344,,64fmpb-atd8j,7147,7148,14295
11345,,wb1trk3bqb8j,7148,7149,14297
11346,,reofue1ytx4j,7149,7150,14299
11347,,xlziqwpnvyyj,7150,7151,14301
11348,,ttqwsgo2udqj,7151,7152,14303
11349,,efjhivxkmjwj,7152,7153,14305
11350,,url:http://www.extenza-eps.com/woi/doi/abs/10.5555/bicl.2005.1.chile.38,7153,7154,14307
11351,,av8_ysl7u2sj,7154,7155,14309
11352,,mv1ebgwcsr0j,7155,7156,14311
11353,,mxmf1bgsor8j,7156,7157,14313
11354,,zrhegtu74dyj,7157,7158,14315
11355,,zxlnhiwz_roj,7158,7159,14317
11356,,url:http://portal.acm.org/citation.cfm3fid3d592202.592472,7159,7160,14319
11357,,mg3fvl5dri0j,7160,7161,14321
11358,,2przocfnsaqj,7161,7162,14323
11359,,1-loio6f5ooj,7163,7164,14327
11360,,idtxunxswr0j,7164,7165,14329
11361,,06jducfjfiuj,7165,7166,14331
11362,,j2v98j3oig8j,7166,7167,14333
11363,,ag60iw0qa78j,7167,7168,14335
11364,,_fp95z4owkej,7168,7169,14337
11365,,rjkr3at7v9qj,7169,7170,14339
11366,,f71cyhhk2raj,7170,7171,14341
11367,,vpumq6c2egcj,7171,7172,14343
11368,,zre-4vh0f9uj,7172,7173,14345
11369,,utglal-exbuj,7173,7174,14347
11370,,btjiaqtxhbkj,7174,7175,14349
11371,,tinnzsjiunwj,7175,7176,14351
11372,,wnkkvlrqogmj,7176,7177,14353
11373,,40tgwt5y2caj,7177,7178,14355
11374,,tsje6z0yluij,7178,7179,14357
11375,,url:http://pubs.acs.org/cgi-bin/abstract.cgi/achre4/2005/38/i04/abs/ar040177o.html,7179,7180,14359
11376,,gu1qta2ot5qj,7180,7181,14361
11377,,eotkoldux4wj,7181,7182,14363
11378,,8ndns98tgiaj,7182,7183,14365
11379,,uis2pqwxg2aj,7183,7184,14367
11380,,g4bdurudmdqj,7184,7185,14369
11381,,bunvmjausnyj,7185,7186,14371
11382,,bwjezg21i8gj,7186,7187,14373
11383,,hrazkh3p2hej,7187,7188,14375
11384,,wnfxt9_45ayj,7188,7189,14377
11385,,p2hed7dwp38j,7190,7191,14381
11386,,,7191,7192,14383
11387,,gmwqme-kteej,7192,7193,14385
11388,,ed0xck3cnbkj,7193,7194,14387
11389,,lqh2lcn6znqj,7194,7195,14389
11390,,url:http://www.csa.com/partners/viewrecord.php3frequester3dgs26collection3dtrd26recid3d0154639ci,7195,7196,14391
11391,,feo_nddgrfwj,7196,7197,14393
11392,,ajm2mjgkinaj,7197,7198,14395
11393,,hgs9hfn3tz4j,7198,7199,14397
11394,,ovl8lxh2gxaj,7199,7200,14399
11395,,_-4et4rilxgj,7200,7201,14401
11396,,hz7qfc1e6b0j,7201,7202,14403
11397,,r72dug9k83kj,7203,7204,14407
11398,,b7hu6cchzfmj,7204,7205,14409
11399,,spqcmjkfm6ej,7206,7207,14413
11400,,fxgs50zxfvej,7207,7208,14415
11401,,dewrzrqi5oaj,7208,7209,14417
11402,,gg8qabji1w8j,7209,7210,14419
11403,,,7210,7211,14421
11404,,tmqcvfbi4faj,7211,7212,14423
11405,,rruwkhjt1j4j,7212,7213,14425
11406,,e6x7b3jn2vij,7213,7214,14427
11407,,g5z1pynokbgj,7214,7215,14429
11408,,mvi_sfze0lcj,7215,7216,14431
11409,,idhnndeiz00j,7216,7217,14433
11410,,url:http://portal.acm.org/citation.cfm3fid3d11585826dl3dacm26coll3dportal26cfid3d1111111126cftoken3d2222222,7217,7218,14435
11411,,lofly1wwz4ej,7218,7219,14437
11412,,arexuzqrkhcj,7219,7220,14439
11413,,c1yzkgcpo4ej,7220,7221,14441
11414,,a0aqtu0mqcyj,7221,7222,14443
11415,,gjyjmpqepw0j,7222,7223,14445
11416,,1_qcwnry32cj,7223,7224,14447
11417,,9h0d_ybuakcj,7224,7225,14449
11418,,jlvv9rzhg3wj,7225,7226,14451
11419,,lyl36jksczej,7226,7227,14453
11420,,jzfsfaa5hv0j,7227,7228,14455
11421,,vd1yi-h9wlcj,7228,7229,14457
11422,,bjrwudkytlcj,7229,7230,14459
11423,,xznjqqwkzvyj,7230,7231,14461
11424,,url:http://doi.wiley.com/10.1002/tl.8007,7231,7232,14463
11425,,bgbhrjiqu7ij,7232,7233,14465
11426,,me0j9dql4nkj,7233,7234,14467
11427,,hs0p_0v5osyj,7234,7235,14469
11428,,9k3y3ujba2sj,7235,7236,14471
11429,,23hbkx4kvwwj,7236,7237,14473
11430,,ji2empz2tb4j,7237,7238,14475
11431,,jl_pdzd9mpej,7238,7239,14477
11432,,wmf_ubhdov4j,7239,7240,14479
11433,,s6x-vifmdvoj,7240,7241,14481
11434,,qoz6ja4m5fcj,7241,7242,14483
11435,,77xwdwhjjfqj,7242,7243,14485
11436,,kildageb2osj,7243,7244,14487
11437,,kdojx3wnfnqj,7244,7245,14489
11438,,ygncrot7kcyj,7245,7246,14491
11439,,url:http://portal.acm.org/ft_gateway.cfm3fid3d110123526type3dpdf,7246,7247,14493
11440,,kx6d1buk8haj,7247,7248,14495
11441,,tdyazqj7gmgj,7249,7250,14499
11442,,cjzfadrws8wj,7250,7251,14501
11443,,kjyo5lho_vaj,7251,7252,14503
11444,,tfeyydcrlxwj,7252,7253,14505
11445,,aivakqvcgqgj,7253,7254,14507
11446,,9-2nlslf1vqj,7254,7255,14509
11447,,xqqybjidgiej,7255,7256,14511
11448,,url:http://www.csa.com/partners/viewrecord.php3frequester3dgs26collection3dtrd26recid3d0834958ci,7256,7257,14513
11449,,gwtps81l4kej,7258,7259,14517
11450,,8r4pnmedtugj,7259,7260,14519
11451,,ymvkc-ebwpwj,7260,7261,14521
11452,,q_twe-aaaj0j,7261,7262,14523
11453,,asa4ffahruwj,7262,7263,14525
11454,,pddm9dl0twoj,7263,7264,14527
11455,,,7264,7265,14529
11456,,4ias_bej-paj,7265,7266,14531
11457,,wbu3g9g-unij,7266,7267,14533
11458,,nn7rly8wdwmj,7267,7268,14535
11459,,4btxoodyyhmj,7268,7269,14537
11460,,dds-tmc6eioj,7269,7270,14539
11461,,f25wplnkllaj,7270,7271,14541
11462,,jvmbkrskdkwj,7271,7272,14543
11463,,69yuab9uljqj,7272,7273,14545
11464,,url:http://www.springerlink.com/index/x713346t55573052.pdf,7273,7274,14547
11465,,ryu7vp9u9oej,7274,7275,14549
11466,,2cn4szgacb0j,7276,7277,14553
11467,,bf9t6epjl14j,7277,7278,14555
11468,,sn85bo7f7xmj,7278,7279,14557
11469,,4qqgbxltlxuj,7279,7280,14559
11470,,doknwvludoej,7280,7281,14561
11471,,gdq8627jb-wj,7281,7282,14563
11472,,1cslisfvgqsj,7282,7283,14565
11473,,of7di1wikuij,7283,7284,14567
11474,,url:http://doi.wiley.com/10.1002/tl.144,7285,7286,14571
11475,,_b_yqxbdyxcj,7286,7287,14573
11476,,url:http://adsabs.harvard.edu/abs/1976infph..16..237d,7287,7288,14575
11477,,itxnns-2qeej,7288,7289,14577
11478,,verq_orrp1kj,7289,7290,14579
11479,,2cbb8em2uaij,7290,7291,14581
11480,,arnld69qrbej,7291,7292,14583
11481,,x9xp-7kyj1qj,7292,7293,14585
11482,,2nnhbut91luj,7293,7294,14587
11483,,0yqhcm6yb9ij,7294,7295,14589
11484,,bs3eschiil0j,7295,7296,14591
11485,,z57tvuzdhgij,7296,7297,14593
11486,,xgrbxnxqt_mj,7297,7298,14595
11487,,qiwaxo0v_dgj,7298,7299,14597
11488,,gfryqmv9z1sj,7299,7300,14599
11489,,url:http://www.springerlink.com/index/j6976k2228661k7x.pdf,7300,7301,14601
11490,,dgo_p28pzrij,7301,7302,14603
11491,,ogvorjjq1z8j,7302,7303,14605
11492,,99kgtpcr85uj,7303,7304,14607
11493,,osrznypu-fij,7304,7305,14609
11494,,5jobt_1scwcj,7305,7306,14611
11495,,smetgarudfwj,7306,7307,14613
11496,,cccgnd3bog0j,7307,7308,14615
11497,,mno-kp-rxfyj,7308,7309,14617
11498,,dcepshgn-agj,7309,7310,14619
11499,,pnxoq6xcgjoj,7310,7311,14621
11500,,9wgg43ukfm0j,7311,7312,14623
11501,,2i3yoq5cde4j,7312,7313,14625
11502,,lnbbaav9qdaj,7313,7314,14627
11503,,n4hxwoa9n9gj,7314,7315,14629
11504,,hwhfj1hofdcj,7315,7316,14631
11505,,w9pyi6w_tw4j,7316,7317,14633
11506,,x2w83qp7xuaj,7317,7318,14635
11507,,irsbyaamb6ij,7318,7319,14637
11508,,sywnhwcoj5gj,7319,7320,14639
11509,,bjgdpdvf91qj,7320,7321,14641
11510,,hy_y6ytoir8j,7321,7322,14643
11511,,wijw7do2r84j,7322,7323,14645
11512,,zjo38eq5rtcj,7323,7324,14647
11513,,3ehannr9yl0j,7324,7325,14649
11514,,twe5in7utamj,7325,7326,14651
11515,,bfbdo0uqqzmj,7326,7327,14653
11516,,mtah2sheznej,7327,7328,14655
11517,,qhqb_yx3qeqj,7328,7329,14657
11518,,lyps1pozk-cj,7329,7330,14659
11519,,rwdwkp5tdguj,7330,7331,14661
11520,,24awxyijgtij,7331,7332,14663
11521,,r6zr-ju-7uyj,7332,7333,14665
11522,,oisvfyfu_1aj,7333,7334,14667
11523,,d0vpvcfqyfsj,7334,7335,14669
11524,,v8xtzdo3lnej,7335,7336,14671
11525,,rgfhb3ue5myj,7336,7337,14673
11526,,ygzskyiibuij,7337,7338,14675
11527,,,7339,7340,14679
11528,,zfidpsqozroj,7340,7341,14681
11529,,xa435qkjzhcj,7341,7342,14683
11530,,xipz2ii5liij,7342,7343,14685
11531,,1c0at4ot_cyj,7343,7344,14687
11532,,uvxhdaycr5oj,7344,7345,14689
11533,,tucbizgt5guj,7345,7346,14691
11534,,afkatzrpg4mj,7347,7348,14695
11535,,xa9sgbtvgrej,7348,7349,14697
11536,,pk8qs1qbqsqj,7349,7350,14699
11537,,url:http://www.springerlink.com/index/g4rp741u4681h355.pdf,7350,7351,14701
11538,,jsvlm2yub68j,7351,7352,14703
11539,,dkxog8pvjoqj,7352,7353,14705
11540,,yajiovapbcej,7353,7354,14707
11541,,glix-w_su7mj,7354,7355,14709
11542,,kk-2kwh4hs0j,7355,7356,14711
11543,,cl_okiqdvmqj,7356,7357,14713
11544,,rpdt6619xhoj,7357,7358,14715
11545,,v8ws93c1fvkj,7358,7359,14717
11546,,ahcgskc7gz0j,7359,7360,14719
11547,,url:http://www.geography.org.uk/journals/journals.asp3farticleid3d15,7360,7361,14721
11548,,f3kpxjokg7uj,7361,7362,14723
11549,,i8smc7zdqa4j,7362,7363,14725
11550,,tfpybefxeuej,7363,7364,14727
11551,,robzsxxm0h0j,7364,7365,14729
11552,,fzgeoxmzciaj,7365,7366,14731
11553,,mdbovmdncmqj,7366,7367,14733
11554,,79qpjdwwxzaj,7367,7368,14735
11555,,gi60qi_2lnoj,7369,7370,14739
11556,,amif36duhhuj,7370,7371,14741
11557,,pmsenhc2xgij,7371,7372,14743
11558,,c-hz6btw11gj,7372,7373,14745
11559,,orrsouwbjc0j,7373,7374,14747
11560,,w8mji0lvivmj,7374,7375,14749
11561,,smn0zspjmp8j,7375,7376,14751
11562,,nknpemexlikj,7376,7377,14753
11563,,g91qmuhpg6qj,7377,7378,14755
11564,,wbkjyfpn4o0j,7378,7379,14757
11565,,0zevageeuooj,7380,7381,14761
11566,,url:http://doi.wiley.com/10.1002/tl.167,7381,7382,14763
11567,,-6j9mgimqdsj,7382,7383,14765
11568,,url:http://portal.acm.org/ft_gateway.cfm3fid3d29857826type3dpdf26dl3dguide26dl3dacm26cfid3d1111111126cftoken3d2222222,7383,7384,14767
11569,,t1o_5lgt5aij,7384,7385,14769
11570,,s7hvpqcjcuaj,7385,7386,14771
11571,,cmyz-bue0qmj,7386,7387,14773
11572,,2ioi-weyqtmj,7387,7388,14775
11573,,nlphtsbflkuj,7388,7389,14777
11574,,8fyi8g1x6gqj,7389,7390,14779
11575,,bi10luv9qfej,7390,7391,14781
11576,,3xxwcm-02wsj,7391,7392,14783
11577,,ngdf4fzmhsmj,7392,7393,14785
11578,,643dxyh282mj,7393,7394,14787
11579,,vgdumz6nl1yj,7394,7395,14789
11580,,ayrs4dvtb3sj,7395,7396,14791
11581,,bxplbcg_u6sj,7396,7397,14793
11582,,zecietpeh-8j,7397,7398,14795
11583,,3twt3ebssnyj,7398,7399,14797
11584,,ykltwjeasggj,7399,7400,14799
11585,,ygsrw5sdkqmj,7400,7401,14801
11586,,mcu3zhcpfcsj,7401,7402,14803
11587,,bohgjqdckfwj,7402,7403,14805
11588,,fqewxoszigmj,7403,7404,14807
11589,,djdfjcicpz4j,7404,7405,14809
11590,,ec7n9-jmic0j,7405,7406,14811
11591,,cpp2exk4idcj,7407,7408,14815
11592,,uic26ha23ocj,7408,7409,14817
11593,,tjktv24m7puj,7409,7410,14819
11594,,fzg-34xffvwj,7410,7411,14821
11595,,url:http://portal.acm.org/citation.cfm3fid3d1099554.1099560,7411,7412,14823
11596,,dhb2wl1y38sj,7412,7413,14825
11597,,ygcf7_ur53cj,7413,7414,14827
11598,,qrkvhgn2phaj,7414,7415,14829
11599,,jek7vhkdp-yj,7415,7416,14831
11600,,bsbfiafs0raj,7416,7417,14833
11601,,7zkm8rw7r1qj,7417,7418,14835
11602,,jn1q2tnlqi8j,7418,7419,14837
11603,,69wxm4qe00qj,7419,7420,14839
11604,,npznlb8z-fgj,7420,7421,14841
11605,,vbblq9n7gfcj,7421,7422,14843
11606,,ou237wotpwsj,7422,7423,14845
11607,,i5vsmfdbqx4j,7423,7424,14847
11608,,3xjdsyikpykj,7424,7425,14849
11609,,3-dufgjjqw8j,7425,7426,14851
11610,,dh7nxin6nouj,7426,7427,14853
11611,,__iwukpozf8j,7427,7428,14855
11612,,qburda9xa_4j,7428,7429,14857
11613,,url:http://doi.wiley.com/10.1002/ev.1621,7429,7430,14859
11614,,8fzyshelcmaj,7430,7431,14861
11615,,90-8_bcwhfyj,7431,7432,14863
11616,,vp-xz0is0aqj,7432,7433,14865
11617,,jvizo8xvvl8j,7433,7434,14867
11618,,qx-wgc5w3nej,7434,7435,14869
11619,,vzp7iw23xc0j,7435,7436,14871
11620,,4astu4moryaj,7436,7437,14873
11621,,lvfepzverdij,7437,7438,14875
11622,,hlx50eotzduj,7438,7439,14877
11623,,a4acsd7xsrcj,7439,7440,14879
11624,,cmiqdz0opnkj,7440,7441,14881
11625,,url:http://portal.acm.org/ft_gateway.cfm3fid3d27637326type3dpdf26dl3dguide26dl3dacm26cfid3d1111111126cftoken3d2222222,7441,7442,14883
11626,,hf5fbng_tfgj,7442,7443,14885
11627,,t8goisnmyvaj,7443,7444,14887
11628,,vsm6-6hwi98j,7444,7445,14889
11629,,mghuu5wim3gj,7445,7446,14891
11630,,rgwmaixop2aj,7446,7447,14893
11631,,gry7xxkyqwij,7447,7448,14895
11632,,176z1jfhdtwj,7448,7449,14897
11633,,cyq_63r5qwgj,7449,7450,14899
11634,,hmaktjpzn6qj,7450,7451,14901
11635,,b9fdxseg21kj,7451,7452,14903
11636,,tfrjmweteuuj,7452,7453,14905
11637,,qily1knwjikj,7453,7454,14907
11638,,rct0zenwsrij,7454,7455,14909
11639,,lomznf7u6w8j,7455,7456,14911
11640,,osafpjobocaj,7456,7457,14913
11641,,itxtsfqwsc8j,7457,7458,14915
11642,,531xkrrvqi8j,7458,7459,14917
11643,,drjsn10qk9wj,7459,7460,14919
11644,,r4rfobbjyswj,7460,7461,14921
11645,,v8cubcbba8mj,7461,7462,14923
11646,,c-jgbheo-hoj,7462,7463,14925
11647,,n-wleb3dv1yj,7463,7464,14927
11648,,ixc6w6v45dyj,7464,7465,14929
11649,,yxhhjn1tygwj,7465,7466,14931
11650,,1dxrvsqqbwgj,7466,7467,14933
11651,,h772ijdpnqgj,7467,7468,14935
11652,,ccsyv2e8zrgj,7468,7469,14937
11653,,h4hmfowjkdcj,7469,7470,14939
11654,,1ek8vkp4rs0j,7470,7471,14941
11655,,h1u3lwdhjngj,7471,7472,14943
11656,,r4adn1ykofij,7472,7473,14945
11657,,nxt3j4xazxij,7473,7474,14947
11658,,9xa4aqahmicj,7474,7475,14949
11659,,ogz8i78zwlkj,7475,7476,14951
11660,,pcwzsibevk4j,7476,7477,14953
11661,,6z2i6p07dw4j,7477,7478,14955
11662,,1rggzf_o4w8j,7478,7479,14957
11663,,0w3pyu3r-d8j,7479,7480,14959
11664,,ifzdfkma09uj,7480,7481,14961
11665,,m3vnjok-h_qj,7481,7482,14963
11666,,mi_o7dgaeswj,7482,7483,14965
11667,,cnu3m_rb7zyj,7483,7484,14967
11668,,3ic-uc91r2ej,7484,7485,14969
11669,,qompfdkg6dsj,7485,7486,14971
11670,,etqbo4eccnij,7486,7487,14973
11671,,vc4sg93p9tej,7487,7488,14975
11672,,7n_mdzqio4wj,7488,7489,14977
11673,,qoecrjalwxyj,7489,7490,14979
11674,,wnwpjh0a0twj,7490,7491,14981
11675,,dn5n-xwurs4j,7491,7492,14983
11676,,sy4xv_itk20j,7492,7493,14985
11677,,url:http://www.springerlink.com/index/w851853q07553665.pdf,7493,7494,14987
11678,,qmhf50z6f0sj,7495,7496,14991
11679,,q6nbk6ugu5qj,7496,7497,14993
11680,,l68pzitjqgqj,7497,7498,14995
11681,,0rwbzq05z_uj,7498,7499,14997
11682,,llgiokczsiyj,7499,7500,14999
11683,,axx0zgp_youj,7500,7501,15001
11684,,setnywm81ymj,7501,7502,15003
11685,,5fjijavdj8ij,7502,7503,15005
11686,,b03nxijhilmj,7504,7505,15009
11687,,wh1lm1nq0p0j,7505,7506,15011
11688,,soin2u4txykj,7506,7507,15013
11689,,url:http://www.springerlink.com/index/n5348030071l6124.pdf,7507,7508,15015
11690,,idy95jbrupwj,7510,7511,15021
11691,,518hebjk7suj,7511,7512,15023
11692,,6s9sjvdaqnqj,7512,7513,15025
11693,,hmx2rw13enmj,7513,7514,15027
11694,,wasuwo9fxrmj,7516,7517,15033
11695,,kxjk9vtgtygj,7517,7518,15035
11696,,_nm5hno35-cj,7518,7519,15037
11697,,em46y0efnl4j,7519,7520,15039
11698,,j9coxekjg40j,7520,7521,15041
11699,,6lk3oqomkowj,7521,7522,15043
11700,,yapqi_4nehyj,7522,7523,15045
11701,,m5a7hkvlrakj,7523,7524,15047
11702,,k1seis2maaej,7524,7525,15049
11703,,pphxnoivdscj,7525,7526,15051
11704,,knjdzxrziuuj,7526,7527,15053
11705,,p2bxzm4qoqij,7527,7528,15055
11706,,ngorya2sciqj,7529,7530,15059
11707,,4j9gbyxxrzij,7530,7531,15061
11708,,klhkca_cfcyj,7531,7532,15063
11709,,l6xiuqrbjmuj,7533,7534,15067
11710,,arlndet_en0j,7534,7535,15069
11711,,dmmjhuzqyqqj,7535,7536,15071
11712,,m7prdh2-0eij,7536,7537,15073
11713,,benpcgvhbwoj,7537,7538,15075
11714,,mx_ok6qexc8j,7538,7539,15077
11715,,xjui2mziv_aj,7539,7540,15079
11716,,uu14ig7u2eaj,7541,7542,15083
11717,,xmjt7tuzrwgj,7542,7543,15085
11718,,umcoofsnvrmj,7543,7544,15087
11719,,xzqz4izumdoj,7544,7545,15089
11720,,kurion7dalcj,7545,7546,15091
11721,,rvamxgfgcr0j,7546,7547,15093
11722,,_dvkdk_hifwj,7547,7548,15095
11723,,oj7dafjgnwgj,7548,7549,15097
11724,,9maygcevjf8j,7549,7550,15099
11725,,2ppzra-tg5wj,7550,7551,15101
11726,,vmhseppfnmmj,7551,7552,15103
11727,,5om2xc9vhyqj,7552,7553,15105
11728,,p9jw2dr8zj8j,7553,7554,15107
11729,,qwxloawtreaj,7555,7556,15111
11730,,1wtthxxqbcwj,7556,7557,15113
11731,,5gz5j_piqhwj,7557,7558,15115
11732,,url:http://www.csa.com/partners/viewrecord.php3frequester3dgs26collection3dtrd26recid3d8402230064md,7558,7559,15117
11733,,_gcfsxsmbryj,7559,7560,15119
11734,,mm7spvx58pgj,7560,7561,15121
11735,,7ne6kriy0mej,7561,7562,15123
11736,,kgz-cbvx_yij,7562,7563,15125
11737,,_lruwnuoyzij,7563,7564,15127
11738,,5guksitbzj8j,7564,7565,15129
11739,,,7565,7566,15131
11740,,dp-ivsnyoaej,7566,7567,15133
11741,,reb8fah5mhgj,7567,7568,15135
11742,,cxetfwujkcwj,7568,7569,15137
11743,,imn9zl7dweyj,7569,7570,15139
11744,,t80pvwybj7oj,7570,7571,15141
11745,,6vahsio_n4kj,7571,7572,15143
11746,,g4jukhc68w4j,7572,7573,15145
11747,,zbqwpi_ipbwj,7573,7574,15147
11748,,nrti2zplvkej,7574,7575,15149
11749,,w6dtoktrv40j,7575,7576,15151
11750,,inzqepkg0w8j,7576,7577,15153
11751,,buppaldsaguj,7577,7578,15155
11752,,xxsqr3gngwaj,7578,7579,15157
11753,,0nenmr5lny0j,7579,7580,15159
11754,,ksmnxmtmviqj,7581,7582,15163
11755,,p3n9f2avcpwj,7582,7583,15165
11756,,dlwjai4b2fej,7583,7584,15167
11757,,fehl9byu3pej,7584,7585,15169
11758,,_ckpzhlir30j,7585,7586,15171
11759,,xs2qabiad00j,7586,7587,15173
11760,,exkk0944rr8j,7587,7588,15175
11761,,lskzzfclccaj,7588,7589,15177
11762,,lp5mrc0oopkj,7589,7590,15179
11763,,sgejdrntbtkj,7590,7591,15181
11764,,ym0uheefyamj,7591,7592,15183
11765,,gza_xoqfbjyj,7592,7593,15185
11766,,h13bbrmare4j,7593,7594,15187
11767,,j8v_08wxfemj,7594,7595,15189
11768,,is4hm1vgvkuj,7595,7596,15191
11769,,fopoj5ext0kj,7596,7597,15193
11770,,iwnhhwnzyeej,7597,7598,15195
11771,,whblzog8bhwj,7598,7599,15197
11772,,ze48jxmp1t4j,7599,7600,15199
11773,,url:http://doi.wiley.com/10.1002/he.10502,7600,7601,15201
11774,,_6cfofg0lpqj,7601,7602,15203
11775,,7vdcwbv6qtcj,7602,7603,15205
11776,,nueeyy3rbksj,7603,7604,15207
11777,,tdqkrrf9ytuj,7604,7605,15209
11778,,bzey3pjfb3kj,7605,7606,15211
11779,,onvdwxedvxcj,7606,7607,15213
11780,,hibcc5hgqpcj,7608,7609,15217
11781,,url:http://portal.acm.org/ft_gateway.cfm3fid3d109965026type3dpdf,7609,7610,15219
11782,,tfo05idxlaaj,7610,7611,15221
11783,,nkrtwhyt1qgj,7611,7612,15223
11784,,bdvgvja033kj,7612,7613,15225
11785,,nahpnb380k4j,7613,7614,15227
11786,,o56oto8wn60j,7614,7615,15229
11787,,url:http://doi.wiley.com/10.1002/ace.98,7615,7616,15231
11788,,l1b5mctntzwj,7616,7617,15233
11789,,gc3vqt0-trwj,7617,7618,15235
11790,,oewb6at_5i8j,7618,7619,15237
11791,,os-8yrumfd0j,7619,7620,15239
11792,,iub1aoahdssj,7620,7621,15241
11793,,url:http://portal.acm.org/citation.cfm3fid3d140979.14100426dl3dguide26dl3dacm26idx3dj68926part3dperiodical26wanttype3dperiodical26title3dacm2520sigmod2520record26cfid3d1111111126cftoken3d2222222,7621,7622,15243
11794,,d4ljsqpfgisj,7622,7623,15245
11795,,xmg7k5-lwtkj,7623,7624,15247
11796,,xc6k0ek288qj,7624,7625,15249
11797,,kppdcqy-jsqj,7625,7626,15251
11798,,y9golmsabfcj,7626,7627,15253
11799,,ara4tdw1oeqj,7627,7628,15255
11800,,21dpmy9ab6oj,7628,7629,15257
11801,,yao0zhjovzuj,7629,7630,15259
11802,,,7630,7631,15261
11803,,cbak7eusyryj,7631,7632,15263
11804,,i0kfdt6sh0gj,7632,7633,15265
11805,,gi7kodse188j,7633,7634,15267
11806,,pw15rwkn8ykj,7634,7635,15269
11807,,lxtk4ms5hpwj,7635,7636,15271
11808,,_b_2qgp6agij,7636,7637,15273
11809,,drxwlqfcaqgj,7637,7638,15275
11810,,cfn_lwksj4wj,7638,7639,15277
11811,,oo-b4qhd-vcj,7639,7640,15279
11812,,oybgbjivllej,7640,7641,15281
11813,,qldlkp-csskj,7641,7642,15283
11814,,svujl3_mj0gj,7642,7643,15285
11815,,url:http://portal.acm.org/ft_gateway.cfm3fid3d100771726type3dpdf,7643,7644,15287
11816,,whfvyibq4huj,7644,7645,15289
11817,,v9pmorgbkfgj,7645,7646,15291
11818,,_-mse7jyda0j,7646,7647,15293
11819,,pia9ymnpywwj,7647,7648,15295
11820,,4oim_dzefpoj,7648,7649,15297
11821,,ta3yuporntgj,7649,7650,15299
11822,,wqtdvbtaatkj,7650,7651,15301
11823,,aovbxs42nm4j,7651,7652,15303
11824,,pylkcztk3jej,7652,7653,15305
11825,,um4oovvc4j4j,7653,7654,15307
11826,,ztfdksj7ff4j,7654,7655,15309
11827,,otokt3t9kuqj,7655,7656,15311
11828,,pfvs4r7e5nuj,7656,7657,15313
11829,,lctwzvrmtnoj,7657,7658,15315
11830,,lvpbm_ux00uj,7658,7659,15317
11831,,m94nzxwo5kwj,7659,7660,15319
11832,,seij0fxg01ej,7660,7661,15321
11833,,ck2l_97r_mij,7661,7662,15323
11834,,dgt5twr87xoj,7662,7663,15325
11835,,cdfehhov7zgj,7663,7664,15327
11836,,kpise5-lrjoj,7664,7665,15329
11837,,ls62cc9hxvoj,7665,7666,15331
11838,,fgnqtxgdsnwj,7666,7667,15333
11839,,k1sd0kry3moj,7667,7668,15335
11840,,oawpxev65bsj,7668,7669,15337
11841,,vhnkurejniuj,7669,7670,15339
11842,,im5fj7frhdsj,7670,7671,15341
11843,,url:http://portal.acm.org/citation.cfm3fid3d192661,7671,7672,15343
11844,,8oo0d5ixj7cj,7672,7673,15345
11845,,aotbvyfuuaej,7673,7674,15347
11846,,nnt3dppgvfuj,7674,7675,15349
11847,,gyb_bpazrgkj,7675,7676,15351
11848,,az_wa1secfqj,7676,7677,15353
11849,,zxfs1dptnpwj,7677,7678,15355
11850,,84v-fqvkswoj,7679,7680,15359
11851,,url:http://www.csa.com/partners/viewrecord.php3frequester3dgs26collection3dtrd26recid3dn9210386ah,7680,7681,15361
11852,,btvydhyesbcj,7681,7682,15363
11853,,xpmcwadeogaj,7682,7683,15365
11854,,awhlwnn4yfaj,7683,7684,15367
11855,,omdaodlupwuj,7684,7685,15369
11856,,zbsafhfjq68j,7685,7686,15371
11857,,unb5fbv-e94j,7686,7687,15373
11858,,3zglbgrfxk8j,7687,7688,15375
11859,,url:http://portal.acm.org/ft_gateway.cfm3fid3d110138326type3dpdf,7688,7689,15377
11860,,vqsjslk8ekcj,7689,7690,15379
11861,,6hcynjojsk4j,7690,7691,15381
11862,,mfmgos_dgx0j,7691,7692,15383
11863,,7jet-szaguyj,7692,7693,15385
11864,,pspgeygmgmcj,7693,7694,15387
11865,,url:http://portal.acm.org/ft_gateway.cfm3fid3d102762026type3dpdf,7694,7695,15389
11866,,1u1ec3wp3ucj,7695,7696,15391
11867,,vqclcspmg3ij,7696,7697,15393
11868,,xsjx-pfplbcj,7697,7698,15395
11869,,k2wxepzemn8j,7698,7699,15397
11870,,rsdafs7jd9uj,7699,7700,15399
11871,,vgi1l8lbdcsj,7700,7701,15401
11872,,_b2jjhe64nqj,7701,7702,15403
11873,,ezcaryckpb8j,7702,7703,15405
11874,,7e_ewulfgusj,7703,7704,15407
11875,,km9qoobigbuj,7704,7705,15409
11876,,rqnd1sfwxcmj,7705,7706,15411
11877,,bjmr2fbrfgwj,7706,7707,15413
11878,,zpwsyra8nrwj,7707,7708,15415
11879,,yfb8p_tlslsj,7708,7709,15417
11880,,_d_doloxn3qj,7710,7711,15421
11881,,xmq9oyydim8j,7711,7712,15423
11882,,1qth8vq3y6mj,7712,7713,15425
11883,,iqovjupzj3sj,7713,7714,15427
11884,,r0nr9e85s0uj,7714,7715,15429
11885,,vz8mobuaqi8j,7715,7716,15431
11886,,c8f5ahzxmh4j,7716,7717,15433
11887,,qmbwue3rbuij,7717,7718,15435
11888,,9-xgd435yuwj,7718,7719,15437
11889,,x-cu6qkayk0j,7719,7720,15439
11890,,9rz6gjxcug0j,7720,7721,15441
11891,,nzzrc7ick9wj,7721,7722,15443
11892,,69zwmfli9duj,7722,7723,15445
11893,,aqdfzfdt7guj,7723,7724,15447
11894,,c0bxqsqgnf4j,7724,7725,15449
11895,,atviboxrl2yj,7725,7726,15451
11896,,e7aeauyll9cj,7726,7727,15453
11897,,ihtpzpczjtqj,7727,7728,15455
11898,,khy3xslzrcij,7728,7729,15457
11899,,ipjsi_qfnn4j,7729,7730,15459
11900,,fnd0dn0_ivij,7730,7731,15461
11901,,cj-i_jrzokgj,7731,7732,15463
11902,,6vsifepwgnaj,7732,7733,15465
11903,,6kcbo4jvtzyj,7733,7734,15467
11904,,f7zkdh6q4qkj,7734,7735,15469
11905,,q4vfbwmer80j,7735,7736,15471
11906,,8s2dpkubro0j,7736,7737,15473
11907,,tmnj5ujywecj,7737,7738,15475
11908,,r9fu5v29hkej,7738,7739,15477
11909,,1_m6q4mu8a8j,7739,7740,15479
11910,,wlufqib8ycgj,7740,7741,15481
11911,,tuk4q9mltxuj,7741,7742,15483
11912,,pz_eje7fgskj,7742,7743,15485
11913,,xyjddpabobwj,7743,7744,15487
11914,,,7744,7745,15489
11915,,url:http://portal.acm.org/citation.cfm3fid3d1083592.1083700,7745,7746,15491
11916,,dtgmkus0jl4j,7746,7747,15493
11917,,w1erboyhwh0j,7747,7748,15495
11918,,pzsm5hq7yncj,7748,7749,15497
11919,,s5w5f5leueij,7749,7750,15499
11920,,url:http://www.csa.com/partners/viewrecord.php3frequester3dgs26collection3dtrd26recid3d9004720189md26recid3d9003g2c0100ec,7750,7751,15501
11921,,g1h3u99lreqj,7751,7752,15503
11922,,zrzwh7_az94j,7752,7753,15505
11923,,cc6bpi4s6csj,7753,7754,15507
11924,,rwfrmgcqujkj,7754,7755,15509
11925,,q1ys9oofufyj,7755,7756,15511
11926,,ukbava4a7fgj,7756,7757,15513
11927,,pavzkapeisuj,7757,7758,15515
11928,,wabriyy6wzcj,7758,7759,15517
11929,,f-otttaek6yj,7759,7760,15519
11930,,vpydoxyyncuj,7760,7761,15521
11931,,2z_x3zsf4coj,7761,7762,15523
11932,,agps1rjfgacj,7762,7763,15525
11933,,rifbyssokwuj,7763,7764,15527
11934,,saya98xx7_mj,7764,7765,15529
11935,,rh_k0d4e3ryj,7765,7766,15531
11936,,2ye9wfnwjk8j,7766,7767,15533
11937,,0j-tbkstmaij,7767,7768,15535
11938,,ok5fy0pklskj,7768,7769,15537
11939,,lf6je5hj_psj,7769,7770,15539
11940,,2-dtjcnw0j8j,7770,7771,15541
11941,,5sjs94w5n-gj,7771,7772,15543
11942,,4tlingz47ssj,7772,7773,15545
11943,,4cq5y-7dtx4j,7773,7774,15547
11944,,cw3acguzwemj,7774,7775,15549
11945,,2vclsoe0svoj,7775,7776,15551
11946,,fus7ng_7upej,7776,7777,15553
11947,,fk5gehww7uqj,7777,7778,15555
11948,,mrei41j4cosj,7778,7779,15557
11949,,gowexrbjfeqj,7779,7780,15559
11950,,xscebfi1ueij,7780,7781,15561
11951,,jpoj63xnffsj,7781,7782,15563
11952,,7oixakwtc1gj,7782,7783,15565
11953,,d_dskgkfb-kj,7783,7784,15567
11954,,_m7mepmilbej,7784,7785,15569
11955,,a9vb6jjtwrwj,7785,7786,15571
11956,,hag0kcjbu4ej,7786,7787,15573
11957,,sp3bzmqhmzsj,7787,7788,15575
11958,,q6dfuy71y8sj,7788,7789,15577
11959,,zkxkpstkk-sj,7789,7790,15579
11960,,6uiiv2eiejaj,7790,7791,15581
11961,,x2xgntyuibkj,7791,7792,15583
11962,,rgdxch7-ihaj,7792,7793,15585
11963,,,7793,7794,15587
11964,,gqf4m5y0h8mj,7794,7795,15589
11965,,xajwhleiewsj,7795,7796,15591
11966,,url:http://www.csa.com/partners/viewrecord.php3frequester3dgs26collection3dtrd26recid3d0174539ci,7796,7797,15593
11967,,ryw2luqd_rcj,7797,7798,15595
11968,,,7798,7799,15597
11969,,c9qujswhxa0j,7800,7801,15601
11970,,xykobo7cl_0j,7801,7802,15603
11971,,47fe4f2kahej,7802,7803,15605
11972,,qnihtms_dbgj,7803,7804,15607
11973,,3mplacmtut0j,7804,7805,15609
11974,,yhwgcljt-k0j,7805,7806,15611
11975,,abkhfjhh0pgj,7806,7807,15613
11976,,o59vdyebknej,7807,7808,15615
11977,,khibjaxgndaj,7808,7809,15617
11978,,5zawjcffwgej,7809,7810,15619
11979,,0sdzdfyv7hmj,7810,7811,15621
11980,,r9hb_o1-qrcj,7811,7812,15623
11981,,m6-9ei57qgwj,7812,7813,15625
11982,,c80ke2xzrlmj,7813,7814,15627
11983,,ukzxbnzrpryj,7814,7815,15629
11984,,l_2wswqm3rcj,7815,7816,15631
11985,,j-imoax9wtaj,7816,7817,15633
11986,,url:http://portal.acm.org/ft_gateway.cfm3fid3d106624226type3dpdf,7817,7818,15635
11987,,9lyafs7fntyj,7818,7819,15637
11988,,url:http://portal.acm.org/citation.cfm3fid3d876899.881166,7819,7820,15639
11989,,svimuerl-e4j,7820,7821,15641
11990,,th6sazvlblsj,7821,7822,15643
11991,,y1-guestbzgj,7823,7824,15647
11992,,u3ab_mkcbsej,7824,7825,15649
11993,,qqkiokqqsuej,7825,7826,15651
11994,,url:http://portal.acm.org/citation.cfm3fid3d234286.1057825,7826,7827,15653
11995,,eiqikmpmrwsj,7827,7828,15655
11996,,_fvd537bn30j,7828,7829,15657
11997,,url:http://www.csa.com/partners/viewrecord.php3frequester3dgs26collection3dtrd26recid3dn9210556ah,7829,7830,15659
11998,,ydcgpdhctcij,7830,7831,15661
11999,,tjdxzk45ds8j,7831,7832,15663
12000,,9i9huprjnegj,7832,7833,15665
12001,,3neczeyi6lej,7833,7834,15667
12002,,1ttqfbxec9gj,7834,7835,15669
12003,,-62xmgdnpiwj,7835,7836,15671
12004,,c1-izbae_egj,7836,7837,15673
12005,,lxjcalx_kbej,7837,7838,15675
12006,,vhgwbn1z-m8j,7838,7839,15677
12007,,vje6o5lxxtsj,7839,7840,15679
12008,,koa8vjumkhcj,7840,7841,15681
12009,,l-dmcosgjmgj,7841,7842,15683
12010,,gq51v3spaboj,7842,7843,15685
12011,,url:http://portal.acm.org/citation.cfm3fid3d237661.23771726dl3dacm26dl3dacm26type3dseries26idx3d23766126part3dproceedings26wanttype3dproceedings26title3dsymposium2520on2520principles2520of2520database2520systems26cfid3d1111111126cftoken3d2222222,7843,7844,15687
12012,,h21e4g1ffboj,7844,7845,15689
12013,,3c78pbpjidij,7845,7846,15691
12014,,ww30sub3o9cj,7846,7847,15693
12015,,meulvqhen-ej,7847,7848,15695
12016,,ypvuxnpjoauj,7848,7849,15697
12017,,yz6h9gqldj4j,7849,7850,15699
12018,,igwgfxqreeaj,7850,7851,15701
12019,,url:http://www.csa.com/partners/viewrecord.php3frequester3dgs26collection3dtrd26recid3dn9210413ah,7851,7852,15703
12020,,url:http://portal.acm.org/ft_gateway.cfm3fid3d110129526type3dpdf,7852,7853,15705
12021,,rrf9_iwjq38j,7853,7854,15707
12022,,aknxf2wpwsmj,7854,7855,15709
12023,,ycr9gkkhq4ej,7855,7856,15711
12024,,9ybzwon4mwej,7856,7857,15713
12025,,rhy4ox1-rsoj,7857,7858,15715
12026,,ovypjyj6sruj,7858,7859,15717
12027,,,7859,7860,15719
12028,,gsdzo2xdtmsj,7860,7861,15721
12029,,jtqysrdz8lcj,7861,7862,15723
12030,,38hofglnxkqj,7862,7863,15725
12031,,hgx8tngsjc4j,7863,7864,15727
12032,,h1zpiddnnxej,7864,7865,15729
12033,,eqhdlzustukj,7865,7866,15731
12034,,_d2cerxucnyj,7866,7867,15733
12035,,url:http://www.csa.com/partners/viewrecord.php3frequester3dgs26collection3dtrd26recid3d200111010712mt26recid3da0032647ah,7867,7868,15735
12036,,y9c-vbkttosj,7868,7869,15737
12037,,nddurqrth3wj,7869,7870,15739
12038,,9mhqirgubbcj,7870,7871,15741
12039,,o1wtdagnrluj,7871,7872,15743
12040,,vz-9rn7tc6wj,7872,7873,15745
12041,,hobnzqkrlk4j,7873,7874,15747
12042,,g5gdiur42rkj,7874,7875,15749
12043,,szyos5gwn0uj,7875,7876,15751
12044,,4jnzbkqmdqej,7876,7877,15753
12045,,mvgzkdofm_gj,7877,7878,15755
12046,,cpgwszsi3jcj,7878,7879,15757
12047,,q1axzlsd7_qj,7879,7880,15759
12048,,xs0fv3ajl0yj,7880,7881,15761
12049,,uj_sbyejhhij,7881,7882,15763
12050,,8hmetf_9e-mj,7882,7883,15765
12051,,fd0jplswfwcj,7883,7884,15767
12052,,eb6xi8_wg3qj,7884,7885,15769
12053,,ruxefcqyrigj,7886,7887,15773
12054,,mb78vc7skzmj,7887,7888,15775
12055,,psnervm9z_oj,7888,7889,15777
12056,,pceljkjplpwj,7889,7890,15779
12057,,url:http://www.csa.com/partners/viewrecord.php3frequester3dgs26collection3dtrd26recid3dn9210483ah,7890,7891,15781
12058,,pz4edrw_nusj,7891,7892,15783
12059,,2fnefjycl5kj,7892,7893,15785
12060,,mlvmwjbj5n4j,7893,7894,15787
12061,,b2gprem66q4j,7894,7895,15789
12062,,f0t2bbwz4ngj,7896,7897,15793
12063,,verqhxhk51yj,7897,7898,15795
12064,,dwuriinr7xij,7898,7899,15797
12065,,jhghn_z6n3wj,7899,7900,15799
12066,,hgypqwyceccj,7900,7901,15801
12067,,r3dos_sq1ywj,7901,7902,15803
12068,,quevvsuntmuj,7902,7903,15805
12069,,r3zwgepzye8j,7903,7904,15807
12070,,krn93o7yhfaj,7904,7905,15809
12071,,h1i1bbg7geej,7905,7906,15811
12072,,5m3-dqb7x-cj,7906,7907,15813
12073,,css1wowaw7kj,7907,7908,15815
12074,,batot0ovo_mj,7908,7909,15817
12075,,rrsd0hufys8j,7909,7910,15819
12076,,6csg8bech-cj,7910,7911,15821
12077,,uokifbpg5rij,7911,7912,15823
12078,,4vnsc5sdfhgj,7912,7913,15825
12079,,hqfolqjnmbuj,7914,7915,15829
12080,,qqckzla0ogcj,7915,7916,15831
12081,,39qjda79x3ej,7916,7917,15833
12082,,nx3znlum03sj,7917,7918,15835
12083,,a_qfc_3oju8j,7918,7919,15837
12084,,haazcc7-vqaj,7919,7920,15839
12085,,uuffol5hhxej,7920,7921,15841
12086,,v3gruh2otymj,7921,7922,15843
12087,,2vmppjvsydoj,7922,7923,15845
12088,,iudgysm8lcgj,7924,7925,15849
12089,,akearwprimoj,7925,7926,15851
12090,,akqo2yntrcgj,7926,7927,15853
12091,,hha4zr7yth8j,7927,7928,15855
12092,,gg_hzk5zpw0j,7928,7929,15857
12093,,vgbpndsne8gj,7930,7931,15861
12094,,zeczzakxn08j,7931,7932,15863
12095,,mhvmakow8hwj,7932,7933,15865
12096,,v2-yosgm3pej,7933,7934,15867
12097,,gsphsdc9rqwj,7934,7935,15869
12098,,typargtwnhaj,7935,7936,15871
12099,,,7936,7937,15873
12100,,jyyr0xph56gj,7937,7938,15875
12101,,tgmiojoqof0j,7938,7939,15877
12102,,tau_jshkx2qj,7939,7940,15879
12103,,0hg-cf_tadsj,7940,7941,15881
12104,,url:http://www.csa.com/partners/viewrecord.php3frequester3dgs26collection3dtrd26recid3dn9210381ah,7941,7942,15883
12105,,gzok_pjlowqj,7942,7943,15885
12106,,vlo-u9ucuwqj,7943,7944,15887
12107,,wxn2y1aepiyj,7944,7945,15889
12108,,kymsgbjuszyj,7945,7946,15891
12109,,5rzwg1vwe2gj,7946,7947,15893
12110,,hqdtmicwjgoj,7947,7948,15895
12111,,qmeutrf-qgkj,7948,7949,15897
12112,,z67ejvsdnhsj,7949,7950,15899
12113,,t6iq-tsnbnaj,7950,7951,15901
12114,,nwq_9t9vxxgj,7951,7952,15903
12115,,9lxclb2--dgj,7952,7953,15905
12116,,6j2qmegtdzmj,7953,7954,15907
12117,,zyy-gih72eej,7954,7955,15909
12118,,gomaqu-zltij,7955,7956,15911
12119,,qhe3xvp3m2kj,7956,7957,15913
12120,,_ssomcze9r4j,7957,7958,15915
12121,,cuz05qpqcmwj,7958,7959,15917
12122,,3ddfhobrlskj,7959,7960,15919
12123,,_pjpnutftyyj,7960,7961,15921
12124,,eqmk38o-cywj,7961,7962,15923
12125,,fij8uyhi510j,7962,7963,15925
12126,,eam9jihzpn4j,7963,7964,15927
12127,,cv8m0jvnb4mj,7964,7965,15929
12128,,nqhra_pronsj,7965,7966,15931
12129,,wokfufi3hjij,7966,7967,15933
12130,,l1stekrrolaj,7967,7968,15935
12131,,zkp2qy8ir1uj,7968,7969,15937
12132,,yi-v6yy9issj,7969,7970,15939
12133,,yibp63apppcj,7970,7971,15941
12134,,arqithq-w4gj,7971,7972,15943
12135,,l3fcgqa38kaj,7972,7973,15945
12136,,fk98vla-iwkj,7973,7974,15947
12137,,tqtsssgfhwkj,7974,7975,15949
12138,,cyb_rux3kgsj,7975,7976,15951
12139,,nsppmd4bs38j,7976,7977,15953
12140,,ugisj6_ztyej,7977,7978,15955
12141,,d5jnelmrzqgj,7978,7979,15957
12142,,url:http://www.csa.com/partners/viewrecord.php3frequester3dgs26collection3dtrd26recid3d20021214033593mt26recid3da7642820ah,7979,7980,15959
12143,,urie28egmicj,7980,7981,15961
12144,,nrlendsplokj,7981,7982,15963
12145,,url:http://doi.wiley.com/10.1002/he.10703,7982,7983,15965
12146,,z-tbqwihm4aj,7983,7984,15967
12147,,iuon062y_d8j,7984,7985,15969
12148,,kmlruaybcroj,7985,7986,15971
12149,,zxhwzppuot0j,7986,7987,15973
12150,,fzyie4mvn7sj,7987,7988,15975
12151,,8rgxim6ctvoj,7988,7989,15977
12152,,bbhhiwjj6hij,7989,7990,15979
12153,,stfxsvejms4j,7990,7991,15981
12154,,pqm4tzojkwsj,7991,7992,15983
12155,,e3x1gqosmmkj,7992,7993,15985
12156,,bxh6zatuzv8j,7993,7994,15987
12157,,y21ha44xuq4j,7994,7995,15989
12158,,xuhtk-dsk6gj,7996,7997,15993
12159,,ysgadq95dfej,7997,7998,15995
12160,,em0x5x2djcej,7998,7999,15997
12161,,pzmted6sfsaj,7999,8000,15999
12162,,fcuplqixkfqj,8000,8001,16001
12163,,sqmuabydxxoj,8001,8002,16003
12164,,jjym5unl5poj,8002,8003,16005
12165,,ozbuzt5hcyuj,8003,8004,16007
12166,,kfub7md4wkqj,8004,8005,16009
12167,,_7ucbslnnekj,8005,8006,16011
12168,,63uzj6we6mej,8006,8007,16013
12169,,p1qopynhvi8j,8007,8008,16015
12170,,uh0hbnrfp_mj,8008,8009,16017
12171,,tnhdljxmoqcj,8009,8010,16019
12172,,jcyz3rr1keej,8010,8011,16021
12173,,0dtlh02tdvsj,8011,8012,16023
12174,,vj9ouqgnqvkj,8012,8013,16025
12175,,q9dovpds80uj,8013,8014,16027
12176,,oyktpnloy4cj,8014,8015,16029
12177,,_p8w9i4qxx0j,8015,8016,16031
12178,,pmfhejymwhuj,8016,8017,16033
12179,,ib3eofeiuxcj,8017,8018,16035
12180,,lsergoe7zsaj,8018,8019,16037
12181,,1cce-j3lgfkj,8019,8020,16039
12182,,avsgn4m0cjmj,8020,8021,16041
12183,,jpkbkf67hqoj,8021,8022,16043
12184,,hoeekg1e88ej,8022,8023,16045
12185,,j19rgv370uqj,8023,8024,16047
12186,,tzmxhipececj,8024,8025,16049
12187,,ym3ssnyvopuj,8025,8026,16051
12188,,ihdhklknhsej,8026,8027,16053
12189,,bseuzeweok4j,8027,8028,16055
12190,,dtf96lzt1fej,8028,8029,16057
12191,,,8029,8030,16059
12192,,g7cjnsibp10j,8030,8031,16061
12193,,u6ezdzkyqqoj,8031,8032,16063
12194,,zepuvdzvtywj,8032,8033,16065
12195,,wyzwttdzxmcj,8033,8034,16067
12196,,2mwh2i95e3ej,8034,8035,16069
12197,,uncxrzidsjyj,8035,8036,16071
12198,,7jbu48s10u8j,8036,8037,16073
12199,,4f4iig_povyj,8037,8038,16075
12200,,wgd4kjssev8j,8038,8039,16077
12201,,_6buswpeh18j,8039,8040,16079
12202,,r4lhvxryc-8j,8040,8041,16081
12203,,xfjqwvwe4xoj,8041,8042,16083
12204,,paq6cakjnsuj,8042,8043,16085
12205,,pxolqn9qf-uj,8043,8044,16087
12206,,v_0odfswowoj,8044,8045,16089
12207,,gh2zcyaadtwj,8045,8046,16091
12208,,kqh1xulqfwyj,8046,8047,16093
12209,,zslcyp48rwqj,8047,8048,16095
12210,,e8hhy_j2cigj,8048,8049,16097
12211,,ihmtfqmlzayj,8049,8050,16099
12212,,ssyfjed0fc4j,8050,8051,16101
12213,,e7jqwonqypoj,8052,8053,16105
12214,,cui_cp6ll34j,8053,8054,16107
12215,,url:http://doi.wiley.com/10.1002/ev.1346,8054,8055,16109
12216,,z8s4kw1y7lmj,8055,8056,16111
12217,,ewivn6yxt1qj,8056,8057,16113
12218,,ivejbqkiuiyj,8057,8058,16115
12219,,abs-rzaq3k0j,8058,8059,16117
12220,,sen5zvajy7mj,8059,8060,16119
12221,,kfe-pxwds-wj,8060,8061,16121
12222,,qfznrmqwswaj,8061,8062,16123
12223,,wgc7ozypsxqj,8062,8063,16125
12224,,,8063,8064,16127
12225,,0yqhgahv5vcj,8064,8065,16129
12226,,_qcsowjgjm0j,8065,8066,16131
12227,,tzwdkncauzcj,8066,8067,16133
12228,,url:http://www.csa.com/partners/viewrecord.php3frequester3dgs26collection3dtrd26recid3d700128cd,8067,8068,16135
12229,,g4hucnsolesj,8068,8069,16137
12230,,v1khseswqxqj,8069,8070,16139
12231,,i0b8atkjjjmj,8070,8071,16141
12232,,v2k7xcvhthoj,8071,8072,16143
12233,,lomyjfx4fgqj,8072,8073,16145
12234,,nlnyak9nnzej,8073,8074,16147
12235,,pxvxcywef18j,8074,8075,16149
12236,,6r4busuu6ssj,8075,8076,16151
12237,,qedpido4dxqj,8076,8077,16153
12238,,utshgv9-zduj,8077,8078,16155
12239,,hfdhc8g86yqj,8078,8079,16157
12240,,_6vlo1qy_scj,8079,8080,16159
12241,,l4a6otz9z74j,8080,8081,16161
12242,,xyxgppu1aqcj,8081,8082,16163
12243,,t5-rwfjwv-8j,8082,8083,16165
12244,,swmyne-arj8j,8083,8084,16167
12245,,url:http://portal.acm.org/ft_gateway.cfm3fid3d110122726type3dpdf,8084,8085,16169
12246,,cuyd93o5jqqj,8085,8086,16171
12247,,t0am0kzdlk4j,8086,8087,16173
12248,,va8ayx04ecij,8087,8088,16175
12249,,r4fj14rujaaj,8088,8089,16177
12250,,kd108dziojcj,8089,8090,16179
12251,,x1hjopotk9gj,8091,8092,16183
12252,,u5tck2gemf0j,8092,8093,16185
12253,,onoz0-ght_cj,8093,8094,16187
12254,,url:http://portal.acm.org/ft_gateway.cfm3fid3d109965226type3dpdf,8094,8095,16189
12255,,roho-bzlsbuj,8095,8096,16191
12256,,url:http://www.csa.com/partners/viewrecord.php3frequester3dgs26collection3dtrd26recid3da8622956ah,8096,8097,16193
12257,,c5pmlqvrgmsj,8097,8098,16195
12258,,nz1ff-2eujsj,8098,8099,16197
12259,,put-bgmmf38j,8099,8100,16199
12260,,mdprxdlljfcj,8100,8101,16201
12261,,0pais1w1bbmj,8101,8102,16203
12262,,ubmyryeb-70j,8102,8103,16205
12263,,z5p-huaeoxqj,8103,8104,16207
12264,,zue36yrqxvwj,8104,8105,16209
12265,,gejice9npwqj,8105,8106,16211
12266,,607zyhvax-0j,8106,8107,16213
12267,,rnk9owghi0uj,8107,8108,16215
12268,,jp-iije00wmj,8108,8109,16217
12269,,sdwzr9_rwfwj,8109,8110,16219
12270,,rxyxmfnjfu4j,8110,8111,16221
12271,,4qypbq1l07yj,8111,8112,16223
12272,,hnmealibitoj,8113,8114,16227
12273,,hdbtpp6pifuj,8114,8115,16229
12274,,14redmcilykj,8115,8116,16231
12275,,k2nxe9ivvnij,8116,8117,16233
12276,,xtmfhgjjcgmj,8117,8118,16235
12277,,qd73ltvuvpsj,8118,8119,16237
12278,,lm-p9vhs7-uj,8119,8120,16239
12279,,dcwucgbm-sij,8120,8121,16241
12280,,funiqceeo2qj,8121,8122,16243
12281,,lobqgd6apyqj,8122,8123,16245
12282,,0q3igh598qgj,8123,8124,16247
12283,,liryj0mtcm8j,8124,8125,16249
12284,,4bwxy1_hky4j,8125,8126,16251
12285,,gwdbw7hcmnwj,8126,8127,16253
12286,,bjjbcazzpumj,8127,8128,16255
12287,,6d7xgwh1bngj,8128,8129,16257
12288,,k987bsbopvej,8129,8130,16259
12289,,url:http://www.csa.com/partners/viewrecord.php3frequester3dgs26collection3denv26recid3d8913232,8130,8131,16261
12290,,kvg5ri6lxmcj,8131,8132,16263
12291,,9s2apur1vpmj,8132,8133,16265
12292,,7cedwhun1-uj,8133,8134,16267
12293,,grdwwpfa9euj,8134,8135,16269
12294,,4nec6qjxsm0j,8135,8136,16271
12295,,url:http://portal.acm.org/ft_gateway.cfm3fid3d106518226type3dpdf,8136,8137,16273
12296,,vqjjblus6wsj,8138,8139,16277
12297,,srs-qfvykhej,8139,8140,16279
12298,,x057cz_3y_yj,8140,8141,16281
12299,,4p6zo-ord_yj,8141,8142,16283
12300,,wohdnzexjl4j,8142,8143,16285
12301,,ueu3m2dgp1ej,8143,8144,16287
12302,,lopdfkjtu9ij,8144,8145,16289
12303,,yzz3jdixey4j,8145,8146,16291
12304,,cwzbhqah3amj,8147,8148,16295
12305,,ju9e2rdp-eij,8148,8149,16297
12306,,lx5ne9gekjcj,8149,8150,16299
12307,,8zwy0hyhcoij,8150,8151,16301
12308,,0osreccpch8j,8151,8152,16303
12309,,uqohdwr5__sj,8152,8153,16305
12310,,o1mqusvgazuj,8153,8154,16307
12311,,4xcs3fiembsj,8154,8155,16309
12312,,url:http://portal.acm.org/ft_gateway.cfm3fid3d102777326type3dpdf,8155,8156,16311
12313,,vxfw5jyvxmqj,8157,8158,16315
12314,,url:http://www.kluweronline.com/article.asp3fpips3d539476526pdf3d1,8158,8159,16317
12315,,abbul4suyqkj,8159,8160,16319
12316,,mrg0idhr4ryj,8160,8161,16321
12317,,vkmb2d1owumj,8161,8162,16323
12318,,c8hnucefc6gj,8162,8163,16325
12319,,qqr8bqjs1jsj,8163,8164,16327
12320,,wdwvqu1i-vqj,8164,8165,16329
12321,,hntnc7eonlqj,8165,8166,16331
12322,,4feb67pte6cj,8166,8167,16333
12323,,qbdsvwwe7vej,8167,8168,16335
12324,,ottzxp2wusmj,8168,8169,16337
12325,,2_t92z3jjekj,8169,8170,16339
12326,,agkbgzqmsnyj,8170,8171,16341
12327,,url:http://portal.acm.org/citation.cfm3fid3d144111.144153,8171,8172,16343
12328,,xy2latpvguij,8172,8173,16345
12329,,etmvkvbpd4kj,8173,8174,16347
12330,,4j9ur0dyehgj,8174,8175,16349
12331,,ytyds8bpt0wj,8175,8176,16351
12332,,hjl0orijus8j,8176,8177,16353
12333,,kj4v0meryrmj,8177,8178,16355
12334,,vbaom5cs0fwj,8178,8179,16357
12335,,kslgu9ptbcgj,8179,8180,16359
12336,,gv6zgsq1w-4j,8180,8181,16361
12337,,ibw8-qto_6ij,8181,8182,16363
12338,,run7vex8xqaj,8182,8183,16365
12339,,dl5itdkggsqj,8183,8184,16367
12340,,oytmdhvmwpij,8184,8185,16369
12341,,vcsbftdptt0j,8185,8186,16371
12342,,or2q_zkh17gj,8186,8187,16373
12343,,iuxbh94to94j,8187,8188,16375
12344,,ptc_adhrw9cj,8188,8189,16377
12345,,url:http://adsabs.harvard.edu/abs/1991emc..sympr....g,8189,8190,16379
12346,,p_to2cnr1ioj,8190,8191,16381
12347,,hbrybuv1h-ej,8191,8192,16383
12348,,cnio9nt0wcmj,8192,8193,16385
12349,,8pbsmfyawaej,8193,8194,16387
12350,,9eodtkolpwqj,8194,8195,16389
12351,,08eywzffmocj,8195,8196,16391
12352,,bzvlbiyoj_cj,8196,8197,16393
12353,,jbbj1ebpsv8j,8197,8198,16395
12354,,rqrz-cp6uugj,8198,8199,16397
12355,,n5alfdkkvgqj,8199,8200,16399
12356,,cpfvhysvl_aj,8200,8201,16401
12357,,i2k2imy6poqj,8201,8202,16403
12358,,df7vul1yx2ej,8202,8203,16405
12359,,hbshvakmyfmj,8203,8204,16407
12360,,yie13vf7cv0j,8204,8205,16409
12361,,dp-phdz7oawj,8205,8206,16411
12362,,7zr_4t4y0pij,8206,8207,16413
12363,,wq4t1l0h-0qj,8207,8208,16415
12364,,zem_gtrhjwqj,8208,8209,16417
12365,,q7ix_xenzgcj,8209,8210,16419
12366,,34htritltmsj,8210,8211,16421
12367,,ibrtlpuiu50j,8211,8212,16423
12368,,jpafmwtssduj,8212,8213,16425
12369,,3r3u-xksbckj,8213,8214,16427
12370,,czsylhrna5qj,8214,8215,16429
12371,,q7ejaopes4ij,8215,8216,16431
12372,,tk0htc7qemcj,8216,8217,16433
12373,,sfkxyqjxvgkj,8217,8218,16435
12374,,ysmp00luo6cj,8218,8219,16437
12375,,zcpnxl-ra1qj,8219,8220,16439
12376,,url:http://portal.acm.org/citation.cfm3fid3d154766.15538326dl3dguide26dl3dguide26type3dseries26idx3d15476626part3dproceedings26wanttype3dproceedings26title3dhistory2520of2520programming2520languages26cfid3d1111111126cftoken3d2222222,8220,8221,16441
12377,,b5yaavtjdjgj,8221,8222,16443
12378,,xws9q_vrl-sj,8222,8223,16445
12379,,9rjfh2wok_ij,8223,8224,16447
12380,,svzpsoufduaj,8224,8225,16449
12381,,oacvy7cjtqmj,8225,8226,16451
12382,,euyctsrc-z8j,8226,8227,16453
12383,,0hcagwtfbckj,8227,8228,16455
12384,,ni2bg_4gzcgj,8228,8229,16457
12385,,qpadzinacvyj,8229,8230,16459
12386,,ytgjf0rpgu0j,8230,8231,16461
12387,,,8231,8232,16463
12388,,kut8-6im3yaj,8232,8233,16465
12389,,mrfbkq6_rkkj,8233,8234,16467
12390,,l2pg4zebveij,8235,8236,16471
12391,,url:http://www.ingentaconnect.com/content/els/09505849/2002/00000044/00000004/art00014,8237,8238,16475
12392,,s4xa9ebpvc0j,8238,8239,16477
12393,,g_vp4_g7jaej,8239,8240,16479
12394,,6ldd1bsqedyj,8240,8241,16481
12395,,url:http://www.springerlink.com/index/q022502x785n5088.pdf,8241,8242,16483
12396,,rnxzehyilvoj,8242,8243,16485
12397,,u7yilraxjrcj,8243,8244,16487
12398,,jkxl-ovuezwj,8245,8246,16491
12399,,zqry0tbgk_sj,8246,8247,16493
12400,,lv8ovpkxk-sj,8247,8248,16495
12401,,_zqem0i4mooj,8248,8249,16497
12402,,-2fixked5l4j,8249,8250,16499
12403,,2frxclml8zcj,8250,8251,16501
12404,,flbfge9zwnoj,8251,8252,16503
12405,,lxrs1u4nqngj,8252,8253,16505
12406,,jnu-j6vn9cij,8253,8254,16507
12407,,jvaeoly2go8j,8254,8255,16509
12408,,z6ep1mmb4a4j,8255,8256,16511
12409,,y84je9n39puj,8256,8257,16513
12410,,dwmrun0-jbcj,8257,8258,16515
12411,,aek9j5jh0zmj,8258,8259,16517
12412,,3ong2mpgckej,8259,8260,16519
12413,,x4izi55bngkj,8260,8261,16521
12414,,qhfel-oazxsj,8261,8262,16523
12415,,xnmtrwxq9_4j,8262,8263,16525
12416,,kdt5orbz0uoj,8263,8264,16527
12417,,nuyp9ntmajyj,8264,8265,16529
12418,,4ns56tpqqcsj,8265,8266,16531
12419,,53i8swrxj08j,8266,8267,16533
12420,,of89hvxd-goj,8267,8268,16535
12421,,pijmftitg08j,8268,8269,16537
12422,,7gjpjffjxzcj,8269,8270,16539
12423,,9prvolvmjawj,8270,8271,16541
12424,,drjyker3djgj,8271,8272,16543
12425,,vtdwbl5ysu8j,8272,8273,16545
12426,,sj_xmdlgruqj,8273,8274,16547
12427,,54qqhfc7e7uj,8274,8275,16549
12428,,7sqnkdto0hyj,8275,8276,16551
12429,,knutrfhrdbij,8276,8277,16553
12430,,uqjrky1sl5kj,8277,8278,16555
12431,,orppnvdtu4sj,8278,8279,16557
12432,,f23ut_7y0akj,8279,8280,16559
12433,,rf_qf9t3jnaj,8280,8281,16561
12434,,v8wqcpjaauuj,8281,8282,16563
12435,,faxlqqntd-0j,8282,8283,16565
12436,,nwmlw45b_h0j,8283,8284,16567
12437,,v2k59fteq_mj,8284,8285,16569
12438,,tjb2i4yydgkj,8285,8286,16571
12439,,drtztityqjwj,8286,8287,16573
12440,,omoz7gcsdwsj,8287,8288,16575
12441,,ybiuudsanucj,8288,8289,16577
12442,,bj8i-uzfqi4j,8289,8290,16579
12443,,hn0i5-qrvewj,8290,8291,16581
12444,,bxfzgxvl6k8j,8291,8292,16583
12445,,g-julfj81baj,8292,8293,16585
12446,,fswzz9-gmkkj,8293,8294,16587
12447,,2upaeipp7hoj,8294,8295,16589
12448,,fpisyjnisiej,8295,8296,16591
12449,,iy_sadhcvlmj,8296,8297,16593
12450,,wdmnboci5i4j,8297,8298,16595
12451,,ed_8itjrrmwj,8298,8299,16597
12452,,17p_bc6z3l0j,8299,8300,16599
12453,,url:http://www.springerlink.com/index/h0t1064025g75324.pdf,8300,8301,16601
12454,,hay0cukkx6gj,8301,8302,16603
12455,,kadqf6ldnkqj,8302,8303,16605
12456,,h4gmlptjvquj,8303,8304,16607
12457,,kkncuwkddcqj,8304,8305,16609
12458,,saw9xozauugj,8305,8306,16611
12459,,ub5xsnxu3v0j,8306,8307,16613
12460,,haeavxvgp1qj,8307,8308,16615
12461,,8xrireu23gcj,8308,8309,16617
12462,,c0d02szwh9mj,8309,8310,16619
12463,,jqftxmuy5cwj,8310,8311,16621
12464,,favapxr6ltwj,8311,8312,16623
12465,,_zs1rabseuoj,8312,8313,16625
12466,,r4eb9qz14-4j,8313,8314,16627
12467,,si5p_fn5e0aj,8314,8315,16629
12468,,6m14uibzf_0j,8315,8316,16631
12469,,2apmj-gqbbwj,8316,8317,16633
12470,,gigmhgy3ztaj,8317,8318,16635
12471,,gkywo_esdwsj,8319,8320,16639
12472,,cdh7p2bte1kj,8320,8321,16641
12473,,iilfy7d6i_ej,8321,8322,16643
12474,,zdfhiu7lhhoj,8322,8323,16645
12475,,5s7ibgeo_rij,8323,8324,16647
12476,,v1aol6mmldmj,8324,8325,16649
12477,,vmxrarwctagj,8325,8326,16651
12478,,odeio1tz47uj,8326,8327,16653
12479,,8zk5gw2owmij,8327,8328,16655
12480,,ealwuoe7cdij,8328,8329,16657
12481,,7dwizo4k7yej,8329,8330,16659
12482,,0pvbv69ehf0j,8330,8331,16661
12483,,mx7ph0q82lwj,8331,8332,16663
12484,,ujx2bj66-1ij,8332,8333,16665
12485,,iqqcdkpv_h0j,8333,8334,16667
12486,,3drjzst3if8j,8334,8335,16669
12487,,b2wwf7gzbyuj,8335,8336,16671
12488,,url:http://www.csa.com/partners/viewrecord.php3frequester3dgs26collection3dtrd26recid3d155948ws26recid3d199301560033md,8336,8337,16673
12489,,url:http://portal.acm.org/citation.cfm3fid3d83784826dl3dacm26coll3dportal26cfid3d1111111126cftoken3d2222222,8337,8338,16675
12490,,eeeqwt9n5yqj,8338,8339,16677
12491,,2b58oweruymj,8339,8340,16679
12492,,q_szigxczpyj,8340,8341,16681
12493,,h3gfedfnjksj,8341,8342,16683
12494,,q4ji_u1atlsj,8342,8343,16685
12495,,6aj_d08mx2oj,8343,8344,16687
12496,,url:http://www.csa.com/partners/viewrecord.php3frequester3dgs26collection3dtrd26recid3d200111000455mt26recid3da0032609ah,8344,8345,16689
12497,,url:http://portal.acm.org/citation.cfm3fid3d902519,8345,8346,16691
12498,,16-yrermusuj,8346,8347,16693
12499,,izqkoiazct0j,8347,8348,16695
12500,,ddaenygg1qcj,8348,8349,16697
12501,,yuxp060jirwj,8349,8350,16699
12502,,vcrcfp6wgb8j,8350,8351,16701
12503,,b_s2obczeaqj,8351,8352,16703
12504,,cokselhbx8ej,8352,8353,16705
12505,,oijyb9vcnooj,8353,8354,16707
12506,,61aonbfs7huj,8354,8355,16709
12507,,jwt1nghgywmj,8355,8356,16711
12508,,lyidlc4qcmaj,8356,8357,16713
12509,,txuit_1m2eyj,8359,8360,16719
12510,,url:http://portal.acm.org/citation.cfm3fid3d110344.110330,8360,8361,16721
12511,,tiwu00icwf8j,8361,8362,16723
12512,,fhgjwvtvloej,8362,8363,16725
12513,,zihxu9cmhukj,8363,8364,16727
12514,,58rgcfra5o8j,8364,8365,16729
12515,,4r5hszuy-0mj,8365,8366,16731
12516,,lef5vbwhir0j,8366,8367,16733
12517,,pneknrzgkiyj,8367,8368,16735
12518,,elnnklephtij,8368,8369,16737
12519,,evrl5mlkw9sj,8369,8370,16739
12520,,tuygq9aiasgj,8370,8371,16741
12521,,5psyqm889goj,8371,8372,16743
12522,,b2kq4r1diqcj,8372,8373,16745
12523,,vxzy-zwlwxqj,8373,8374,16747
12524,,4ygpc0j5uugj,8374,8375,16749
12525,,e5-pk_ldx2aj,8375,8376,16751
12526,,hkppoq2pqwoj,8376,8377,16753
12527,,cgl8pdweoqyj,8378,8379,16757
12528,,fynpt3sl7f8j,8379,8380,16759
12529,,yharftze3nsj,8380,8381,16761
12530,,m_xed1ck3w8j,8381,8382,16763
12531,,i07wqinrmc8j,8382,8383,16765
12532,,d_8n46_xwggj,8383,8384,16767
12533,,hngxqyayvv0j,8384,8385,16769
12534,,bdn0l3vvhzuj,8385,8386,16771
12535,,ccy5lcrmph8j,8386,8387,16773
12536,,uifeiwmdyckj,8387,8388,16775
12537,,llyvnk8yn9uj,8388,8389,16777
12538,,ipzkzxb-lcej,8389,8390,16779
12539,,tjeeehiggdmj,8390,8391,16781
12540,,vnqua47gigmj,8391,8392,16783
12541,,xzzoinyhq0sj,8392,8393,16785
12542,,ys7fjt5bsw8j,8393,8394,16787
12543,,znbtodelvoaj,8394,8395,16789
12544,,eihejemmnloj,8395,8396,16791
12545,,zcfedtuey54j,8396,8397,16793
12546,,wmbloga-wc8j,8397,8398,16795
12547,,edugkulgjf4j,8398,8399,16797
12548,,sabng8szvhqj,8399,8400,16799
12549,,f4f_aj6xqosj,8400,8401,16801
12550,,vxbezhovfaoj,8401,8402,16803
12551,,lc0widctbxuj,8402,8403,16805
12552,,url:http://portal.acm.org/ft_gateway.cfm3fid3d109973826type3dpdf,8403,8404,16807
12553,,jozmgqxedjgj,8404,8405,16809
12554,,s-e3asigoowj,8405,8406,16811
12555,,ekvss2ucxu4j,8406,8407,16813
12556,,tn7fqfs_ys8j,8407,8408,16815
12557,,ui5bboirydkj,8408,8409,16817
12558,,lz8fzpqniqwj,8409,8410,16819
12559,,nb4cpgdal0mj,8410,8411,16821
12560,,gw1u1s3pwlyj,8411,8412,16823
12561,,daitjsnngycj,8412,8413,16825
12562,,mimygwqrgy8j,8413,8414,16827
12563,,lpwbrjxyl4aj,8414,8415,16829
12564,,38h1fid3vnej,8415,8416,16831
12565,,pyvajzmlhnyj,8416,8417,16833
12566,,n3fqmfihkt4j,8417,8418,16835
12567,,gjgqjxj5b8yj,8418,8419,16837
12568,,2p5yjw4ufe8j,8419,8420,16839
12569,,7nhcyfosiaij,8420,8421,16841
12570,,qsajehyup0qj,8422,8423,16845
12571,,akc8qqzt8jsj,8423,8424,16847
12572,,dtydo3jnqjsj,8424,8425,16849
12573,,110yqd1zmf0j,8425,8426,16851
12574,,z-p0rziyz4ij,8426,8427,16853
12575,,rg4fqdkmwoij,8427,8428,16855
12576,,sy_yt0rbobkj,8428,8429,16857
12577,,or5fwpxkayoj,8429,8430,16859
12578,,jwhox73d9ecj,8430,8431,16861
12579,,z8zzybjyvusj,8432,8433,16865
12580,,eitvdsc8jtwj,8433,8434,16867
12581,,lndbshtbsc0j,8434,8435,16869
12582,,9mnt7r03kkaj,8435,8436,16871
12583,,zxl2udjo0lqj,8436,8437,16873
12584,,q-xlvpf0alwj,8437,8438,16875
12585,,i85bzezyzcgj,8438,8439,16877
12586,,y5djb6aupjaj,8439,8440,16879
12587,,iarpponib3aj,8440,8441,16881
12588,,pdxps5mb78sj,8441,8442,16883
12589,,bo21ruvrqasj,8442,8443,16885
12590,,d0tmgmt961uj,8443,8444,16887
12591,,rjafjo6cj0sj,8444,8445,16889
12592,,asgg3fxbudcj,8446,8447,16893
12593,,sobraillvzgj,8447,8448,16895
12594,,8_alo_kq-1qj,8448,8449,16897
12595,,9zd1ycthfrwj,8449,8450,16899
12596,,kbkqri-ujdyj,8450,8451,16901
12597,,ujcfh0mdhg8j,8451,8452,16903
12598,,ci2ctzwh8nmj,8452,8453,16905
12599,,jpb0wboqcpwj,8453,8454,16907
12600,,clm51_xbp_qj,8454,8455,16909
12601,,ti7-55_ksfoj,8455,8456,16911
12602,,4nj0upmlh2ej,8456,8457,16913
12603,,r4qmlqhdic8j,8457,8458,16915
12604,,f8cacvskztej,8458,8459,16917
12605,,ng8ijt5lrbwj,8459,8460,16919
12606,,nz8ig2l78pyj,8460,8461,16921
12607,,p547hlkkzpqj,8461,8462,16923
12608,,rlbcv77h0paj,8462,8463,16925
12609,,lx0suvkgtzcj,8463,8464,16927
12610,,ifvaqbwqycmj,8464,8465,16929
12611,,ycw7nfoh0aij,8465,8466,16931
12612,,npaltiwoglyj,8466,8467,16933
12613,,url:http://www.csa.com/partners/viewrecord.php3frequester3dgs26collection3dtrd26recid3d1563564ci,8467,8468,16935
12614,,3xgsnwelbqyj,8468,8469,16937
12615,,pahbqhuoi38j,8469,8470,16939
12616,,u9eh7ljjrwaj,8470,8471,16941
12617,,5qfmf0oqdaej,8471,8472,16943
12618,,9vvn0pfp3woj,8472,8473,16945
12619,,cowstspg-hmj,8473,8474,16947
12620,,x7lozstegpwj,8474,8475,16949
12621,,xt02ibtxcqaj,8475,8476,16951
12622,,7auoyvrn01gj,8476,8477,16953
12623,,c4rd5bzv2muj,8477,8478,16955
12624,,smy0c6pqvhej,8478,8479,16957
12625,,u2sytnxbmxyj,8479,8480,16959
12626,,mrpr3dvvb2ij,8480,8481,16961
12627,,lqljlx1ss5qj,8481,8482,16963
12628,,klvwqnpmm2mj,8482,8483,16965
12629,,rj6dmt1mtpoj,8483,8484,16967
12630,,244yhsyw3o0j,8484,8485,16969
12631,,dktvl68aafwj,8485,8486,16971
12632,,rcdpn7rm6z4j,8486,8487,16973
12633,,i9nxbjzjswwj,8487,8488,16975
12634,,plmgkhvrwv8j,8488,8489,16977
12635,,2vcffjcujfcj,8489,8490,16979
12636,,vyykhi96iqkj,8490,8491,16981
12637,,gelfgjd2bkwj,8491,8492,16983
12638,,xsmri9nm1emj,8492,8493,16985
12639,,url:http://doi.wiley.com/10.1002/ace.113,8493,8494,16987
12640,,f6pk9t_0szcj,8494,8495,16989
12641,,e-iit7yut2uj,8495,8496,16991
12642,,dobjqu7n8j4j,8497,8498,16995
12643,,urmdpbafttwj,8498,8499,16997
12644,,p-tow5z1snmj,8499,8500,16999
12645,,hcliyggk84mj,8500,8501,17001
12646,,1uhix4h8q7wj,8501,8502,17003
12647,,_4jg9vdvz00j,8502,8503,17005
12648,,hugnlg7z-z4j,8503,8504,17007
12649,,6mbkij2n36ij,8504,8505,17009
12650,,4pzei-wh49uj,8505,8506,17011
12651,,u88hrixldtaj,8506,8507,17013
12652,,mk9xo4-qifej,8507,8508,17015
12653,,l4oha8r58ykj,8508,8509,17017
12654,,nc4afnnqwyuj,8509,8510,17019
12655,,puhsq-r7fmcj,8510,8511,17021
12656,,bcb_ac6e6kuj,8511,8512,17023
12657,,h5wmd1dmn0ej,8512,8513,17025
12658,,0dr-nwo4kzqj,8513,8514,17027
12659,,oiil44zs6tmj,8514,8515,17029
12660,,dkplfrjpuq8j,8515,8516,17031
12661,,ka8sqmzw9l8j,8516,8517,17033
12662,,yomzy4dcg9qj,8517,8518,17035
12663,,i0oong9rt88j,8518,8519,17037
12664,,ir6wnlmgugqj,8519,8520,17039
12665,,bt2gb401timj,8520,8521,17041
12666,,ovtatybrgqcj,8521,8522,17043
12667,,bcuezs6iydsj,8522,8523,17045
12668,,,8523,8524,17047
12669,,exa5inuiz2cj,8524,8525,17049
12670,,url:http://pubs.acs.org/cgi-bin/abstract.cgi/achre4/asap/abs/ar980101q.html,8525,8526,17051
12671,,ieeoypvz2rcj,8526,8527,17053
12672,,smnddwtnggmj,8527,8528,17055
12673,,u41x1xiybnyj,8528,8529,17057
12674,,wxkt22nms-qj,8529,8530,17059
12675,,b9qkcvloe8sj,8530,8531,17061
12676,,c17boygragkj,8531,8532,17063
12677,,,8532,8533,17065
12678,,w1gdbl474ksj,8533,8534,17067
12679,,zbzs3iqxfhcj,8534,8535,17069
12680,,sg35tacen2yj,8535,8536,17071
12681,,s1xuyp7qhpgj,8536,8537,17073
12682,,url:http://www.springerlink.com/index/q6678x51p4178655.pdf,8537,8538,17075
12683,,2nhtfm59ub4j,8539,8540,17079
12684,,pxnuitzl94oj,8541,8542,17083
12685,,e7kschsfxm4j,8542,8543,17085
12686,,5dxhiszrch0j,8543,8544,17087
12687,,cdkjmg-08hkj,8544,8545,17089
12688,,url:http://portal.acm.org/ft_gateway.cfm3fid3d110120926type3dpdf,8545,8546,17091
12689,,ngyv_wpnfogj,8546,8547,17093
12690,,5gg2umdbj1uj,8547,8548,17095
12691,,o_zlv-o5dfej,8548,8549,17097
12692,,11x4l3i5do4j,8549,8550,17099
12693,,a_c1j9g14soj,8550,8551,17101
12694,,mv7pjr2nhxij,8551,8552,17103
12695,,msitcejzwwaj,8552,8553,17105
12696,,xg2ahj9rj1ij,8553,8554,17107
12697,,wxahgxdrrcgj,8554,8555,17109
12698,,np1xpnsj1pyj,8555,8556,17111
12699,,za6vjpmjxxcj,8556,8557,17113
12700,,59bzpzlvkh8j,8557,8558,17115
12701,,d8x29wujn6qj,8558,8559,17117
12702,,bgtcz10yn_ej,8559,8560,17119
12703,,jj_ayeqmsrej,8560,8561,17121
12704,,djuezxoky3wj,8561,8562,17123
12705,,e-pnz9wta0kj,8562,8563,17125
12706,,0oozo0vlsm8j,8563,8564,17127
12707,,4p02stm9ca8j,8564,8565,17129
12708,,qx4nv4hjvcwj,8565,8566,17131
12709,,4otij1tet0ej,8566,8567,17133
12710,,jccbqf3qon8j,8567,8568,17135
12711,,dbsoohgsaysj,8568,8569,17137
12712,,uo4i7h_rw_ij,8569,8570,17139
12713,,xizhtukxfg0j,8570,8571,17141
12714,,6qec-dxvm0kj,8571,8572,17143
12715,,s3zsewlw9xkj,8572,8573,17145
12716,,esyaaa9opkyj,8573,8574,17147
12717,,aevfanm-rykj,8574,8575,17149
12718,,tl8yciyispcj,8575,8576,17151
12719,,uatfftpzkaij,8576,8577,17153
12720,,j1claoehutwj,8577,8578,17155
12721,,pkbwjrruuqqj,8578,8579,17157
12722,,widpm0wvqt8j,8579,8580,17159
12723,,8ste-genkwuj,8580,8581,17161
12724,,dsqyxqbnyzmj,8581,8582,17163
12725,,uj0dj1oznnyj,8582,8583,17165
12726,,ng46gvvjoc8j,8583,8584,17167
12727,,17fsetjp3ywj,8584,8585,17169
12728,,gdgprgs57xmj,8585,8586,17171
12729,,4oh7yg8zleej,8586,8587,17173
12730,,j5twsjzhyokj,8587,8588,17175
12731,,jh3feknxrwaj,8588,8589,17177
12732,,ytzl8s_1qmkj,8589,8590,17179
12733,,y5sz3ldhg4qj,8590,8591,17181
12734,,,8591,8592,17183
12735,,ogpk7zevqjmj,8592,8593,17185
12736,,x58hlwnil5wj,8593,8594,17187
12737,,4mdxcezgowoj,8594,8595,17189
12738,,sfp4wyxozqij,8595,8596,17191
12739,,ktxly68bfkaj,8596,8597,17193
12740,,2zhhpmsvtaaj,8597,8598,17195
12741,,yvwzyzdqy4uj,8598,8599,17197
12742,,uns2-w0bcnkj,8599,8600,17199
12743,,ysr0rolehmaj,8600,8601,17201
12744,,dynvnyvtqboj,8601,8602,17203
12745,,hidpwq_j6pej,8602,8603,17205
12746,,_epvkrw4bq0j,8603,8604,17207
12747,,qtthcgx4epoj,8604,8605,17209
12748,,zzu45-e5vkqj,8605,8606,17211
12749,,url:http://doi.wiley.com/10.1002/ev.1531,8606,8607,17213
12750,,rg2txcbvqhoj,8607,8608,17215
12751,,s3fxoxpg4-wj,8608,8609,17217
12752,,560jfiirjjmj,8609,8610,17219
12753,,4ny3ms43vzyj,8610,8611,17221
12754,,sa06ztlt2rij,8611,8612,17223
12755,,glmeersddmij,8612,8613,17225
12756,,kuy-m0_thesj,8613,8614,17227
12757,,url:http://www.csa.com/partners/viewrecord.php3frequester3dgs26collection3dtrd26recid3d8311609an26recid3da8350198ah,8614,8615,17229
12758,,jswt_rdpurcj,8615,8616,17231
12759,,ng2s8hancvwj,8616,8617,17233
12760,,ixwf_9dzhesj,8617,8618,17235
12761,,vgnreqtcjkuj,8618,8619,17237
12762,,hti26bfvycsj,8619,8620,17239
12763,,l5_kr9ch3c4j,8620,8621,17241
12764,,1_ehg50gkdoj,8621,8622,17243
12765,,47qsokpclqwj,8622,8623,17245
12766,,z0jnqe4pgw8j,8623,8624,17247
12767,,yflblpwbmiqj,8624,8625,17249
12768,,35wamsjnswcj,8625,8626,17251
12769,,,8626,8627,17253
12770,,qrst_h_avd0j,8627,8628,17255
12771,,tgaxcbruduqj,8628,8629,17257
12772,,kjhg56mwhoej,8629,8630,17259
12773,,jqlps6kq6cij,8630,8631,17261
12774,,kt88pinbtnij,8631,8632,17263
12775,,jko2v0pp41oj,8632,8633,17265
12776,,anhg1moiw5wj,8633,8634,17267
12777,,,8634,8635,17269
12778,,dl8ce2jizg4j,8635,8636,17271
12779,,zykkmxgscacj,8636,8637,17273
12780,,hp8sih7-nugj,8637,8638,17275
12781,,h0ghzvrm9ncj,8638,8639,17277
12782,,url:http://portal.acm.org/ft_gateway.cfm3fid3d109956326type3dpdf,8639,8640,17279
12783,,jwoyduvezicj,8640,8641,17281
12784,,,8641,8642,17283
12785,,19wdy6zwdsgj,8642,8643,17285
12786,,c4r3itcwu6cj,8643,8644,17287
12787,,,8644,8645,17289
12788,,d5_f6qeicfoj,8645,8646,17291
12789,,a7ennlkmgsgj,8646,8647,17293
12790,,jpjpq4cygpej,8647,8648,17295
12791,,ik48zo5svbyj,8648,8649,17297
12792,,74vkzfh4troj,8649,8650,17299
12793,,h8ttwedltysj,8650,8651,17301
12794,,c6rl6ppcrm0j,8651,8652,17303
12795,,zeqofm380caj,8652,8653,17305
12796,,h5qjtt2i0nij,8653,8654,17307
12797,,url:http://portal.acm.org/citation.cfm3fid3d171926.171963,8654,8655,17309
12798,,8b_ng73cxg4j,8655,8656,17311
12799,,p1ur0ltqvg0j,8656,8657,17313
12800,,z31tt7jom6ej,8657,8658,17315
12801,,doc0zq8ecgaj,8658,8659,17317
12802,,ki67ipwhshwj,8659,8660,17319
12803,,8cijw_uxnm0j,8660,8661,17321
12804,,qtxld-lqj0wj,8661,8662,17323
12805,,be6dhsip_vmj,8662,8663,17325
12806,,bbefk1h8ccej,8663,8664,17327
12807,,1uqelo3a50ej,8664,8665,17329
12808,,rjusqrrpfk0j,8665,8666,17331
12809,,zzmihqljig0j,8666,8667,17333
12810,,waivamhnjl8j,8667,8668,17335
12811,,ycyognnmfukj,8668,8669,17337
12812,,p-wxp5uo64uj,8669,8670,17339
12813,,url:http://www.csa.com/partners/viewrecord.php3frequester3dgs26collection3dtrd26recid3dn9210466ah,8670,8671,17341
12814,,emc7f-yarskj,8671,8672,17343
12815,,0hrz2z4dpkoj,8672,8673,17345
12816,,mn8sxohfyayj,8673,8674,17347
12817,,i-gxopu7_gej,8674,8675,17349
12818,,8prlf-jkhygj,8675,8676,17351
12819,,dnq2lac_plyj,8676,8677,17353
12820,,909hlnr8130j,8677,8678,17355
12821,,12rgimjm4ggj,8678,8679,17357
12822,,jrgmzbowgmaj,8679,8680,17359
12823,,kbop-sthhicj,8680,8681,17361
12824,,2ubmxn3x95yj,8681,8682,17363
12825,,cy2jwyx6yiwj,8682,8683,17365
12826,,1v1pbv7wu9wj,8683,8684,17367
12827,,f-cfvggrjd4j,8684,8685,17369
12828,,,8685,8686,17371
12829,,iekyla_5bukj,8686,8687,17373
12830,,vcz0hav6sfij,8687,8688,17375
12831,,jo4zcudq5baj,8688,8689,17377
12832,,url:http://portal.acm.org/ft_gateway.cfm3fid3d110131926type3dpdf,8689,8690,17379
12833,,url:http://doi.wiley.com/10.1002/tl.6906,8690,8691,17381
12834,,nexmltnrk_mj,8691,8692,17383
12835,,url:http://ieeexplore.ieee.org/iel2/3038/8631/00379930.pdf3farnumber3d379930,8692,8693,17385
12836,,bzenrmw5raqj,8694,8695,17389
12837,,taehrxkmxg8j,8695,8696,17391
12838,,fvobabaslu4j,8696,8697,17393
12839,,aa0runzrjzuj,8697,8698,17395
12840,,c8tfxd-_w10j,8698,8699,17397
12841,,t_c5ca95osej,8699,8700,17399
12842,,o2hyskcf7cuj,8700,8701,17401
12843,,9kk4hpf1v3kj,8701,8702,17403
12844,,w17yka0mz2oj,8702,8703,17405
12845,,url:http://doi.wiley.com/10.1002/ev.1533,8703,8704,17407
12846,,cnpca9pk5dej,8704,8705,17409
12847,,57t2gtrkzeej,8705,8706,17411
12848,,tsxlisynpkwj,8706,8707,17413
12849,,ue6icn4cqh8j,8707,8708,17415
12850,,e82z5alfjnqj,8708,8709,17417
12851,,n4ztiy3jd6aj,8709,8710,17419
12852,,osipbej_w0qj,8710,8711,17421
12853,,w5lpaazjqyij,8711,8712,17423
12854,,ttag0qjzdhsj,8712,8713,17425
12855,,3iafojiicioj,8713,8714,17427
12856,,ogogmcxpbt0j,8714,8715,17429
12857,,ebarpn0wqf4j,8715,8716,17431
12858,,url:http://doi.wiley.com/10.1002/tl.30,8716,8717,17433
12859,,zlkvngtzxquj,8717,8718,17435
12860,,zbw4txzp6bmj,8718,8719,17437
12861,,pvlfel54udej,8719,8720,17439
12862,,zjp2sjlddrgj,8720,8721,17441
12863,,ge54yq1x0k0j,8721,8722,17443
12864,,i4ptd2yg3r4j,8722,8723,17445
12865,,cfpgcsbtsbej,8723,8724,17447
12866,,kz-m2ivgeeqj,8724,8725,17449
12867,,gbehhama3wcj,8725,8726,17451
12868,,z5uzt35iyw0j,8726,8727,17453
12869,,a_dyyxqi-8qj,8727,8728,17455
12870,,as79owidzxsj,8728,8729,17457
12871,,cewcuzuar5wj,8729,8730,17459
12872,,url:http://portal.acm.org/ft_gateway.cfm3fid3d110123626type3dpdf,8730,8731,17461
12873,,uwpjb_d1gnoj,8731,8732,17463
12874,,whnp7fycyfij,8732,8733,17465
12875,,jht8ma_1b6sj,8733,8734,17467
12876,,hl64kxx33bgj,8734,8735,17469
12877,,vrycn1lzgugj,8735,8736,17471
12878,,pl4rj3ocn7ij,8736,8737,17473
12879,,url:http://portal.acm.org/citation.cfm3fid3d264346,8737,8738,17475
12880,,psgmgxfwp5mj,8738,8739,17477
12881,,y8yaximlnbkj,8739,8740,17479
12882,,yoi5kx9cemej,8740,8741,17481
12883,,aslcvnbpot4j,8741,8742,17483
12884,,8pf7s6iex4wj,8742,8743,17485
12885,,asxgvvdtcxej,8743,8744,17487
12886,,ltcux5vy964j,8744,8745,17489
12887,,mcspzet3sdej,8745,8746,17491
12888,,sxmgelwgclij,8746,8747,17493
12889,,0tnylui0n0uj,8747,8748,17495
12890,,pgvkunmn9quj,8749,8750,17499
12891,,8cfi8dolak0j,8750,8751,17501
12892,,7_4dnqc8p_aj,8751,8752,17503
12893,,rqgpmpo35fqj,8752,8753,17505
12894,,qpjw1riwlaqj,8753,8754,17507
12895,,y2bd6weunsqj,8754,8755,17509
12896,,pko8w4o5va4j,8755,8756,17511
12897,,url:http://portal.acm.org/ft_gateway.cfm3fid3d108625426type3dpdf,8756,8757,17513
12898,,ds73wsumwpij,8757,8758,17515
12899,,x3h2nl0hbbqj,8758,8759,17517
12900,,v8kykk6bvg8j,8759,8760,17519
12901,,hajvxmgucikj,8760,8761,17521
12902,,kcxemqvhaeaj,8761,8762,17523
12903,,7fc-gcc_k3kj,8762,8763,17525
12904,,0h_accgdst8j,8763,8764,17527
12905,,jnh5kyefejkj,8764,8765,17529
12906,,xgg2mbj2ktgj,8765,8766,17531
12907,,457dixxk1wej,8766,8767,17533
12908,,g4fckoa3p78j,8767,8768,17535
12909,,ub4qcs1oqxij,8768,8769,17537
12910,,mlqfo_snlkqj,8769,8770,17539
12911,,wrwvz-df_28j,8770,8771,17541
12912,,ducddpntj1cj,8771,8772,17543
12913,,upesrwy-bksj,8772,8773,17545
12914,,url:http://doi.wiley.com/10.1002/he.10902,8773,8774,17547
12915,,igcvbi4ebhij,8774,8775,17549
12916,,hj0w6lx0yusj,8775,8776,17551
12917,,udsggdbrjrcj,8776,8777,17553
12918,,teqj_5r3xsej,8777,8778,17555
12919,,uc2iedsyenuj,8778,8779,17557
12920,,lcrdtwzpqogj,8779,8780,17559
12921,,2skhg-hl3pij,8780,8781,17561
12922,,0zt7gsukdgoj,8781,8782,17563
12923,,alirvhrqs0kj,8782,8783,17565
12924,,iuq6ba-ny74j,8783,8784,17567
12925,,pdtq6ll9askj,8784,8785,17569
12926,,b-ehyg6gtomj,8786,8787,17573
12927,,ttjfcsqttrij,8787,8788,17575
12928,,ftq7hpj8vlej,8788,8789,17577
12929,,byvqwnelvkuj,8789,8790,17579
12930,,xoomzwlmsaaj,8790,8791,17581
12931,,kmns4wdzw7wj,8791,8792,17583
12932,,w-2lcpxk3pqj,8792,8793,17585
12933,,ykxfh6ionbaj,8793,8794,17587
12934,,dugyzs6sdmaj,8794,8795,17589
12935,,cuzsyx9mwowj,8795,8796,17591
12936,,jno2l7otzusj,8796,8797,17593
12937,,3edatsivdskj,8797,8798,17595
12938,,ppv5ehk8twsj,8798,8799,17597
12939,,bavduphvtgwj,8800,8801,17601
12940,,lhrec6jrogmj,8801,8802,17603
12941,,qoiru8q7fbij,8802,8803,17605
12942,,cyglcfnluqqj,8803,8804,17607
12943,,gbn9aitd38qj,8804,8805,17609
12944,,gvum006n-eij,8805,8806,17611
12945,,yibcoqg2romj,8806,8807,17613
12946,,g96kej4sfe0j,8807,8808,17615
12947,,tfc5wjpswo8j,8809,8810,17619
12948,,moif5mytiryj,8810,8811,17621
12949,,z8olfmiqid0j,8811,8812,17623
12950,,ticp6iyuemsj,8812,8813,17625
12951,,ns_djvzypdoj,8813,8814,17627
12952,,8zxu3uybqmqj,8814,8815,17629
12953,,url:http://doi.wiley.com/10.1002/he.10604,8815,8816,17631
12954,,6ermv8yekmej,8816,8817,17633
12955,,v45mxxcmkukj,8817,8818,17635
12956,,9kms0refokkj,8818,8819,17637
12957,,ybcqhl4n0qqj,8819,8820,17639
12958,,fnn9zw2ipxcj,8820,8821,17641
12959,,vv4sr_13icsj,8821,8822,17643
12960,,0gcxbwmxa6mj,8822,8823,17645
12961,,wjdrrz99zb4j,8823,8824,17647
12962,,iyptakrqexmj,8824,8825,17649
12963,,ocnh8o3aj4kj,8825,8826,17651
12964,,url:http://ieeexplore.ieee.org/iel1/2206/2029/00056134.pdf3farnumber3d56134,8826,8827,17653
12965,,hxiyuvsen4gj,8827,8828,17655
12966,,t5b_hdw7cayj,8828,8829,17657
12967,,9agpmvxzq3aj,8829,8830,17659
12968,,zsyvfqnnxfkj,8830,8831,17661
12969,,dooggmfdgyoj,8831,8832,17663
12970,,vzdut7s1x9cj,8832,8833,17665
12971,,oyhq6fh7_dwj,8833,8834,17667
12972,,bixlux2y38aj,8834,8835,17669
12973,,url:http://portal.acm.org/ft_gateway.cfm3fid3d106621126type3dpdf,8835,8836,17671
12974,,ato-atr72xyj,8836,8837,17673
12975,,xfn7qntlsvaj,8837,8838,17675
12976,,z9-9nofedj0j,8838,8839,17677
12977,,hgokymn8yd0j,8839,8840,17679
12978,,6fb5cvnh9cwj,8840,8841,17681
12979,,,8841,8842,17683
12980,,zdx9nrllb8sj,8842,8843,17685
12981,,url:http://portal.acm.org/citation.cfm3fid3d960120.80837926coll3dguide26dl3dacm26idx3dj70626part3dperiodical26wanttype3dperiodical26title3dacm2520sigplan2520notices26cfid3d1111111126cftoken3d2222222,8843,8844,17687
12982,,4xzg0s74dj0j,8844,8845,17689
12983,,i4sejigm4u0j,8845,8846,17691
12984,,g0xvnegfh68j,8846,8847,17693
12985,,e7ckuukwc1kj,8847,8848,17695
12986,,me6m9h-hyakj,8848,8849,17697
12987,,xdazy9hazc0j,8849,8850,17699
12988,,5sqq20vb3q4j,8850,8851,17701
12989,,zrzpxbbsl58j,8851,8852,17703
12990,,d310gh6qizqj,8852,8853,17705
12991,,cdsxbo_x4maj,8853,8854,17707
12992,,jsyeacsrfkuj,8854,8855,17709
12993,,_pnsxulhegaj,8855,8856,17711
12994,,7vi75jahggwj,8856,8857,17713
12995,,woaprotgccyj,8857,8858,17715
12996,,kkrl1lei_foj,8858,8859,17717
12997,,ewhvgapmlicj,8859,8860,17719
12998,,gamfcjd7s38j,8860,8861,17721
12999,,ugejq6ufmlgj,8861,8862,17723
13000,,xn1qycwzeiyj,8862,8863,17725
13001,,eqfx4vke8eij,8863,8864,17727
13002,,umjh4wzst2uj,8864,8865,17729
13003,,xquvnsv3su0j,8865,8866,17731
13004,,9gfdl85zv8gj,8866,8867,17733
13005,,c9kxes1ktz4j,8867,8868,17735
13006,,sug3v4othbqj,8868,8869,17737
13007,,bcnfjqsvq8aj,8869,8870,17739
13008,,e8kbo1jfs98j,8870,8871,17741
13009,,mmk-jiwcpf0j,8871,8872,17743
13010,,m4g18mfkn2oj,8872,8873,17745
13011,,at19vkojhxsj,8873,8874,17747
13012,,ndcnmvqum_yj,8874,8875,17749
13013,,ep_9xx4czbuj,8875,8876,17751
13014,,akv8iij3smkj,8876,8877,17753
13015,,xr4na0tyboyj,8877,8878,17755
13016,,v7xvdsuzwdoj,8878,8879,17757
13017,,wxvstwwyywaj,8879,8880,17759
13018,,r4soqzxes70j,8880,8881,17761
13019,,,8881,8882,17763
13020,,rhq6ubao4naj,8882,8883,17765
13021,,uua8ur3tj7aj,8883,8884,17767
13022,,iwmq0qkgsfyj,8884,8885,17769
13023,,slkuids0i2ij,8885,8886,17771
13024,,pu5pnczaeyuj,8886,8887,17773
13025,,nbegyzisqhaj,8887,8888,17775
13026,,kbpjnhzizwuj,8888,8889,17777
13027,,etxlbz90eboj,8889,8890,17779
13028,,lp1vcsobfdoj,8890,8891,17781
13029,,iyv5rcuylkwj,8891,8892,17783
13030,,k_xehz8irvwj,8892,8893,17785
13031,,s01coh8b_gkj,8893,8894,17787
13032,,gdf7pl75qwgj,8894,8895,17789
13033,,rkalnerm2u8j,8895,8896,17791
13034,,7mcpiu-piuij,8896,8897,17793
13035,,_cfb8yiiysmj,8897,8898,17795
13036,,s2ngrhl15hkj,8898,8899,17797
13037,,wyty6g5dmiej,8899,8900,17799
13038,,baan0mnkk5cj,8900,8901,17801
13039,,xtaw9fusup0j,8901,8902,17803
13040,,mu1yauzwiqwj,8902,8903,17805
13041,,lil3aghmwqaj,8903,8904,17807
13042,,4psnmsnb0zwj,8904,8905,17809
13043,,7r8h8_des5sj,8905,8906,17811
13044,,url:http://doi.wiley.com/10.1002/tl.151,8906,8907,17813
13045,,xq0vkuqjti8j,8907,8908,17815
13046,,yap7atfljcgj,8908,8909,17817
13047,,jfwovizjg6qj,8909,8910,17819
13048,,f-qgodyechyj,8910,8911,17821
13049,,wasfh3ybbyaj,8911,8912,17823
13050,,dknhad-fgjsj,8912,8913,17825
13051,,url:http://portal.acm.org/ft_gateway.cfm3fid3d50928526type3dpdf26dl3dguide26dl3dacm26cfid3d1111111126cftoken3d2222222,8913,8914,17827
13052,,dkp8e46ogwkj,8914,8915,17829
13053,,xycoa_aaxnaj,8915,8916,17831
13054,,9ujztqsvv5ij,8916,8917,17833
13055,,rzvr2u34t8sj,8917,8918,17835
13056,,css8ripajcoj,8918,8919,17837
13057,,url:http://portal.acm.org/citation.cfm3fid3d1058150.1058152,8919,8920,17839
13058,,url:http://www.csa.com/partners/viewrecord.php3frequester3dgs26collection3dtrd26recid3d20021213005371mt26recid3da8012606ah,8920,8921,17841
13059,,yvuf17ycsaej,8921,8922,17843
13060,,dy9weyczxp8j,8922,8923,17845
13061,,wuk9fjakhfwj,8923,8924,17847
13062,,n67crtksd14j,8924,8925,17849
13063,,zccn58zypyqj,8925,8926,17851
13064,,vyed5m-qqcoj,8926,8927,17853
13065,,dldock2-8ewj,8927,8928,17855
13066,,i0phiqmomsuj,8928,8929,17857
13067,,_hf9n9e_w84j,8929,8930,17859
13068,,vtf6ydmcciyj,8930,8931,17861
13069,,hkkzophps2aj,8931,8932,17863
13070,,2r2kexlh8eej,8932,8933,17865
13071,,3b0ffutcbtaj,8933,8934,17867
13072,,w0uvhd9a8ymj,8934,8935,17869
13073,,j-x8sjklzk0j,8935,8936,17871
13074,,o2q-jykfknej,8936,8937,17873
13075,,zgv6f5r6_roj,8937,8938,17875
13076,,brzz1cid4qmj,8938,8939,17877
13077,,391wcdbgovgj,8939,8940,17879
13078,,v7lee_yhpxej,8940,8941,17881
13079,,0momhjtxgrmj,8941,8942,17883
13080,,dsohgtcovuoj,8942,8943,17885
13081,,m7qk24qlx00j,8943,8944,17887
13082,,rrzf69wx4wwj,8944,8945,17889
13083,,sqpdzk7caoaj,8945,8946,17891
13084,,ujqh590d3rij,8946,8947,17893
13085,,_cm1ax9bpwqj,8947,8948,17895
13086,,url:http://adsabs.harvard.edu/abs/1974phdt..........q,8948,8949,17897
13087,,ggtvek6795wj,8949,8950,17899
13088,,j95nifnukjej,8950,8951,17901
13089,,gzevnymquhij,8951,8952,17903
13090,,rr6drgqjfb4j,8952,8953,17905
13091,,fpzfo0lnvvcj,8953,8954,17907
13092,,ss8weczuoxmj,8954,8955,17909
13093,,ox87fon0pv0j,8955,8956,17911
13094,,7abvgtyx8y0j,8956,8957,17913
13095,,1pqxh5cltfcj,8957,8958,17915
13096,,jaowulkyqiwj,8958,8959,17917
13097,,so0kbu8rcjsj,8959,8960,17919
13098,,1u2gxoz8ujuj,8960,8961,17921
13099,,7z8tyi5cmgij,8961,8962,17923
13100,,itoslqb1qeaj,8962,8963,17925
13101,,hzwz3uq9ytmj,8963,8964,17927
13102,,gihtedmvrhwj,8964,8965,17929
13103,,wkpanzkyw_8j,8965,8966,17931
13104,,gd_gizwlzqsj,8966,8967,17933
13105,,8urblesxy10j,8967,8968,17935
13106,,f2v4a3fob-ej,8968,8969,17937
13107,,kgbd6rqdezoj,8969,8970,17939
13108,,swryx4jr2bwj,8970,8971,17941
13109,,url:http://ieeexplore.ieee.org/iel1/2206/325/00006500.pdf3farnumber3d6500,8971,8972,17943
13110,,vnjpsuje5zgj,8972,8973,17945
13111,,owpgduurj1gj,8973,8974,17947
13112,,uugopj13qhaj,8974,8975,17949
13113,,ikpg3amtpgmj,8975,8976,17951
13114,,,8976,8977,17953
13115,,7scc9bo-hsuj,8977,8978,17955
13116,,,8978,8979,17957
13117,,f6hxdzfyocoj,8980,8981,17961
13118,,fycozgfri-gj,8981,8982,17963
13119,,fey0ruyqmioj,8982,8983,17965
13120,,q_65exscdhwj,8983,8984,17967
13121,,vmna-eq43qej,8984,8985,17969
13122,,wjodh6zw-mij,8985,8986,17971
13123,,trsgyl1rwiij,8986,8987,17973
13124,,qrab3st1q90j,8987,8988,17975
13125,,69ny_nzje68j,8988,8989,17977
13126,,,8989,8990,17979
13127,,i4m4i15mw-wj,8990,8991,17981
13128,,url:http://www.csa.com/partners/viewrecord.php3frequester3dgs26collection3dtrd26recid3dn9210505ah,8991,8992,17983
13129,,_iytc6lrw50j,8992,8993,17985
13130,,szbsk5kmevaj,8993,8994,17987
13131,,iujlxrpaqhwj,8994,8995,17989
13132,,in8mewyfi6sj,8995,8996,17991
13133,,8qldsgrnmcmj,8996,8997,17993
13134,,g6twcfhetn0j,8997,8998,17995
13135,,q1hj45bsitaj,8998,8999,17997
13136,,vb4poutennej,8999,9000,17999
13137,,mkenwwx6pf0j,9000,9001,18001
13138,,8rokarypma0j,9001,9002,18003
13139,,nc-229ycpuij,9002,9003,18005
13140,,v-bcb4zohoqj,9003,9004,18007
13141,,m7rkqz_ksrmj,9004,9005,18009
13142,,flhypxvcytwj,9005,9006,18011
13143,,cts7cq2irwgj,9006,9007,18013
13144,,xhmlkjl2xjij,9007,9008,18015
13145,,8xw-xhsfxw8j,9008,9009,18017
13146,,fgkajigik7sj,9009,9010,18019
13147,,hkcvxfm7-2aj,9010,9011,18021
13148,,vvc30dkwqckj,9011,9012,18023
13149,,n0ldxqcwvw4j,9012,9013,18025
13150,,tcmecmvf2lij,9013,9014,18027
13151,,affecr2mhxyj,9014,9015,18029
13152,,frlpkqgoa9cj,9015,9016,18031
13153,,ew9fiyzqrx0j,9016,9017,18033
13154,,isxblpd26u4j,9017,9018,18035
13155,,jchdna-pyswj,9018,9019,18037
13156,,jd7blqtzjnkj,9019,9020,18039
13157,,aca6vxlggbwj,9020,9021,18041
13158,,hkipdqe8ozkj,9021,9022,18043
13159,,url:http://portal.acm.org/ft_gateway.cfm3fid3d108376526type3dpdf,9022,9023,18045
13160,,uwqrg7wxqh0j,9023,9024,18047
13161,,lfl1hwlcsy8j,9024,9025,18049
13162,,gjgcti7qs9ej,9026,9027,18053
13163,,rablh_8q9bkj,9027,9028,18055
13164,,aou9f11ysdgj,9028,9029,18057
13165,,ctdbnxn2xjmj,9029,9030,18059
13166,,hsydbksi02ij,9030,9031,18061
13167,,mkaqt20a3agj,9031,9032,18063
13168,,hqj3ilcht3ej,9033,9034,18067
13169,,s73cork-8iij,9034,9035,18069
13170,,mebkhubabeej,9035,9036,18071
13171,,qex9wohb6gsj,9036,9037,18073
13172,,_ff5i-bkusqj,9037,9038,18075
13173,,_asuxllcyvaj,9038,9039,18077
13174,,,9039,9040,18079
13175,,s0gxpbp_f4ej,9040,9041,18081
13176,,tdyrjdbiatqj,9041,9042,18083
13177,,oycx2ykufuuj,9042,9043,18085
13178,,hh_oevdczyuj,9043,9044,18087
13179,,,9044,9045,18089
13180,,k0gkwpfgkosj,9045,9046,18091
13181,,goyxoatcrjkj,9046,9047,18093
13182,,knb2dyqikqoj,9047,9048,18095
13183,,nhkz6rmprd4j,9048,9049,18097
13184,,unzhbau86iaj,9049,9050,18099
13185,,w0d6gfkloqwj,9050,9051,18101
13186,,url:http://doi.wiley.com/10.1002/ace.7605,9051,9052,18103
13187,,ohplsjp4mu8j,9052,9053,18105
13188,,auyxup8dr1ej,9053,9054,18107
13189,,gj50_9nncbqj,9054,9055,18109
13190,,nzwpezjmdu0j,9055,9056,18111
13191,,7iqd4ucqldwj,9056,9057,18113
13192,,6lfgdulbobcj,9057,9058,18115
13193,,mo-tkbogfcoj,9058,9059,18117
13194,,xzcc6o5cnwcj,9059,9060,18119
13195,,_wvwrh1jolwj,9060,9061,18121
13196,,zgiuii7j1m0j,9061,9062,18123
13197,,nklbid9mcvej,9062,9063,18125
13198,,8hgkissky78j,9063,9064,18127
13199,,,9064,9065,18129
13200,,umqimnb4904j,9065,9066,18131
13201,,hnx8vlfnsfmj,9066,9067,18133
13202,,jeewrj1z2yoj,9067,9068,18135
13203,,-1-6bklfyy4j,9068,9069,18137
13204,,7qv9ic8f_wqj,9069,9070,18139
13205,,3unj2zdw2vkj,9071,9072,18143
13206,,tbvjdpyiwgqj,9072,9073,18145
13207,,dbltpml2pkwj,9073,9074,18147
13208,,jwbjeffecomj,9074,9075,18149
13209,,lcv9qojuhmij,9075,9076,18151
13210,,qwd1egmbtqyj,9076,9077,18153
13211,,sdnstin67z4j,9077,9078,18155
13212,,ibwfnhjztakj,9079,9080,18159
13213,,_ascukpe1oej,9080,9081,18161
13214,,jyshpi8zgcij,9081,9082,18163
13215,,umtttx9jco8j,9082,9083,18165
13216,,vcqne9slihqj,9083,9084,18167
13217,,bm_g2a86bbuj,9084,9085,18169
13218,,e0ih0sgcm7gj,9085,9086,18171
13219,,qbwwtvzp7ucj,9086,9087,18173
13220,,v6cmns2__nuj,9087,9088,18175
13221,,luxze7hipeoj,9088,9089,18177
13222,,p3iy_5akszuj,9089,9090,18179
13223,,yilayoonowgj,9090,9091,18181
13224,,url:http://doi.wiley.com/10.1002/he.28,9091,9092,18183
13225,,c0bs9nkd9puj,9092,9093,18185
13226,,hzlid7szsu4j,9093,9094,18187
13227,,t9r79kzipr4j,9094,9095,18189
13228,,at09gdywiw0j,9095,9096,18191
13229,,wh4ttesgq58j,9096,9097,18193
13230,,s507nx3oqpwj,9097,9098,18195
13231,,_1drqdyrtmsj,9098,9099,18197
13232,,bazayxpnfbuj,9099,9100,18199
13233,,95wrt_v0w24j,9100,9101,18201
13234,,61kimhcpg0sj,9101,9102,18203
13235,,m8-0lbvgd30j,9102,9103,18205
13236,,euzjl39eltmj,9103,9104,18207
13237,,okua1ntzwjmj,9104,9105,18209
13238,,url:http://www.csa.com/partners/viewrecord.php3frequester3dgs26collection3dtrd26recid3d20021211001539mt26recid3da8622971ah,9105,9106,18211
13239,,s0od4qlwkfuj,9106,9107,18213
13240,,9qgtidfhw6aj,9107,9108,18215
13241,,ew-kvckotfcj,9108,9109,18217
13242,,url:http://portal.acm.org/citation.cfm3fid3d105467.105474,9109,9110,18219
13243,,dalxxlmxyiij,9110,9111,18221
13244,,su-yypjhrekj,9111,9112,18223
13245,,cvfk4i2ubn4j,9112,9113,18225
13246,,h_rlslj8u1yj,9113,9114,18227
13247,,1jjm3nsjmqkj,9114,9115,18229
13248,,,9115,9116,18231
13249,,e4vwuz-njm0j,9116,9117,18233
13250,,y4curkth0vaj,9117,9118,18235
13251,,ixz5ldvw9_8j,9118,9119,18237
13252,,url:http://portal.acm.org/citation.cfm3fid3d234286.1053420,9119,9120,18239
13253,,jwqzmgzgergj,9120,9121,18241
13254,,pyvodbjrcswj,9121,9122,18243
13255,,6ijiqqs6yk4j,9122,9123,18245
13256,,onmdokktzr0j,9123,9124,18247
13257,,syjbbf3025ij,9124,9125,18249
13258,,ll4niyqbqngj,9125,9126,18251
13259,,url:http://www.springerlink.com/index/x426154m14231465.pdf,9126,9127,18253
13260,,npu37tnawpsj,9127,9128,18255
13261,,2lhwxxmngzyj,9128,9129,18257
13262,,z9pdp7ieikuj,9129,9130,18259
13263,,xc-joem6_vuj,9130,9131,18261
13264,,ohci04dsvigj,9131,9132,18263
13265,,xrltacxdvn0j,9132,9133,18265
13266,,oyfjqke8vx8j,9133,9134,18267
13267,,h5p6j2jcmm0j,9134,9135,18269
13268,,sjzitl6vzdgj,9135,9136,18271
13269,,3u8oliq2pgij,9136,9137,18273
13270,,cap3avmudusj,9137,9138,18275
13271,,d_1d4p70sdkj,9138,9139,18277
13272,,5y15ejspig0j,9139,9140,18279
13273,,xxbs4g8iq24j,9140,9141,18281
13274,,uulqzb0dkvgj,9141,9142,18283
13275,,katppkc68awj,9142,9143,18285
13276,,hxnlcwm_rhmj,9143,9144,18287
13277,,bhzvk2j49l8j,9144,9145,18289
13278,,2xtdi2wgl_uj,9145,9146,18291
13279,,gh3umb-slb0j,9146,9147,18293
13280,,af8yx25sjsej,9147,9148,18295
13281,,spcmrpurp4oj,9148,9149,18297
13282,,s2hob_ti63aj,9149,9150,18299
13283,,e3vg4ctgvlgj,9150,9151,18301
13284,,url:http://www.csa.com/partners/viewrecord.php3frequester3dgs26collection3dtrd26recid3d0294013ci,9151,9152,18303
13285,,y-783l2jpgwj,9152,9153,18305
13286,,0icu6p6bmjwj,9153,9154,18307
13287,,9js2axnhxlsj,9154,9155,18309
13288,,tjifqgru-nij,9155,9156,18311
13289,,prlfwtypm_8j,9156,9157,18313
13290,,2senk3nddykj,9157,9158,18315
13291,,qtben3bf7_cj,9158,9159,18317
13292,,r_asj_enmmcj,9159,9160,18319
13293,,w54gl9ndfcoj,9160,9161,18321
13294,,orddgvfxfbej,9161,9162,18323
13295,,mcj-duz0lcyj,9162,9163,18325
13296,,uu6vadxr1rqj,9163,9164,18327
13297,,db-gp-hh1zkj,9164,9165,18329
13298,,geisn6cftb8j,9165,9166,18331
13299,,j2bqhsjaeb8j,9166,9167,18333
13300,,b6jk0v8uymkj,9167,9168,18335
13301,,cbck_bu3liaj,9168,9169,18337
13302,,-2mm1b5rrf4j,9169,9170,18339
13303,,epieijdzi5ej,9170,9171,18341
13304,,zs0sqmxtzq8j,9171,9172,18343
13305,,f0a5vyb06sij,9173,9174,18347
13306,,nfivgfskcqij,9174,9175,18349
13307,,r5e8h4ycrvoj,9175,9176,18351
13308,,ysaofljq5cyj,9176,9177,18353
13309,,url:http://portal.acm.org/citation.cfm3fid3d335484,9177,9178,18355
13310,,nqcazxhkewmj,9178,9179,18357
13311,,n2nwd8qqxs4j,9179,9180,18359
13312,,pshucooxgosj,9180,9181,18361
13313,,upycvyb4htuj,9181,9182,18363
13314,,ipk43quye-kj,9182,9183,18365
13315,,e6dxyx0mkeij,9183,9184,18367
13316,,qb6mq3sbxdaj,9184,9185,18369
13317,,f5_a3w6lf9kj,9185,9186,18371
13318,,z8tfyrw_5_0j,9186,9187,18373
13319,,psslggcmvekj,9187,9188,18375
13320,,r_l5phti9xuj,9188,9189,18377
13321,,pobpjll4thgj,9189,9190,18379
13322,,uscau420facj,9190,9191,18381
13323,,aadgsurooeyj,9191,9192,18383
13324,,sahds9fewpij,9192,9193,18385
13325,,n55_fswbo-yj,9193,9194,18387
13326,,qarktitsosmj,9194,9195,18389
13327,,3fawpcjubsmj,9195,9196,18391
13328,,url:http://www.csa.com/partners/viewrecord.php3frequester3dgs26collection3dtrd26recid3dn9210587ah,9196,9197,18393
13329,,quuziidf3bkj,9197,9198,18395
13330,,xbnreuospk0j,9198,9199,18397
13331,,fmi_dryswuej,9199,9200,18399
13332,,kgjemn286laj,9200,9201,18401
13333,,idihl_7daocj,9201,9202,18403
13334,,ohmxtgmskduj,9202,9203,18405
13335,,mqwwg1z0fggj,9203,9204,18407
13336,,dcqm71frmtkj,9204,9205,18409
13337,,3sgtke-wi4kj,9205,9206,18411
13338,,h0cqaw9xlt0j,9206,9207,18413
13339,,c8c3asw0vpgj,9207,9208,18415
13340,,0mjzbbbmixgj,9208,9209,18417
13341,,b-aaktocty0j,9209,9210,18419
13342,,un5vu5lr2aaj,9210,9211,18421
13343,,ghxxdjwvm1yj,9211,9212,18423
13344,,-r1qoch0rv4j,9212,9213,18425
13345,,rt8a02omxy8j,9213,9214,18427
13346,,url:http://portal.acm.org/ft_gateway.cfm3fid3d110134326type3dpdf,9214,9215,18429
13347,,xqqb8qboiysj,9215,9216,18431
13348,,url:http://portal.acm.org/ft_gateway.cfm3fid3d109968426type3dpdf,9216,9217,18433
13349,,wb_ss6uprquj,9217,9218,18435
13350,,faxfsvcvfqgj,9218,9219,18437
13351,,ym37qkjjxdaj,9219,9220,18439
13352,,jm_9wxtv2vkj,9220,9221,18441
13353,,fdyygijxshqj,9221,9222,18443
13354,,jufv4406yxoj,9222,9223,18445
13355,,fc7iz_zdwlyj,9223,9224,18447
13356,,ywzknlix2m8j,9224,9225,18449
13357,,xeftvuozj1ij,9225,9226,18451
13358,,87xcuvyr3sqj,9226,9227,18453
13359,,kb8gd2xepl0j,9227,9228,18455
13360,,vsw63cmzvsmj,9228,9229,18457
13361,,url:http://doi.wiley.com/10.1002/he.84,9229,9230,18459
13362,,mut8u7ihg3sj,9230,9231,18461
13363,,0cgfrt1-ni0j,9231,9232,18463
13364,,6gk7k-oqgeuj,9232,9233,18465
13365,,pnf0ycqjeekj,9233,9234,18467
13366,,4sy9ayqvcfcj,9234,9235,18469
13367,,0mixv77fkbyj,9235,9236,18471
13368,,mdqkk7ziw84j,9236,9237,18473
13369,,0imadmjbltaj,9237,9238,18475
13370,,o8eltykcvjqj,9238,9239,18477
13371,,6w3z9hittqqj,9239,9240,18479
13372,,url:http://portal.acm.org/citation.cfm3fid3d983028.98303126coll3dguide26dl3dacm26idx3dj68926part3dperiodical26wanttype3dperiodical26title3dacm2520sigmod2520record26cfid3d1111111126cftoken3d2222222,9240,9241,18481
13373,,5arjuperddmj,9241,9242,18483
13374,,ubtg7filzoyj,9242,9243,18485
13375,,h9bjf9ssafej,9243,9244,18487
13376,,crkvvynthsuj,9244,9245,18489
13377,,xxswd822fc8j,9245,9246,18491
13378,,e-0jettsmuaj,9247,9248,18495
13379,,mehsclla7wij,9248,9249,18497
13380,,0voonz-wa_uj,9249,9250,18499
13381,,pul2teuqkeyj,9250,9251,18501
13382,,k-9s0thvu1uj,9251,9252,18503
13383,,jpjjyl65tgmj,9252,9253,18505
13384,,x1uqyvzflb8j,9253,9254,18507
13385,,,9254,9255,18509
13386,,nb0odntgu7qj,9255,9256,18511
13387,,jhygiy_soo0j,9256,9257,18513
13388,,ehemobchvwmj,9257,9258,18515
13389,,34yme5n1v_wj,9258,9259,18517
13390,,url:http://portal.acm.org/ft_gateway.cfm3fid3d107322426type3dpdf,9259,9260,18519
13391,,oanzji_-7tsj,9260,9261,18521
13392,,rqdko6yf2xij,9261,9262,18523
13393,,edm6-wydpmuj,9262,9263,18525
13394,,mc7lrbencukj,9263,9264,18527
13395,,cgzyjtmndcej,9264,9265,18529
13396,,gm2cvhoprtij,9265,9266,18531
13397,,07ntg1ls62kj,9266,9267,18533
13398,,ekhj9lmrjr4j,9267,9268,18535
13399,,vlyk92-risqj,9268,9269,18537
13400,,nvcoeskdi5yj,9269,9270,18539
13401,,rzsjog-0kaij,9271,9272,18543
13402,,xbtoiyjjbrsj,9272,9273,18545
13403,,r1lubgx-zlwj,9273,9274,18547
13404,,xj0ivddktv0j,9274,9275,18549
13405,,url:http://www.ingentaconnect.com/search/expand3fpub3dinfobike://els/09505849/1999/00000041/00000007/art0000426unc3d,9275,9276,18551
13406,,4cgl-qybgkuj,9276,9277,18553
13407,,7vl3hyst9_cj,9277,9278,18555
13408,,ohdzmd_4aaaj,9278,9279,18557
13409,,dwdpjqfw7hsj,9279,9280,18559
13410,,fgozmfxjf-uj,9280,9281,18561
13411,,mw6rfabkodsj,9281,9282,18563
13412,,edlrohx4m8mj,9282,9283,18565
13413,,url:http://doi.wiley.com/10.1002/ev.1255,9283,9284,18567
13414,,gfygs0wxynkj,9284,9285,18569
13415,,g5pjn-hss-qj,9285,9286,18571
13416,,jrxnqzys-sgj,9286,9287,18573
13417,,qqnhkvv3bj0j,9287,9288,18575
13418,,qedte3ujgd8j,9288,9289,18577
13419,,url:http://www.springerlink.com/index/p4q0445827654287.pdf,9289,9290,18579
13420,,qwhpxiqwowwj,9290,9291,18581
13421,,qixh2yb-nh0j,9291,9292,18583
13422,,f6-f0knfeioj,9292,9293,18585
13423,,crclco3sf2ej,9293,9294,18587
13424,,lxn3whbokq0j,9294,9295,18589
13425,,x0fku9mqah0j,9295,9296,18591
13426,,j0ku8qcgzcgj,9296,9297,18593
13427,,wwb_njfpamkj,9297,9298,18595
13428,,lnblonu7idkj,9298,9299,18597
13429,,_0azwgjc2m4j,9299,9300,18599
13430,,ycjip8n8unmj,9300,9301,18601
13431,,dwrl7xygmlqj,9301,9302,18603
13432,,oimpmvfkow8j,9302,9303,18605
13433,,2nylvtuhchij,9303,9304,18607
13434,,q2lyjiu9c2gj,9304,9305,18609
13435,,pzk6d7251u8j,9305,9306,18611
13436,,wn8ekvd-ewuj,9306,9307,18613
13437,,m7dcqnzavm0j,9307,9308,18615
13438,,063e6wiopaqj,9308,9309,18617
13439,,18_r28t9icyj,9309,9310,18619
13440,,l22snd5ymmej,9310,9311,18621
13441,,dun0lhremhoj,9311,9312,18623
13442,,eglwz2ftbfgj,9312,9313,18625
13443,,kxiicscy3gwj,9313,9314,18627
13444,,c7mplbxl0qaj,9314,9315,18629
13445,,ehnugnuwkbqj,9315,9316,18631
13446,,zgtnj81p2ccj,9316,9317,18633
13447,,nj8bj1xe3jej,9317,9318,18635
13448,,gcak1ih3bxcj,9318,9319,18637
13449,,0s4l73146p4j,9319,9320,18639
13450,,x0yc8yr95fwj,9320,9321,18641
13451,,fm69lhjs4t0j,9321,9322,18643
13452,,q_7vrbprdfqj,9322,9323,18645
13453,,idk_jwgthcuj,9323,9324,18647
13454,,tngik87bicij,9324,9325,18649
13455,,zvqyo3ohhv4j,9325,9326,18651
13456,,hiphy23fuaqj,9326,9327,18653
13457,,gob9rsyxbgwj,9327,9328,18655
13458,,5dg2g33fvzuj,9328,9329,18657
13459,,p_-nn4hnbq4j,9329,9330,18659
13460,,lg8yejb8jmaj,9330,9331,18661
13461,,tr7ob8-rqfwj,9331,9332,18663
13462,,x0gqs3dvmikj,9332,9333,18665
13463,,fafxr2w9d1qj,9333,9334,18667
13464,,xvo0klb8ajwj,9334,9335,18669
13465,,g4anuwdend4j,9335,9336,18671
13466,,wlsenjs09jqj,9337,9338,18675
13467,,q7kyg1h7mggj,9338,9339,18677
13468,,vuvnbchnmacj,9339,9340,18679
13469,,vx3qhezrayoj,9340,9341,18681
13470,,q-yrfqbcblwj,9341,9342,18683
13471,,hx83yponakkj,9342,9343,18685
13472,,xvpvikfzu0qj,9343,9344,18687
13473,,url:http://www.csa.com/partners/viewrecord.php3frequester3dgs26collection3dtrd26recid3d200124027168ce26recid3dn9210562ah,9344,9345,18689
13474,,0vs3frihw60j,9345,9346,18691
13475,,ufviie9yg_ej,9346,9347,18693
13476,,oyg-yvisxhkj,9347,9348,18695
13477,,2a2r9k04pr4j,9348,9349,18697
13478,,a3seoymwpxmj,9349,9350,18699
13479,,t8mv1mnqa2oj,9350,9351,18701
13480,,fzwjztu5qbkj,9351,9352,18703
13481,,esznzrsbxh4j,9352,9353,18705
13482,,h7risokimtwj,9353,9354,18707
13483,,bag9zkqkgkwj,9354,9355,18709
13484,,3q9_dy_hzc8j,9355,9356,18711
13485,,w9lv3gv85wij,9356,9357,18713
13486,,naexopajyrej,9357,9358,18715
13487,,33mexarsed0j,9358,9359,18717
13488,,cvm1psjhjyaj,9359,9360,18719
13489,,1cyegct952yj,9360,9361,18721
13490,,url:http://portal.acm.org/ft_gateway.cfm3fid3d108624726type3dpdf,9361,9362,18723
13491,,dccblfewtfej,9362,9363,18725
13492,,mib9nfd-y8mj,9363,9364,18727
13493,,qereos5selsj,9364,9365,18729
13494,,huvllih8odmj,9365,9366,18731
13495,,z6zobm43limj,9366,9367,18733
13496,,slweqmi00aaj,9367,9368,18735
13497,,hggduxxk_aij,9368,9369,18737
13498,,d_tcs04yqz0j,9369,9370,18739
13499,,3max6eynjfyj,9370,9371,18741
13500,,wjsq7ciboewj,9371,9372,18743
13501,,vt6v9qski2uj,9372,9373,18745
13502,,m-feol4m4ncj,9373,9374,18747
13503,,glisjwqaq88j,9374,9375,18749
13504,,fr1h4tu9fosj,9375,9376,18751
13505,,n1nje6fekpcj,9376,9377,18753
13506,,caf0mx7oftmj,9377,9378,18755
13507,,pjvvi7_zfhej,9378,9379,18757
13508,,o-h_7cqrxguj,9380,9381,18761
13509,,v5vl5ykbwnij,9382,9383,18765
13510,,eswcac0p7hyj,9383,9384,18767
13511,,o5vyy_c62qyj,9384,9385,18769
13512,,wqaz-ii_gykj,9385,9386,18771
13513,,2s1bqb2m9awj,9386,9387,18773
13514,,zgl2lyjpb0ej,9387,9388,18775
13515,,1ausn-_nkd0j,9388,9389,18777
13516,,u-0aqdcdis4j,9389,9390,18779
13517,,gsz6mr-w3xkj,9390,9391,18781
13518,,tlezqbs-_wmj,9391,9392,18783
13519,,ft5psub-utyj,9392,9393,18785
13520,,umsb6ykynzqj,9394,9395,18789
13521,,s1rzr4imj8ej,9395,9396,18791
13522,,zmv33rrmqlqj,9396,9397,18793
13523,,6_9ymn15qp4j,9397,9398,18795
13524,,w1_i-z94efej,9398,9399,18797
13525,,h6vhr6i2jwij,9399,9400,18799
13526,,cxzl0zts5ugj,9400,9401,18801
13527,,yx1nhlqxfbkj,9401,9402,18803
13528,,e_tcdegwigqj,9402,9403,18805
13529,,y_yqfhb2g2yj,9403,9404,18807
13530,,url:http://doi.wiley.com/10.1002/ace.105,9404,9405,18809
13531,,byv1jyneeo8j,9405,9406,18811
13532,,,9406,9407,18813
13533,,omg7lsunuouj,9407,9408,18815
13534,,jrxmrjghxxej,9408,9409,18817
13535,,mrz-hw5utxsj,9409,9410,18819
13536,,9qnhxy7ofp4j,9410,9411,18821
13537,,wxkm0x9k1fuj,9411,9412,18823
13538,,gtxdhtov6fwj,9412,9413,18825
13539,,ixekmyci4koj,9413,9414,18827
13540,,039b5nmaynaj,9414,9415,18829
13541,,dmqfcve0_egj,9415,9416,18831
13542,,jcujbdsbmgaj,9416,9417,18833
13543,,cqkuwcnyvaej,9417,9418,18835
13544,,ayggdz-4zymj,9418,9419,18837
13545,,psqtnm6kg50j,9419,9420,18839
13546,,lv9kjhme-cej,9420,9421,18841
13547,,v2feeaysva4j,9421,9422,18843
13548,,ccsbkp9gpuej,9422,9423,18845
13549,,9fltflcrxeyj,9423,9424,18847
13550,,dcbsl4cqaxij,9424,9425,18849
13551,,nu55xp_z81aj,9425,9426,18851
13552,,url:http://www.csa.com/partners/viewrecord.php3frequester3dgs26collection3dtrd26recid3d800738co,9426,9427,18853
13553,,lmalqkabmwyj,9427,9428,18855
13554,,y5-iqr5ncy8j,9428,9429,18857
13555,,qc05qmjk1vmj,9429,9430,18859
13556,,ml7to5mjhf8j,9430,9431,18861
13557,,b62dkweqbuqj,9431,9432,18863
13558,,wbavguabbjmj,9432,9433,18865
13559,,5ooas2wmxycj,9433,9434,18867
13560,,sqftwccluk4j,9434,9435,18869
13561,,2rvkzn0ypomj,9435,9436,18871
13562,,url:http://www.ncbi.nlm.nih.gov/entrez/query.fcgi3fcmd3dretrieve26db3dpubmed26list_uids3d1293427326dopt3dcitation,9436,9437,18873
13563,,kpjbdra9bg8j,9437,9438,18875
13564,,r5n4lhwykeoj,9438,9439,18877
13565,,flzliipg2esj,9439,9440,18879
13566,,q7ulz8vhneyj,9440,9441,18881
13567,,,9441,9442,18883
13568,,url:http://doi.wiley.com/10.1002/ace.131,9442,9443,18885
13569,,knnpwlgkdxsj,9443,9444,18887
13570,,4hngiy17egqj,9444,9445,18889
13571,,mhubedlndwyj,9445,9446,18891
13572,,7isfotdscxmj,9446,9447,18893
13573,,94k_drrmp30j,9447,9448,18895
13574,,kn-ffgscct0j,9448,9449,18897
13575,,8tkrvqx68ywj,9449,9450,18899
13576,,c6gpvbwlh8cj,9450,9451,18901
13577,,url:http://www.csa.com/partners/viewrecord.php3frequester3dgs26collection3dtrd26recid3dn9210535ah,9451,9452,18903
13578,,url:http://www.springerlink.com/index/lt7jx34632537374.pdf,9452,9453,18905
13579,,nklett5c1s0j,9453,9454,18907
13580,,diqk_rsrwjmj,9454,9455,18909
13581,,_snvblke6byj,9455,9456,18911
13582,,2-boxd2r-vej,9456,9457,18913
13583,,ntm7nvles-uj,9457,9458,18915
13584,,x_utvvht4boj,9458,9459,18917
13585,,our5o4b8idwj,9459,9460,18919
13586,,o2lwvreid00j,9460,9461,18921
13587,,izmp-pnu-hgj,9461,9462,18923
13588,,daj-k1g9wkaj,9462,9463,18925
13589,,mxjxhd7widaj,9463,9464,18927
13590,,u6vkktmjaqsj,9465,9466,18931
13591,,dhvr99lpe9yj,9466,9467,18933
13592,,nali42wolt4j,9467,9468,18935
13593,,u-0hholnvc0j,9468,9469,18937
13594,,fn5faq5glz0j,9469,9470,18939
13595,,tmjghpnn3sij,9470,9471,18941
13596,,xs2afioqn6kj,9471,9472,18943
13597,,9bpsxey5d4uj,9473,9474,18947
13598,,pbw-_ssaufaj,9474,9475,18949
13599,,c35dbeso_tuj,9475,9476,18951
13600,,kynxpn2kp_kj,9476,9477,18953
13601,,k5zrytg8kpuj,9478,9479,18957
13602,,kupipx3q02sj,9479,9480,18959
13603,,xd6denvlp5ij,9480,9481,18961
13604,,url:http://adsabs.harvard.edu/abs/1991mit..reptq....c,9481,9482,18963
13605,,p8xjxeot--gj,9482,9483,18965
13606,,eiz0rrl17tyj,9483,9484,18967
13607,,j6s7nyc-pt0j,9484,9485,18969
13608,,rcwekwliwjqj,9485,9486,18971
13609,,f-b7ofwqtnmj,9486,9487,18973
13610,,url:http://www.csa.com/partners/viewrecord.php3frequester3dgs26collection3dtrd26recid3dn9210494ah,9487,9488,18975
13611,,ramn3g_cptyj,9488,9489,18977
13612,,moy_-11bvsyj,9489,9490,18979
13613,,qrkto-nov3mj,9490,9491,18981
13614,,fog1fbh5x6aj,9491,9492,18983
13615,,eceanvhdmp0j,9492,9493,18985
13616,,jf7bivvy8jij,9493,9494,18987
13617,,ltc6qsdernwj,9494,9495,18989
13618,,upvxe6vjrssj,9495,9496,18991
13619,,oqr_lw8xykij,9496,9497,18993
13620,,wsnbltzmbuyj,9497,9498,18995
13621,,kd7x5y6utkaj,9499,9500,18999
13622,,wjkdvpce0poj,9500,9501,19001
13623,,,9501,9502,19003
13624,,tt3rkgfkvmcj,9502,9503,19005
13625,,nakxdr3wekwj,9503,9504,19007
13626,,gn9anh1l_y4j,9504,9505,19009
13627,,4zgr5snn3zoj,9505,9506,19011
13628,,ce-cnactxeqj,9506,9507,19013
13629,,wecytiw_iiej,9507,9508,19015
13630,,cbwq3jsxrsaj,9508,9509,19017
13631,,d1yi0spvnysj,9509,9510,19019
13632,,yfj9qmap740j,9510,9511,19021
13633,,hxqhduy-27aj,9511,9512,19023
13634,,borsbq_t2xcj,9512,9513,19025
13635,,eevzek727-8j,9513,9514,19027
13636,,h2dgc0mmtgij,9514,9515,19029
13637,,,9515,9516,19031
13638,,url:http://journals.iucr.org/c/issues/1996/12/00/bk1270/bk1270.pdf,9516,9517,19033
13639,,w1c_okmlijyj,9517,9518,19035
13640,,djiq1ddh7g4j,9518,9519,19037
13641,,7zsm_dsizpij,9519,9520,19039
13642,,ueo7gcciq6ij,9520,9521,19041
13643,,fnyazvukg7qj,9521,9522,19043
13644,,q5q6lrg5wjmj,9522,9523,19045
13645,,ll8gro5axamj,9523,9524,19047
13646,,hyv-gmjnjhgj,9524,9525,19049
13647,,fp-tq5emr5oj,9525,9526,19051
13648,,wugpcneu2kqj,9526,9527,19053
13649,,2njahdhfzaoj,9527,9528,19055
13650,,gxxlcfhszioj,9528,9529,19057
13651,,svxzhbwarp8j,9529,9530,19059
13652,,2csv0jzhaymj,9530,9531,19061
13653,,k19di4v3eauj,9531,9532,19063
13654,,_c26cgybqwmj,9532,9533,19065
13655,,vcp9gbsnczgj,9533,9534,19067
13656,,voh3tenjkjij,9534,9535,19069
13657,,_m2pp21m2-uj,9535,9536,19071
13658,,url:http://portal.acm.org/ft_gateway.cfm3fid3d63741726type3dpdf26coll3dguide26dl3dacm26cfid3d1111111126cftoken3d2222222,9536,9537,19073
13659,,zobnujtyse8j,9537,9538,19075
13660,,ehbnshpsn5cj,9538,9539,19077
13661,,w12lk5bumqqj,9539,9540,19079
13662,,aes9u8zylf8j,9541,9542,19083
13663,,url:http://www.csa.com/partners/viewrecord.php3frequester3dgs26collection3dtrd26recid3dn9210546ah,9542,9543,19085
13664,,xlld3hq3vt0j,9543,9544,19087
13665,,nuh-9l-flooj,9544,9545,19089
13666,,pvcog8lb5woj,9545,9546,19091
13667,,wtqxebqwlroj,9546,9547,19093
13668,,prdng0smcsoj,9547,9548,19095
13669,,v4b2nabejs8j,9548,9549,19097
13670,,ujutjqu-ugcj,9549,9550,19099
13671,,nsdndiujw3oj,9550,9551,19101
13672,,s5xcrd8mf3wj,9551,9552,19103
13673,,ikaqgglfuduj,9552,9553,19105
13674,,birgyxsqr-kj,9553,9554,19107
13675,,url:http://portal.acm.org/citation.cfm3fid3d984403.98440626dl3dportal26dl3dacm26idx3d98440326part3dperiodical26wanttype3dperiodical26title3dacm2520sigmod2520record26cfid3d1111111126cftoken3d2222222,9554,9555,19109
13676,,hyp7efa5kx0j,9555,9556,19111
13677,,xwyog7xt4tqj,9557,9558,19115
13678,,hrm5fjbfqhsj,9558,9559,19117
13679,,yqbfozc2x18j,9559,9560,19119
13680,,lyk6swvmzl0j,9560,9561,19121
13681,,ohb9jh10zuyj,9561,9562,19123
13682,,zkpukposvl4j,9562,9563,19125
13683,,yfzqr5g9yh4j,9563,9564,19127
13684,,n690sxz0q88j,9564,9565,19129
13685,,zc81ld31flyj,9565,9566,19131
13686,,pkbtg0vnvtij,9566,9567,19133
13687,,lt3xyoc4zmej,9567,9568,19135
13688,,rikdicljffej,9568,9569,19137
13689,,frv36jzay1wj,9569,9570,19139
13690,,m-im3n5f0quj,9570,9571,19141
13691,,ue9sxuevygsj,9571,9572,19143
13692,,vtsrcmejp70j,9572,9573,19145
13693,,yyl6i-ixbjaj,9573,9574,19147
13694,,url:http://www.springerlink.com/index/j6811p0488112055.pdf,9575,9576,19151
13695,,url:http://www.springerlink.com/index/x0t44088kh546638.pdf,9576,9577,19153
13696,,p_0v9d9e3qwj,9577,9578,19155
13697,,skbpzfobl14j,9578,9579,19157
13698,,gjdcr763iaej,9579,9580,19159
13699,,zzvtsxrebwoj,9580,9581,19161
13700,,sflxeexy_gmj,9581,9582,19163
13701,,azc0qgxlgu8j,9582,9583,19165
13702,,3zr5uyytvdkj,9583,9584,19167
13703,,2fxjx5qnzyyj,9584,9585,19169
13704,,nrxvpmcnk3ij,9585,9586,19171
13705,,url:http://doi.wiley.com/10.1002/tl.7706,9586,9587,19173
13706,,sa9fbndlnckj,9587,9588,19175
13707,,puf33gpxjcmj,9588,9589,19177
13708,,6duplnabghyj,9589,9590,19179
13709,,42xippygxpuj,9590,9591,19181
13710,,q3zjxqmrtncj,9591,9592,19183
13711,,en1mhbes2r8j,9592,9593,19185
13712,,enz84yk77x8j,9593,9594,19187
13713,,8aapmwoalgyj,9594,9595,19189
13714,,q4oxcfempf8j,9595,9596,19191
13715,,dwyggqfjqsqj,9596,9597,19193
13716,,9jejrpbr8g8j,9597,9598,19195
13717,,url:http://www.csa.com/partners/viewrecord.php3frequester3dgs26collection3dtrd26recid3d0332246ci,9598,9599,19197
13718,,yhjakw9ff-wj,9599,9600,19199
13719,,wkldv8de4ncj,9600,9601,19201
13720,,kmkr9xrv324j,9601,9602,19203
13721,,afnsm5tarjcj,9602,9603,19205
13722,,1l4tskv9s_gj,9603,9604,19207
13723,,w_gvsilh7iej,9604,9605,19209
13724,,pedbdceofqgj,9605,9606,19211
13725,,url:http://doi.wiley.com/10.1002/tl.49,9606,9607,19213
13726,,dzbsn_mjm5gj,9607,9608,19215
13727,,ongayxnw0-8j,9608,9609,19217
13728,,sm5qi-ynoxuj,9609,9610,19219
13729,,sb9aknflwmmj,9611,9612,19223
13730,,e6qxyq5ku6mj,9612,9613,19225
13731,,10ocxsirzxej,9613,9614,19227
13732,,kpwqycbogq0j,9614,9615,19229
13733,,hcdahckkfoqj,9615,9616,19231
13734,,aicvguigkcoj,9616,9617,19233
13735,,piquafvxunuj,9617,9618,19235
13736,,oofbft1jv-8j,9618,9619,19237
13737,,c4chufq9o94j,9619,9620,19239
13738,,url:http://portal.acm.org/citation.cfm3fid3d28934926coll3dportal26dl3dacm,9620,9621,19241
13739,,ei_bpryx_ksj,9621,9622,19243
13740,,wiepg5txwf0j,9622,9623,19245
13741,,4jeqven9odkj,9623,9624,19247
13742,,ldlnxvs7iasj,9624,9625,19249
13743,,lu-u52zs3luj,9625,9626,19251
13744,,_b0qtldtr7sj,9626,9627,19253
13745,,dbtg7__m99cj,9627,9628,19255
13746,,rzsxzt2ucoqj,9628,9629,19257
13747,,8xjy7bsjqf8j,9629,9630,19259
13748,,budbh6u8zzaj,9630,9631,19261
13749,,7g4celfeh7ej,9631,9632,19263
13750,,t6ktjxvxwj4j,9632,9633,19265
13751,,hpl-2o_z4bsj,9633,9634,19267
13752,,vhlgpckdeugj,9634,9635,19269
13753,,bnu2lw6mgk8j,9635,9636,19271
13754,,url:http://portal.acm.org/citation.cfm3fid3d604264.60427626dl3dguide26dl3dacm26cfid3d1111111126cftoken3d2222222,9637,9638,19275
13755,,mu86ynpjza8j,9638,9639,19277
13756,,4wmyggspfxqj,9640,9641,19281
13757,,bmgzx0tpfykj,9641,9642,19283
13758,,qbku0yzx9cqj,9643,9644,19287
13759,,utt1zw1-figj,9644,9645,19289
13760,,pcxwdupjfwej,9645,9646,19291
13761,,url:http://portal.acm.org/citation.cfm3fid3d171926.171933,9646,9647,19293
13762,,url:http://doi.wiley.com/10.1002/tl.7008,9647,9648,19295
13763,,evawmo8bjsmj,9649,9650,19299
13764,,ypui7tdisdkj,9650,9651,19301
13765,,me-wa8tti6ij,9651,9652,19303
13766,,kmulyukbgvoj,9652,9653,19305
13767,,uy2461o2p5oj,9653,9654,19307
13768,,2gmumqpeoymj,9654,9655,19309
13769,,nif9sc2wlowj,9655,9656,19311
13770,,url:http://ieeexplore.ieee.org/iel5/69/29318/01324635.pdf3farnumber3d1324635,9656,9657,19313
13771,,btmtrmg9gecj,9657,9658,19315
13772,,2jqpgj9s_w0j,9658,9659,19317
13773,,gtiwsgpzyxkj,9659,9660,19319
13774,,lc2_sk3i42yj,9660,9661,19321
13775,,9kbswejrck4j,9661,9662,19323
13776,,ci12sfusvloj,9662,9663,19325
13777,,nnjf3y_3pv0j,9663,9664,19327
13778,,e7bzlk-q5vmj,9664,9665,19329
13779,,oinljjpxtjkj,9665,9666,19331
13780,,url:http://portal.acm.org/citation.cfm3fid3d320473,9666,9667,19333
13781,,yy3ecklgcb0j,9667,9668,19335
13782,,a9eklqzvl8ij,9668,9669,19337
13783,,wikciyaltzuj,9669,9670,19339
13784,,m5t9xmkdi_sj,9670,9671,19341
13785,,7mtcmb1fo5cj,9672,9673,19345
13786,,jydeoz9hvjqj,9673,9674,19347
13787,,f1b7ayzpcsgj,9674,9675,19349
13788,,4b2-u2npkksj,9675,9676,19351
13789,,zevwlpbrmj4j,9676,9677,19353
13790,,5fsqmjg7fv4j,9677,9678,19355
13791,,psm9b42te9qj,9678,9679,19357
13792,,j2upyvvud90j,9679,9680,19359
13793,,j8jeb6ymrmej,9680,9681,19361
13794,,md1h5e8helsj,9681,9682,19363
13795,,spvddglvflqj,9682,9683,19365
13796,,wgsmxsxmbcaj,9683,9684,19367
13797,,pqujkxdlrxyj,9684,9685,19369
13798,,url:http://portal.acm.org/ft_gateway.cfm3fid3d110117326type3dpdf,9685,9686,19371
13799,,s-wgjk0dbtyj,9686,9687,19373
13800,,ab3jdetohjuj,9687,9688,19375
13801,,csdgh7ezhpwj,9689,9690,19379
13802,,1sfflopufkaj,9690,9691,19381
13803,,zztneauqxrgj,9691,9692,19383
13804,,3ykrv0l_6w0j,9692,9693,19385
13805,,cxmy2sn8wi0j,9694,9695,19389
13806,,xvnbokc3ukcj,9695,9696,19391
13807,,6rhdcfyazw4j,9696,9697,19393
13808,,e2bipixzlkyj,9697,9698,19395
13809,,dzu9usi6e1cj,9698,9699,19397
13810,,url:http://www.csa.com/partners/viewrecord.php3frequester3dgs26collection3dtrd26recid3dn9210492ah,9699,9700,19399
13811,,mgt6iem77vaj,9700,9701,19401
13812,,bdjcfbalxouj,9701,9702,19403
13813,,url:http://portal.acm.org/ft_gateway.cfm3fid3d102769626type3dpdf,9702,9703,19405
13814,,n-w35ayr4eyj,9703,9704,19407
13815,,ca5828ll8yuj,9704,9705,19409
13816,,url:http://journals.iucr.org/c/issues/1995/07/00/jz1027/jz1027.pdf,9705,9706,19411
13817,,dt3zeqn0dbkj,9706,9707,19413
13818,,yhw2voyl-myj,9707,9708,19415
13819,,url:http://doi.wiley.com/10.1002/ev.1659,9708,9709,19417
13820,,,9710,9711,19421
13821,,nklfztmb3dsj,9711,9712,19423
13822,,ykaiqgwsdlmj,9712,9713,19425
13823,,njybdn_phvwj,9713,9714,19427
13824,,8i1uldtksu4j,9714,9715,19429
13825,,86c5wjrpdayj,9715,9716,19431
13826,,_okld2dxvv4j,9716,9717,19433
13827,,lein8ojzdf4j,9717,9718,19435
13828,,9djqf4a0aa0j,9718,9719,19437
13829,,wwldfr2b9bgj,9720,9721,19441
13830,,kxpknoddt0uj,9721,9722,19443
13831,,_1nrgljjrzij,9722,9723,19445
13832,,02kbnykunlgj,9723,9724,19447
13833,,url:http://portal.acm.org/ft_gateway.cfm3fid3d110192126type3dpdf,9724,9725,19449
13834,,ymzonnw063ij,9725,9726,19451
13835,,hou-smkuja4j,9726,9727,19453
13836,,fr_wsbcbopmj,9727,9728,19455
13837,,qet8ckh1kk0j,9728,9729,19457
13838,,url:http://www.ingentaconnect.com/content/els/08830355/2001/00000035/00000006/art00013,9729,9730,19459
13839,,hap-9j7zw0qj,9730,9731,19461
13840,,nmwnhkxvs2oj,9731,9732,19463
13841,,yuryfqjzpg4j,9732,9733,19465
13842,,tn7hwsdrmy4j,9733,9734,19467
13843,,uhl7jkpbtawj,9734,9735,19469
13844,,ilcfvkneofqj,9735,9736,19471
13845,,irhicgtx_usj,9736,9737,19473
13846,,agfqtzsb48qj,9737,9738,19475
13847,,url:http://portal.acm.org/citation.cfm3fid3d983066,9738,9739,19477
13848,,zqwtlqemgggj,9739,9740,19479
13849,,gyrfdl5rdlgj,9740,9741,19481
13850,,jq0pqo_k1duj,9741,9742,19483
13851,,4u-dvgztlqaj,9742,9743,19485
13852,,ijf404ib8u4j,9744,9745,19489
13853,,azz1nh5izw0j,9745,9746,19491
13854,,1pxa_iehinij,9746,9747,19493
13855,,p6qjvn5mkcij,9747,9748,19495
13856,,nikschxjti0j,9748,9749,19497
13857,,url:http://portal.acm.org/ft_gateway.cfm3fid3d95711526type3dpdf26dl3dportal26dl3dacm26cfid3d1111111126cftoken3d2222222,9749,9750,19499
13858,,e39dyvjw5zyj,9750,9751,19501
13859,,w_35ukrxtf4j,9751,9752,19503
13860,,rvwzioaaaw8j,9752,9753,19505
13861,,osyxdl1zexgj,9753,9754,19507
13862,,p_lyms9onoyj,9754,9755,19509
13863,,cvkkz2csnfwj,9755,9756,19511
13864,,wstbqcjr5psj,9756,9757,19513
13865,,ljvm7i4rgpaj,9757,9758,19515
13866,,,9758,9759,19517
13867,,mhlm6vu873kj,9759,9760,19519
13868,,_xi0_vofbaaj,9760,9761,19521
13869,,avubi7rjcuoj,9761,9762,19523
13870,,2fsbguewzwkj,9762,9763,19525
13871,,v1fqpz_c0qgj,9764,9765,19529
13872,,eoveyp73nzij,9765,9766,19531
13873,,fwrjsi9_52wj,9766,9767,19533
13874,,oyrvs0a52zaj,9767,9768,19535
13875,,alzf6ic2j8gj,9768,9769,19537
13876,,3kqnstuvq70j,9769,9770,19539
13877,,s6npt_maxuaj,9770,9771,19541
13878,,mcrhxncbywmj,9771,9772,19543
13879,,anvvy4s5vwsj,9772,9773,19545
13880,,ialrws3f1xoj,9773,9774,19547
13881,,st7w8mkrwrwj,9774,9775,19549
13882,,v5sugcoqkucj,9775,9776,19551
13883,,0jovhwx0hayj,9776,9777,19553
13884,,_zhaz0-byccj,9777,9778,19555
13885,,tt68nq6cfrgj,9778,9779,19557
13886,,b10xhvaskuoj,9779,9780,19559
13887,,url:http://portal.acm.org/citation.cfm3fid3d36208426dl3dguide26dl3dacm26type3dissue26idx3dj68926part3dperiodical26wanttype3dperiodical26title3dacm2520sigmod2520record26cfid3d1111111126cftoken3d2222222,9781,9782,19563
13888,,nm9bjesswnoj,9782,9783,19565
13889,,0svv6fr9pvsj,9783,9784,19567
13890,,50mmemgpcraj,9784,9785,19569
13891,,_ccwocy3unmj,9785,9786,19571
13892,,v1vm6d0birsj,9787,9788,19575
13893,,l8vveg2kyowj,9788,9789,19577
13894,,nq1hyxvmzsoj,9789,9790,19579
13895,,sz7bdg-adnsj,9790,9791,19581
13896,,r1xnlufugfgj,9791,9792,19583
13897,,tfp9wufdnnyj,9792,9793,19585
13898,,lyhuutatvtsj,9793,9794,19587
13899,,iucyid4bdkcj,9794,9795,19589
13900,,hze-edqb6j4j,9795,9796,19591
13901,,kjaqndx-hqkj,9796,9797,19593
13902,,7scsx7jeyowj,9797,9798,19595
13903,,url:http://portal.acm.org/ft_gateway.cfm3fid3d106626326type3dpdf,9798,9799,19597
13904,,url:http://www.csa.com/partners/viewrecord.php3frequester3dgs26collection3dtrd26recid3d0835443ci,9799,9800,19599
13905,,gwamzkreaeoj,9800,9801,19601
13906,,8nluhtfbh7ej,9801,9802,19603
13907,,ulgzjib9aiaj,9802,9803,19605
13908,,gctt_lvme2kj,9803,9804,19607
13909,,oqwbs_khvysj,9804,9805,19609
13910,,8nqsypga09ij,9806,9807,19613
13911,,aszcgfgzhp4j,9807,9808,19615
13912,,pzdelkgmdkgj,9808,9809,19617
13913,,bkf7mgnmg-wj,9809,9810,19619
13914,,xhwps3p0hzgj,9810,9811,19621
13915,,1zxob79adlij,9811,9812,19623
13916,,6y-dxejcu9kj,9812,9813,19625
13917,,u8hmj6ox-k0j,9813,9814,19627
13918,,9gaybkyxhpgj,9814,9815,19629
13919,,mpfecl5c7wij,9815,9816,19631
13920,,5zrno3cuyjmj,9816,9817,19633
13921,,h4oue4yfcsaj,9817,9818,19635
13922,,j2acjmk6rymj,9818,9819,19637
13923,,uebdetnacxmj,9819,9820,19639
13924,,lihmmry7eqcj,9820,9821,19641
13925,,sxa76m0wbgyj,9821,9822,19643
13926,,wajwmfajstwj,9823,9824,19647
13927,,vp3lmhevyeqj,9824,9825,19649
13928,,mssifpr13kej,9825,9826,19651
13929,,k-xjvbzhttoj,9826,9827,19653
13930,,en4fx3_fnewj,9827,9828,19655
13931,,m0aymvd5c-qj,9828,9829,19657
13932,,_ukqviqhdguj,9829,9830,19659
13933,,do7sovf1tjwj,9830,9831,19661
13934,,wzm6j3tolsmj,9831,9832,19663
13935,,iq21cop1_f4j,9832,9833,19665
13936,,vq0lngys2zqj,9833,9834,19667
13937,,zm9bnlpc428j,9834,9835,19669
13938,,uotle4vdbfgj,9836,9837,19673
13939,,bz3elojfqlyj,9837,9838,19675
13940,,wlf0tjghbucj,9838,9839,19677
13941,,nj___bt9anij,9839,9840,19679
13942,,fg0dpiokfzqj,9840,9841,19681
13943,,mi8oosrnpxuj,9841,9842,19683
13944,,dgpmlmdb2coj,9842,9843,19685
13945,,ibshrgjq5nqj,9843,9844,19687
13946,,pgrbufszlkqj,9844,9845,19689
13947,,wregscgueuej,9845,9846,19691
13948,,u3ycrvcenhkj,9846,9847,19693
13949,,blwvf0a-ji8j,9847,9848,19695
13950,,e_w0agxyz8qj,9848,9849,19697
13951,,fjrrsyulql0j,9849,9850,19699
13952,,kdkfdusixhoj,9850,9851,19701
13953,,qzxto_zgu9uj,9851,9852,19703
13954,,xcs2aqvr5x8j,9852,9853,19705
13955,,6qrfu8owtfuj,9853,9854,19707
13956,,tumcd_asyrqj,9854,9855,19709
13957,,ghqgxpreohaj,9855,9856,19711
13958,,url:http://www.csa.com/partners/viewrecord.php3frequester3dgs26collection3dtrd26recid3d0437114ci26recid3d0437114ea,9856,9857,19713
13959,,ewvrothun0sj,9857,9858,19715
13960,,k7dhyrzumsoj,9858,9859,19717
13961,,yqrnxdgxmvej,9859,9860,19719
13962,,url:http://links.jstor.org/sici3fsici3d0146-4949(196423)5253a3253c213253atmcomc253e2.0.co253b2-o,9860,9861,19721
13963,,cbcdjgpxs9cj,9861,9862,19723
13964,,url:http://www.csa.com/partners/viewrecord.php3frequester3dgs26collection3dtrd26recid3dn9210469ah,9862,9863,19725
13965,,j1kseehmcu4j,9863,9864,19727
13966,,sobkq8ks0zij,9864,9865,19729
13967,,nnz7sceqj6ej,9865,9866,19731
13968,,r5lxzrvjvvwj,9866,9867,19733
13969,,xu11sqzh7l4j,9867,9868,19735
13970,,,9868,9869,19737
13971,,oznfpwmz1lcj,9869,9870,19739
13972,,zn-8benq_akj,9870,9871,19741
13973,,guyzx0dolwoj,9871,9872,19743
13974,,waj3u39ycmij,9872,9873,19745
13975,,iskonjiafbsj,9874,9875,19749
13976,,iy3oqylckbwj,9875,9876,19751
13977,,gl8xeeym7gsj,9876,9877,19753
13978,,hllyccdcb_uj,9877,9878,19755
13979,,6h_gc92fs70j,9878,9879,19757
13980,,sww5ow2xzsaj,9879,9880,19759
13981,,x4xgzn5qq0oj,9880,9881,19761
13982,,cclrcupjv00j,9881,9882,19763
13983,,vuepdoprotwj,9882,9883,19765
13984,,ycw1pkqskkoj,9883,9884,19767
13985,,ljetfssd60aj,9884,9885,19769
13986,,2nyee9qtugij,9885,9886,19771
13987,,4xsfo7mzqskj,9886,9887,19773
13988,,hr2nv5adxcoj,9887,9888,19775
13989,,pomm8ovtdlyj,9888,9889,19777
13990,,6srwyw06gjij,9889,9890,19779
13991,,hb1i1va9h64j,9890,9891,19781
13992,,moim_np_inyj,9891,9892,19783
13993,,akxipxm1gdoj,9892,9893,19785
13994,,wb6y5ww6x6mj,9893,9894,19787
13995,,vdusfne_8i8j,9894,9895,19789
13996,,url:http://portal.acm.org/citation.cfm3fid3d29682.29686,9895,9896,19791
13997,,68ehcgtunhcj,9896,9897,19793
13998,,wmqjk3nq09sj,9897,9898,19795
13999,,url:http://adsabs.harvard.edu/abs/1982mit..reptu....s,9898,9899,19797
14000,,v8mtjn-klh4j,9899,9900,19799
14001,,0edodcgoyiuj,9900,9901,19801
14002,,y16tsy8zmqkj,9901,9902,19803
14003,,ldnctbiatr8j,9902,9903,19805
14004,,sjygripbckij,9903,9904,19807
14005,,nqy7cpxcwpoj,9904,9905,19809
14006,,wigiwluejzsj,9905,9906,19811
14007,,8zg_ls3g8hyj,9906,9907,19813
14008,,njht3ybqmeaj,9907,9908,19815
14009,,oumcfsxvj9mj,9908,9909,19817
14010,,hdlcprpezrkj,9909,9910,19819
14011,,url:http://www.csa.com/partners/viewrecord.php3frequester3dgs26collection3dtrd26recid3d200114001098mt26recid3da0032592ah,9910,9911,19821
14012,,1ivmte5w6fsj,9911,9912,19823
14013,,z_nekpp5eloj,9912,9913,19825
14014,,f9a-ztmpnsqj,9913,9914,19827
14015,,trilgft_etgj,9914,9915,19829
14016,,rzsge-noej8j,9915,9916,19831
14017,,py7l9jadntaj,9916,9917,19833
14018,,zqybjtpbhvij,9917,9918,19835
14019,,1sczs3wmnd4j,9918,9919,19837
14020,,z4jxxhpualgj,9919,9920,19839
14021,,d69g1j8p7baj,9920,9921,19841
14022,,o_wtrsrkx_ej,9921,9922,19843
14023,,r9x4fgtu7cuj,9922,9923,19845
14024,,h4ly5ppvbe4j,9923,9924,19847
14025,,l2mzsafcnwwj,9924,9925,19849
14026,,mo1xzlwmrwkj,9925,9926,19851
14027,,hkhllhrd1s8j,9926,9927,19853
14028,,1caiqfwlog8j,9927,9928,19855
14029,,vel-zdfjxrej,9928,9929,19857
14030,,ls7vkmlcymkj,9929,9930,19859
14031,,4vtrtw4ams0j,9930,9931,19861
14032,,tbde0swsas0j,9931,9932,19863
14033,,ir9om81w-_yj,9932,9933,19865
14034,,lmhheexkraqj,9933,9934,19867
14035,,io1lnqtibbuj,9934,9935,19869
14036,,x6frqi0b3mqj,9935,9936,19871
14037,,dzfmap3kxfmj,9936,9937,19873
14038,,wtfqwgjaupij,9938,9939,19877
14039,,0wu7v4dam00j,9939,9940,19879
14040,,vlqcznck-emj,9940,9941,19881
14041,,6cul1remh3wj,9941,9942,19883
14042,,6-jyntvgluaj,9942,9943,19885
14043,,fllayun3kyaj,9943,9944,19887
14044,,un9vwqhrzr4j,9944,9945,19889
14045,,65qra40xjqyj,9945,9946,19891
14046,,5j8lmlowj-aj,9946,9947,19893
14047,,1zsy3-f8bd4j,9947,9948,19895
14048,,tzpemfkdl8cj,9948,9949,19897
14049,,hjh_gzhxbduj,9949,9950,19899
14050,,w93-ww886bwj,9950,9951,19901
14051,,amirz0l0wd8j,9951,9952,19903
14052,,ytqwhs8dybuj,9952,9953,19905
14053,,xhultsoa1p4j,9953,9954,19907
14054,,buc-chxhhfmj,9954,9955,19909
14055,,homd8yac6umj,9955,9956,19911
14056,,yx1z8hatqaaj,9956,9957,19913
14057,,envqiz5p3hkj,9957,9958,19915
14058,,q8umuqkwrkkj,9958,9959,19917
14059,,v1-rxu4ua2ij,9959,9960,19919
14060,,i8shpbftof0j,9960,9961,19921
14061,,url:http://links.jstor.org/sici3fsici3d0146-4949(196524252f21)6253a1253c45253acsfhc2522253e2.0.co253b2-l,9961,9962,19923
14062,,t0onnmqsqjqj,9962,9963,19925
14063,,f1nf8qznwv8j,9963,9964,19927
14064,,2gwpstadvsqj,9964,9965,19929
14065,,6rsliepjnxoj,9965,9966,19931
14066,,wyiuysnlhugj,9966,9967,19933
14067,,1s-vlkbodmkj,9967,9968,19935
14068,,6xdsv3gos5aj,9968,9969,19937
14069,,uvp26v1qyaaj,9969,9970,19939
14070,,url:http://www.csa.com/partners/viewrecord.php3frequester3dgs26collection3dtrd26recid3d20021214039897mt26recid3da7423788ah,9970,9971,19941
14071,,hodaq8pss-uj,9971,9972,19943
14072,,vcnctz9mafcj,9972,9973,19945
14073,,url:http://portal.acm.org/citation.cfm3fid3d592208.592569,9973,9974,19947
14074,,4fqt2hdyaesj,9974,9975,19949
14075,,qdknff094lcj,9975,9976,19951
14076,,rcep3enky2aj,9976,9977,19953
14077,,ofjiehokdwuj,9977,9978,19955
14078,,l2ewblp9i7kj,9978,9979,19957
14079,,bnwnbsu5jmej,9979,9980,19959
14080,,xj859ynlagmj,9980,9981,19961
14081,,mlbh2ujsxxij,9981,9982,19963
14082,,lc5m1wvbdu4j,9982,9983,19965
14083,,ea4aeav4ikuj,9983,9984,19967
14084,,xhle0bk7qsmj,9984,9985,19969
14085,,jlgi_ntylsqj,9985,9986,19971
14086,,ffdsymhtkb0j,9986,9987,19973
14087,,zuna9y25rbgj,9987,9988,19975
14088,,rfau--ibhwkj,9988,9989,19977
14089,,wwanvvue-oej,9989,9990,19979
14090,,es56wbyjgboj,9990,9991,19981
14091,,iibgzixfyayj,9991,9992,19983
14092,,3t2zjawju6kj,9992,9993,19985
14093,,-5enj0qc1ioj,9995,9996,19991
14094,,lulyehyefkuj,9996,9997,19993
14095,,_5uwdzyabgmj,9997,9998,19995
14096,,bovbupnovuij,9998,9999,19997
14097,,o9mpn66nxxwj,9999,10000,19999
14098,,url:http://www.csa.com/partners/viewrecord.php3frequester3dgs26collection3dtrd26recid3d2109009ci,10000,10001,20001
14099,,lm2glxycbcwj,10001,10002,20003
14100,,cyo90miixgyj,10002,10003,20005
14101,,br7wp7aonigj,10003,10004,20007
14102,,7keseqnhfhkj,10004,10005,20009
14103,,sxams4v2i7mj,10005,10006,20011
14104,,pkotqw7c1_uj,10006,10007,20013
14105,,url:http://portal.acm.org/ft_gateway.cfm3fid3d110126726type3dpdf,10007,10008,20015
14106,,_adtvm1eybsj,10008,10009,20017
14107,,iwod1brv2ykj,10009,10010,20019
14108,,cmp0ojfoiu8j,10010,10011,20021
14109,,akagn7e3wrwj,10012,10013,20025
14110,,5zvsktb1jtwj,10013,10014,20027
14111,,mvhvbbgcvcgj,10014,10015,20029
14112,,url:http://portal.acm.org/ft_gateway.cfm3fid3d102756026type3dpdf,10015,10016,20031
14113,,mc5ooeivh24j,10016,10017,20033
14114,,domj5bzbcswj,10017,10018,20035
14115,,mzv802jlilej,10018,10019,20037
14116,,qpzrkbh9u7wj,10019,10020,20039
14117,,1csn2mx2ho0j,10020,10021,20041
14118,,q9iooiaduaqj,10021,10022,20043
14119,,5wnsml9_ck0j,10022,10023,20045
14120,,5b0r02r2bc0j,10023,10024,20047
14121,,url:http://portal.acm.org/ft_gateway.cfm3fid3d108379126type3dpdf,10024,10025,20049
14122,,htpmrqpcgo0j,10025,10026,20051
14123,,yqtx9pjbtyqj,10026,10027,20053
14124,,fuivhwrcmpij,10027,10028,20055
14125,,c-ma1amcj8uj,10028,10029,20057
14126,,iv8whls2ijcj,10029,10030,20059
14127,,vuxh9t7tqygj,10030,10031,20061
14128,,yihsd9p3nzmj,10031,10032,20063
14129,,c3slj_iwbwgj,10032,10033,20065
14130,,l8qjedrwrlwj,10033,10034,20067
14131,,bxh4utubcu0j,10034,10035,20069
14132,,zm422ijzcpgj,10035,10036,20071
14133,,ais93gkrihej,10036,10037,20073
14134,,vgnvmdpq6zkj,10037,10038,20075
14135,,a4n1y8iro_ij,10038,10039,20077
14136,,r84ndcgsf70j,10039,10040,20079
14137,,c9ccdx1tlgkj,10040,10041,20081
14138,,dqkxdcehngcj,10041,10042,20083
14139,,_ilbhts8rvcj,10042,10043,20085
14140,,5fjjeo5b31aj,10043,10044,20087
14141,,epdkq8ig1dqj,10044,10045,20089
14142,,l_chzd8kn6ej,10045,10046,20091
14143,,nmpgi8vipzej,10046,10047,20093
14144,,s5rdz6kypxej,10047,10048,20095
14145,,wl6m-m_v-eoj,10048,10049,20097
14146,,hq3vlaqgk6uj,10049,10050,20099
14147,,t3w0lrjfylgj,10050,10051,20101
14148,,0rpqh6gqytoj,10051,10052,20103
14149,,dl2yeucgkpkj,10052,10053,20105
14150,,hi4cnhm5gfgj,10053,10054,20107
14151,,omvxci3xvu4j,10054,10055,20109
14152,,2-pt9trdbbcj,10055,10056,20111
14153,,ipdtmprxtncj,10056,10057,20113
14154,,mobmihlvrkej,10057,10058,20115
14155,,,10058,10059,20117
14156,,ak63oe42c-oj,10059,10060,20119
14157,,vktfclydz6yj,10060,10061,20121
14158,,url:http://links.jstor.org/sici3fsici3d0146-4949(196724)8253a1253c96253atdjc2522o253e2.0.co253b2-5,10061,10062,20123
14159,,fxbyz9itqecj,10062,10063,20125
14160,,vutrdgyxe2aj,10063,10064,20127
14161,,fvffkv6_orsj,10064,10065,20129
14162,,zrcewg-pb0yj,10065,10066,20131
14163,,zszs7s24bsyj,10066,10067,20133
14164,,dshpu98naccj,10067,10068,20135
14165,,flkpjgv7468j,10068,10069,20137
14166,,ki6xgxl7ap4j,10069,10070,20139
14167,,nedkvqncy6mj,10070,10071,20141
14168,,lc7almwqjzuj,10071,10072,20143
14169,,d-7o6s3h2paj,10072,10073,20145
14170,,phrrxagsrboj,10073,10074,20147
14171,,pyz5krrqf7qj,10074,10075,20149
14172,,rcluicaunk8j,10075,10076,20151
14173,,ltngaqhmbdqj,10076,10077,20153
14174,,aqme8li_pdwj,10077,10078,20155
14175,,oybm4ojb9saj,10078,10079,20157
14176,,fcoinqaimo8j,10079,10080,20159
14177,,qocvap3xpiyj,10080,10081,20161
14178,,va2q8fp-ff0j,10081,10082,20163
14179,,87swo3gd3pij,10082,10083,20165
14180,,n4o4ihjsawqj,10083,10084,20167
14181,,q0j9tnd8vpuj,10084,10085,20169
14182,,f0sqbrwsy0cj,10085,10086,20171
14183,,vblo7cuxhfuj,10086,10087,20173
14184,,u0bnc_ykawoj,10087,10088,20175
14185,,url:http://portal.acm.org/ft_gateway.cfm3fid3d108361626type3dpdf,10088,10089,20177
14186,,2kgsqbjmexij,10089,10090,20179
14187,,lbvzeckcvkyj,10090,10091,20181
14188,,yixwbwdl-z0j,10091,10092,20183
14189,,vbxpz9jtgzyj,10093,10094,20187
14190,,q_jylv8eyqqj,10094,10095,20189
14191,,vlov1u-ev4gj,10095,10096,20191
14192,,url:http://www.csa.com/partners/viewrecord.php3frequester3dgs26collection3denv26recid3d8913255,10096,10097,20193
14193,,gh0fwijh2pgj,10097,10098,20195
14194,,98teya9za-yj,10098,10099,20197
14195,,05f4xzpnjy0j,10099,10100,20199
14196,,ad-tvnzbg8yj,10100,10101,20201
14197,,fkjg4ik66xqj,10101,10102,20203
14198,,_jegsg2xolaj,10102,10103,20205
14199,,cjhjbmrzxsij,10103,10104,20207
14200,,arj3e9o7g6uj,10104,10105,20209
14201,,aq-uado3m8cj,10105,10106,20211
14202,,esly3pagrakj,10106,10107,20213
14203,,kxslwfh5t48j,10107,10108,20215
14204,,rwdnzrz8mpgj,10108,10109,20217
14205,,fgvrrdfuc1ij,10109,10110,20219
14206,,ioyyuw0aboyj,10110,10111,20221
14207,,hemkmovys4uj,10111,10112,20223
14208,,zc0zlripfrgj,10112,10113,20225
14209,,_ewbpaqxwskj,10113,10114,20227
14210,,jscor0ixgr8j,10114,10115,20229
14211,,rrxotkdeop0j,10115,10116,20231
14212,,mu31rucr_e4j,10116,10117,20233
14213,,vujrlmujftuj,10117,10118,20235
14214,,drjvomtlskuj,10118,10119,20237
14215,,url:http://www.springerlink.com/index/5ju86d7j2ywj4ct0.pdf,10119,10120,20239
14216,,i2bpca8kojgj,10120,10121,20241
14217,,eqzhjgqhfgcj,10121,10122,20243
14218,,zmvl3_h6dquj,10122,10123,20245
14219,,xytbgy--8lmj,10123,10124,20247
14220,,yc9pqruq2zej,10124,10125,20249
14221,,rq_m2jf41qej,10125,10126,20251
14222,,3dpup1ot4faj,10126,10127,20253
14223,,gqapuymwcaij,10127,10128,20255
14224,,7p88wea4tlwj,10128,10129,20257
14225,,qrln2kbgvhqj,10129,10130,20259
14226,,qffoieo76qij,10130,10131,20261
14227,,zymprslxuikj,10131,10132,20263
14228,,jtej-q3t1vsj,10132,10133,20265
14229,,mswt2io8zdej,10133,10134,20267
14230,,g4zcjyz35gsj,10134,10135,20269
14231,,75p1q-eqwy0j,10135,10136,20271
14232,,azolykxgl1mj,10136,10137,20273
14233,,eloxfiofsaej,10137,10138,20275
14234,,4yyozx8vdukj,10138,10139,20277
14235,,8axlakpzysij,10139,10140,20279
14236,,syaxerlvlcaj,10140,10141,20281
14237,,yqfb4qodkqmj,10141,10142,20283
14238,,odu8yroujd8j,10142,10143,20285
14239,,url:http://portal.acm.org/ft_gateway.cfm3fid3d31600826type3dpdf26dl3dportal26dl3dacm26cfid3d1111111126cftoken3d2222222,10143,10144,20287
14240,,g7lnzxvualcj,10145,10146,20291
14241,,pexcy_05qtkj,10146,10147,20293
14242,,url:http://portal.acm.org/ft_gateway.cfm3fid3d56513726type3dpdf26dl3dguide26dl3dacm26cfid3d1111111126cftoken3d2222222,10147,10148,20295
14243,,zwdtrefnijaj,10148,10149,20297
14244,,tyaztrbxo40j,10149,10150,20299
14245,,quq0rgix3hsj,10150,10151,20301
14246,,qvfccaknsbij,10151,10152,20303
14247,,re3a7mkwctgj,10152,10153,20305
14248,,url:http://portal.acm.org/citation.cfm3fid3d1041410.1041425,10153,10154,20307
14249,,m_evrnpjomoj,10154,10155,20309
14250,,kdrvdqdi0jaj,10155,10156,20311
14251,,amk4gxnb8e4j,10156,10157,20313
14252,,5qxarxqbb6aj,10157,10158,20315
14253,,z1lfon1kbycj,10158,10159,20317
14254,,u8epaosch4gj,10159,10160,20319
14255,,jsel5_9wkpuj,10160,10161,20321
14256,,2yb1fdzmldoj,10161,10162,20323
14257,,lojjlsl029yj,10162,10163,20325
14258,,otm0xnqcaiyj,10163,10164,20327
14259,,g6hvnjhb8muj,10164,10165,20329
14260,,9pzuynaqpwaj,10165,10166,20331
14261,,poqrnamiysij,10166,10167,20333
14262,,japl4py3vbmj,10167,10168,20335
14263,,gpptacunpjcj,10168,10169,20337
14264,,,10169,10170,20339
14265,,yp9sa9h9c5ij,10170,10171,20341
14266,,bkpikikwoz4j,10173,10174,20347
14267,,so68xdxqc80j,10174,10175,20349
14268,,upwcmv2rd3ij,10175,10176,20351
14269,,ru2m6vlos3ej,10176,10177,20353
14270,,vjpyydx6-iyj,10177,10178,20355
14271,,_jsxpa86mm0j,10178,10179,20357
14272,,2jbif2rr0hmj,10179,10180,20359
14273,,it6yftbkx4qj,10180,10181,20361
14274,,pshdxplwelkj,10181,10182,20363
14275,,9nsxj3qqslcj,10182,10183,20365
14276,,w6ius_2kjjgj,10183,10184,20367
14277,,09lhvvhrug4j,10184,10185,20369
14278,,brvpgnqevv4j,10185,10186,20371
14279,,_l81jfevm2kj,10186,10187,20373
14280,,xpdi0k9ih6sj,10187,10188,20375
14281,,jhnby-lpgocj,10188,10189,20377
14282,,zpkzuqlulaej,10189,10190,20379
14283,,utosdt2xbtoj,10190,10191,20381
14284,,kaodinezx2ij,10191,10192,20383
14285,,tidfwhbsq6aj,10192,10193,20385
14286,,trhww2j0nykj,10193,10194,20387
14287,,ncryssugrv0j,10194,10195,20389
14288,,wd4qsuzsqfcj,10195,10196,20391
14289,,lef5hwodzokj,10196,10197,20393
14290,,6sl6ja2tc3gj,10197,10198,20395
14291,,um3tvib0cxaj,10198,10199,20397
14292,,wws2shzsmo0j,10199,10200,20399
14293,,pbuyxh-s7fmj,10200,10201,20401
14294,,x6xlbxl2cwgj,10201,10202,20403
14295,,kdc1e1gyl6aj,10202,10203,20405
14296,,zlbqgawcesaj,10204,10205,20409
14297,,uwmno5gcgk8j,10205,10206,20411
14298,,hlzcjrf56jaj,10206,10207,20413
14299,,zyt7vwe7-v0j,10207,10208,20415
14300,,0c_9os14laoj,10208,10209,20417
14301,,gwrugt0jjdej,10209,10210,20419
14302,,url:http://www.kluweronline.com/article.asp3fpips3d525848526pdf3d1,10210,10211,20421
14303,,rvqawjjpdsmj,10211,10212,20423
14304,,isncwvrcssij,10212,10213,20425
14305,,yzmj1_3ebb0j,10213,10214,20427
14306,,_hsqfpzta5oj,10214,10215,20429
14307,,je7abejzxgaj,10215,10216,20431
14308,,va_wabxfrnoj,10216,10217,20433
14309,,ozbhjmj1pjaj,10217,10218,20435
14310,,url:http://portal.acm.org/citation.cfm3fid3d984399,10218,10219,20437
14311,,5fojqtvd0iij,10219,10220,20439
14312,,b6d0fh18emkj,10220,10221,20441
14313,,vyz19hnzh_cj,10221,10222,20443
14314,,url:http://www.csa.com/partners/viewrecord.php3frequester3dgs26collection3dtrd26recid3da8622930ah,10222,10223,20445
14315,,ecotasipt78j,10223,10224,20447
14316,,019zsr3lx4ej,10224,10225,20449
14317,,1whdowdz7tgj,10225,10226,20451
14318,,f4aeqmpur70j,10226,10227,20453
14319,,57x0foqfdeuj,10227,10228,20455
14320,,,10228,10229,20457
14321,,cq6yekpgkxuj,10229,10230,20459
14322,,btagt5tqr14j,10230,10231,20461
14323,,quciahol38gj,10231,10232,20463
14324,,_lsbygb0lgkj,10232,10233,20465
14325,,veygscco9ykj,10233,10234,20467
14326,,75vgtkuwpqcj,10234,10235,20469
14327,,fyuqsjckdmcj,10236,10237,20473
14328,,eb8opxv-pxuj,10237,10238,20475
14329,,rhpn24dob80j,10238,10239,20477
14330,,fckjahfivsaj,10239,10240,20479
14331,,fi5adxch414j,10240,10241,20481
14332,,_apukrsghjwj,10241,10242,20483
14333,,blpcdzgx3iqj,10242,10243,20485
14334,,oi1ykqoyb9kj,10243,10244,20487
14335,,pzxsewadav0j,10244,10245,20489
14336,,ecpl52hcelwj,10245,10246,20491
14337,,s3f2elf6sa4j,10246,10247,20493
14338,,ax69kqsxsgyj,10247,10248,20495
14339,,dkrzedh9kt8j,10248,10249,20497
14340,,g5w1-2iue1wj,10249,10250,20499
14341,,zk2glv0nqksj,10250,10251,20501
14342,,hv_ry4p1y74j,10251,10252,20503
14343,,vb2-tinwkpkj,10252,10253,20505
14344,,xzu-an0j3gej,10253,10254,20507
14345,,xuamjdy6hzij,10254,10255,20509
14346,,wfjijhoalz0j,10255,10256,20511
14347,,vnkphzyjrjmj,10256,10257,20513
14348,,xz9i36hv8sij,10257,10258,20515
14349,,gkiefykkfnuj,10258,10259,20517
14350,,_hzp0e9lramj,10259,10260,20519
14351,,xi3fxztd26aj,10260,10261,20521
14352,,alwwfq_84igj,10261,10262,20523
14353,,srief48p5gej,10262,10263,20525
14354,,z03psxepfhkj,10263,10264,20527
14355,,icfllrqajgyj,10264,10265,20529
14356,,zf6wny5dquuj,10265,10266,20531
14357,,or8ofhlpu2ij,10266,10267,20533
14358,,ohcj7czc1twj,10267,10268,20535
14359,,zfkaf92i3nkj,10268,10269,20537
14360,,efob0hlbuuwj,10269,10270,20539
14361,,qlomek9zqxcj,10271,10272,20543
14362,,45_hpirmofgj,10272,10273,20545
14363,,bkrnkqc9xuyj,10273,10274,20547
14364,,6gobqdq3iwoj,10274,10275,20549
14365,,nqdychzmj-gj,10275,10276,20551
14366,,ilhsfpogesqj,10276,10277,20553
14367,,ch-srzdlfm4j,10277,10278,20555
14368,,iaojgjc8up0j,10278,10279,20557
14369,,8eutjznb_i0j,10279,10280,20559
14370,,b0vr17rlg0gj,10280,10281,20561
14371,,4fl1j3qtgkaj,10281,10282,20563
14372,,sxtlcs0t1dsj,10282,10283,20565
14373,,ylstlec6yccj,10283,10284,20567
14374,,ivgect27jekj,10284,10285,20569
14375,,jslwozmz7fej,10285,10286,20571
14376,,64myzx3mxkmj,10286,10287,20573
14377,,xalcxqe9wvwj,10287,10288,20575
14378,,_ymzouwh7wwj,10288,10289,20577
14379,,9sbmwtqgbmoj,10289,10290,20579
14380,,h_v6sdhdc2kj,10290,10291,20581
14381,,lgbremh04iij,10291,10292,20583
14382,,0-au3qflkfoj,10292,10293,20585
14383,,11-uue9knpij,10293,10294,20587
14384,,zr3wpn7i84aj,10294,10295,20589
14385,,maa3ujj5niwj,10295,10296,20591
14386,,wid66zkz498j,10296,10297,20593
14387,,hw8lcofisauj,10297,10298,20595
14388,,jjpirq6qlxaj,10298,10299,20597
14389,,dgkvnzowknmj,10299,10300,20599
14390,,uevciykyfbwj,10300,10301,20601
14391,,ux7z1yv_xtaj,10301,10302,20603
14392,,cvklnh9dg7gj,10302,10303,20605
14393,,wfkz03yd3qcj,10303,10304,20607
14394,,mwufki1cdgyj,10304,10305,20609
14395,,i8wskvm41msj,10305,10306,20611
14396,,orqjbmuhlbmj,10306,10307,20613
14397,,url:http://www.csa.com/partners/viewrecord.php3frequester3dgs26collection3dtrd26recid3d200111010715mt26recid3da0032651ah,10307,10308,20615
14398,,p8uoouwzkemj,10308,10309,20617
14399,,8yrblmxmwowj,10309,10310,20619
14400,,rrszoovigqoj,10310,10311,20621
14401,,4vrx5kjdhbkj,10311,10312,20623
14402,,9igpd1gbpmsj,10312,10313,20625
14403,,ku2abu8pqsqj,10313,10314,20627
14404,,7bdcl140kx4j,10314,10315,20629
14405,,naqb-d9wng0j,10315,10316,20631
14406,,fziq7leo89uj,10316,10317,20633
14407,,rxc4t3n35-ij,10317,10318,20635
14408,,f0hzlxtcwfmj,10318,10319,20637
14409,,7sqern6q7soj,10319,10320,20639
14410,,ablp_rlmmuej,10320,10321,20641
14411,,url:http://www.springerlink.com/index/j768531753x21358.pdf,10321,10322,20643
14412,,eqhbgfoz7gkj,10322,10323,20645
14413,,rjjnep6jaa4j,10323,10324,20647
14414,,ieos4kvjd88j,10324,10325,20649
14415,,zgenhoxsligj,10325,10326,20651
14416,,bsu9zgk87yej,10326,10327,20653
14417,,t4ameq35yy4j,10327,10328,20655
14418,,pgtwaptrocuj,10328,10329,20657
14419,,exkhm_9hlkcj,10329,10330,20659
14420,,71iftugyuhsj,10330,10331,20661
14421,,0kskuyg4q04j,10331,10332,20663
14422,,wv1lq3ibkx8j,10332,10333,20665
14423,,xgaagmheqrsj,10333,10334,20667
14424,,h9ahgyj43hcj,10334,10335,20669
14425,,dpeme3e5xzoj,10335,10336,20671
14426,,url:http://taylorandfrancis.metapress.com/index/mv6vepur6b62ulv7.pdf,10336,10337,20673
14427,,tjgybqifayuj,10337,10338,20675
14428,,url:http://www.csa.com/partners/viewrecord.php3frequester3dgs26collection3dtrd26recid3d017311530370ai,10338,10339,20677
14429,,bhq2nwlynl8j,10339,10340,20679
14430,,rzhqfk6bmlaj,10340,10341,20681
14431,,9aq-4aczmaqj,10341,10342,20683
14432,,ttuxte2uwd8j,10342,10343,20685
14433,,lry_2by9lc4j,10343,10344,20687
14434,,yaylmkjtltcj,10344,10345,20689
14435,,1s9quanz4wqj,10345,10346,20691
14436,,b41crptptmcj,10346,10347,20693
14437,,ngbxnqmswfkj,10347,10348,20695
14438,,xsz19ae1bsgj,10348,10349,20697
14439,,vgalraqtykaj,10349,10350,20699
14440,,wtl1jzbwwjij,10350,10351,20701
14441,,pdzhu54mzewj,10351,10352,20703
14442,,73yulmw2q7cj,10352,10353,20705
14443,,zvvpw_vbuqoj,10353,10354,20707
14444,,kp03ic-r8soj,10354,10355,20709
14445,,ckozfnlc7gqj,10355,10356,20711
14446,,qaodqr5u9dgj,10357,10358,20715
14447,,e5ogo5easdgj,10358,10359,20717
14448,,lezw3lmpvacj,10359,10360,20719
14449,,e_5rchpf_oyj,10360,10361,20721
14450,,2wtrrys1cuyj,10361,10362,20723
14451,,4wrhxzn6pyej,10362,10363,20725
14452,,pf0k8vsuibij,10363,10364,20727
14453,,7inerv34e4sj,10364,10365,20729
14454,,wdu_cwsxo4oj,10366,10367,20733
14455,,xvmc7i8dyomj,10367,10368,20735
14456,,vdyve7o2w80j,10368,10369,20737
14457,,nasrexv21bij,10369,10370,20739
14458,,vtweeikpw0cj,10370,10371,20741
14459,,yumdnjie0b0j,10371,10372,20743
14460,,vz0u5itl3jsj,10372,10373,20745
14461,,ff3q_cguaxwj,10373,10374,20747
14462,,ng65x1fvtxsj,10374,10375,20749
14463,,3b7dsbkud14j,10375,10376,20751
14464,,w_epicm4macj,10376,10377,20753
14465,,kmyzmhoavzij,10377,10378,20755
14466,,hszyuzix-kqj,10378,10379,20757
14467,,vcwup0e7yd0j,10379,10380,20759
14468,,zda5vywvhbqj,10380,10381,20761
14469,,fucobvsh1g8j,10381,10382,20763
14470,,cezcpbaemouj,10382,10383,20765
14471,,ifbdu4br7nqj,10383,10384,20767
14472,,c7yhgb-aoeuj,10384,10385,20769
14473,,s6ysyujrd3oj,10385,10386,20771
14474,,ku5i_gjig3kj,10386,10387,20773
14475,,mbkd8gt2kcej,10387,10388,20775
14476,,3qdjeqpbs44j,10388,10389,20777
14477,,qf7nccevujoj,10389,10390,20779
14478,,k2bvlvqkudcj,10390,10391,20781
14479,,36z1zjsnefkj,10391,10392,20783
14480,,l8wwff0_cbqj,10392,10393,20785
14481,,_bn9npvhnd0j,10393,10394,20787
14482,,hng2ycty-paj,10394,10395,20789
14483,,ov59clw1udcj,10395,10396,20791
14484,,mwhqtykblx0j,10396,10397,20793
14485,,qxj0yrobjroj,10397,10398,20795
14486,,url:http://www.ncbi.nlm.nih.gov/entrez/query.fcgi3fcmd3dretrieve26db3dpubmed26list_uids3d74841826dopt3dcitation,10398,10399,20797
14487,,2npwecr6fecj,10399,10400,20799
14488,,tmcdzj1xbpkj,10400,10401,20801
14489,,67a1smz2xhyj,10401,10402,20803
14490,,dud37u2nvmij,10402,10403,20805
14491,,fhfb1vojji0j,10403,10404,20807
14492,,zdzcto7edvwj,10404,10405,20809
14493,,,10405,10406,20811
14494,,3gzqa9d2deoj,10406,10407,20813
14495,,sttufqivnsaj,10407,10408,20815
14496,,javk2dgppy8j,10408,10409,20817
14497,,rwov8wuq1qyj,10409,10410,20819
14498,,jwfm4rhsjmwj,10410,10411,20821
14499,,lact0m6bddaj,10411,10412,20823
14500,,url:http://www.csa.com/partners/viewrecord.php3frequester3dgs26collection3dtrd26recid3d9010720438md26recid3d9010g2c0339ec,10412,10413,20825
14501,,v2wnsqzxpnaj,10413,10414,20827
14502,,wnxgb587mzij,10414,10415,20829
14503,,xdnna7mh1wcj,10415,10416,20831
14504,,os2olwvcqowj,10416,10417,20833
14505,,qrn1ax5deruj,10417,10418,20835
14506,,dtglzbfpoboj,10418,10419,20837
14507,,ybmju1qgj2ij,10419,10420,20839
14508,,r0u6nrfcyruj,10420,10421,20841
14509,,jyovm-lgbzcj,10421,10422,20843
14510,,vm4b8kfqknqj,10422,10423,20845
14511,,sjvkneopoigj,10423,10424,20847
14512,,t1j2efbssrkj,10424,10425,20849
14513,,1_nz7pqk22qj,10425,10426,20851
14514,,bbwxebbuueyj,10426,10427,20853
14515,,scrx46kxhj4j,10427,10428,20855
14516,,url:http://pubs.acs.org/cgi-bin/abstract.cgi/achre4/2003/36/i01/abs/ar020149a.html,10428,10429,20857
14517,,osf8hb89zy8j,10430,10431,20861
14518,,kseyp3p5yn0j,10431,10432,20863
14519,,kfhqi74phqcj,10432,10433,20865
14520,,qco-aj521a4j,10433,10434,20867
14521,,b7b1y3ef49wj,10434,10435,20869
14522,,z517-cabh9qj,10435,10436,20871
14523,,kwgllnllatcj,10436,10437,20873
14524,,8kegp4t_xxaj,10437,10438,20875
14525,,vygdtg3lpngj,10438,10439,20877
14526,,lzy39ur6q-uj,10439,10440,20879
14527,,pnwyia04cvaj,10440,10441,20881
14528,,9kx6zbecm-kj,10441,10442,20883
14529,,hh84bjt5pucj,10442,10443,20885
14530,,2zkibhhqjuqj,10443,10444,20887
14531,,fs__r1gw13uj,10444,10445,20889
14532,,9st2mn2c4dcj,10445,10446,20891
14533,,gxbhd3kkcq0j,10446,10447,20893
14534,,l_osruzcgygj,10447,10448,20895
14535,,xf02gwb4equj,10448,10449,20897
14536,,vjahiga4vp8j,10449,10450,20899
14537,,qsyrzw1rd_8j,10450,10451,20901
14538,,ps9wavp2ewqj,10451,10452,20903
14539,,mxawvg8niicj,10452,10453,20905
14540,,rcn0oybfl4mj,10453,10454,20907
14541,,sn8luuc34dyj,10454,10455,20909
14542,,j06mf7khtu8j,10455,10456,20911
14543,,bawvtrxkc8aj,10456,10457,20913
14544,,54w4cikl11uj,10457,10458,20915
14545,,9w6qmrvxwo8j,10458,10459,20917
14546,,4thtkqrbs3aj,10459,10460,20919
14547,,hvxsjet5dmkj,10460,10461,20921
14548,,5jmz3upeseqj,10461,10462,20923
14549,,wp2fxabpkz8j,10462,10463,20925
14550,,uqtbtmywknqj,10463,10464,20927
14551,,hq8-ekcchvmj,10464,10465,20929
14552,,wlrd1jz_jzoj,10465,10466,20931
14553,,7jrwry6vapmj,10466,10467,20933
14554,,71hsadwfxqcj,10467,10468,20935
14555,,iyh-fikltg0j,10468,10469,20937
14556,,yhizhhwof6mj,10469,10470,20939
14557,,url:http://www.ncbi.nlm.nih.gov/entrez/query.fcgi3fcmd3dretrieve26db3dpubmed26list_uids3d37229326dopt3dcitation,10470,10471,20941
14558,,xjtmsn2wz1gj,10471,10472,20943
14559,,aw5lcduembsj,10472,10473,20945
14560,,v-qz7enk8amj,10473,10474,20947
14561,,_xo5kc5hwu0j,10474,10475,20949
14562,,eqiftmaypcgj,10475,10476,20951
14563,,jm5t7tdjsggj,10476,10477,20953
14564,,url:http://portal.acm.org/ft_gateway.cfm3fid3d110129326type3dpdf,10477,10478,20955
14565,,maz0jc0isz8j,10478,10479,20957
14566,,lifzfe91qyuj,10479,10480,20959
14567,,ri_rtodwbooj,10480,10481,20961
14568,,rh8jilz8tigj,10481,10482,20963
14569,,tq8sautfsnsj,10482,10483,20965
14570,,loknvc3rz1mj,10483,10484,20967
14571,,swaaja_xme4j,10484,10485,20969
14572,,url:http://portal.acm.org/citation.cfm3fid3d945721.94572726coll3dguide26dl3dacm26idx3dj68926part3dperiodical26wanttype3dperiodical26title3dacm2520sigmod2520record26cfid3d1111111126cftoken3d2222222,10485,10486,20971
14573,,vucvhe1s4n4j,10486,10487,20973
14574,,q1ttfts4eukj,10487,10488,20975
14575,,c69kcf-wljmj,10488,10489,20977
14576,,g1i6jppvmbcj,10489,10490,20979
14577,,7j6zqsykyacj,10490,10491,20981
14578,,kqyyijvtgqkj,10491,10492,20983
14579,,c3ciggh_vl0j,10492,10493,20985
14580,,7244m9z6lpmj,10493,10494,20987
14581,,er5samf0pfgj,10494,10495,20989
14582,,jcayeeurdfoj,10495,10496,20991
14583,,bmyqwej5nc0j,10496,10497,20993
14584,,ffosxg4xrwcj,10497,10498,20995
14585,,wfogo8gyld0j,10498,10499,20997
14586,,wvpwxbbbhiqj,10499,10500,20999
14587,,skln1tggmu4j,10500,10501,21001
14588,,dnlxgq2xxmkj,10501,10502,21003
14589,,ylyryzfo_hij,10502,10503,21005
14590,,f_elu7v6rxej,10503,10504,21007
14591,,p4t6cclvu6sj,10504,10505,21009
14592,,vvs-2s0txbij,10505,10506,21011
14593,,e7gyib8asuuj,10506,10507,21013
14594,,pqygegyqf_oj,10507,10508,21015
14595,,url:http://portal.acm.org/ft_gateway.cfm3fid3d108367926type3dpdf,10508,10509,21017
14596,,t2ybeiogah0j,10509,10510,21019
14597,,tkmwdjm82quj,10510,10511,21021
14598,,b9mnzyo0sfoj,10511,10512,21023
14599,,iyaugxn0wf8j,10512,10513,21025
14600,,6cmo5jntiqkj,10514,10515,21029
14601,,g0tjwcnd1xwj,10515,10516,21031
14602,,cs_j5lvlqbmj,10516,10517,21033
14603,,rv6vj_achm8j,10517,10518,21035
14604,,grxgf8iikiwj,10518,10519,21037
14605,,suexauh9qxij,10519,10520,21039
14606,,daq321wcwuwj,10520,10521,21041
14607,,42tq_tfnoegj,10521,10522,21043
14608,,v6dk5wi-4pmj,10522,10523,21045
14609,,t1dvnhwfo7wj,10523,10524,21047
14610,,eslmd8dlrxcj,10524,10525,21049
14611,,q2awxeoeamuj,10525,10526,21051
14612,,qnpdgl3-eh4j,10526,10527,21053
14613,,fmgbgs4jlnwj,10527,10528,21055
14614,,ldgedy8uyc0j,10528,10529,21057
14615,,5igdcftpf6qj,10529,10530,21059
14616,,upd8db9fzyej,10530,10531,21061
14617,,rjmunoz79t0j,10531,10532,21063
14618,,qzfgec_rsq4j,10532,10533,21065
14619,,zfo_cgiovg8j,10533,10534,21067
14620,,udnnpyi0tqmj,10534,10535,21069
14621,,jrgkvthugg4j,10535,10536,21071
14622,,bqx45f4ukqyj,10536,10537,21073
14623,,jnbgxoleb-8j,10537,10538,21075
14624,,5wuyp1albocj,10538,10539,21077
14625,,bo7ib-r3qr0j,10539,10540,21079
14626,,6mszin2qhmsj,10540,10541,21081
14627,,ihxesykfuv0j,10541,10542,21083
14628,,8vjejrhm7foj,10542,10543,21085
14629,,aarvgcvxzigj,10543,10544,21087
14630,,vxenmtspglaj,10544,10545,21089
14631,,8xq9qerjcwuj,10545,10546,21091
14632,,boqdyefgi3gj,10546,10547,21093
14633,,pxkgmylv93cj,10547,10548,21095
14634,,r4bp27h0fjij,10548,10549,21097
14635,,ppa5u0hs25oj,10549,10550,21099
14636,,3xtolckkkxyj,10550,10551,21101
14637,,szmunaxngcwj,10551,10552,21103
14638,,8liwxmfozn4j,10552,10553,21105
14639,,5qwteqp7g_8j,10553,10554,21107
14640,,rfaptlyvtomj,10554,10555,21109
14641,,cnnsj-hevyaj,10555,10556,21111
14642,,4pz4shr2bmwj,10556,10557,21113
14643,,fitxswlw4fwj,10557,10558,21115
14644,,url:http://doi.wiley.com/10.1002/tl.4,10558,10559,21117
14645,,avsqmtdbeicj,10559,10560,21119
14646,,8dgwbgnv-0cj,10560,10561,21121
14647,,w_a__nzu58sj,10561,10562,21123
14648,,tmlbuiz6kjkj,10562,10563,21125
14649,,5s8zkud5_b4j,10563,10564,21127
14650,,5fgjgqli3j8j,10565,10566,21131
14651,,jzuwic_x6pwj,10566,10567,21133
14652,,_rocnqi9z1wj,10567,10568,21135
14653,,1b6b3_yjpc4j,10568,10569,21137
14654,,uahqnhikuywj,10569,10570,21139
14655,,trhw4q2yshaj,10570,10571,21141
14656,,axpt-8vhnlkj,10571,10572,21143
14657,,69icrg5jaccj,10572,10573,21145
14658,,wc8-6l0ebfoj,10573,10574,21147
14659,,2bg_rmfpoisj,10574,10575,21149
14660,,awc4sni1mmwj,10575,10576,21151
14661,,w_wvgs27tmyj,10576,10577,21153
14662,,umie8ngskfsj,10577,10578,21155
14663,,qoyzu2hgl-aj,10578,10579,21157
14664,,gjbksqwbwvcj,10579,10580,21159
14665,,ntrkw_xmqlkj,10580,10581,21161
14666,,jvwhnopa0ccj,10582,10583,21165
14667,,5lzct8ti1kgj,10583,10584,21167
14668,,bffb5fwzaegj,10584,10585,21169
14669,,w0kvbjs1psij,10585,10586,21171
14670,,5ggwipp7b4wj,10586,10587,21173
14671,,yxcyqist70aj,10587,10588,21175
14672,,url:http://www.springerlink.com/index/x212k74uuhh03377.pdf,10588,10589,21177
14673,,1b7edyym7scj,10589,10590,21179
14674,,nusql_2spdyj,10590,10591,21181
14675,,dcnuh436udoj,10591,10592,21183
14676,,dqwsj_otumqj,10592,10593,21185
14677,,rg5jevqyvzej,10593,10594,21187
14678,,ukfrzlkdozyj,10595,10596,21191
14679,,lyqwyjozf7yj,10597,10598,21195
14680,,ev7_eb6qumej,10598,10599,21197
14681,,kxxzjksfg7cj,10599,10600,21199
14682,,lq4r3kpof3yj,10600,10601,21201
14683,,xmhnpz3pdggj,10601,10602,21203
14684,,u3oskzr6rwoj,10602,10603,21205
14685,,2jr32fgnxjaj,10603,10604,21207
14686,,v55_mpdmlnej,10604,10605,21209
14687,,obnhnh7reukj,10605,10606,21211
14688,,bhorhuazfemj,10606,10607,21213
14689,,_z7dgxhhqvwj,10607,10608,21215
14690,,vlsj0aq4ee4j,10608,10609,21217
14691,,fhtamm7aeewj,10609,10610,21219
14692,,rjt8uiszdtkj,10610,10611,21221
14693,,zbjyyuhl2cij,10611,10612,21223
14694,,r_qdjbsjd4kj,10612,10613,21225
14695,,xuug3bl5pscj,10613,10614,21227
14696,,kwl5en5pfdij,10615,10616,21231
14697,,diqk7y_z3xwj,10616,10617,21233
14698,,jymrsf-vxa4j,10617,10618,21235
14699,,ref3lb5kxxmj,10618,10619,21237
14700,,slmqwvsytkyj,10619,10620,21239
14701,,nmknz_7nniyj,10620,10621,21241
14702,,czl83srgj0gj,10621,10622,21243
14703,,rsxduf1dvnqj,10622,10623,21245
14704,,l0k23xwfvc4j,10624,10625,21249
14705,,ct8a-hj70cyj,10625,10626,21251
14706,,url:http://www.springerlink.com/index/hv67ph1524476544.pdf,10626,10627,21253
14707,,6hbahzfjt4wj,10627,10628,21255
14708,,_i_j1rou0igj,10628,10629,21257
14709,,url:http://portal.acm.org/ft_gateway.cfm3fid3d106630126type3dpdf,10629,10630,21259
14710,,9uzuvgookvsj,10630,10631,21261
14711,,zmg9padotjwj,10631,10632,21263
14712,,qzwz8gssqtoj,10632,10633,21265
14713,,ezxbx7uibboj,10633,10634,21267
14714,,fuirtujm6bqj,10634,10635,21269
14715,,8rorle1q7_yj,10635,10636,21271
14716,,dws0ry30vamj,10636,10637,21273
14717,,dq0alnutgqqj,10637,10638,21275
14718,,aq09xwkkg6wj,10638,10639,21277
14719,,rh3jv-gzgkyj,10639,10640,21279
14720,,rj9kdoneq7oj,10640,10641,21281
14721,,z26hdhr1amoj,10641,10642,21283
14722,,vjpb_v41yvkj,10642,10643,21285
14723,,yxkb8avkctoj,10643,10644,21287
14724,,vmdj6momy_qj,10644,10645,21289
14725,,v2c0oukuedwj,10645,10646,21291
14726,,xhn-2obhf6qj,10646,10647,21293
14727,,xorym7goisuj,10647,10648,21295
14728,,whe_tbzwzv8j,10648,10649,21297
14729,,7syvhi1k26ej,10649,10650,21299
14730,,tie5ie5n41oj,10650,10651,21301
14731,,z_dgyrdvmzoj,10651,10652,21303
14732,,yv3jq4wuugyj,10652,10653,21305
14733,,fu5kekc4lesj,10653,10654,21307
14734,,9hplhzmda7yj,10654,10655,21309
14735,,url:http://portal.acm.org/ft_gateway.cfm3fid3d110126226type3dpdf,10655,10656,21311
14736,,gkub2nk8vb4j,10656,10657,21313
14737,,fyelmih3sa4j,10657,10658,21315
14738,,somas1npnauj,10658,10659,21317
14739,,rats_gqbhwcj,10659,10660,21319
14740,,fft8yhu8syoj,10661,10662,21323
14741,,ht0apfzgvrkj,10662,10663,21325
14742,,lmwn3cxgjlkj,10663,10664,21327
14743,,url:http://doi.wiley.com/10.1002/tl.66,10664,10665,21329
14744,,6b3ozae-s_yj,10665,10666,21331
14745,,elww0czctpuj,10666,10667,21333
14746,,xgsmgzipagej,10667,10668,21335
14747,,6rkyiagtmckj,10668,10669,21337
14748,,,10669,10670,21339
14749,,cekbz4q-kpuj,10670,10671,21341
14750,,o5kvnzcoxbcj,10671,10672,21343
14751,,zdkktgvx4bwj,10672,10673,21345
14752,,url:http://portal.acm.org/ft_gateway.cfm3fid3d102471126type3dpdf,10673,10674,21347
14753,,h0s4mybderej,10674,10675,21349
14754,,i33umox3v_4j,10675,10676,21351
14755,,2kyhlk9g3fwj,10676,10677,21353
14756,,ns1xmepzzxwj,10677,10678,21355
14757,,ount-q5rgkuj,10678,10679,21357
14758,,k5d5cit5toyj,10679,10680,21359
14759,,j3t4yzriiokj,10680,10681,21361
14760,,ru3rjgnjfnkj,10681,10682,21363
14761,,vlhke7okywqj,10682,10683,21365
14762,,ogdku2hrpumj,10683,10684,21367
14763,,yi0jiqyzhxcj,10684,10685,21369
14764,,84yj8p61ehaj,10685,10686,21371
14765,,flqegkzxux8j,10687,10688,21375
14766,,htbjxetbas4j,10688,10689,21377
14767,,o2vwq-m022ej,10689,10690,21379
14768,,lppjnk5ibsuj,10690,10691,21381
14769,,0dzxqmp4cmoj,10691,10692,21383
14770,,etvqzxvm0dgj,10692,10693,21385
14771,,iddg7u9-yk8j,10693,10694,21387
14772,,url:http://links.jstor.org/sici3fsici3d0146-4949(196522)6253a2253c161253atcotj253e2.0.co253b2-d,10694,10695,21389
14773,,k_y-7xlhcywj,10695,10696,21391
14774,,pfd02mihmvij,10696,10697,21393
14775,,n9bujqsnei0j,10697,10698,21395
14776,,x8nql_-nimgj,10698,10699,21397
14777,,7fsz-hywdtoj,10699,10700,21399
14778,,j-r3nihtfnej,10700,10701,21401
14779,,i6arizxydsqj,10701,10702,21403
14780,,kec3-6cgsxwj,10702,10703,21405
14781,,nhuhorex2jwj,10703,10704,21407
14782,,url:http://portal.acm.org/citation.cfm3fid3d16857,10704,10705,21409
14783,,url:http://www.csa.com/partners/viewrecord.php3frequester3dgs26collection3denv26recid3d2658727,10705,10706,21411
14784,,ijovunoeicyj,10706,10707,21413
14785,,vesif7smlvyj,10707,10708,21415
14786,,nzrurklvdv8j,10708,10709,21417
14787,,url:http://portal.acm.org/citation.cfm3fid3d604264.60427926coll3dguide26dl3dacm26type3dissue26idx3dj68926part3dperiodical26wanttype3dperiodical26title3dacm2520sigmod2520record26cfid3d1111111126cftoken3d2222222,10709,10710,21419
14788,,7zawaok_dx4j,10710,10711,21421
14789,,rso0-vvmb5cj,10711,10712,21423
14790,,lrzqfmhwir8j,10712,10713,21425
14791,,kxih8hsnabej,10713,10714,21427
14792,,x1jn4uobglkj,10714,10715,21429
14793,,0p0t5_gmnwoj,10715,10716,21431
14794,,alj4tobsdlij,10716,10717,21433
14795,,pn9-aj16tb0j,10717,10718,21435
14796,,rasm_gaexgej,10718,10719,21437
14797,,nm1oqfzbiosj,10719,10720,21439
14798,,im7iyblf2dmj,10720,10721,21441
14799,,xkj7bheagxaj,10721,10722,21443
14800,,gh5n4xw-8ykj,10722,10723,21445
14801,,6unigigsyeyj,10724,10725,21449
14802,,v6fhb6h66u0j,10725,10726,21451
14803,,tyawvykpyw0j,10726,10727,21453
14804,,_sjnqy9pnkyj,10727,10728,21455
14805,,efskq7hurhsj,10728,10729,21457
14806,,qqr7zrrbsrgj,10729,10730,21459
14807,,yqgbv-ttivmj,10730,10731,21461
14808,,g_tkkdzsjwyj,10731,10732,21463
14809,,aj4nues4sycj,10732,10733,21465
14810,,pxlkla_gvryj,10733,10734,21467
14811,,v-pnhtvtkmij,10734,10735,21469
14812,,u6kz1qniqwkj,10735,10736,21471
14813,,lhpdcnxjidyj,10736,10737,21473
14814,,xn7xduq6vocj,10737,10738,21475
14815,,rrhlx70dl_ij,10738,10739,21477
14816,,onadh6lsmzkj,10739,10740,21479
14817,,fepzpyefr3cj,10740,10741,21481
14818,,url:http://ieeexplore.ieee.org/xpl/abs_free.jsp3farnumber3d1350761,10741,10742,21483
14819,,earribu-0cmj,10742,10743,21485
14820,,tjuerjh7r1kj,10743,10744,21487
14821,,url:http://www.springerlink.com/index/dq59uak6br9yc5tq.pdf,10744,10745,21489
14822,,gwill7xowt4j,10745,10746,21491
14823,,o6gzs4y1xc4j,10746,10747,21493
14824,,3n_9t8c1ibsj,10747,10748,21495
14825,,xecek06z5dij,10748,10749,21497
14826,,hcx4esa2zzuj,10749,10750,21499
14827,,lng7wyd26lgj,10750,10751,21501
14828,,url:http://ieeexplore.ieee.org/iel1/2220/3998/00153239.pdf3farnumber3d153239,10751,10752,21503
14829,,w-huzvtqikcj,10752,10753,21505
14830,,mtkuj1ghdwoj,10753,10754,21507
14831,,9mivrpqowgyj,10754,10755,21509
14832,,w_babdromaoj,10755,10756,21511
14833,,eqpuqwuw2gsj,10756,10757,21513
14834,,wrrenojsws4j,10757,10758,21515
14835,,sqg5aa6n5caj,10758,10759,21517
14836,,c3k23dscqx8j,10759,10760,21519
14837,,fd13infrefej,10760,10761,21521
14838,,d77uov1aikmj,10761,10762,21523
14839,,01mxeen31zsj,10762,10763,21525
14840,,ijc7imsuwowj,10763,10764,21527
14841,,44iidc-latuj,10765,10766,21531
14842,,url:http://ieeexplore.ieee.org/iel5/9639/30462/01403669.pdf3farnumber3d1403669,10767,10768,21535
14843,,cy_v25uahk4j,10768,10769,21537
14844,,v-wgkdvsr2uj,10769,10770,21539
14845,,maerw6ndtzmj,10770,10771,21541
14846,,dlhay0icnj4j,10771,10772,21543
14847,,eiln_yrmwdkj,10773,10774,21547
14848,,z26h2tqo7bkj,10775,10776,21551
14849,,u8fy_uftxzwj,10776,10777,21553
14850,,760vr_mr5o4j,10777,10778,21555
14851,,tht2gwj5o64j,10778,10779,21557
14852,,feyon7j0iw8j,10779,10780,21559
14853,,jhupd7ii5-ej,10780,10781,21561
14854,,zmafzts_hxsj,10781,10782,21563
14855,,ghglke4-qs8j,10782,10783,21565
14856,,t6nrbxcu2moj,10783,10784,21567
14857,,tvzjuauoyl8j,10784,10785,21569
14858,,tukjutwjo8oj,10785,10786,21571
14859,,aroapke3geyj,10786,10787,21573
14860,,jsza-uc-jr4j,10787,10788,21575
14861,,5movzwxwnzuj,10788,10789,21577
14862,,ci6mpy64_wqj,10789,10790,21579
14863,,na0iv86bymsj,10790,10791,21581
14864,,hzkbllp7asej,10791,10792,21583
14865,,16sdd1kapi4j,10792,10793,21585
14866,,oey3badm3cyj,10793,10794,21587
14867,,a0yki5akjo8j,10794,10795,21589
14868,,dw-jm4l341sj,10795,10796,21591
14869,,a3xuvofauc0j,10796,10797,21593
14870,,zy32rcwx6okj,10797,10798,21595
14871,,ljarwpwynsyj,10798,10799,21597
14872,,qcokcccopcwj,10799,10800,21599
14873,,,10800,10801,21601
14874,,ajeotkxwzmmj,10801,10802,21603
14875,,i6ixcmz3owmj,10802,10803,21605
14876,,t_bv64veorgj,10803,10804,21607
14877,,rlkrzm3xpa0j,10804,10805,21609
14878,,nnmafzmzxf4j,10805,10806,21611
14879,,uxuz2c6zjoaj,10806,10807,21613
14880,,s3wusen68tij,10807,10808,21615
14881,,si8obwwseeyj,10808,10809,21617
14882,,lrzxxtatscqj,10809,10810,21619
14883,,aztxmbjy5ikj,10810,10811,21621
14884,,u-8glxqmf2ij,10811,10812,21623
14885,,l8elxnov1rmj,10812,10813,21625
14886,,pltucsqn9m8j,10813,10814,21627
14887,,epbpjxrmtnyj,10814,10815,21629
14888,,2yl1smwcbnmj,10815,10816,21631
14889,,faesbtygg0yj,10816,10817,21633
14890,,z9a1e0grkkij,10817,10818,21635
14891,,ffkoisppojuj,10818,10819,21637
14892,,yjkecknldtyj,10819,10820,21639
14893,,if-eabut2wsj,10820,10821,21641
14894,,url:http://www.springerlink.com/index/7pqvrhep95qavlda.pdf,10821,10822,21643
14895,,0nsdoynjrimj,10822,10823,21645
14896,,url:http://www.ingentaconnect.com/search/expand3fpub3dinfobike://els/08830355/2001/00000035/00000004/art0003326unc3d,10823,10824,21647
14897,,od8vojlseowj,10824,10825,21649
14898,,gxr_mrcd8dej,10825,10826,21651
14899,,iagzfbjyx1qj,10826,10827,21653
14900,,eupcg3q482aj,10827,10828,21655
14901,,oa6uam-hjecj,10828,10829,21657
14902,,ymwuofmc2gaj,10829,10830,21659
14903,,vvmqxtisrwaj,10830,10831,21661
14904,,yry9cidski0j,10831,10832,21663
14905,,5rsl0somunej,10832,10833,21665
14906,,d1mxynbd60oj,10833,10834,21667
14907,,bedemk58es4j,10835,10836,21671
14908,,url:http://www.ingentaconnect.com/content/els/09505849/2002/00000044/00000003/art00006,10836,10837,21673
14909,,url:http://portal.acm.org/citation.cfm3fid3d641077,10837,10838,21675
14910,,gspfcgacgtej,10838,10839,21677
14911,,6pj3z8gs3csj,10839,10840,21679
14912,,gd3_czaybzsj,10840,10841,21681
14913,,s2mbvq1sn0ij,10841,10842,21683
14914,,h1b38a1h8fcj,10842,10843,21685
14915,,vvvvm0uatyqj,10843,10844,21687
14916,,8_z3zdej7zuj,10844,10845,21689
14917,,igsdnqimqa8j,10846,10847,21693
14918,,url:http://www.csa.com/partners/viewrecord.php3frequester3dgs26collection3dtrd26recid3dn8331418ah,10847,10848,21695
14919,,13vobjd7yxuj,10848,10849,21697
14920,,4nk7q7ozh0aj,10849,10850,21699
14921,,lj4m8b9mnwaj,10850,10851,21701
14922,,tddgjgldc2aj,10851,10852,21703
14923,,irhg2rbqsvuj,10852,10853,21705
14924,,lm9rc5krl_cj,10853,10854,21707
14925,,nvlsv_kwdskj,10854,10855,21709
14926,,awz2dt0m9rqj,10855,10856,21711
14927,,xq4ac0zelysj,10856,10857,21713
14928,,vhnzvuuzrr8j,10857,10858,21715
14929,,anpwby6qqgej,10858,10859,21717
14930,,0fra1ujfhdkj,10859,10860,21719
14931,,0sbnokmlalwj,10860,10861,21721
14932,,,10861,10862,21723
14933,,r9td18dhkr0j,10862,10863,21725
14934,,fp7zdo5gbeyj,10863,10864,21727
14935,,oby-qcnxpaqj,10864,10865,21729
14936,,dpbuo0qzvdwj,10865,10866,21731
14937,,qku4atjjfegj,10866,10867,21733
14938,,url:http://www.csa.com/partners/viewrecord.php3frequester3dgs26collection3dtrd26recid3dn9210545ah,10867,10868,21735
14939,,ssvwynhuvxij,10869,10870,21739
14940,,pn7treggv0sj,10870,10871,21741
14941,,9ao5sdf-dquj,10871,10872,21743
14942,,ulm2hsjfovqj,10872,10873,21745
14943,,rzkmp_ec9moj,10873,10874,21747
14944,,hghuvpvsk0aj,10874,10875,21749
14945,,5-3rbopajnij,10875,10876,21751
14946,,jumwo9rtlq8j,10876,10877,21753
14947,,n6klju2tvqyj,10877,10878,21755
14948,,ubuyudbv90uj,10878,10879,21757
14949,,url:http://www.csa.com/partners/viewrecord.php3frequester3dgs26collection3dtrd26recid3d0164170ci,10879,10880,21759
14950,,zs9d5ynkmxmj,10880,10881,21761
14951,,-0uwhjbjdbaj,10881,10882,21763
14952,,oztw3i7lvtij,10882,10883,21765
14953,,url:http://doi.ieeecomputersociety.org/10.1109/mic.2004.59,10883,10884,21767
14954,,hor1eyc3isyj,10884,10885,21769
14955,,g220ayhydpyj,10885,10886,21771
14956,,ylflvkuucpmj,10886,10887,21773
14957,,n73ijvegnvmj,10887,10888,21775
14958,,url:http://ieeexplore.ieee.org/iel5/9217/29235/01320090.pdf3farnumber3d1320090,10888,10889,21777
14959,,7wpfhgsn2uij,10889,10890,21779
14960,,rim9udx6phuj,10890,10891,21781
14961,,url:http://www.ingentaconnect.com/search/expand3fpub3dinfobike://els/09505849/2001/00000043/00000004/art0016026unc3d,10891,10892,21783
14962,,7wvfkmbzy-uj,10892,10893,21785
14963,,g538olgqmaij,10893,10894,21787
14964,,zys4oaas__qj,10894,10895,21789
14965,,4lewhkqcnzmj,10895,10896,21791
14966,,lc5ll_vgv0mj,10896,10897,21793
14967,,eotgauwaq0yj,10897,10898,21795
14968,,xsab5tjhfhmj,10898,10899,21797
14969,,n5psjsk-cq8j,10899,10900,21799
14970,,wr8juc9cenwj,10900,10901,21801
14971,,qivf5mcxlpij,10901,10902,21803
14972,,yotatmamqbej,10902,10903,21805
14973,,ajq8bxi3vz4j,10903,10904,21807
14974,,g0oet1qwc9aj,10904,10905,21809
14975,,faynzummvxuj,10905,10906,21811
14976,,zpvsny_zjvwj,10906,10907,21813
14977,,csvd2kmmcfaj,10907,10908,21815
14978,,8lfxafivbrwj,10908,10909,21817
14979,,rwg6l-dx2ryj,10909,10910,21819
14980,,vqspelc47zwj,10910,10911,21821
14981,,xti5v6mdjd8j,10911,10912,21823
14982,,rqqjpe9ismij,10913,10914,21827
14983,,url:http://doi.wiley.com/10.1002/ev.1385,10914,10915,21829
14984,,f-sxpqrmz8kj,10915,10916,21831
14985,,url:http://portal.acm.org/ft_gateway.cfm3fid3d110131426type3dpdf,10916,10917,21833
14986,,vdnfbtlvmicj,10917,10918,21835
14987,,l7lwk-7nok8j,10918,10919,21837
14988,,q1g9kcztspqj,10919,10920,21839
14989,,bkt3ylwwdq0j,10920,10921,21841
14990,,gbtmoemezwyj,10921,10922,21843
14991,,mipls8cs0auj,10922,10923,21845
14992,,gfbqmsogk8kj,10923,10924,21847
14993,,jc9xuft3hm8j,10924,10925,21849
14994,,z95iugauzhsj,10925,10926,21851
14995,,x0arrve3r20j,10926,10927,21853
14996,,zhyegrmxw0aj,10927,10928,21855
14997,,lcs1_n1dhpkj,10928,10929,21857
14998,,8vtuokuldisj,10929,10930,21859
14999,,a5et_qxykfyj,10930,10931,21861
15000,,hlekio5hqu8j,10931,10932,21863
15001,,xpvrfzpq308j,10932,10933,21865
15002,,dpy-2p1wpw8j,10933,10934,21867
15003,,ovpmajvx4p8j,10934,10935,21869
15004,,khsmp6v8niqj,10935,10936,21871
15005,,d7zsjp1povij,10936,10937,21873
15006,,o8cvwuelfusj,10937,10938,21875
15007,,ojkmv9r19qoj,10938,10939,21877
15008,,txwag_skesgj,10939,10940,21879
15009,,lvcnzr2u0q8j,10940,10941,21881
15010,,yeg0xwsncdwj,10942,10943,21885
15011,,uuorb_hponcj,10943,10944,21887
15012,,dkeod6nprbij,10944,10945,21889
15013,,ashluw5vfkej,10945,10946,21891
15014,,gll48xhnxnkj,10946,10947,21893
15015,,o30xnyaw4iqj,10947,10948,21895
15016,,_kyazmydm6oj,10948,10949,21897
15017,,l5uysiv0y3sj,10949,10950,21899
15018,,jggeq6uhxbcj,10951,10952,21903
15019,,xd9pio1mptoj,10952,10953,21905
15020,,p5q6_6hldauj,10953,10954,21907
15021,,hdzillpsho4j,10954,10955,21909
15022,,rbivctdttuyj,10955,10956,21911
15023,,btpnrhieuiyj,10956,10957,21913
15024,,rvoz_tgudbmj,10957,10958,21915
15025,,lgaenuc-0iwj,10958,10959,21917
15026,,w0och40bnb0j,10959,10960,21919
15027,,mr_hqryvdqij,10960,10961,21921
15028,,klbzdgmab_uj,10961,10962,21923
15029,,url:http://portal.acm.org/ft_gateway.cfm3fid3d12649326type3dpdf26coll3dguide26dl3dacm26cfid3d1111111126cftoken3d2222222,10962,10963,21925
15030,,lpps3bcizj0j,10963,10964,21927
15031,,ezvagbcpln0j,10964,10965,21929
15032,,td2l0x7tzh4j,10965,10966,21931
15033,,ezdkzpuig10j,10966,10967,21933
15034,,r0pofgymlkuj,10967,10968,21935
15035,,_r6ftvxsbn4j,10968,10969,21937
15036,,d4aioxaeersj,10969,10970,21939
15037,,vp4ixbofxa4j,10970,10971,21941
15038,,ufd-plplftej,10971,10972,21943
15039,,h68_hkwmmlqj,10972,10973,21945
15040,,hym_l83d7e4j,10973,10974,21947
15041,,jdqvl9wki0yj,10974,10975,21949
15042,,yczjamfzmzsj,10975,10976,21951
15043,,tdjmaasfhfoj,10976,10977,21953
15044,,hovgrl8nmmoj,10977,10978,21955
15045,,pxkmmyk56dsj,10978,10979,21957
15046,,7f6q9ggxsmgj,10979,10980,21959
15047,,pd6wsv6eu74j,10980,10981,21961
15048,,6qsptb7c00qj,10981,10982,21963
15049,,gciyrjybp_oj,10982,10983,21965
15050,,vvrgcndjn28j,10983,10984,21967
15051,,y-kxztd20yqj,10984,10985,21969
15052,,url:http://doi.wiley.com/10.1002/he.121,10985,10986,21971
15053,,oda7g-cqze0j,10986,10987,21973
15054,,,10987,10988,21975
15055,,wuhy_9rwpfkj,10988,10989,21977
15056,,z_epljmmnqoj,10989,10990,21979
15057,,3t4sxd09r3mj,10990,10991,21981
15058,,bwijphuo0imj,10991,10992,21983
15059,,ki6h8tzdrb4j,10992,10993,21985
15060,,4516r2jrjlmj,10993,10994,21987
15061,,cwjloh1u28ij,10994,10995,21989
15062,,7vk1prumdukj,10995,10996,21991
15063,,kgvpxm-wlcej,10996,10997,21993
15064,,1yjycnjko4qj,10997,10998,21995
15065,,j9hgivfhl2ij,10998,10999,21997
15066,,8i6ygupu9waj,10999,11000,21999
15067,,l6vazwbot-4j,11000,11001,22001
15068,,e2cls4obtn8j,11001,11002,22003
15069,,fujtfhpwj0sj,11002,11003,22005
15070,,3a5pehfnzlmj,11003,11004,22007
15071,,rurufofrqgsj,11004,11005,22009
15072,,lwi9xs6rzjgj,11005,11006,22011
15073,,k8esgeukhq0j,11006,11007,22013
15074,,wl3py6qnyvgj,11007,11008,22015
15075,,vyn0faevomuj,11008,11009,22017
15076,,whibjieizb4j,11009,11010,22019
15077,,hyjodgculzkj,11010,11011,22021
15078,,e7agj9tslfyj,11011,11012,22023
15079,,x3ooxlslvn8j,11012,11013,22025
15080,,wneaqf0i-rej,11013,11014,22027
15081,,yjjm2zzn5zgj,11015,11016,22031
15082,,oazhxkh3-paj,11016,11017,22033
15083,,ashh5xhgtjoj,11017,11018,22035
15084,,w3knmd0fty4j,11018,11019,22037
15085,,i5m6xkja_vij,11019,11020,22039
15086,,0m_q5tf3odaj,11020,11021,22041
15087,,qzw5by67kwcj,11021,11022,22043
15088,,kzmcoykqvtuj,11022,11023,22045
15089,,wsdjyg7jczej,11023,11024,22047
15090,,pj755vwjc9mj,11024,11025,22049
15091,,4q5ikicy82uj,11025,11026,22051
15092,,geke9xwv0oij,11026,11027,22053
15093,,7frf8lxtogmj,11027,11028,22055
15094,,dk8iubeo4l8j,11028,11029,22057
15095,,xs6cg64wj2ij,11029,11030,22059
15096,,wk2qb1m3z4uj,11030,11031,22061
15097,,wdmrrpo5c4aj,11032,11033,22065
15098,,ssco6cc8rwej,11033,11034,22067
15099,,r46dotw4ul8j,11034,11035,22069
15100,,eh0do9q3-fcj,11035,11036,22071
15101,,8whxyowqwhcj,11037,11038,22075
15102,,url:http://www.ingentaconnect.com/search/expand3fpub3dinfobike://pep/jae/2002/00000216/00000008/art0000926unc3d,11038,11039,22077
15103,,13p0ae6tpayj,11039,11040,22079
15104,,xafbzo9xncgj,11040,11041,22081
15105,,8mruozepuwoj,11041,11042,22083
15106,,sktnapct1i4j,11042,11043,22085
15107,,tjn0z-a_i4mj,11043,11044,22087
15108,,url:http://portal.acm.org/ft_gateway.cfm3fid3d105815626type3dpdf,11044,11045,22089
15109,,pvu6ijuygnwj,11045,11046,22091
15110,,ghr7pv4pvfij,11047,11048,22095
15111,,qg_4bfjpeo8j,11048,11049,22097
15112,,vk6ok1wzmtej,11049,11050,22099
15113,,kexokktyni4j,11050,11051,22101
15114,,dssprbsrl70j,11051,11052,22103
15115,,uytk0h86u60j,11052,11053,22105
15116,,url:http://www.ncbi.nlm.nih.gov/entrez/query.fcgi3fcmd3dretrieve26db3dpubmed26list_uids3d1565473526dopt3dcitation,11053,11054,22107
15117,,url:http://portal.acm.org/citation.cfm3fid3d223784.223880,11054,11055,22109
15118,,pny_rsjsxvsj,11055,11056,22111
15119,,hvirvmhots4j,11056,11057,22113
15120,,ag1jjt4nb3ij,11057,11058,22115
15121,,qpkrqzobcfwj,11058,11059,22117
15122,,hz7tbegzrz8j,11059,11060,22119
15123,,url:http://portal.acm.org/citation.cfm3fid3d984395.98439726coll3dguide26dl3dacm26idx3dj68926part3dperiodical26wanttype3dperiodical26title3dacm2520sigmod2520record26cfid3d1111111126cftoken3d2222222,11060,11061,22121
15124,,jsbtu4dadzyj,11061,11062,22123
15125,,ztaeadgfvr8j,11062,11063,22125
15126,,acqlz23mo1uj,11063,11064,22127
15127,,m7lmw37fsfcj,11064,11065,22129
15128,,url:http://portal.acm.org/citation.cfm3fid3d509252.509288,11065,11066,22131
15129,,vs_vdeyvgnqj,11066,11067,22133
15130,,rvphmv_qttmj,11067,11068,22135
15131,,voc4yq0qcbsj,11069,11070,22139
15132,,nh_w3kzvq-4j,11070,11071,22141
15133,,hxlzldg4jtqj,11071,11072,22143
15134,,h-uhagymtycj,11072,11073,22145
15135,,dorfejgvrs4j,11073,11074,22147
15136,,smvnynln91gj,11074,11075,22149
15137,,voojq4xjru0j,11075,11076,22151
15138,,yaqleofwod4j,11076,11077,22153
15139,,yhqwrkr_lc8j,11077,11078,22155
15140,,hjwhoqaxkhqj,11078,11079,22157
15141,,tbdyjqsvhl4j,11079,11080,22159
15142,,advtrjooep4j,11080,11081,22161
15143,,38zul6-4ykqj,11081,11082,22163
15144,,5breojfevqqj,11082,11083,22165
15145,,qcjgwusai-ej,11083,11084,22167
15146,,xyctgpn_8yuj,11084,11085,22169
15147,,_cc2lapjrjmj,11085,11086,22171
15148,,ibhwvcd_gfej,11086,11087,22173
15149,,jbky7aiznvmj,11087,11088,22175
15150,,url:http://portal.acm.org/citation.cfm3fid3d1539926dl3dacm26coll3dportal26cfid3d1111111126cftoken3d2222222,11088,11089,22177
15151,,shxp0f0h7z4j,11089,11090,22179
15152,,vkbivwnspjkj,11090,11091,22181
15153,,mi4zjikzwpaj,11091,11092,22183
15154,,wfhzceh5cl8j,11092,11093,22185
15155,,oqcongqd_g0j,11093,11094,22187
15156,,tzoamhrxm8gj,11094,11095,22189
15157,,l6vz3clr7zej,11095,11096,22191
15158,,1scrrcpiofaj,11096,11097,22193
15159,,fezqowkl34yj,11097,11098,22195
15160,,xj5ij5vha38j,11098,11099,22197
15161,,url:http://portal.acm.org/ft_gateway.cfm3fid3d3221926type3dpdf26dl3dportal26dl3dacm26cfid3d1111111126cftoken3d2222222,11099,11100,22199
15162,,0ytjridztqej,11100,11101,22201
15163,,ocy3jdfgjasj,11101,11102,22203
15164,,fnnoyoclkzwj,11102,11103,22205
15165,,lyaiatmct6aj,11103,11104,22207
15166,,giwqyggui70j,11104,11105,22209
15167,,1hhqpwm6zvmj,11105,11106,22211
15168,,v7nrd323odaj,11106,11107,22213
15169,,o8wk89boyrwj,11107,11108,22215
15170,,url:http://portal.acm.org/ft_gateway.cfm3fid3d108626226type3dpdf,11108,11109,22217
15171,,url:http://portal.acm.org/citation.cfm3fid3d645927.672185,11109,11110,22219
15172,,f6z7pphx4qkj,11110,11111,22221
15173,,hncwkcpcz04j,11111,11112,22223
15174,,url:http://ieeexplore.ieee.org/iel3/4040/11586/00527322.pdf3farnumber3d527322,11113,11114,22227
15175,,p-yxanu1qvwj,11114,11115,22229
15176,,woj-wbwp8_yj,11115,11116,22231
15177,,url:http://links.jstor.org/sici3fsici3d0146-4949(196124)2253a1253c5253akitbrm253e2.0.co253b2-5,11116,11117,22233
15178,,twdpoth2gumj,11117,11118,22235
15179,,k8bn5yxqoiqj,11118,11119,22237
15180,,yqodlhajtqqj,11119,11120,22239
15181,,8210lpnumb0j,11120,11121,22241
15182,,i7koeytscauj,11121,11122,22243
15183,,zgi7aqrx3ygj,11122,11123,22245
15184,,url:http://www.csa.com/partners/viewrecord.php3frequester3dgs26collection3dtrd26recid3dn9210374ah,11123,11124,22247
15185,,kowjv5znfduj,11124,11125,22249
15186,,wo5mbg3vzjaj,11125,11126,22251
15187,,578jkkc8ki0j,11126,11127,22253
15188,,dwau8aow75gj,11127,11128,22255
15189,,urbtnmz6sd4j,11128,11129,22257
15190,,srlof9f5nkcj,11129,11130,22259
15191,,4gplahyv1ncj,11130,11131,22261
15192,,_xm5an54qv4j,11131,11132,22263
15193,,tagq11e6hfaj,11132,11133,22265
15194,,3jkw2etg_gqj,11133,11134,22267
15195,,apdirocdqm8j,11134,11135,22269
15196,,gsgrxg-8wq8j,11135,11136,22271
15197,,uqi5hv2aot0j,11136,11137,22273
15198,,akss_w-hbvcj,11137,11138,22275
15199,,xz224apna18j,11138,11139,22277
15200,,xlnm6z5a8vcj,11139,11140,22279
15201,,lkhazm8hwsaj,11140,11141,22281
15202,,esppim_ox4qj,11141,11142,22283
15203,,gm1musm9i7qj,11142,11143,22285
15204,,q_7hmfecxygj,11143,11144,22287
15205,,wt0_1yayhg0j,11145,11146,22291
15206,,ogsskc_bcvcj,11146,11147,22293
15207,,hsjrocqzqdej,11147,11148,22295
15208,,r0xuzuxsgmwj,11148,11149,22297
15209,,url:http://links.jstor.org/sici3fsici3d0146-4949(196721)8253a2253c312253aanaac253e2.0.co253b2-h,11149,11150,22299
15210,,bi-tgl1emmoj,11150,11151,22301
15211,,5jv-lyznei8j,11152,11153,22305
15212,,znafqj7wymqj,11153,11154,22307
15213,,dubzxxrllx8j,11154,11155,22309
15214,,url:http://portal.acm.org/ft_gateway.cfm3fid3d9994926type3dpdf26dl3dguide26dl3dacm26cfid3d1111111126cftoken3d2222222,11155,11156,22311
15215,,elvw-y3jkqsj,11156,11157,22313
15216,,url:http://portal.acm.org/citation.cfm3fid3d1007568.1007720,11157,11158,22315
15217,,gjtc6tce-hij,11158,11159,22317
15218,,qyeg-vuh-2kj,11159,11160,22319
15219,,xflzfidvktsj,11160,11161,22321
15220,,vdh6yzfak3uj,11161,11162,22323
15221,,3pcywk9-dwcj,11162,11163,22325
15222,,z3bqivi6kfgj,11163,11164,22327
15223,,fss9mpockfuj,11164,11165,22329
15224,,e8w591d4soaj,11165,11166,22331
15225,,lvrcrl-ck0kj,11166,11167,22333
15226,,fsqvg6s3uacj,11167,11168,22335
15227,,adg5-clsngaj,11168,11169,22337
15228,,s0b8xaqafz8j,11169,11170,22339
15229,,url:http://adsabs.harvard.edu/abs/1978phdt........18j,11170,11171,22341
15230,,akpldmxvht8j,11171,11172,22343
15231,,absjf7s7oqmj,11172,11173,22345
15232,,gl8xm07m3xoj,11173,11174,22347
15233,,qxncakipfqsj,11174,11175,22349
15234,,ao2piaqnip0j,11175,11176,22351
15235,,ixeijyoug0qj,11176,11177,22353
15236,,url:http://adsabs.harvard.edu/abs/1988mit..reptq....g,11177,11178,22355
15237,,1-bffnwqltyj,11178,11179,22357
15238,,4z0rrs6kjs8j,11179,11180,22359
15239,,gyhnzpmuqkaj,11180,11181,22361
15240,,rzf103t-dzyj,11181,11182,22363
15241,,cs8_6qp-jyuj,11182,11183,22365
15242,,pj7cjghxagwj,11183,11184,22367
15243,,1kcd4c0mts0j,11184,11185,22369
15244,,ip4hjdb3ypyj,11185,11186,22371
15245,,h1cojiga-rcj,11186,11187,22373
15246,,akpmnzrenlqj,11187,11188,22375
15247,,pacs8velrawj,11188,11189,22377
15248,,eeu1kb_d3tsj,11189,11190,22379
15249,,lalowkxenwcj,11190,11191,22381
15250,,dnm2etsz0m0j,11191,11192,22383
15251,,xa84uivi1dmj,11192,11193,22385
15252,,2uy_p9f8uiaj,11194,11195,22389
15253,,_csxxmt8mbmj,11195,11196,22391
15254,,osg19oktmyoj,11196,11197,22393
15255,,url:http://portal.acm.org/citation.cfm3fid3d592093.592144,11197,11198,22395
15256,,,11198,11199,22397
15257,,wjrte4quusqj,11199,11200,22399
15258,,nwhziuisvaij,11200,11201,22401
15259,,,11201,11202,22403
15260,,xabeibse1wmj,11202,11203,22405
15261,,j1si2l-s9pgj,11203,11204,22407
15262,,oksxcoq76_ij,11204,11205,22409
15263,,url:http://www.csa.com/partners/viewrecord.php3frequester3dgs26collection3dtrd26recid3d20021211035204mt26recid3da7536966ah,11205,11206,22411
15264,,7sn6bwlvpu0j,11206,11207,22413
15265,,2vprw4tf08ej,11207,11208,22415
15266,,6qa1s0lkblmj,11208,11209,22417
15267,,bogiu_rni-yj,11209,11210,22419
15268,,jjn2q74ghmyj,11210,11211,22421
15269,,ifemwltyz-oj,11211,11212,22423
15270,,gsxap6uaptuj,11212,11213,22425
15271,,8qbeokhjeg0j,11213,11214,22427
15272,,p7xsim78vskj,11214,11215,22429
15273,,r5o6icanpcwj,11215,11216,22431
15274,,izy3l38c6p8j,11216,11217,22433
15275,,qaq3cjexar4j,11217,11218,22435
15276,,tbozjr9jajaj,11218,11219,22437
15277,,rrfiy6fpxmuj,11219,11220,22439
15278,,yfixfqggvl8j,11220,11221,22441
15279,,gimus2k4dkej,11221,11222,22443
15280,,z6p4-bdhro0j,11222,11223,22445
15281,,mcoshh9jhnmj,11223,11224,22447
15282,,1dq24xicaxwj,11224,11225,22449
15283,,pbpcf78sarsj,11225,11226,22451
15284,,u0zrjkeejkyj,11226,11227,22453
15285,,kb6csiy-xkkj,11227,11228,22455
15286,,eqrpzjv31ycj,11228,11229,22457
15287,,2wqqcgxw2baj,11229,11230,22459
15288,,g7jjvwfo2muj,11230,11231,22461
15289,,l5essmhraaaj,11231,11232,22463
15290,,ghdsf8ecx1cj,11232,11233,22465
15291,,v0pa9tfmxgsj,11233,11234,22467
15292,,8a_9uchrxyij,11234,11235,22469
15293,,4wq_wvsthvqj,11237,11238,22475
15294,,6qbwwarw6n8j,11238,11239,22477
15295,,nypmlzkk4m8j,11239,11240,22479
15296,,p3orplquelij,11240,11241,22481
15297,,oia0xuaetvmj,11241,11242,22483
15298,,kipdo6ym8buj,11242,11243,22485
15299,,,11243,11244,22487
15300,,7sngbo5xp0kj,11244,11245,22489
15301,,u3stth-k9vkj,11245,11246,22491
15302,,iihp5d53ipaj,11247,11248,22495
15303,,mamudiy-q5yj,11248,11249,22497
15304,,nzj020likh0j,11249,11250,22499
15305,,6lkw2vua-hwj,11250,11251,22501
15306,,fhkp73hltjij,11251,11252,22503
15307,,qio6id_fla0j,11252,11253,22505
15308,,x-jmxnecloej,11253,11254,22507
15309,,0pafby4efbkj,11254,11255,22509
15310,,v-fp87su0moj,11255,11256,22511
15311,,dhltxjnfljqj,11256,11257,22513
15312,,_ehed54ciq8j,11257,11258,22515
15313,,__fmt6m5gy4j,11258,11259,22517
15314,,pu79sd2194ij,11259,11260,22519
15315,,i-0_sjk5jocj,11260,11261,22521
15316,,url:http://www.ingentaconnect.com/content/els/13891286/1999/00000031/00000023/art00116,11261,11262,22523
15317,,uuxsfnym944j,11262,11263,22525
15318,,iz8rfdrkzquj,11263,11264,22527
15319,,r_ot8ur6p_kj,11264,11265,22529
15320,,cfxzuy4etzcj,11265,11266,22531
15321,,9hgnjxzmf8aj,11266,11267,22533
15322,,081tn-1iwkej,11267,11268,22535
15323,,g5q_a11eaeoj,11268,11269,22537
15324,,b5wxzuh_l_ij,11269,11270,22539
15325,,nd8vq0nmafij,11270,11271,22541
15326,,ujkdt_g1uhgj,11271,11272,22543
15327,,mnmgxhzefisj,11272,11273,22545
15328,,idkkgxnb9umj,11273,11274,22547
15329,,w3pojxtvylij,11274,11275,22549
15330,,a7shsc6njnyj,11275,11276,22551
15331,,nsowdevhmy4j,11276,11277,22553
15332,,xajglc9c-roj,11277,11278,22555
15333,,4aok2eb8xgaj,11278,11279,22557
15334,,fk9nd9jnvgyj,11279,11280,22559
15335,,9ji6tox9wtoj,11280,11281,22561
15336,,eagaqfdiygkj,11281,11282,22563
15337,,srbidj5vpgij,11282,11283,22565
15338,,jazk5vztgfkj,11283,11284,22567
15339,,fu4qmppcdlej,11284,11285,22569
15340,,ig5rewde1_ej,11285,11286,22571
15341,,gtnhb0dhac8j,11287,11288,22575
15342,,0mw4sfubuwsj,11288,11289,22577
15343,,dbbzw9epv4qj,11289,11290,22579
15344,,vhhvvyhdkysj,11290,11291,22581
15345,,brycmswmqiwj,11291,11292,22583
15346,,wx0gtgy6dbej,11292,11293,22585
15347,,zgzj5whd04uj,11293,11294,22587
15348,,kfazpklr0x8j,11294,11295,22589
15349,,,11295,11296,22591
15350,,dphlkbztev4j,11296,11297,22593
15351,,g7eatcjedgoj,11297,11298,22595
15352,,url:http://www.csa.com/partners/viewrecord.php3frequester3dgs26collection3dtrd26recid3d0972094ci,11298,11299,22597
15353,,url:http://pubs.acs.org/cgi-bin/abstract.cgi/achre4/2005/38/i05/abs/ar980025r.html,11299,11300,22599
15354,,_llg9ggquq4j,11300,11301,22601
15355,,kyayv1fhhxcj,11301,11302,22603
15356,,iqgsqogoypuj,11302,11303,22605
15357,,bsvndltzca8j,11303,11304,22607
15358,,oiabvf5d4y8j,11304,11305,22609
15359,,powom_mq-bgj,11305,11306,22611
15360,,oqdolhjoz88j,11306,11307,22613
15361,,7ucs6vmjhn0j,11307,11308,22615
15362,,2msx0bejwu4j,11308,11309,22617
15363,,url:http://portal.acm.org/citation.cfm3fid3d171926.171974,11310,11311,22621
15364,,c3qo__olywej,11311,11312,22623
15365,,6ndhrjcfq74j,11312,11313,22625
15366,,lsix00en2a8j,11313,11314,22627
15367,,c6ysbu6zijsj,11315,11316,22631
15368,,hs9vgdwem-cj,11316,11317,22633
15369,,hwpiaqfipgqj,11317,11318,22635
15370,,tgvxtzankr4j,11318,11319,22637
15371,,v1vcpaaa9x8j,11319,11320,22639
15372,,cnxkns4ubhej,11320,11321,22641
15373,,64t0zqzcfgqj,11321,11322,22643
15374,,url:http://doi.wiley.com/10.1002/ev.1656,11322,11323,22645
15375,,tk0mx3zvltej,11323,11324,22647
15376,,kyy7ctu6ogoj,11324,11325,22649
15377,,valwr2pwa2yj,11325,11326,22651
15378,,url:http://www.springerlink.com/index/16794813kj1pqd08.pdf,11326,11327,22653
15379,,lrsr4ga-oa4j,11327,11328,22655
15380,,fuxhzlv9sjuj,11328,11329,22657
15381,,qhq2y3aykc4j,11329,11330,22659
15382,,br4pqxy0eboj,11330,11331,22661
15383,,03tegnxtdh4j,11331,11332,22663
15384,,vqaqjesrqeqj,11332,11333,22665
15385,,1mcn43iim5aj,11333,11334,22667
15386,,b2udycro5cij,11334,11335,22669
15387,,e1cuiv_gifsj,11335,11336,22671
15388,,a_dvn71oa8mj,11336,11337,22673
15389,,4avkiz53ulej,11338,11339,22677
15390,,ujrcwkkm7vmj,11339,11340,22679
15391,,9esx_gd0joqj,11340,11341,22681
15392,,h4dugl8ljxcj,11341,11342,22683
15393,,ujgay2xgzywj,11342,11343,22685
15394,,qjpueno0qjuj,11343,11344,22687
15395,,nbydoftnxewj,11344,11345,22689
15396,,m7b4zkrx9m4j,11345,11346,22691
15397,,21zwy0pm8yaj,11346,11347,22693
15398,,mfcu-5dvecoj,11347,11348,22695
15399,,imbco80aekuj,11348,11349,22697
15400,,url:http://portal.acm.org/citation.cfm3fid3d1101908.1101948,11349,11350,22699
15401,,url:http://portal.acm.org/citation.cfm3fid3d1083784.1083787,11350,11351,22701
15402,,3v6btodte_qj,11351,11352,22703
15403,,url:http://doi.wiley.com/10.1002/he.149,11352,11353,22705
15404,,9njyf0fgpywj,11354,11355,22709
15405,,akosvrla_0qj,11355,11356,22711
15406,,tkef-rzdrhcj,11356,11357,22713
15407,,0qcyhahiircj,11357,11358,22715
15408,,r7o9lxnkozcj,11358,11359,22717
15409,,hvisq8gp4hsj,11359,11360,22719
15410,,pwpmrhlw1u8j,11360,11361,22721
15411,,8ugo38gybbmj,11361,11362,22723
15412,,trbrxzjtm14j,11362,11363,22725
15413,,wij5r_mwwayj,11363,11364,22727
15414,,ntrpqzo4vggj,11364,11365,22729
15415,,3bmcumtplv4j,11365,11366,22731
15416,,tyfhkj20iy4j,11366,11367,22733
15417,,qm_sdjj8-3oj,11368,11369,22737
15418,,5jkw0dzbv9cj,11369,11370,22739
15419,,mjjuireijjwj,11370,11371,22741
15420,,apoh-mmv7nmj,11371,11372,22743
15421,,bxc3gc3b-vkj,11372,11373,22745
15422,,pnqjf4gucfuj,11373,11374,22747
15423,,-02qiatxwv8j,11374,11375,22749
15424,,wx9sjrhtikkj,11375,11376,22751
15425,,2g9ibtdhfwqj,11376,11377,22753
15426,,nbmhxulcbyuj,11377,11378,22755
15427,,doawikqscjyj,11378,11379,22757
15428,,q4sflxytgjmj,11379,11380,22759
15429,,o4tvq7njlqmj,11380,11381,22761
15430,,kylsgtn4tiij,11381,11382,22763
15431,,vsn01kk8gesj,11382,11383,22765
15432,,6zfg1vxb3ryj,11383,11384,22767
15433,,s0oaskpyzewj,11384,11385,22769
15434,,tnuonq9zi4cj,11385,11386,22771
15435,,lenmxp4lw-mj,11386,11387,22773
15436,,kh1ek9hfsskj,11387,11388,22775
15437,,xge69i8zpw0j,11388,11389,22777
15438,,0_oflu76z28j,11389,11390,22779
15439,,7ochjaidcc8j,11390,11391,22781
15440,,uklovw9wkvmj,11391,11392,22783
15441,,gtaal3yv5smj,11392,11393,22785
15442,,agjbnojvumgj,11393,11394,22787
15443,,bl_klsjgf7ij,11394,11395,22789
15444,,spcb4fcry6qj,11395,11396,22791
15445,,jwnnsafxubkj,11396,11397,22793
15446,,afcpeojc2w8j,11397,11398,22795
15447,,vrez7bth37uj,11398,11399,22797
15448,,8guceu2s-f4j,11399,11400,22799
15449,,q9lhtetka9mj,11400,11401,22801
15450,,7zvcfujjzr4j,11401,11402,22803
15451,,fhww9msyudaj,11402,11403,22805
15452,,6v3cbga2484j,11403,11404,22807
15453,,,11405,11406,22811
15454,,relfiscbtqcj,11406,11407,22813
15455,,xar1i7dtkikj,11407,11408,22815
15456,,bkhltmprwbcj,11408,11409,22817
15457,,_udactcm2dyj,11409,11410,22819
15458,,2vnbfiqvv5gj,11410,11411,22821
15459,,xyrhhggzoqsj,11411,11412,22823
15460,,url:http://www.csa.com/partners/viewrecord.php3frequester3dgs26collection3dtrd26recid3d200111010698mt26recid3da0032622ah,11412,11413,22825
15461,,arpojr7gqmmj,11413,11414,22827
15462,,2n9_eckvnlkj,11414,11415,22829
15463,,4eqntunlww8j,11415,11416,22831
15464,,8vsttlnbh5wj,11416,11417,22833
15465,,0ntbasv8slmj,11417,11418,22835
15466,,67sd-t2-mwkj,11418,11419,22837
15467,,w29at2gmncuj,11419,11420,22839
15468,,u_9ttqd-it0j,11420,11421,22841
15469,,tokwft-xgooj,11421,11422,22843
15470,,s-aechjplbmj,11422,11423,22845
15471,,2e5fdifgdoej,11423,11424,22847
15472,,n8krnsf_y30j,11424,11425,22849
15473,,url:http://www.csa.com/partners/viewrecord.php3frequester3dgs26collection3dtrd26recid3d20021214033590mt26recid3da7642816ah,11425,11426,22851
15474,,nc87pssbjksj,11426,11427,22853
15475,,fdjhy-vit-uj,11427,11428,22855
15476,,0bmuqiicbqsj,11428,11429,22857
15477,,h701fniasvaj,11429,11430,22859
15478,,dlubh8qrlkoj,11430,11431,22861
15479,,_sg8qdg4wqkj,11431,11432,22863
15480,,url:http://portal.acm.org/ft_gateway.cfm3fid3d109960326type3dpdf,11432,11433,22865
15481,,xx5_kwxxz2mj,11433,11434,22867
15482,,cvz4sreboq0j,11434,11435,22869
15483,,url:http://adsabs.harvard.edu/abs/1980phdt........55w,11435,11436,22871
15484,,url:http://www.csa.com/partners/viewrecord.php3frequester3dgs26collection3dtrd26recid3d7210130770md26recid3d017205530185xai,11436,11437,22873
15485,,huamipv90_yj,11437,11438,22875
15486,,2tdrpx4vn2cj,11438,11439,22877
15487,,yzk4avdklhgj,11440,11441,22881
15488,,frxcsv7j4lcj,11441,11442,22883
15489,,79lmachig7oj,11442,11443,22885
15490,,vbik95qamgej,11443,11444,22887
15491,,bhrcactuxw8j,11444,11445,22889
15492,,zbviutipqxkj,11445,11446,22891
15493,,81rchdty_nej,11446,11447,22893
15494,,at7rz9xfqpyj,11447,11448,22895
15495,,hszhjkddckmj,11448,11449,22897
15496,,h2j7_rthg7mj,11449,11450,22899
15497,,v0rxhk_k2e4j,11450,11451,22901
15498,,wrpdjf7u7w8j,11451,11452,22903
15499,,e2us8yqvx1sj,11452,11453,22905
15500,,cnlkrvlnpq8j,11453,11454,22907
15501,,odli7ubshg0j,11454,11455,22909
15502,,pv1bjyzvd84j,11455,11456,22911
15503,,aonmghbnvi8j,11456,11457,22913
15504,,5lnnhs9xoqij,11457,11458,22915
15505,,yz72t6ltsuyj,11458,11459,22917
15506,,t1xr0rv1ovqj,11459,11460,22919
15507,,zc_duqpwbuaj,11461,11462,22923
15508,,d4kryxhndssj,11462,11463,22925
15509,,jxuamej_f-kj,11463,11464,22927
15510,,e6dgc-h1ftmj,11464,11465,22929
15511,,hxizjqoaorsj,11465,11466,22931
15512,,u8h8cyzk3tij,11466,11467,22933
15513,,whhgxhrmyikj,11467,11468,22935
15514,,xzvdbss7cfwj,11468,11469,22937
15515,,g9jogv-nuguj,11469,11470,22939
15516,,yixgyke-ycuj,11470,11471,22941
15517,,gntya5hhi0cj,11471,11472,22943
15518,,1xvazyh9qhyj,11472,11473,22945
15519,,rlb299qwr10j,11473,11474,22947
15520,,url:http://doi.wiley.com/10.1002/tl.59,11474,11475,22949
15521,,hgs9sf0nx3kj,11475,11476,22951
15522,,27poopphny4j,11476,11477,22953
15523,,y9qxw394lqmj,11477,11478,22955
15524,,___8oqvrevmj,11478,11479,22957
15525,,xrn3ajfmozoj,11479,11480,22959
15526,,j0kwjunw1uej,11480,11481,22961
15527,,url:http://www.csa.com/partners/viewrecord.php3frequester3dgs26collection3dtrd26recid3d1664587ci,11481,11482,22963
15528,,elvf7mpu42yj,11482,11483,22965
15529,,f4hc2ltcvekj,11483,11484,22967
15530,,yp7-a31y4lyj,11484,11485,22969
15531,,vzfxesmoyucj,11485,11486,22971
15532,,rhqeappqhmoj,11486,11487,22973
15533,,spe6f0cok0aj,11487,11488,22975
15534,,lseageb2iymj,11488,11489,22977
15535,,hncsynip5toj,11489,11490,22979
15536,,zd2vvw8sig8j,11490,11491,22981
15537,,9rlobombhkgj,11491,11492,22983
15538,,zifpmqaozrcj,11493,11494,22987
15539,,wr11qntpdwkj,11494,11495,22989
15540,,qknrc4krsauj,11495,11496,22991
15541,,2ed49yrsdn0j,11496,11497,22993
15542,,r9sqjgbdbloj,11497,11498,22995
15543,,yzvaqfvu4g4j,11498,11499,22997
15544,,1j7sfvupbsgj,11499,11500,22999
15545,,q5ooyzsalc8j,11500,11501,23001
15546,,_bwv0uo54zyj,11501,11502,23003
15547,,i6uc4jkq8quj,11502,11503,23005
15548,,22qjjlyrt3wj,11503,11504,23007
15549,,a_k7dn3bca4j,11504,11505,23009
15550,,kmly6wsh-ewj,11505,11506,23011
15551,,qcjwk2zjrqoj,11506,11507,23013
15552,,jmwvdpny_k0j,11507,11508,23015
15553,,qdzujrelfzij,11508,11509,23017
15554,,dfgddeqdhl0j,11509,11510,23019
15555,,wglhh33jju8j,11510,11511,23021
15556,,aeewxhh7jpsj,11511,11512,23023
15557,,url:http://portal.acm.org/ft_gateway.cfm3fid3d109963426type3dpdf,11512,11513,23025
15558,,0pug3vaijq8j,11513,11514,23027
15559,,brszs5dnvsij,11515,11516,23031
15560,,b8pq-mb78ruj,11516,11517,23033
15561,,yymgro6dy_ej,11517,11518,23035
15562,,3otnpetj1vej,11518,11519,23037
15563,,mny4k4-rjcaj,11519,11520,23039
15564,,vgtaammykvaj,11520,11521,23041
15565,,tfu9pajjrggj,11521,11522,23043
15566,,oqn7one3sz8j,11522,11523,23045
15567,,3cg-mby0zp4j,11523,11524,23047
15568,,c7jqtd28wuuj,11524,11525,23049
15569,,w61bimralrij,11525,11526,23051
15570,,pcmk2xpsrpuj,11527,11528,23055
15571,,vao8o5wo0icj,11528,11529,23057
15572,,ijbop6wdfigj,11529,11530,23059
15573,,i1vxmihdspqj,11530,11531,23061
15574,,kf6x15l8zhqj,11531,11532,23063
15575,,l7-ilq4zpyyj,11532,11533,23065
15576,,m9wpbbrbnmaj,11534,11535,23069
15577,,d5o0ekwgosej,11535,11536,23071
15578,,74wgdyip7ywj,11536,11537,23073
15579,,-t-8gb8h3cgj,11537,11538,23075
15580,,qvyytwotskwj,11538,11539,23077
15581,,1vegfnqtk6kj,11539,11540,23079
15582,,tkwivhyofyaj,11540,11541,23081
15583,,h83y3lv4kaaj,11541,11542,23083
15584,,sj7ujpgnejej,11542,11543,23085
15585,,zdtlljrzco8j,11543,11544,23087
15586,,ejhbh_xweq0j,11544,11545,23089
15587,,hb4nvudipqej,11545,11546,23091
15588,,url:http://doi.wiley.com/10.1002/ev.1703,11546,11547,23093
15589,,czmksb2y1bkj,11547,11548,23095
15590,,vzqmp_yxcl0j,11548,11549,23097
15591,,,11549,11550,23099
15592,,url:http://portal.acm.org/ft_gateway.cfm3fid3d102777126type3dpdf,11550,11551,23101
15593,,ifom4z6uxxuj,11551,11552,23103
15594,,bqvccjazjnmj,11552,11553,23105
15595,,odb3su9uuyqj,11553,11554,23107
15596,,7fegm0jsd4ij,11554,11555,23109
15597,,0brclay1tzaj,11555,11556,23111
15598,,2_ope50oi3cj,11556,11557,23113
15599,,rsdydiq-ocoj,11557,11558,23115
15600,,9zs3lpwnxruj,11558,11559,23117
15601,,5cpiocmcsccj,11559,11560,23119
15602,,khufhcjem84j,11560,11561,23121
15603,,url:http://www.csa.com/partners/viewrecord.php3frequester3dgs26collection3denv26recid3d8913235,11561,11562,23123
15604,,h8ged7c3b9aj,11562,11563,23125
15605,,url:http://portal.acm.org/citation.cfm3fid3d67992.67993,11563,11564,23127
15606,,uk8z1w6l30gj,11564,11565,23129
15607,,4grfg5lsbkuj,11565,11566,23131
15608,,url:http://portal.acm.org/ft_gateway.cfm3fid3d109973326type3dpdf,11566,11567,23133
15609,,kpbf8yvu85uj,11567,11568,23135
15610,,ttqpdbzyzgoj,11568,11569,23137
15611,,yl9jfbtwxkij,11569,11570,23139
15612,,fi2ttzo4hh8j,11570,11571,23141
15613,,url:http://www.csa.com/partners/viewrecord.php3frequester3dgs26collection3dtrd26recid3dn9210500ah,11571,11572,23143
15614,,m7p1xmrc5bsj,11572,11573,23145
15615,,0fxtfb0rs48j,11573,11574,23147
15616,,69jszwnpla0j,11574,11575,23149
15617,,hjwbhppjvasj,11575,11576,23151
15618,,pgxadvdp2dsj,11576,11577,23153
15619,,_csfg5hz97kj,11577,11578,23155
15620,,ckt9u4sihbyj,11578,11579,23157
15621,,o8fpwnf0nm4j,11579,11580,23159
15622,,kmziorwaqguj,11580,11581,23161
15623,,qj9qug6a8okj,11581,11582,23163
15624,,55iw9q6w_noj,11582,11583,23165
15625,,g6xlqjcrkfcj,11583,11584,23167
15626,,zi-ww5ggk0qj,11584,11585,23169
15627,,iool4bra5tyj,11585,11586,23171
15628,,p7wumimn_2oj,11586,11587,23173
15629,,jriqeqrg5wqj,11587,11588,23175
15630,,axj3kyj77n4j,11588,11589,23177
15631,,pde3sz7ft-gj,11589,11590,23179
15632,,cterp8wjvv0j,11590,11591,23181
15633,,yphwxwb_iasj,11591,11592,23183
15634,,nuryi07yqlij,11592,11593,23185
15635,,hn08l-adbz4j,11593,11594,23187
15636,,e0xv8svhrisj,11594,11595,23189
15637,,pllhd97ofpwj,11595,11596,23191
15638,,url:http://portal.acm.org/citation.cfm3fid3d590133.592101,11596,11597,23193
15639,,url:http://www.csa.com/partners/viewrecord.php3frequester3dgs26collection3dtrd26recid3d0697582ci,11597,11598,23195
15640,,8krnuno7-acj,11598,11599,23197
15641,,cbjyoynptw4j,11599,11600,23199
15642,,ls5du51gpzej,11600,11601,23201
15643,,f3wouiyzcnmj,11601,11602,23203
15644,,wpn7s14lzboj,11602,11603,23205
15645,,1m9bmezgbbyj,11603,11604,23207
15646,,y9o18fzzwsmj,11604,11605,23209
15647,,vqhngtzqbpqj,11605,11606,23211
15648,,url:http://www.csa.com/partners/viewrecord.php3frequester3dgs26collection3dtrd26recid3da8622952ah,11606,11607,23213
15649,,ey-uossf-igj,11607,11608,23215
15650,,pebumm8oi9sj,11608,11609,23217
15651,,url:http://portal.acm.org/ft_gateway.cfm3fid3d110125826type3dpdf,11609,11610,23219
15652,,jqglour2x24j,11610,11611,23221
15653,,8pgaxfzy2r8j,11611,11612,23223
15654,,xdnfrtfdscgj,11612,11613,23225
15655,,khkcqsgobjij,11613,11614,23227
15656,,ey4wkdagzsoj,11614,11615,23229
15657,,bottgikqhacj,11615,11616,23231
15658,,url:http://portal.acm.org/ft_gateway.cfm3fid3d35324126type3dpdf26dl3dguide26dl3dacm26cfid3d1111111126cftoken3d2222222,11617,11618,23235
15659,,uny-rlvr5-mj,11618,11619,23237
15660,,o12ycihsjssj,11619,11620,23239
15661,,m1tyn3ow1qmj,11620,11621,23241
15662,,rgwsixshcgaj,11621,11622,23243
15663,,r-nj017mzruj,11622,11623,23245
15664,,1l6riib7lv0j,11623,11624,23247
15665,,url:http://portal.acm.org/ft_gateway.cfm3fid3d110135026type3dpdf,11624,11625,23249
15666,,ep57mmwa7dwj,11625,11626,23251
15667,,degjwa5w1c4j,11627,11628,23255
15668,,gsdvcbqfueej,11628,11629,23257
15669,,0xliojbzdnsj,11629,11630,23259
15670,,5yrfdee2auqj,11630,11631,23261
15671,,7eum2btnfewj,11631,11632,23263
15672,,lyt-atbqxaej,11632,11633,23265
15673,,jizj7hber7yj,11633,11634,23267
15674,,hgn4ukfr_ayj,11634,11635,23269
15675,,url:http://doi.wiley.com/10.1002/ev.1626,11635,11636,23271
15676,,dkedwrmevdgj,11636,11637,23273
15677,,k2ezn69uyx4j,11637,11638,23275
15678,,4layatrgjqyj,11638,11639,23277
15679,,ymu4oloc49wj,11639,11640,23279
15680,,bqnxomvlnuqj,11640,11641,23281
15681,,gr7nw0pah1sj,11641,11642,23283
15682,,evdmclrp1sij,11642,11643,23285
15683,,il_27n_ao2qj,11643,11644,23287
15684,,22m6gshqksyj,11644,11645,23289
15685,,szfx4x7zbygj,11645,11646,23291
15686,,url:http://adsabs.harvard.edu/abs/1973phdt.........1p,11646,11647,23293
15687,,rb8xmhj9fgej,11647,11648,23295
15688,,1rnye3bwutmj,11648,11649,23297
15689,,zwgxfnam2suj,11649,11650,23299
15690,,,11650,11651,23301
15691,,o22gavhcrkgj,11651,11652,23303
15692,,o5p9ea8-tm0j,11652,11653,23305
15693,,hcch_4gs6swj,11653,11654,23307
15694,,z9ecuch9hqaj,11654,11655,23309
15695,,upnmrk5olqwj,11655,11656,23311
15696,,hwzldquk4hcj,11656,11657,23313
15697,,z4bckdja1rcj,11657,11658,23315
15698,,diy4-ustaqij,11658,11659,23317
15699,,go4ympxtc-0j,11659,11660,23319
15700,,zr_ljdzujpyj,11660,11661,23321
15701,,syfsrkkbctcj,11661,11662,23323
15702,,i8fbiyiknmsj,11662,11663,23325
15703,,noqiybqgaj0j,11663,11664,23327
15704,,cxji6iu1wcyj,11664,11665,23329
15705,,itsdkhrqmfmj,11665,11666,23331
15706,,,11666,11667,23333
15707,,av-x5gdrslej,11667,11668,23335
15708,,khpuw1-0noej,11668,11669,23337
15709,,cuyjjeshqowj,11669,11670,23339
15710,,o4zl9vblaemj,11670,11671,23341
15711,,orwtcco6xlaj,11671,11672,23343
15712,,ufmx0jyzht8j,11672,11673,23345
15713,,ybeftbgzpq4j,11673,11674,23347
15714,,to0j2hogccij,11674,11675,23349
15715,,51ikso8ctqsj,11675,11676,23351
15716,,dqr1kdviooej,11676,11677,23353
15717,,ppzqjfbqv_yj,11677,11678,23355
15718,,jxi-cvxzelqj,11678,11679,23357
15719,,iv9_0xggbnej,11679,11680,23359
15720,,spdgviwm8buj,11680,11681,23361
15721,,ja4wnjsalxuj,11681,11682,23363
15722,,-3zolds0bfuj,11682,11683,23365
15723,,l5v-60mi6vwj,11683,11684,23367
15724,,url:http://www.csa.com/partners/viewrecord.php3frequester3dgs26collection3dtrd26recid3da8622965ah,11684,11685,23369
15725,,url:http://portal.acm.org/ft_gateway.cfm3fid3d109960726type3dpdf,11685,11686,23371
15726,,4kqgx9ar3dqj,11686,11687,23373
15727,,url:http://portal.acm.org/ft_gateway.cfm3fid3d109960126type3dpdf,11687,11688,23375
15728,,zhxxpfzbk18j,11688,11689,23377
15729,,tde9belrrgoj,11689,11690,23379
15730,,tjd9d2efez4j,11690,11691,23381
15731,,oyd2lcdxm88j,11691,11692,23383
15732,,_xiiv7vs9xij,11692,11693,23385
15733,,opbq0fg6hzwj,11693,11694,23387
15734,,o7xdnzzsaxij,11694,11695,23389
15735,,uceraydvf_mj,11695,11696,23391
15736,,53hvh65767oj,11696,11697,23393
15737,,bbfbo7tx9bsj,11697,11698,23395
15738,,ptmf3rkgi-8j,11698,11699,23397
15739,,url:http://www.csa.com/partners/viewrecord.php3frequester3dgs26collection3dtrd26recid3da9115399ah,11699,11700,23399
15740,,rflvcp0hlo4j,11700,11701,23401
15741,,ji5cx4wc-zsj,11701,11702,23403
15742,,4lexkxvqnraj,11702,11703,23405
15743,,zxsag85a1uaj,11703,11704,23407
15744,,jjt90ixql2ij,11704,11705,23409
15745,,lvlkkv5jbzcj,11706,11707,23413
15746,,rhiiyodxtnaj,11707,11708,23415
15747,,sy-krhpr6bkj,11708,11709,23417
15748,,so3-yoabh70j,11709,11710,23419
15749,,ocupsppqgnoj,11710,11711,23421
15750,,url:http://pubs.acs.org/cgi-bin/abstract.cgi/achre4/2005/38/i08/abs/ar040006j.html,11711,11712,23423
15751,,hkm1i2h962kj,11712,11713,23425
15752,,bizro_-bhjqj,11713,11714,23427
15753,,tfdsr7bmsgcj,11714,11715,23429
15754,,hnhusxkkn0mj,11715,11716,23431
15755,,kmkmix89yt8j,11716,11717,23433
15756,,amd4oqlfg9mj,11717,11718,23435
15757,,url:http://portal.acm.org/citation.cfm3fid3d144111.144137,11718,11719,23437
15758,,mhejfpbjvkej,11719,11720,23439
15759,,m3wyvzxgf4kj,11720,11721,23441
15760,,hjn8phlf4goj,11721,11722,23443
15761,,m_fbnfvbl60j,11722,11723,23445
15762,,7xtizb-kbkij,11723,11724,23447
15763,,cqlnsekt12ej,11724,11725,23449
15764,,psa_gpbasb8j,11725,11726,23451
15765,,x-yifd0dit4j,11726,11727,23453
15766,,uvcjokwxqyej,11727,11728,23455
15767,,eztqjs-oqg8j,11728,11729,23457
15768,,,11729,11730,23459
15769,,f7s4sjqs2yuj,11730,11731,23461
15770,,pzofzn2b2dcj,11731,11732,23463
15771,,ta25syp2ijwj,11732,11733,23465
15772,,_8xzxxrqtaij,11733,11734,23467
15773,,xo-pbn2ttogj,11734,11735,23469
15774,,5lgbyb0q8ooj,11735,11736,23471
15775,,dq331au8zpwj,11737,11738,23475
15776,,la3fkmwnegaj,11738,11739,23477
15777,,78nek-zalr0j,11739,11740,23479
15778,,hidw-cpbp0cj,11740,11741,23481
15779,,owkspk7qs70j,11741,11742,23483
15780,,dncd4e4hsbmj,11742,11743,23485
15781,,iixxigk58noj,11743,11744,23487
15782,,url:http://portal.acm.org/ft_gateway.cfm3fid3d108366826type3dpdf,11744,11745,23489
15783,,url:http://www.ingentaconnect.com/search/expand3fpub3dinfobike://els/09505849/1999/00000041/00000007/art0001026unc3d,11745,11746,23491
15784,,tgzqrxju8j4j,11746,11747,23493
15785,,fzn8w6qn8c8j,11747,11748,23495
15786,,zbuwjivoe94j,11748,11749,23497
15787,,c2gyh8omiwwj,11749,11750,23499
15788,,k6l0_zcaj8yj,11750,11751,23501
15789,,9-ighmhf6qej,11751,11752,23503
15790,,8aq4n96pe3kj,11752,11753,23505
15791,,72it36q0mkoj,11753,11754,23507
15792,,pid7jrtxkmyj,11754,11755,23509
15793,,oaii0-bxdkoj,11755,11756,23511
15794,,ar4bo3p42ccj,11756,11757,23513
15795,,dz4aisvsur0j,11757,11758,23515
15796,,url:http://doi.wiley.com/10.1002/ev.1464,11758,11759,23517
15797,,wtxnpcefzl8j,11759,11760,23519
15798,,nps8d_xmuxwj,11760,11761,23521
15799,,ifqgbvkr-wcj,11761,11762,23523
15800,,hzt9t_tztk4j,11762,11763,23525
15801,,gtfeiqmmhhcj,11763,11764,23527
15802,,hlapovn8twsj,11764,11765,23529
15803,,ztgvm1cqgh8j,11765,11766,23531
15804,,wad60b0locaj,11766,11767,23533
15805,,mjkswetlxuwj,11767,11768,23535
15806,,dfqtnawn6vmj,11768,11769,23537
15807,,sr5nlh0onngj,11769,11770,23539
15808,,cbyaephdtz0j,11770,11771,23541
15809,,ceg0smt-wrej,11771,11772,23543
15810,,gvo-cecc2mcj,11772,11773,23545
15811,,bbti2v_wtxgj,11773,11774,23547
15812,,r_vozzb88b0j,11774,11775,23549
15813,,o-vuqte0xcgj,11775,11776,23551
15814,,d6ax6xi7ib0j,11776,11777,23553
15815,,url:http://www.csa.com/partners/viewrecord.php3frequester3dgs26collection3dtrd26recid3d0250421ci,11777,11778,23555
15816,,x3_clkt9axqj,11778,11779,23557
15817,,_xlymdiavkej,11779,11780,23559
15818,,pyvxittvimqj,11780,11781,23561
15819,,w0bgt3lmmr0j,11781,11782,23563
15820,,xnnbigmodpuj,11782,11783,23565
15821,,url:http://links.jstor.org/sici3fsici3d0146-4949(196623)7253a3253c295253aiom2522ma253e2.0.co253b2-x,11783,11784,23567
15822,,_zaolrrlndgj,11784,11785,23569
15823,,de5taugqogoj,11785,11786,23571
15824,,urkua_d0kvoj,11786,11787,23573
15825,,url:http://adsabs.harvard.edu/abs/1976phdt........14v,11787,11788,23575
15826,,848sdmnkpckj,11788,11789,23577
15827,,bdmrqboz_ygj,11789,11790,23579
15828,,k5kezw_ebdoj,11790,11791,23581
15829,,whbhqqg-7l8j,11791,11792,23583
15830,,iwcb28deohkj,11792,11793,23585
15831,,_qqgjwo6hg8j,11793,11794,23587
15832,,norfznfxhaej,11794,11795,23589
15833,,034_1kobh24j,11795,11796,23591
15834,,9btofag3vwej,11796,11797,23593
15835,,ik1wds3bgqcj,11797,11798,23595
15836,,9jousa8n5eqj,11798,11799,23597
15837,,url:http://www.csa.com/partners/viewrecord.php3frequester3dgs26collection3denv26recid3d7708725,11799,11800,23599
15838,,2bzcwlklslsj,11800,11801,23601
15839,,ieg3milduioj,11801,11802,23603
15840,,ljwomq8puf8j,11802,11803,23605
15841,,w9__agb84zkj,11803,11804,23607
15842,,ubekhnswouej,11804,11805,23609
15843,,h6warzxpa7yj,11805,11806,23611
15844,,v64jydpu7-wj,11806,11807,23613
15845,,rt3qbwix1fyj,11807,11808,23615
15846,,tkgvuotf-3ij,11808,11809,23617
15847,,url:http://links.jstor.org/sici3fsici3d0146-4949(196522)6253a2253c204253ap2522auvo253e2.0.co253b2-1,11809,11810,23619
15848,,8now9gv1gakj,11810,11811,23621
15849,,apbov8mzozuj,11811,11812,23623
15850,,x4barlj1rguj,11812,11813,23625
15851,,url:http://doi.wiley.com/10.1002/he.140,11813,11814,23627
15852,,h8sfj-gotbwj,11814,11815,23629
15853,,tsymhfk_5foj,11815,11816,23631
15854,,bpamr1g2whgj,11816,11817,23633
15855,,tdmoi56h4fyj,11818,11819,23637
15856,,pyelgnws9z8j,11819,11820,23639
15857,,_zjjo83dd3qj,11820,11821,23641
15858,,,11821,11822,23643
15859,,53fxnzzfw_gj,11822,11823,23645
15860,,bnd0xjyh-hoj,11823,11824,23647
15861,,ouuijel-cgej,11825,11826,23651
15862,,dzof6cukmqej,11826,11827,23653
15863,,6iffwt3reyyj,11828,11829,23657
15864,,bkudfs-luf8j,11829,11830,23659
15865,,kasce-wc9kcj,11831,11832,23663
15866,,kyeht2u1awsj,11832,11833,23665
15867,,swfgf_a7rooj,11833,11834,23667
15868,,url:http://doi.wiley.com/10.1002/anie.199213351,11834,11835,23669
15869,,efvet5151j8j,11835,11836,23671
15870,,2el_yzhkjz0j,11836,11837,23673
15871,,8xpvmb7_gx4j,11837,11838,23675
15872,,ryyxbqenntoj,11838,11839,23677
15873,,url:http://doi.wiley.com/10.1002/ace.8306,11839,11840,23679
15874,,wqfzvotlz8wj,11840,11841,23681
15875,,2usezewz6jsj,11841,11842,23683
15876,,pmjvxf3pn9qj,11842,11843,23685
15877,,6ik7finwlngj,11843,11844,23687
15878,,bqvyxaqsnk0j,11844,11845,23689
15879,,rs20z-scuucj,11845,11846,23691
15880,,dowitkb7pbuj,11846,11847,23693
15881,,q7hiye8deq8j,11847,11848,23695
15882,,krzp_vfnmnej,11848,11849,23697
15883,,020l43rjc00j,11849,11850,23699
15884,,gnhowucvyn4j,11850,11851,23701
15885,,kecfhxfl5e4j,11851,11852,23703
15886,,weoyn3lcniaj,11852,11853,23705
15887,,tqskjhlxquaj,11853,11854,23707
15888,,cjauv4ivsayj,11854,11855,23709
15889,,mtoaimssycqj,11855,11856,23711
15890,,url:http://www.csa.com/partners/viewrecord.php3frequester3dgs26collection3dtrd26recid3d0586715ci,11856,11857,23713
15891,,url:http://www.csa.com/partners/viewrecord.php3frequester3dgs26collection3dtrd26recid3d0028591ci,11857,11858,23715
15892,,m2izm3tz_ioj,11858,11859,23717
15893,,ggypkvtpqnsj,11859,11860,23719
15894,,ly3cq8f4oxej,11860,11861,23721
15895,,v6hztp4lexgj,11861,11862,23723
15896,,lrdmc8aol50j,11862,11863,23725
15897,,x7jjmixx8quj,11863,11864,23727
15898,,udstduzil7qj,11864,11865,23729
15899,,qem2rzbcfcmj,11865,11866,23731
15900,,xe8turxjmhcj,11866,11867,23733
15901,,xf3tlxtmaoyj,11867,11868,23735
15902,,46cg4ov631mj,11868,11869,23737
15903,,hn4j4ucvl4oj,11869,11870,23739
15904,,_5vtibiifgmj,11870,11871,23741
15905,,rgbckkcgteyj,11871,11872,23743
15906,,hctxmdi_dykj,11872,11873,23745
15907,,url:http://portal.acm.org/ft_gateway.cfm3fid3d108370726type3dpdf,11873,11874,23747
15908,,url:http://www.springerlink.com/index/tw66374133851747.pdf,11874,11875,23749
15909,,dcwupe-lwquj,11875,11876,23751
15910,,sp_lyuwrsrmj,11876,11877,23753
15911,,hpeema5tjeqj,11877,11878,23755
15912,,k4qkfckxglej,11878,11879,23757
15913,,lqowibauivqj,11879,11880,23759
15914,,lbys7bnmqlij,11880,11881,23761
15915,,yf1eqajvvb4j,11881,11882,23763
15916,,r90b-sijtewj,11883,11884,23767
15917,,i-pteeuktrkj,11884,11885,23769
15918,,8t5090vlzqoj,11886,11887,23773
15919,,vwupxk02fbkj,11887,11888,23775
15920,,vl3wq99gwscj,11888,11889,23777
15921,,0evk9w3deuqj,11889,11890,23779
15922,,g9exlbledtuj,11890,11891,23781
15923,,a1f6kzliyrwj,11891,11892,23783
15924,,uvl0vskogjij,11892,11893,23785
15925,,7byaafo50r8j,11893,11894,23787
15926,,ewioz8hzozuj,11894,11895,23789
15927,,xmyaneh5gz4j,11895,11896,23791
15928,,ido_qgo3xt8j,11896,11897,23793
15929,,rbeecgammpwj,11897,11898,23795
15930,,hgouvwzc38cj,11898,11899,23797
15931,,sev-9px9auoj,11899,11900,23799
15932,,wrvyiznzhe8j,11900,11901,23801
15933,,al2mfirhz9sj,11901,11902,23803
15934,,tpg--ikwjgcj,11902,11903,23805
15935,,liftv9l1m3aj,11903,11904,23807
15936,,kps4ifr26jaj,11904,11905,23809
15937,,4jfsbhoxbpyj,11905,11906,23811
15938,,ow9ur5uowbmj,11906,11907,23813
15939,,gpgxgr8qzukj,11907,11908,23815
15940,,qoz1-iyrknsj,11908,11909,23817
15941,,avsmuv4yxmsj,11909,11910,23819
15942,,x1cmg30-pvsj,11910,11911,23821
15943,,edi1j2ssb8ij,11911,11912,23823
15944,,obm28t8th08j,11912,11913,23825
15945,,fmuv7iuthxuj,11913,11914,23827
15946,,44gkg3iotdij,11914,11915,23829
15947,,27xk7xw4rncj,11915,11916,23831
15948,,url:http://doi.wiley.com/10.1002/ace.51,11916,11917,23833
15949,,vowtcewpfm8j,11917,11918,23835
15950,,9lfaqz1v2m4j,11918,11919,23837
15951,,g-vxiet9f9sj,11919,11920,23839
15952,,y8cswrnw3xyj,11920,11921,23841
15953,,8qjol5mogm8j,11921,11922,23843
15954,,url:http://doi.wiley.com/10.1002/he.168,11922,11923,23845
15955,,fvki7lbhwdsj,11923,11924,23847
15956,,_rsdhfee2vsj,11924,11925,23849
15957,,wqhoegczcx8j,11925,11926,23851
15958,,bok7h-hklnqj,11926,11927,23853
15959,,tlolfo1dphqj,11927,11928,23855
15960,,url:http://www.csa.com/partners/viewrecord.php3frequester3dgs26collection3dtrd26recid3d0879844ci,11928,11929,23857
15961,,nnvfc1rufqaj,11929,11930,23859
15962,,x1curmr_xfsj,11930,11931,23861
15963,,bjz8sxynrd0j,11931,11932,23863
15964,,2wytzmmz9mmj,11932,11933,23865
15965,,2ldubny0hwwj,11933,11934,23867
15966,,8oh7hh0-awwj,11934,11935,23869
15967,,eqe1keqt1tcj,11935,11936,23871
15968,,xukb8z_g63sj,11936,11937,23873
15969,,ivnxxl0_tzej,11937,11938,23875
15970,,url:http://www.csa.com/partners/viewrecord.php3frequester3dgs26collection3dtrd26recid3d20021211001548mt26recid3da8622909ah,11938,11939,23877
15971,,epmjqve8c0uj,11939,11940,23879
15972,,lqagqxpxpxmj,11940,11941,23881
15973,,nhfbwa7-ksij,11941,11942,23883
15974,,u1lng1p5wwkj,11942,11943,23885
15975,,fnhyfxjae7aj,11943,11944,23887
15976,,uty3umahgkej,11944,11945,23889
15977,,onijwxjqz4aj,11945,11946,23891
15978,,ta4l8izfz40j,11946,11947,23893
15979,,4cvokhi4viwj,11947,11948,23895
15980,,nmtgtely8naj,11948,11949,23897
15981,,ryyvla3-mikj,11949,11950,23899
15982,,put9mt12a7mj,11950,11951,23901
15983,,utvqf9cbszmj,11951,11952,23903
15984,,0ja1eixpdb0j,11953,11954,23907
15985,,cjm6ngvvt0wj,11954,11955,23909
15986,,hyym3v0bamqj,11955,11956,23911
15987,,9fhfyg7kciwj,11956,11957,23913
15988,,d3dgp2ow8bej,11957,11958,23915
15989,,wc-ynrqvpjcj,11958,11959,23917
15990,,uyfnzowgapyj,11959,11960,23919
15991,,isftaxsmr2yj,11960,11961,23921
15992,,zry61xtycksj,11961,11962,23923
15993,,y5yk-0zvsb0j,11962,11963,23925
15994,,grq7gf4ws8gj,11963,11964,23927
15995,,99kihunk5gwj,11964,11965,23929
15996,,quucx1uwwc0j,11965,11966,23931
15997,,de_mk2kgbrqj,11966,11967,23933
15998,,url:http://www.csa.com/partners/viewrecord.php3frequester3dgs26collection3dtrd26recid3d200111010704mt26recid3da0032635ah,11967,11968,23935
15999,,ekn7_fkpxl4j,11968,11969,23937
16000,,77oikqsr1tkj,11969,11970,23939
16001,,,11970,11971,23941
16002,,wslh1vg4gd0j,11971,11972,23943
16003,,mnkpx54vvocj,11972,11973,23945
16004,,kurffrlfmfoj,11973,11974,23947
16005,,evcvwhrzwisj,11974,11975,23949
16006,,w64ouftjjq4j,11975,11976,23951
16007,,kiqmjcpsfp0j,11976,11977,23953
16008,,3gfg_x8llqqj,11977,11978,23955
16009,,url:http://www.csa.com/partners/viewrecord.php3frequester3dgs26collection3dtrd26recid3d155942ws26recid3d199301550075md,11978,11979,23957
16010,,zfgzdnpnofuj,11979,11980,23959
16011,,nimmkrzxwzoj,11980,11981,23961
16012,,38haljpoqpwj,11981,11982,23963
16013,,4tnp3rw2uqkj,11982,11983,23965
16014,,2gwxn3jt0uwj,11984,11985,23969
16015,,url:http://adsabs.harvard.edu/abs/1978phdt........71g,11985,11986,23971
16016,,srwif9g-tbgj,11986,11987,23973
16017,,sldq4tkewuqj,11988,11989,23977
16018,,8vxpkpf-ay8j,11989,11990,23979
16019,,g4js4jqjua0j,11990,11991,23981
16020,,azicsgcj36aj,11991,11992,23983
16021,,kcvmjpw4pa4j,11992,11993,23985
16022,,3uvjpnq96ouj,11993,11994,23987
16023,,g38vlyaw4bmj,11994,11995,23989
16024,,rmbqwkp0kauj,11995,11996,23991
16025,,tuyvblf-05qj,11996,11997,23993
16026,,ahn0glrl4hij,11997,11998,23995
16027,,cyuphsi9ecmj,11998,11999,23997
16028,,gvlgwthk4s4j,11999,12000,23999
16029,,mzilcuhva8yj,12000,12001,24001
16030,,vrdio9ydh6uj,12001,12002,24003
16031,,thob0y4uudij,12002,12003,24005
16032,,url:http://adsabs.harvard.edu/abs/1982mit..repts....w,12003,12004,24007
16033,,ey_9i9vz8jkj,12004,12005,24009
16034,,xwlncaiblboj,12005,12006,24011
16035,,mfho0e9dtlcj,12006,12007,24013
16036,,t6uv74lrgw4j,12007,12008,24015
16037,,egwtjpgzezmj,12008,12009,24017
16038,,4r1fg8cbcsaj,12009,12010,24019
16039,,nrigbb65r3kj,12010,12011,24021
16040,,h4dom_tpde4j,12011,12012,24023
16041,,cc188eyk0qmj,12012,12013,24025
16042,,yxuwy0c9gs8j,12014,12015,24029
16043,,vzqqwoedg1sj,12015,12016,24031
16044,,r2swiuo1qvaj,12016,12017,24033
16045,,og-sbfstkogj,12017,12018,24035
16046,,yefe2cl85kkj,12018,12019,24037
16047,,4srgcliwkncj,12019,12020,24039
16048,,qel7zszgazqj,12020,12021,24041
16049,,,12021,12022,24043
16050,,ilvpttozmjuj,12022,12023,24045
16051,,8kfqssrbga0j,12023,12024,24047
16052,,nexeipkvatkj,12024,12025,24049
16053,,zoy5yonpongj,12025,12026,24051
16054,,lx7jxjm_fa0j,12026,12027,24053
16055,,gjqjw5ptwsuj,12027,12028,24055
16056,,vcqka_llu8sj,12028,12029,24057
16057,,oacoazg64awj,12029,12030,24059
16058,,qtc23vvz5yej,12030,12031,24061
16059,,tpt9eyqa2qoj,12031,12032,24063
16060,,zdoxmbns6loj,12032,12033,24065
16061,,c7kr2biysbaj,12033,12034,24067
16062,,oi5ud5uqwlcj,12034,12035,24069
16063,,mbi-f8yclsej,12035,12036,24071
16064,,tycxsyhw-gsj,12036,12037,24073
16065,,gc6ve7n1z8ij,12037,12038,24075
16066,,1c4uh8blyaej,12038,12039,24077
16067,,zf4uvaovytij,12039,12040,24079
16068,,rr8vefn_6v0j,12040,12041,24081
16069,,6dmmmnfsohqj,12041,12042,24083
16070,,xgdlb0zogs4j,12042,12043,24085
16071,,ztibx8kspluj,12043,12044,24087
16072,,q0mjlsuhsxkj,12044,12045,24089
16073,,gt44wy948imj,12045,12046,24091
16074,,ejtj0udern8j,12046,12047,24093
16075,,wpaxulzzqpsj,12047,12048,24095
16076,,dctcpm33ocwj,12049,12050,24099
16077,,gan6cjr_hb8j,12051,12052,24103
16078,,7qmkfar19aij,12052,12053,24105
16079,,url:http://www.csa.com/partners/viewrecord.php3frequester3dgs26collection3dtrd26recid3dn9210532ah,12053,12054,24107
16080,,c-rj2aimujwj,12054,12055,24109
16081,,40h0phbmpnyj,12055,12056,24111
16082,,url:http://doi.wiley.com/10.1002/ace.165,12056,12057,24113
16083,,zmheu6z4etmj,12057,12058,24115
16084,,cp5co2kyb68j,12058,12059,24117
16085,,wb6wvzwlgd4j,12059,12060,24119
16086,,0ie5wxvtlhkj,12060,12061,24121
16087,,c28og6cz8cwj,12061,12062,24123
16088,,hxct03pm8kgj,12062,12063,24125
16089,,urfegda2xtoj,12063,12064,24127
16090,,zynthv5pqooj,12064,12065,24129
16091,,gmcdnjr0q9ij,12065,12066,24131
16092,,gpyzal6hblij,12066,12067,24133
16093,,8kz1nhmd4dcj,12067,12068,24135
16094,,0kepyv8vvd8j,12068,12069,24137
16095,,_uw3fg4zjxqj,12069,12070,24139
16096,,nd46ldkhz80j,12070,12071,24141
16097,,5n2k30iylwoj,12071,12072,24143
16098,,wkmtofmijvwj,12072,12073,24145
16099,,url:http://portal.acm.org/ft_gateway.cfm3fid3d97413826type3dpdf26dl3dguide26dl3dacm26cfid3d1111111126cftoken3d2222222,12073,12074,24147
16100,,gincm2-nqr8j,12074,12075,24149
16101,,vnkc7x7kbk0j,12075,12076,24151
16102,,e7iw2fqjtrmj,12076,12077,24153
16103,,_6ouz1u_rjwj,12077,12078,24155
16104,,fhkbdyqnzvmj,12078,12079,24157
16105,,ncr0-cl0gryj,12079,12080,24159
16106,,url:http://www.csa.com/partners/viewrecord.php3frequester3dgs26collection3dtrd26recid3d0201748ci,12080,12081,24161
16107,,zkid-lpfkgej,12081,12082,24163
16108,,url:http://doi.wiley.com/10.1002/he.9708,12082,12083,24165
16109,,ouw7up9-avcj,12083,12084,24167
16110,,ps-0qinhh4ij,12084,12085,24169
16111,,z6pfwudg5z4j,12085,12086,24171
16112,,q3dlfkmw9maj,12086,12087,24173
16113,,6b1kvrnln-cj,12087,12088,24175
16114,,url:http://www.csa.com/partners/viewrecord.php3frequester3dgs26collection3dtrd26recid3dn9210479ah,12088,12089,24177
16115,,0fi_szumoluj,12089,12090,24179
16116,,8dj_i69xp60j,12090,12091,24181
16117,,wt3sbf2mdhcj,12091,12092,24183
16118,,9hhrbld8ldwj,12092,12093,24185
16119,,ylasnwfvt2sj,12093,12094,24187
16120,,fkqwp92eroqj,12094,12095,24189
16121,,8johspofnjij,12095,12096,24191
16122,,g0qxucp6-_ej,12096,12097,24193
16123,,eq0ys8s10vcj,12097,12098,24195
16124,,odurm1yq7xcj,12098,12099,24197
16125,,co2ye-uyyu8j,12099,12100,24199
16126,,vmfqxybjyqij,12100,12101,24201
16127,,l5iqttdp9bej,12101,12102,24203
16128,,rt9jb9sw6c4j,12102,12103,24205
16129,,csy3l7bkfxqj,12103,12104,24207
16130,,lt3_ks_eeioj,12104,12105,24209
16131,,d2watesetcmj,12105,12106,24211
16132,,fsm0o6kxrngj,12106,12107,24213
16133,,url:http://www.springerlink.com/index/g56t488724357j32.pdf,12108,12109,24217
16134,,w4jsphdfxlej,12109,12110,24219
16135,,vcxhuwieowqj,12110,12111,24221
16136,,sfhnxjekw1cj,12111,12112,24223
16137,,dclc1yd9q7ij,12112,12113,24225
16138,,qi8so7k48jyj,12113,12114,24227
16139,,bsyvrdqvl2cj,12114,12115,24229
16140,,qauiobiroiwj,12115,12116,24231
16141,,tzktr8kkdcsj,12116,12117,24233
16142,,rty-rtlk85uj,12117,12118,24235
16143,,ap62mlaveugj,12118,12119,24237
16144,,aaggwgg6iqcj,12119,12120,24239
16145,,tkpepqppxpcj,12120,12121,24241
16146,,ukldza0_w8yj,12121,12122,24243
16147,,quq7afbseduj,12122,12123,24245
16148,,9lsaq9dfm88j,12123,12124,24247
16149,,f9umrvi8ndgj,12124,12125,24249
16150,,sueqtp5sctej,12125,12126,24251
16151,,hehdvy37j8kj,12126,12127,24253
16152,,dllbq-q3stgj,12127,12128,24255
16153,,3o-rngrfcpsj,12128,12129,24257
16154,,ii-qq8y3fiuj,12129,12130,24259
16155,,_jqjzczug-kj,12130,12131,24261
16156,,mi0c0opstooj,12131,12132,24263
16157,,n5mvjf7oo1wj,12132,12133,24265
16158,,omqpxscl5gyj,12133,12134,24267
16159,,2lms2klethkj,12134,12135,24269
16160,,rk6g2m3bsqgj,12135,12136,24271
16161,,yub30hymaycj,12136,12137,24273
16162,,pnwrku_px3cj,12137,12138,24275
16163,,s-vkm5byifmj,12138,12139,24277
16164,,osfwkjek9l8j,12139,12140,24279
16165,,zvzjgybcptij,12140,12141,24281
16166,,pd0cg860r4sj,12141,12142,24283
16167,,8eddfr9v_k8j,12142,12143,24285
16168,,1mfqkrzumq0j,12143,12144,24287
16169,,el2hw1d_a3oj,12144,12145,24289
16170,,egzkis4tfpmj,12145,12146,24291
16171,,boyfe62n0lkj,12146,12147,24293
16172,,lbvi9r1wkrgj,12147,12148,24295
16173,,e6t2uyxgmk8j,12148,12149,24297
16174,,zrnybk18ow8j,12149,12150,24299
16175,,url:http://portal.acm.org/ft_gateway.cfm3fid3d21976926type3dpdf26dl3dguide26dl3dacm26cfid3d1111111126cftoken3d2222222,12150,12151,24301
16176,,oipcch_c9gej,12151,12152,24303
16177,,vmoxcfdfzhqj,12152,12153,24305
16178,,yc4dc6q1ggoj,12153,12154,24307
16179,,r0el4syuulkj,12154,12155,24309
16180,,uhbwtfdaufwj,12155,12156,24311
16181,,dmqy1xrbd_cj,12156,12157,24313
16182,,nu3nzoy91ogj,12157,12158,24315
16183,,oumb9lgpm6cj,12159,12160,24319
16184,,3rbs_k3di6sj,12160,12161,24321
16185,,jghlkgn70kij,12161,12162,24323
16186,,au9qkjbzcp8j,12162,12163,24325
16187,,uiemflwtpkqj,12163,12164,24327
16188,,3yp5ytubviij,12164,12165,24329
16189,,xxtspmkjyuqj,12165,12166,24331
16190,,wrj3huven6mj,12166,12167,24333
16191,,sdwycmrbzhij,12167,12168,24335
16192,,url:http://www.csa.com/partners/viewrecord.php3frequester3dgs26collection3dtrd26recid3dn9210498ah,12168,12169,24337
16193,,fjqsxkrwxj4j,12169,12170,24339
16194,,iho-wxg_iyuj,12170,12171,24341
16195,,d9fzbz0nmmmj,12171,12172,24343
16196,,0zvzqsktm5uj,12172,12173,24345
16197,,8640q2sygbij,12173,12174,24347
16198,,vu6w7vujd78j,12174,12175,24349
16199,,rugpxuoyov0j,12176,12177,24353
16200,,jtbgy68ggroj,12177,12178,24355
16201,,tvtb_4mtaj0j,12178,12179,24357
16202,,rkiwtl2yov4j,12179,12180,24359
16203,,1yfyb-t_9z8j,12180,12181,24361
16204,,kqng3-wlcmkj,12181,12182,24363
16205,,bg5fknqawf0j,12182,12183,24365
16206,,acifshkvou0j,12183,12184,24367
16207,,denme85yhrqj,12184,12185,24369
16208,,tsu83ysxaxmj,12185,12186,24371
16209,,545xxkmyqpej,12186,12187,24373
16210,,url:http://www.springerlink.com/index/v077257007611033.pdf,12187,12188,24375
16211,,heugnp9r_zmj,12188,12189,24377
16212,,1d0xhap4zykj,12189,12190,24379
16213,,1w3iefga2duj,12190,12191,24381
16214,,48f1hf4wv-ij,12191,12192,24383
16215,,m3orlyxxnaij,12192,12193,24385
16216,,kokv0dsecs8j,12193,12194,24387
16217,,tudcqorkkcsj,12194,12195,24389
16218,,i_y_iwhlin8j,12195,12196,24391
16219,,do69xfflxukj,12196,12197,24393
16220,,dne3yybaoxgj,12197,12198,24395
16221,,mca7gne_y7aj,12198,12199,24397
16222,,52t-38vphxaj,12199,12200,24399
16223,,lwkep4vk1_ej,12200,12201,24401
16224,,nbmyibe8kmkj,12201,12202,24403
16225,,gnxryfbsqa4j,12202,12203,24405
16226,,st5z7fwpahyj,12203,12204,24407
16227,,6kicljpjalmj,12204,12205,24409
16228,,8jmquvf-oh4j,12205,12206,24411
16229,,32aydsd8k3kj,12206,12207,24413
16230,,vl7y_ryu8yij,12207,12208,24415
16231,,f5bivv8dpluj,12208,12209,24417
16232,,acentrfntegj,12209,12210,24419
16233,,mkmjfzwyryyj,12210,12211,24421
16234,,tx-yrdldymqj,12211,12212,24423
16235,,pbqjepdb8b4j,12212,12213,24425
16236,,1hyh5mg-iq8j,12213,12214,24427
16237,,6vdac8z7kmcj,12214,12215,24429
16238,,oxinyjoxmlej,12215,12216,24431
16239,,sqq3e67-zamj,12216,12217,24433
16240,,url:http://portal.acm.org/ft_gateway.cfm3fid3d106616526type3dpdf,12217,12218,24435
16241,,osd1ecrkgtgj,12218,12219,24437
16242,,msw9onodcvej,12219,12220,24439
16243,,ukgmcc4xug4j,12220,12221,24441
16244,,otkpdk53anqj,12221,12222,24443
16245,,zwevfipm1xcj,12222,12223,24445
16246,,wy8yhqybkdoj,12223,12224,24447
16247,,nnn2b3acrtyj,12224,12225,24449
16248,,cmj-pwff5doj,12225,12226,24451
16249,,rcmmgto63rej,12226,12227,24453
16250,,h60yds0orcij,12227,12228,24455
16251,,kcovxa5z05oj,12228,12229,24457
16252,,ufvpnjnk-k4j,12229,12230,24459
16253,,8mob29alxmaj,12230,12231,24461
16254,,shkq2thnt4ej,12231,12232,24463
16255,,jcvx29hunxoj,12232,12233,24465
16256,,nlx2coqkaaoj,12233,12234,24467
16257,,kbrwipkgqcyj,12234,12235,24469
16258,,gq2yqozghbgj,12235,12236,24471
16259,,ngjr-yaz7x4j,12236,12237,24473
16260,,ybauisdh0m0j,12237,12238,24475
16261,,h2shqmjq64gj,12238,12239,24477
16262,,xavssa9xyjij,12239,12240,24479
16263,,umkgcfe77l8j,12240,12241,24481
16264,,ni4vwvktwrmj,12241,12242,24483
16265,,zmo6l4llsfkj,12243,12244,24487
16266,,h-1foiqpjj0j,12244,12245,24489
16267,,cqtlt2hlguwj,12245,12246,24491
16268,,qdwd_yg3ygmj,12246,12247,24493
16269,,jxvsw6vxbmyj,12247,12248,24495
16270,,ayxhofdlknkj,12248,12249,24497
16271,,6rd0bksrraej,12250,12251,24501
16272,,waqkco-lsaej,12251,12252,24503
16273,,eduohnx-awej,12252,12253,24505
16274,,,12253,12254,24507
16275,,xlfkieolfwuj,12254,12255,24509
16276,,viqck3xfms0j,12255,12256,24511
16277,,url:http://portal.acm.org/citation.cfm3fid3d48351.48359,12256,12257,24513
16278,,paoevjzvrvij,12257,12258,24515
16279,,ij6g4vkp71wj,12258,12259,24517
16280,,9_hy4pynlpaj,12259,12260,24519
16281,,t_hwarvgq3mj,12260,12261,24521
16282,,gbv6bmc-8kuj,12261,12262,24523
16283,,cd58swazp7oj,12262,12263,24525
16284,,n4dghqlosloj,12263,12264,24527
16285,,awlfpddbobsj,12264,12265,24529
16286,,avoddw7yaokj,12265,12266,24531
16287,,rlxzal9jttyj,12266,12267,24533
16288,,0ntkhjfxdmej,12267,12268,24535
16289,,jtwvnxtz794j,12268,12269,24537
16290,,nro_g9y0tv8j,12269,12270,24539
16291,,hqnmmloov-kj,12270,12271,24541
16292,,uocjqeqhw_uj,12271,12272,24543
16293,,j2qlvkkiopej,12272,12273,24545
16294,,oswd9dn_ojqj,12273,12274,24547
16295,,efdha7hrbdsj,12274,12275,24549
16296,,uewztume8h4j,12275,12276,24551
16297,,r61_ez1cmocj,12276,12277,24553
16298,,awqlq_mmegkj,12277,12278,24555
16299,,yrf2cmsokscj,12278,12279,24557
16300,,eklh1u2tbhcj,12279,12280,24559
16301,,9rdll5yaqnoj,12280,12281,24561
16302,,qhiwliv88myj,12281,12282,24563
16303,,pdpt2xonmkoj,12282,12283,24565
16304,,url:http://www.geography.org.uk/journals/journals.asp3farticleid3d155,12283,12284,24567
16305,,ozu_ntz9xyej,12284,12285,24569
16306,,ubbvtz2wnogj,12285,12286,24571
16307,,g0wrgmmgp3ij,12286,12287,24573
16308,,sjlspa54vuyj,12287,12288,24575
16309,,dzggvwgplnyj,12288,12289,24577
16310,,ocgvlmv7jmkj,12289,12290,24579
16311,,8vx3jdrfoucj,12290,12291,24581
16312,,z58oclwtygsj,12291,12292,24583
16313,,fpuo4tc4lkoj,12292,12293,24585
16314,,8nwnsijdjxij,12293,12294,24587
16315,,uy66zsedf4sj,12294,12295,24589
16316,,gptowaonrm4j,12295,12296,24591
16317,,oqiyaqt2kqoj,12296,12297,24593
16318,,tugrmskm_pkj,12297,12298,24595
16319,,twsjs41bgpgj,12298,12299,24597
16320,,90rzfozmfh8j,12299,12300,24599
16321,,2kyx0g-05ucj,12300,12301,24601
16322,,url:http://portal.acm.org/citation.cfm3fid3d234286.1057847,12301,12302,24603
16323,,taj3xqyz2pwj,12302,12303,24605
16324,,1ij1q8p3iy8j,12303,12304,24607
16325,,url:http://portal.acm.org/ft_gateway.cfm3fid3d35309126type3dpdf26dl3dportal26dl3dacm26cfid3d1111111126cftoken3d2222222,12304,12305,24609
16326,,kuhrzrcnxg0j,12305,12306,24611
16327,,aujzcz3q69ej,12306,12307,24613
16328,,tvxhvbzs0z0j,12307,12308,24615
16329,,z6idugp9fwaj,12308,12309,24617
16330,,8amuaqgfxnsj,12309,12310,24619
16331,,etlgzqjzptej,12310,12311,24621
16332,,ea-cffcpowkj,12311,12312,24623
16333,,asokindya04j,12312,12313,24625
16334,,c4crc-bdrzwj,12313,12314,24627
16335,,e9of96s1gq8j,12314,12315,24629
16336,,9un2rtpksr4j,12315,12316,24631
16337,,u9bpuk_6kjkj,12316,12317,24633
16338,,hiz__vorhzoj,12317,12318,24635
16339,,swjpiloxgemj,12318,12319,24637
16340,,cvchvz9-m_oj,12319,12320,24639
16341,,ba4wl-uggroj,12320,12321,24641
16342,,g9-cxkfbdzcj,12321,12322,24643
16343,,xb-weyme7pcj,12322,12323,24645
16344,,xw464_efsboj,12323,12324,24647
16345,,qluvkecx8mcj,12325,12326,24651
16346,,bdk2zsjq1ucj,12326,12327,24653
16347,,fqkczwtmqm4j,12327,12328,24655
16348,,nuuaytenoigj,12328,12329,24657
16349,,mhswp9ztmtyj,12329,12330,24659
16350,,7dsw2lcfhjej,12330,12331,24661
16351,,_ltnqlq_2_ej,12331,12332,24663
16352,,jdccaw6m0xgj,12332,12333,24665
16353,,8hadvd1lhssj,12333,12334,24667
16354,,x15bvav_qmoj,12334,12335,24669
16355,,z_g8bbtjkygj,12335,12336,24671
16356,,svaatw6gu54j,12336,12337,24673
16357,,url:http://www.csa.com/partners/viewrecord.php3frequester3dgs26collection3dtrd26recid3dn9210462ah,12337,12338,24675
16358,,lw5mw5unngij,12338,12339,24677
16359,,mdpjfeklcssj,12339,12340,24679
16360,,zs1wkrovceoj,12340,12341,24681
16361,,fekoaxfl1hoj,12341,12342,24683
16362,,mv-d2yzypiuj,12342,12343,24685
16363,,npdnu0l1jmoj,12343,12344,24687
16364,,jwfy9djvjuij,12345,12346,24691
16365,,q87jrcr_gqqj,12346,12347,24693
16366,,irafmo6t6c0j,12347,12348,24695
16367,,r2iudyi5rtcj,12348,12349,24697
16368,,kfoh4clsqhej,12349,12350,24699
16369,,url:http://portal.acm.org/ft_gateway.cfm3fid3d108361926type3dpdf,12350,12351,24701
16370,,vwtaaodwyggj,12351,12352,24703
16371,,ez-wun5imgoj,12352,12353,24705
16372,,tm5kaphcgjuj,12353,12354,24707
16373,,whfpwnwzqksj,12354,12355,24709
16374,,c92uhb2oismj,12355,12356,24711
16375,,3pdxn1lmlyyj,12356,12357,24713
16376,,a7-noviz3voj,12357,12358,24715
16377,,0ohkgkpeq1qj,12358,12359,24717
16378,,url:http://www.csa.com/partners/viewrecord.php3frequester3dgs26collection3dtrd26recid3d200122000145ce26recid3d200111000449mt26recid3da0032568ah,12359,12360,24719
16379,,wbhiwxekt8qj,12360,12361,24721
16380,,vcdpy0kzzygj,12361,12362,24723
16381,,llw9g1folkoj,12362,12363,24725
16382,,mwlbprsl5_uj,12363,12364,24727
16383,,cunkcr4shtoj,12364,12365,24729
16384,,ijuqxo57uaej,12365,12366,24731
16385,,gwewj-icbbyj,12366,12367,24733
16386,,url:http://www.csa.com/partners/viewrecord.php3frequester3dgs26collection3dtrd26recid3da8622950ah,12367,12368,24735
16387,,u926nimzr6sj,12369,12370,24739
16388,,b5dsxqrt1ogj,12370,12371,24741
16389,,u8mdyilwsaqj,12371,12372,24743
16390,,tieprfvh5cej,12372,12373,24745
16391,,nryleq0cx5cj,12373,12374,24747
16392,,m2ovycanv_qj,12374,12375,24749
16393,,ivbvft1h_smj,12375,12376,24751
16394,,p7vgxbo_mlsj,12376,12377,24753
16395,,rsuivjyr3gqj,12377,12378,24755
16396,,aho9buvyzwgj,12378,12379,24757
16397,,ijwj7cfqpe0j,12379,12380,24759
16398,,fyybol6qd84j,12380,12381,24761
16399,,jcg9mxzfxsyj,12381,12382,24763
16400,,b3g8n0iacdmj,12382,12383,24765
16401,,w2nbbrrqdrij,12383,12384,24767
16402,,2hwfmn6c-sij,12384,12385,24769
16403,,_1tjvs4bo1qj,12385,12386,24771
16404,,url:http://portal.acm.org/citation.cfm3fid3d244883,12386,12387,24773
16405,,biys3qzdi48j,12387,12388,24775
16406,,pc1au7jtknij,12388,12389,24777
16407,,dgxs0o8i2syj,12389,12390,24779
16408,,pra06lm1qkoj,12390,12391,24781
16409,,mxwmn937fc0j,12391,12392,24783
16410,,skgofvmsu4yj,12392,12393,24785
16411,,ivhmi0u0lywj,12393,12394,24787
16412,,e9otngd3qv8j,12394,12395,24789
16413,,url:http://ieeexplore.ieee.org/iel1/2206/3608/00129228.pdf3farnumber3d129228,12395,12396,24791
16414,,fdpmbqxd7zgj,12396,12397,24793
16415,,zqbigrhif4gj,12397,12398,24795
16416,,url:http://portal.acm.org/citation.cfm3fid3d19184326dl3dguide26dl3dacm26type3dissue26idx3d19184326part3dperiodical26wanttype3dperiodical26title3dacm2520sigmod2520record26cfid3d1111111126cftoken3d2222222,12398,12399,24797
16417,,url:http://portal.acm.org/ft_gateway.cfm3fid3d95707426type3dpdf26dl3dguide26dl3dacm26cfid3d1111111126cftoken3d2222222,12399,12400,24799
16418,,xfzi4hjx4rej,12400,12401,24801
16419,,mhrifyiq6n4j,12401,12402,24803
16420,,uomxtkbeomwj,12402,12403,24805
16421,,zdbwqwilbp4j,12403,12404,24807
16422,,bhwlvcodunqj,12404,12405,24809
16423,,clmzohibds8j,12405,12406,24811
16424,,esp8tlapgqej,12406,12407,24813
16425,,qqzkolvjpuoj,12407,12408,24815
16426,,jroaweomxesj,12408,12409,24817
16427,,jl4bpjlhoz0j,12409,12410,24819
16428,,kbyvcq1nacqj,12410,12411,24821
16429,,qehxdj2x7emj,12411,12412,24823
16430,,nrmzjvdzf8aj,12412,12413,24825
16431,,o7clpdly0akj,12413,12414,24827
16432,,je21ckaenj0j,12414,12415,24829
16433,,kztawetx7hwj,12415,12416,24831
16434,,gyfd2qehxzej,12416,12417,24833
16435,,c54zclhl5emj,12417,12418,24835
16436,,kyzkm4zem04j,12418,12419,24837
16437,,spertt_vfeej,12419,12420,24839
16438,,k1iw5644oxoj,12420,12421,24841
16439,,1hpy5dx3brij,12421,12422,24843
16440,,pk1p1aq1wyuj,12422,12423,24845
16441,,o5ohzv0ahrkj,12423,12424,24847
16442,,sjg97dyn45ej,12424,12425,24849
16443,,v4z62fgfjk8j,12425,12426,24851
16444,,hedxftvfe2sj,12426,12427,24853
16445,,url:http://www.csa.com/partners/viewrecord.php3frequester3dgs26collection3dtrd26recid3d0197710ci,12427,12428,24855
16446,,3057lvy80qaj,12428,12429,24857
16447,,d3yfovbt5-oj,12429,12430,24859
16448,,2qkmtfgkbmuj,12431,12432,24863
16449,,mhr3pf6yngyj,12432,12433,24865
16450,,yhsqjtyfcimj,12433,12434,24867
16451,,1xqdu1vx-bsj,12434,12435,24869
16452,,injt67cmqg0j,12435,12436,24871
16453,,odmrvp76shaj,12436,12437,24873
16454,,gwr2ybc8lnyj,12437,12438,24875
16455,,8bk9jnu_bp8j,12438,12439,24877
16456,,sqrr3i_8u80j,12439,12440,24879
16457,,syxaj4f5nv0j,12440,12441,24881
16458,,wbmnbk-ahz4j,12441,12442,24883
16459,,7bwzglnuoh0j,12443,12444,24887
16460,,wg-3vx59mvij,12444,12445,24889
16461,,l4nabp7ad4cj,12445,12446,24891
16462,,vgvtqcarndej,12446,12447,24893
16463,,bdb55wepgocj,12447,12448,24895
16464,,89uqs71mt5mj,12448,12449,24897
16465,,fvmkvdej4csj,12449,12450,24899
16466,,yjwyjamatu8j,12450,12451,24901
16467,,fxhlrcl1nhkj,12451,12452,24903
16468,,60mqnx6losgj,12452,12453,24905
16469,,,12453,12454,24907
16470,,blw7evrpqhsj,12454,12455,24909
16471,,t39r5hs28uej,12455,12456,24911
16472,,_rg5ojq9z2ij,12456,12457,24913
16473,,7aex1hgeiluj,12457,12458,24915
16474,,1nrko4mls18j,12458,12459,24917
16475,,kehspbtvh6cj,12460,12461,24921
16476,,gh4dcpttl58j,12461,12462,24923
16477,,tstdm0egiiaj,12462,12463,24925
16478,,48tniihyvtsj,12463,12464,24927
16479,,jtpgfce9q1gj,12464,12465,24929
16480,,s-yrji7avsoj,12465,12466,24931
16481,,uqcwqtfl6nmj,12466,12467,24933
16482,,0wm8maylmm8j,12467,12468,24935
16483,,yltu-hgdiiyj,12468,12469,24937
16484,,2tsv5ftfbvaj,12469,12470,24939
16485,,doxvdkygrj8j,12470,12471,24941
16486,,iifiwlf39vij,12471,12472,24943
16487,,oekw4ylf5_mj,12472,12473,24945
16488,,jt784k5tnz8j,12473,12474,24947
16489,,xizjj-po6gij,12474,12475,24949
16490,,12ywtc4vc1oj,12475,12476,24951
16491,,lt3vpsdmniij,12476,12477,24953
16492,,t8p4zqecjmqj,12477,12478,24955
16493,,3rll5t2f8d0j,12478,12479,24957
16494,,xpqeldsxvskj,12479,12480,24959
16495,,t62l0zgnk7oj,12480,12481,24961
16496,,jljgggr02bkj,12482,12483,24965
16497,,p6vwqlaqqnoj,12484,12485,24969
16498,,lgjw6an1ezmj,12485,12486,24971
16499,,xrflw0tezicj,12486,12487,24973
16500,,cct9gdnojluj,12487,12488,24975
16501,,xlxb83u_7jyj,12488,12489,24977
16502,,kb4ourrpnlaj,12489,12490,24979
16503,,iortdzve6tuj,12490,12491,24981
16504,,sofwgigjlnkj,12491,12492,24983
16505,,sb3yj7ubh18j,12492,12493,24985
16506,,v5mrjmmzotmj,12493,12494,24987
16507,,v-lfh9avyiuj,12494,12495,24989
16508,,mpoam5dta1sj,12495,12496,24991
16509,,93bbbthtyouj,12496,12497,24993
16510,,i_wzy4iy0gqj,12497,12498,24995
16511,,1txk_9azjp0j,12498,12499,24997
16512,,mjdirdkzhroj,12499,12500,24999
16513,,i9yyvzi8db4j,12500,12501,25001
16514,,1cszasnmzkej,12501,12502,25003
16515,,hnmse9mpdwij,12502,12503,25005
16516,,cw0a6daovvwj,12503,12504,25007
16517,,a18d_uobwvwj,12504,12505,25009
16518,,ao7ttf_xpyaj,12505,12506,25011
16519,,skmlhbtqseuj,12506,12507,25013
16520,,qptmqiuoouoj,12507,12508,25015
16521,,4nv0dhvy9jmj,12508,12509,25017
16522,,tf-fbhttttaj,12509,12510,25019
16523,,pn15lkymypsj,12510,12511,25021
16524,,bszusyyv0aej,12511,12512,25023
16525,,url:http://www.csa.com/partners/viewrecord.php3frequester3dgs26collection3dtrd26recid3dn9210429ah,12512,12513,25025
16526,,pzapm3ezcvcj,12513,12514,25027
16527,,eqtodfsuo7aj,12514,12515,25029
16528,,j985fyevz2oj,12515,12516,25031
16529,,wgbtf7winfaj,12516,12517,25033
16530,,qctqqlgy2nej,12517,12518,25035
16531,,url:http://doi.wiley.com/10.1002/ace.53,12518,12519,25037
16532,,url:http://portal.acm.org/ft_gateway.cfm3fid3d105557926type3dpdf,12519,12520,25039
16533,,ye4ti8gmrrgj,12520,12521,25041
16534,,xfzn2x-om5ej,12521,12522,25043
16535,,4smh2nbztboj,12522,12523,25045
16536,,1igugjnhcpoj,12523,12524,25047
16537,,3pztlqxfso4j,12524,12525,25049
16538,,obxr1ylwgjcj,12525,12526,25051
16539,,e5idyqcooh8j,12526,12527,25053
16540,,fqymfdttjnsj,12527,12528,25055
16541,,k36rkrbi5j4j,12528,12529,25057
16542,,6pnvsehv1lqj,12529,12530,25059
16543,,7sivcgvzmrgj,12530,12531,25061
16544,,zkh1f-3pq0gj,12531,12532,25063
16545,,url:http://portal.acm.org/ft_gateway.cfm3fid3d109972226type3dpdf,12532,12533,25065
16546,,k8mtc5e7wtej,12533,12534,25067
16547,,e_1gayn5f08j,12534,12535,25069
16548,,nia28zmfcpej,12535,12536,25071
16549,,ckohlb6inlej,12536,12537,25073
16550,,url:http://portal.acm.org/citation.cfm3fid3d47144.47147,12537,12538,25075
16551,,url:http://www.springerlink.com/index/h422g0686421661t.pdf,12538,12539,25077
16552,,mz729ecrzlij,12539,12540,25079
16553,,rhbwa9gal6ej,12540,12541,25081
16554,,vfi4zjy6lm8j,12541,12542,25083
16555,,gk03x7i8figj,12542,12543,25085
16556,,_nceb7wlikgj,12543,12544,25087
16557,,ilxi15zfsgej,12544,12545,25089
16558,,jmc3u-zrtpej,12545,12546,25091
16559,,cexca09oftqj,12546,12547,25093
16560,,y2oalmrypiuj,12548,12549,25097
16561,,8wkyfvwcyl8j,12549,12550,25099
16562,,ikg9vkpoa-ej,12550,12551,25101
16563,,nk9uncpbfi4j,12551,12552,25103
16564,,8bjnsoacaeqj,12552,12553,25105
16565,,7iedmcqvmcej,12553,12554,25107
16566,,ia65_1ensmoj,12554,12555,25109
16567,,5npws_ycsuaj,12555,12556,25111
16568,,url:http://portal.acm.org/ft_gateway.cfm3fid3d104204726type3dpdf,12556,12557,25113
16569,,cnqkecognssj,12557,12558,25115
16570,,k1o894ge6s0j,12558,12559,25117
16571,,feubthjrq0cj,12559,12560,25119
16572,,80d7n8eclhwj,12560,12561,25121
16573,,ovwlugirgwmj,12561,12562,25123
16574,,tjn-ono3atij,12562,12563,25125
16575,,a0id5vx47hqj,12563,12564,25127
16576,,jrorz1drc1yj,12564,12565,25129
16577,,6_td5zpxriej,12565,12566,25131
16578,,uosjxzlqgjqj,12566,12567,25133
16579,,hdps8zsvpbij,12567,12568,25135
16580,,7qnxjb14vfgj,12568,12569,25137
16581,,eewiek9mq60j,12569,12570,25139
16582,,gan-8on7h3aj,12570,12571,25141
16583,,zm3s3wehbtij,12571,12572,25143
16584,,0uld5cvvl7oj,12572,12573,25145
16585,,ebw7ufg52vij,12573,12574,25147
16586,,4io9kp8nz_kj,12574,12575,25149
16587,,v-3fgnrp7akj,12575,12576,25151
16588,,h5n3in1bj0qj,12576,12577,25153
16589,,eleimestebyj,12577,12578,25155
16590,,zfdt0xzwduij,12578,12579,25157
16591,,aoy_g9fiqg8j,12580,12581,25161
16592,,nqzrc_gwodkj,12581,12582,25163
16593,,qln9vrx5_boj,12582,12583,25165
16594,,tvx7zsqqgyuj,12583,12584,25167
16595,,edsfxq-up8oj,12584,12585,25169
16596,,qknzs0whpguj,12585,12586,25171
16597,,cyntxv744cqj,12586,12587,25173
16598,,sr0qcxngeh0j,12587,12588,25175
16599,,qo0ixiapr-sj,12588,12589,25177
16600,,kvpe2mc7rwkj,12589,12590,25179
16601,,tr6mfrcfzzkj,12590,12591,25181
16602,,oqzapxjvyauj,12591,12592,25183
16603,,62cu-sruh5oj,12592,12593,25185
16604,,jmuiehhtjh8j,12593,12594,25187
16605,,ntesm3-blcmj,12594,12595,25189
16606,,hvkrzsmj3mqj,12595,12596,25191
16607,,i_16hed8hx8j,12596,12597,25193
16608,,hkfbmg9wu-aj,12597,12598,25195
16609,,pb5woezcdnij,12598,12599,25197
16610,,bpu5_e0il5oj,12599,12600,25199
16611,,egtft4de9xqj,12600,12601,25201
16612,,0yw58wvabxej,12601,12602,25203
16613,,p10srmakomkj,12602,12603,25205
16614,,njfkrcyyziyj,12604,12605,25209
16615,,url:http://portal.acm.org/citation.cfm3fid3d171926.171979,12605,12606,25211
16616,,url:http://www.csa.com/partners/viewrecord.php3frequester3dgs26collection3dtrd26recid3da8622938ah,12606,12607,25213
16617,,l27aka3lfb0j,12607,12608,25215
16618,,oorfzpsjbauj,12608,12609,25217
16619,,i-wygd574koj,12609,12610,25219
16620,,5aancyqvjjqj,12610,12611,25221
16621,,aq0qlhbkl0cj,12611,12612,25223
16622,,mwqn38gir1kj,12612,12613,25225
16623,,dojuoh0nwesj,12613,12614,25227
16624,,akjocwzfgzoj,12614,12615,25229
16625,,rwcurknuvrcj,12615,12616,25231
16626,,lnt3itcisfqj,12616,12617,25233
16627,,url:http://portal.acm.org/ft_gateway.cfm3fid3d110127226type3dpdf,12617,12618,25235
16628,,9bzgilofctij,12618,12619,25237
16629,,y_esxqgg43oj,12619,12620,25239
16630,,arcog5x61vij,12620,12621,25241
16631,,3q0wjg_ihccj,12621,12622,25243
16632,,ebv4-i_olu8j,12622,12623,25245
16633,,7ssmrq8f7twj,12623,12624,25247
16634,,kn77azmydbmj,12624,12625,25249
16635,,kuj-woc66e4j,12625,12626,25251
16636,,sb6oexx-eacj,12626,12627,25253
16637,,mvxcgvwth7qj,12627,12628,25255
16638,,7iesxidztl4j,12628,12629,25257
16639,,pfewuluqlcyj,12629,12630,25259
16640,,8s89-dskydmj,12630,12631,25261
16641,,r2hddimeaoyj,12631,12632,25263
16642,,wo5wjquldc4j,12632,12633,25265
16643,,vzysvwy4c-cj,12633,12634,25267
16644,,pvoiwb2fi_ij,12634,12635,25269
16645,,fbykcj03pbuj,12635,12636,25271
16646,,url:http://portal.acm.org/citation.cfm3fid3d109094.109103,12636,12637,25273
16647,,n2eiq_awvkqj,12637,12638,25275
16648,,pf2qbevcjxgj,12638,12639,25277
16649,,kd6iuc8wpeej,12639,12640,25279
16650,,zwrhdej3ufcj,12640,12641,25281
16651,,pboxhpzx00gj,12641,12642,25283
16652,,url:http://portal.acm.org/citation.cfm3fid3d983055.98305726coll3dguide26dl3dacm26idx3dj68926part3dperiodical26wanttype3dperiodical26title3dacm2520sigmod2520record26cfid3d1111111126cftoken3d2222222,12642,12643,25285
16653,,kx_pi1hjccyj,12643,12644,25287
16654,,0xmp9ff1uoaj,12644,12645,25289
16655,,,12645,12646,25291
16656,,legirkl7ppij,12646,12647,25293
16657,,,12647,12648,25295
16658,,ker2jbbiiouj,12648,12649,25297
16659,,rphn4gfxj4cj,12649,12650,25299
16660,,9boh4ulth8qj,12650,12651,25301
16661,,zogggj-wahuj,12651,12652,25303
16662,,izakw-9zuvgj,12652,12653,25305
16663,,bykwxxpnfjsj,12653,12654,25307
16664,,sdid9bmtjl4j,12654,12655,25309
16665,,rxipuofzpvgj,12655,12656,25311
16666,,ma1cfq2q4m4j,12656,12657,25313
16667,,url:http://adsabs.harvard.edu/abs/1994ssgd.conf.....a,12657,12658,25315
16668,,vprspdsdzooj,12658,12659,25317
16669,,mfjzfuwl1jcj,12659,12660,25319
16670,,4gjzuo0rxraj,12661,12662,25323
16671,,atri4thaj-kj,12662,12663,25325
16672,,f8i3sl5fzymj,12663,12664,25327
16673,,9skopjkq9sij,12664,12665,25329
16674,,z--1tz-zfzoj,12665,12666,25331
16675,,_imxf4vlaraj,12666,12667,25333
16676,,fzlls5n2bcgj,12667,12668,25335
16677,,hlrrtjiggbyj,12668,12669,25337
16678,,y0qfwhazydkj,12669,12670,25339
16679,,h_uh_jcrs6oj,12670,12671,25341
16680,,nhbwxu7xbm0j,12671,12672,25343
16681,,lzgb5wnlayqj,12672,12673,25345
16682,,ld7ogf3xw6wj,12673,12674,25347
16683,,q3crjw83wy4j,12674,12675,25349
16684,,qehx5ijlvsej,12675,12676,25351
16685,,rbosgonh214j,12676,12677,25353
16686,,mbeicd0n1rqj,12677,12678,25355
16687,,nnt3nl3iglmj,12678,12679,25357
16688,,saxl5qjf4o0j,12679,12680,25359
16689,,gsy3uq-edhmj,12680,12681,25361
16690,,c_nki-m4mu8j,12681,12682,25363
16691,,broyv3mfhmsj,12682,12683,25365
16692,,geruccbteaaj,12683,12684,25367
16693,,b6zp-cey1j8j,12684,12685,25369
16694,,dnmiraxy3zgj,12685,12686,25371
16695,,fmlmu2ntrwqj,12686,12687,25373
16696,,ne_5hlyo66cj,12688,12689,25377
16697,,3fkmwb1dce8j,12689,12690,25379
16698,,vdcxtbfu81kj,12690,12691,25381
16699,,gg3kqvryi3ij,12691,12692,25383
16700,,kck9dlmwo0kj,12692,12693,25385
16701,,fn5nvw7wheqj,12694,12695,25389
16702,,7s8zualgxywj,12695,12696,25391
16703,,eefd7okedggj,12696,12697,25393
16704,,kx73ov7er0mj,12697,12698,25395
16705,,l7d5kntvueij,12698,12699,25397
16706,,edlq6vc996gj,12699,12700,25399
16707,,0pqnhyusdagj,12700,12701,25401
16708,,9kswyh8lqz4j,12701,12702,25403
16709,,6o_irczxpcyj,12702,12703,25405
16710,,ntsjjbg5_dmj,12703,12704,25407
16711,,jnczdiqnntuj,12704,12705,25409
16712,,g0ovvro2xtuj,12705,12706,25411
16713,,zoglngfe8imj,12706,12707,25413
16714,,l8lata9u7y4j,12707,12708,25415
16715,,jlx5v28vriij,12708,12709,25417
16716,,w3h34lbumtoj,12709,12710,25419
16717,,luf6jcdgnkoj,12710,12711,25421
16718,,gghc1sdntgqj,12711,12712,25423
16719,,cehtefp0exgj,12712,12713,25425
16720,,4h1kwnzqkauj,12713,12714,25427
16721,,jsinf-tyff0j,12714,12715,25429
16722,,likkzj6orn8j,12715,12716,25431
16723,,i7o3zvi9k40j,12717,12718,25435
16724,,sgteigjwynij,12718,12719,25437
16725,,r-54ddahdxoj,12719,12720,25439
16726,,zkdygkw3m0mj,12720,12721,25441
16727,,ylconap14zoj,12721,12722,25443
16728,,_imnhtad4auj,12722,12723,25445
16729,,url:http://www.springerlink.com/index/n2w04729j64kp86l.pdf,12723,12724,25447
16730,,hueyoim88f0j,12724,12725,25449
16731,,zma_bug8x_kj,12725,12726,25451
16732,,bwlkzq78cluj,12726,12727,25453
16733,,2x1kjzjglscj,12727,12728,25455
16734,,wvemwwhxi_sj,12729,12730,25459
16735,,vvh-y4ufejej,12730,12731,25461
16736,,yuao6fzoxmqj,12731,12732,25463
16737,,x4kmrz-es70j,12732,12733,25465
16738,,wfioeiqscouj,12733,12734,25467
16739,,8vnfgpisgtuj,12734,12735,25469
16740,,fogbjkuw3xmj,12735,12736,25471
16741,,n8xkcmio0ysj,12736,12737,25473
16742,,t-orbrldn30j,12737,12738,25475
16743,,jljaf5j0uvoj,12738,12739,25477
16744,,4_1aqc84csyj,12739,12740,25479
16745,,dxl7i4fd0lqj,12740,12741,25481
16746,,rtzd_n7w6wcj,12741,12742,25483
16747,,fv__21qykj8j,12742,12743,25485
16748,,4y-m8zsrntqj,12743,12744,25487
16749,,8zdbg3tjrlsj,12744,12745,25489
16750,,,12745,12746,25491
16751,,6yjcqp0jahaj,12746,12747,25493
16752,,j5w2p0gndv0j,12747,12748,25495
16753,,ihywqthb744j,12748,12749,25497
16754,,url:http://ieeexplore.ieee.org/iel3/3990/11481/00547817.pdf3farnumber3d547817,12749,12750,25499
16755,,f7qaoj5pgekj,12750,12751,25501
16756,,hu0wujhdkoqj,12751,12752,25503
16757,,f9s9s1ixa7gj,12752,12753,25505
16758,,tf73zky1yzqj,12753,12754,25507
16759,,2ndxe8hel-gj,12754,12755,25509
16760,,csmv5qyd_pmj,12755,12756,25511
16761,,czeuzk2j9yij,12756,12757,25513
16762,,url:http://doi.wiley.com/10.1002/tl.7904,12757,12758,25515
16763,,kugjzt-igpoj,12758,12759,25517
16764,,mh-hqmhu9p4j,12759,12760,25519
16765,,10ovblrdieej,12760,12761,25521
16766,,xmnpdwmgpsmj,12761,12762,25523
16767,,j_lx2d3wcl4j,12762,12763,25525
16768,,r8z5mu0i5bej,12763,12764,25527
16769,,jdgchur2unkj,12764,12765,25529
16770,,mksgdihl_g8j,12765,12766,25531
16771,,ynvbd1fwz-4j,12766,12767,25533
16772,,cayka_o2croj,12767,12768,25535
16773,,7q8kwovlg5gj,12768,12769,25537
16774,,m1j0hs9iaz0j,12769,12770,25539
16775,,6pecjqdapv8j,12770,12771,25541
16776,,0u27pab3qdsj,12771,12772,25543
16777,,ibuez6ne4ckj,12772,12773,25545
16778,,url:http://www.csa.com/partners/viewrecord.php3frequester3dgs26collection3dtrd26recid3d155972ws26recid3d199301550086md26recid3d199302b50057ai,12773,12774,25547
16779,,ay7rnlxwzeuj,12774,12775,25549
16780,,url:http://portal.acm.org/citation.cfm3fid3d31812826dl3dacm26coll3dportal26cfid3d1111111126cftoken3d2222222,12775,12776,25551
16781,,hyfebfhiqdej,12776,12777,25553
16782,,2ooxasugoxqj,12777,12778,25555
16783,,tyzzmwq1gycj,12778,12779,25557
16784,,casnhllpnigj,12779,12780,25559
16785,,url:http://portal.acm.org/ft_gateway.cfm3fid3d101775426type3dpdf,12780,12781,25561
16786,,b3w_qvsptdyj,12781,12782,25563
16787,,yup9-oyfvuaj,12783,12784,25567
16788,,sd1scjcm6-8j,12784,12785,25569
16789,,0m2ijvqqb2uj,12785,12786,25571
16790,,jz4p-pzm6dmj,12786,12787,25573
16791,,bbjj1xwppbyj,12787,12788,25575
16792,,uy9wwkcg-wgj,12788,12789,25577
16793,,c8i_ns46ilqj,12789,12790,25579
16794,,pkanvkxdc60j,12790,12791,25581
16795,,jj_mqb0om9gj,12791,12792,25583
16796,,lkgwvxxktwij,12792,12793,25585
16797,,0rvojnvrolqj,12793,12794,25587
16798,,zh_ecvgdjw0j,12794,12795,25589
16799,,dn-jw_s9ko8j,12795,12796,25591
16800,,eij4yh420qqj,12796,12797,25593
16801,,_v_memdinwmj,12797,12798,25595
16802,,6oj1lctd3kmj,12798,12799,25597
16803,,mlnqkcjovtcj,12800,12801,25601
16804,,c-1mfhdnnisj,12801,12802,25603
16805,,ahxzenjfklcj,12802,12803,25605
16806,,t_rsi2ashrsj,12803,12804,25607
16807,,od3tv7b76oqj,12804,12805,25609
16808,,8e7fddurgq8j,12805,12806,25611
16809,,8bhmfnizowgj,12806,12807,25613
16810,,b4tnr5kywncj,12807,12808,25615
16811,,ioihf7k58aqj,12808,12809,25617
16812,,irjcpdnlbgmj,12809,12810,25619
16813,,tohsa5_rwfij,12810,12811,25621
16814,,bjnirtsivusj,12811,12812,25623
16815,,fptlhrz5eowj,12812,12813,25625
16816,,h4sfkqew2wyj,12813,12814,25627
16817,,uhlao7yh2tej,12814,12815,25629
16818,,ne2e3q_tiasj,12815,12816,25631
16819,,lnhshrurfoyj,12816,12817,25633
16820,,6oreapfgucwj,12817,12818,25635
16821,,rfpo8ttsbwoj,12818,12819,25637
16822,,89ig0airqkuj,12819,12820,25639
16823,,inivssauccyj,12820,12821,25641
16824,,2idqhgi5g24j,12821,12822,25643
16825,,fsg-2bivfigj,12822,12823,25645
16826,,url:http://links.jstor.org/sici3fsici3d0146-4949(196724)8253a1253c31253aa2522tld253e2.0.co253b2-6,12823,12824,25647
16827,,ntoeos0vdnej,12824,12825,25649
16828,,url:http://doi.wiley.com/10.1002/he.11110,12825,12826,25651
16829,,ue8vjwctvfsj,12826,12827,25653
16830,,laakincbkmaj,12827,12828,25655
16831,,url:http://www.csa.com/partners/viewrecord.php3frequester3dgs26collection3dtrd26recid3d200111010703mt26recid3da0032634ah,12828,12829,25657
16832,,fruosrfyqa0j,12829,12830,25659
16833,,saq4cx_4hsqj,12830,12831,25661
16834,,b-kbq7a9vi0j,12831,12832,25663
16835,,iqitl70nssgj,12832,12833,25665
16836,,fgcuaf-ugdmj,12833,12834,25667
16837,,iblbrnbohwej,12834,12835,25669
16838,,i1uvgchkc_kj,12835,12836,25671
16839,,zoyqixe1-j8j,12836,12837,25673
16840,,jyhcz-hpkjej,12837,12838,25675
16841,,ikvjtiufabyj,12838,12839,25677
16842,,0r-jaceq_rkj,12839,12840,25679
16843,,uj4ptdaogtuj,12840,12841,25681
16844,,4-tj1whqg_kj,12841,12842,25683
16845,,e_ttzpp7jykj,12842,12843,25685
16846,,hve-7xtxsjgj,12843,12844,25687
16847,,riugyzampjej,12844,12845,25689
16848,,u4f5ehqcckij,12845,12846,25691
16849,,q1na3io21swj,12846,12847,25693
16850,,wov0-0k_nouj,12847,12848,25695
16851,,zapdwamribyj,12848,12849,25697
16852,,8ig7cy6j3fej,12850,12851,25701
16853,,ogsawq9_cj0j,12851,12852,25703
16854,,4zf2tvkhb8mj,12852,12853,25705
16855,,5ehh3hxfffuj,12853,12854,25707
16856,,url:http://journals.iucr.org/c/issues/1995/04/00/mu1120/mu1120.pdf,12854,12855,25709
16857,,kaoquvy0ozyj,12855,12856,25711
16858,,0i1hk0ugjhqj,12856,12857,25713
16859,,f2uglmjzn4yj,12857,12858,25715
16860,,2jtxt5mldpuj,12858,12859,25717
16861,,b9qtulkyaboj,12859,12860,25719
16862,,9psmg0a0up8j,12860,12861,25721
16863,,srvhd-iaubcj,12861,12862,25723
16864,,dxcqssgacwwj,12862,12863,25725
16865,,lvpnmgeii-oj,12863,12864,25727
16866,,zm3vjfqfekej,12864,12865,25729
16867,,64bljqphxvwj,12865,12866,25731
16868,,8yfgijz-vwij,12866,12867,25733
16869,,e_dhslwaubaj,12867,12868,25735
16870,,dgzqethbogwj,12869,12870,25739
16871,,vpdwvlyat5kj,12870,12871,25741
16872,,yflgknrajkyj,12871,12872,25743
16873,,2qvvchg4ehqj,12873,12874,25747
16874,,jpx0tvkj-fuj,12874,12875,25749
16875,,url:http://portal.acm.org/citation.cfm3fid3d1086228.1086296,12876,12877,25753
16876,,x0kv7pnqsh0j,12877,12878,25755
16877,,f8ggvpnr4qyj,12878,12879,25757
16878,,url:http://www.csa.com/partners/viewrecord.php3frequester3dgs26collection3dtrd26recid3da063201349ah,12879,12880,25759
16879,,aeljz4pp9xqj,12880,12881,25761
16880,,gen-fcqfegaj,12881,12882,25763
16881,,sgdvmsd1r18j,12882,12883,25765
16882,,uamvvqalxxcj,12883,12884,25767
16883,,fzxfekcy6isj,12884,12885,25769
16884,,oammx2cf5kkj,12885,12886,25771
16885,,lkcqer0y6jaj,12886,12887,25773
16886,,url:http://ieeexplore.ieee.org/iel1/2206/324/00006469.pdf3farnumber3d6469,12887,12888,25775
16887,,mqiheso_9haj,12888,12889,25777
16888,,r2xzcwtwfbwj,12889,12890,25779
16889,,-1ogzaopunqj,12890,12891,25781
16890,,df8tr4byabmj,12891,12892,25783
16891,,lhlg5uri0igj,12892,12893,25785
16892,,9cxfj4nyugoj,12893,12894,25787
16893,,lxg0jfgbj1aj,12894,12895,25789
16894,,hgq5h2qp2g0j,12895,12896,25791
16895,,46mdnod-sbaj,12896,12897,25793
16896,,s_g9yk1is_4j,12897,12898,25795
16897,,m2acas29e94j,12898,12899,25797
16898,,e-tyhb_tceoj,12899,12900,25799
16899,,zdth_ckh2bkj,12900,12901,25801
16900,,fy6csrnx5zij,12901,12902,25803
16901,,camhcf4osv8j,12902,12903,25805
16902,,k7h7xtdff5qj,12904,12905,25809
16903,,edjr1ronnwkj,12905,12906,25811
16904,,r2utl41ljt0j,12906,12907,25813
16905,,bup_kdg_s1ej,12908,12909,25817
16906,,ugecjkv3jiij,12909,12910,25819
16907,,grvxpiifsfoj,12910,12911,25821
16908,,nzyzoztyaqoj,12911,12912,25823
16909,,hpgsdxcodjij,12912,12913,25825
16910,,wcj9mxcnwqoj,12913,12914,25827
16911,,w5du8mf_it0j,12914,12915,25829
16912,,dwy3qu404wej,12915,12916,25831
16913,,lg508_x-ruuj,12916,12917,25833
16914,,dee7fx642paj,12917,12918,25835
16915,,rcwy2fq6xrqj,12918,12919,25837
16916,,3oa20f9ww0yj,12919,12920,25839
16917,,q46xqfn91i8j,12920,12921,25841
16918,,m_lfyastyz4j,12921,12922,25843
16919,,kj7uymppo0wj,12922,12923,25845
16920,,cza6twwawu4j,12923,12924,25847
16921,,labu-pfrdhoj,12924,12925,25849
16922,,url:http://www.springerlink.com/index/l1631843x6346040.pdf,12925,12926,25851
16923,,,12926,12927,25853
16924,,q3zjyzm5q7kj,12927,12928,25855
16925,,6aqtdms3klkj,12928,12929,25857
16926,,iu3w0ine42uj,12929,12930,25859
16927,,7ow8gye_6lyj,12930,12931,25861
16928,,dw2tnfk7iyqj,12931,12932,25863
16929,,rhsl_jxwaqaj,12932,12933,25865
16930,,eq2awwfnowoj,12933,12934,25867
16931,,mn2qqjwgakoj,12934,12935,25869
16932,,umphll-tzzyj,12935,12936,25871
16933,,url:http://doi.wiley.com/10.1002/he.46,12937,12938,25875
16934,,bjraekfe5jaj,12938,12939,25877
16935,,mmemmkrezaij,12939,12940,25879
16936,,0vratwmmfl4j,12940,12941,25881
16937,,c3yobnvi65cj,12941,12942,25883
16938,,ygudo35fxv4j,12942,12943,25885
16939,,vdxsdvs6iv8j,12943,12944,25887
16940,,5ixtdawfyroj,12944,12945,25889
16941,,vnutgvytaxaj,12945,12946,25891
16942,,nv97jnvthdwj,12947,12948,25895
16943,,xqsrp_otidij,12948,12949,25897
16944,,zrd3kro5knwj,12949,12950,25899
16945,,gcubteocu8sj,12950,12951,25901
16946,,vk8k_y80mkyj,12951,12952,25903
16947,,aiufz1t_hnwj,12953,12954,25907
16948,,url:http://portal.acm.org/ft_gateway.cfm3fid3d110133626type3dpdf,12954,12955,25909
16949,,url:http://portal.acm.org/ft_gateway.cfm3fid3d14100226type3dpdf26coll3dguide26dl3dacm26cfid3d1111111126cftoken3d2222222,12955,12956,25911
16950,,wzoontff2ckj,12956,12957,25913
16951,,g7jjsgfnwuqj,12957,12958,25915
16952,,9trudhvxepqj,12958,12959,25917
16953,,0gjbxnizxu0j,12959,12960,25919
16954,,rjv2tqkahsyj,12960,12961,25921
16955,,ay76zpjpfg4j,12961,12962,25923
16956,,r30cyoxoeycj,12962,12963,25925
16957,,url:http://portal.acm.org/ft_gateway.cfm3fid3d108367526type3dpdf,12963,12964,25927
16958,,uajbc0hep50j,12964,12965,25929
16959,,fmsm0snem7wj,12965,12966,25931
16960,,heomrjeko24j,12967,12968,25935
16961,,x52rdyvvcz4j,12968,12969,25937
16962,,6kdjw-c8l1sj,12969,12970,25939
16963,,8_61v9gz9kej,12970,12971,25941
16964,,vsqvrbpzudyj,12971,12972,25943
16965,,jxrzdt_0knej,12972,12973,25945
16966,,dwhcvi8rtbkj,12973,12974,25947
16967,,b6axlocrkdwj,12974,12975,25949
16968,,c1tdxjiwm1wj,12975,12976,25951
16969,,lqubtzrdgdej,12976,12977,25953
16970,,rc7r3l7skq4j,12977,12978,25955
16971,,dnwtq1wmf7sj,12978,12979,25957
16972,,52nyx7iitwsj,12979,12980,25959
16973,,b0zwgqqh-xkj,12980,12981,25961
16974,,ce84ggnzjsmj,12981,12982,25963
16975,,url:http://www.springerlink.com/index/0jgde6a9jhwt3cf5.pdf,12982,12983,25965
16976,,yp4hdod65vuj,12983,12984,25967
16977,,ofk1ojmjrdgj,12984,12985,25969
16978,,ka4s7dm1ejej,12985,12986,25971
16979,,kt92rnlzjkoj,12986,12987,25973
16980,,tc9n4ltvuswj,12987,12988,25975
16981,,1lb6shqbb7oj,12988,12989,25977
16982,,xiwjlxavlu4j,12989,12990,25979
16983,,9h_vc_zbd2mj,12990,12991,25981
16984,,98psyvq89xkj,12991,12992,25983
16985,,fscan4f9fzmj,12992,12993,25985
16986,,vq8gc1zw1gqj,12993,12994,25987
16987,,aycjocg2bkgj,12994,12995,25989
16988,,ua7q37qgci4j,12995,12996,25991
16989,,s79foce5y_ej,12996,12997,25993
16990,,ij2j7la4ktgj,12997,12998,25995
16991,,6uodvmhd2ccj,12998,12999,25997
16992,,hue8mztbhcwj,12999,13000,25999
16993,,z42-urve4yaj,13000,13001,26001
16994,,uu1axczwypsj,13001,13002,26003
16995,,bsa5gu3ucymj,13002,13003,26005
16996,,whcyovsmlzaj,13003,13004,26007
16997,,01ibi-x5mkgj,13004,13005,26009
16998,,dlcjfyjwwosj,13005,13006,26011
16999,,url:http://adsabs.harvard.edu/abs/1976scom.nasa..611d,13006,13007,26013
17000,,l9pbmuhtlpcj,13007,13008,26015
17001,,wsom1indbg8j,13008,13009,26017
17002,,xbfys3-dzgyj,13009,13010,26019
17003,,ybhp3hwdrwkj,13010,13011,26021
17004,,wq-f5ewsfgwj,13011,13012,26023
17005,,0bm8zt8dxi8j,13012,13013,26025
17006,,ho_32nq5umkj,13013,13014,26027
17007,,0wii3x--wkwj,13014,13015,26029
17008,,6yxynlb8cyyj,13015,13016,26031
17009,,zz30pajccvoj,13016,13017,26033
17010,,sidtuizw_-wj,13017,13018,26035
17011,,pivar0_e0iej,13018,13019,26037
17012,,1fkaf7uk_e8j,13019,13020,26039
17013,,omaxuoedwp0j,13020,13021,26041
17014,,zvmdwvsj_ccj,13021,13022,26043
17015,,url:http://doi.wiley.com/10.1002/he.11106,13022,13023,26045
17016,,vsezs3lbd24j,13023,13024,26047
17017,,url:http://adsabs.harvard.edu/abs/1986stin...8624868s,13024,13025,26049
17018,,b-q_gc7lguij,13025,13026,26051
17019,,wilasxsf0eej,13026,13027,26053
17020,,lwq1zod_x74j,13027,13028,26055
17021,,b5g43pke3zkj,13028,13029,26057
17022,,p4hdrawf0z0j,13029,13030,26059
17023,,xbhdhhtfse4j,13030,13031,26061
17024,,jp0ftdxn3dej,13031,13032,26063
17025,,pi-sax_5njmj,13032,13033,26065
17026,,fdg7r3uswaej,13033,13034,26067
17027,,url:http://ieeexplore.ieee.org/iel2/3038/8631/00379932.pdf3farnumber3d379932,13034,13035,26069
17028,,m69a-juqxe4j,13035,13036,26071
17029,,p_4hbefnfruj,13036,13037,26073
17030,,,13037,13038,26075
17031,,1zvsrj_zgxsj,13038,13039,26077
17032,,oopubhuufjuj,13039,13040,26079
17033,,yhruaw49hfsj,13042,13043,26085
17034,,dig7-oe0nvoj,13043,13044,26087
17035,,_u5jmwbrcbej,13044,13045,26089
17036,,j_4a9g0s41uj,13045,13046,26091
17037,,ydnntg1thosj,13046,13047,26093
17038,,2ww-e_nm9kaj,13047,13048,26095
17039,,puca05laldgj,13048,13049,26097
17040,,1iuzzdvhyfuj,13049,13050,26099
17041,,zbv89s2esnwj,13050,13051,26101
17042,,r-erjydcskcj,13051,13052,26103
17043,,1rltox1cncqj,13052,13053,26105
17044,,ht2qayhovmij,13053,13054,26107
17045,,slijb36x5skj,13054,13055,26109
17046,,8lafnpe84ocj,13055,13056,26111
17047,,qnvoxrwswe0j,13056,13057,26113
17048,,5y7dq5ls_mej,13057,13058,26115
17049,,relyx1psuiyj,13058,13059,26117
17050,,url:http://www.ingentaconnect.com/content/els/09505849/1998/00000040/00000005/art00062,13059,13060,26119
17051,,b9ngxb3_exaj,13060,13061,26121
17052,,mfnnszm73egj,13061,13062,26123
17053,,url:http://www.springerlink.com/index/v305387275h11470.pdf,13062,13063,26125
17054,,ikof0mofjrej,13063,13064,26127
17055,,jhs4e33imicj,13064,13065,26129
17056,,tu0azbloe-yj,13065,13066,26131
17057,,gwuxxb21hamj,13066,13067,26133
17058,,7yafivbljokj,13067,13068,26135
17059,,u0vgbv0fhhej,13068,13069,26137
17060,,url:http://portal.acm.org/ft_gateway.cfm3fid3d106519926type3dpdf,13069,13070,26139
17061,,desqewr_7lej,13070,13071,26141
17062,,5m5xranjhnwj,13071,13072,26143
17063,,5ygaj_5dguij,13072,13073,26145
17064,,ne_hjaa2eaaj,13073,13074,26147
17065,,hevpljfdpb4j,13074,13075,26149
17066,,tz_vy9ekhjij,13075,13076,26151
17067,,ly_fx-cpspoj,13076,13077,26153
17068,,63vbbfmor6wj,13077,13078,26155
17069,,jo1_c3fwchij,13078,13079,26157
17070,,bdh4omzdslej,13079,13080,26159
17071,,au8mabi3tv0j,13080,13081,26161
17072,,6vjmnnw3lfmj,13081,13082,26163
17073,,ulmzwkzqjpwj,13082,13083,26165
17074,,d55lx2hl-28j,13083,13084,26167
17075,,lwwgqlfnpvaj,13084,13085,26169
17076,,5ejrrrs54fsj,13085,13086,26171
17077,,lkopcmfk4e0j,13086,13087,26173
17078,,ltx04kjtpf8j,13087,13088,26175
17079,,ecb0zbg1y5cj,13088,13089,26177
17080,,uxzyjlqj7fuj,13089,13090,26179
17081,,a-nosb2z20aj,13090,13091,26181
17082,,taejrmd0pumj,13091,13092,26183
17083,,bpkchirzypuj,13092,13093,26185
17084,,ppj3b8gzzekj,13093,13094,26187
17085,,fjmer16d-bkj,13094,13095,26189
17086,,jvotciii_ymj,13095,13096,26191
17087,,n-poqwkc8q0j,13096,13097,26193
17088,,xp7feaxdfuaj,13097,13098,26195
17089,,lanksnb7kzsj,13098,13099,26197
17090,,pkd6sb4k6fcj,13099,13100,26199
17091,,52c1g0wlyksj,13100,13101,26201
17092,,d9glorrssjgj,13101,13102,26203
17093,,ncb_nhazplcj,13102,13103,26205
17094,,_0d06vhygcyj,13104,13105,26209
17095,,wdrwjyti4uej,13105,13106,26211
17096,,eun2_lm7cj4j,13106,13107,26213
17097,,5vmteoqyf0aj,13107,13108,26215
17098,,xzprtv6v-nuj,13108,13109,26217
17099,,d7qpmjb3bmyj,13109,13110,26219
17100,,ovvnigxiyoij,13110,13111,26221
17101,,jvmhelgy6gcj,13111,13112,26223
17102,,z7zaa_qwnysj,13112,13113,26225
17103,,7r2mwkc9eiqj,13113,13114,26227
17104,,ql4hla1e06gj,13114,13115,26229
17105,,url:http://portal.acm.org/citation.cfm3fid3d234286.1057838,13115,13116,26231
17106,,ziksi4k2gaoj,13116,13117,26233
17107,,p6yujf3vpigj,13117,13118,26235
17108,,wncdogat9tqj,13118,13119,26237
17109,,kdt5ejevlr4j,13120,13121,26241
17110,,xpkpdvhcqmgj,13121,13122,26243
17111,,49fsw71tyqqj,13122,13123,26245
17112,,2riiqlolipsj,13123,13124,26247
17113,,iet8ba0wlywj,13124,13125,26249
17114,,wgwxozmsyj4j,13125,13126,26251
17115,,h_5al2ngprcj,13126,13127,26253
17116,,qlor449zfbyj,13127,13128,26255
17117,,tqacgb10b6mj,13128,13129,26257
17118,,rcrzdv1ualcj,13129,13130,26259
17119,,85wwulpvtcij,13130,13131,26261
17120,,cw07vlwtni0j,13131,13132,26263
17121,,hgmmxqp42kgj,13132,13133,26265
17122,,h3u8tb3oh2qj,13133,13134,26267
17123,,zfpmidphnhij,13134,13135,26269
17124,,f_catwyiu2gj,13135,13136,26271
17125,,_steuxuugauj,13136,13137,26273
17126,,36ed9yopyvij,13137,13138,26275
17127,,4jt6pmn2ah4j,13138,13139,26277
17128,,intrj0tntp0j,13139,13140,26279
17129,,sjdadlpfzqsj,13140,13141,26281
17130,,jtv9vcwpkk8j,13141,13142,26283
17131,,url:http://doi.wiley.com/10.1002/he.162,13142,13143,26285
17132,,x_qh7a2c_1ej,13143,13144,26287
17133,,g1dv4zs2puqj,13144,13145,26289
17134,,diaisioo7baj,13145,13146,26291
17135,,bwhlkhwwnumj,13146,13147,26293
17136,,ilxzhy4-bluj,13148,13149,26297
17137,,wb_equo2zeij,13149,13150,26299
17138,,god1eoirxcaj,13150,13151,26301
17139,,devwmsm-x3cj,13151,13152,26303
17140,,3alatqxyvg4j,13152,13153,26305
17141,,blprnl018nej,13153,13154,26307
17142,,ibyyc6ppopej,13154,13155,26309
17143,,w-f61p0z9vgj,13155,13156,26311
17144,,sxndwkgwrtej,13156,13157,26313
17145,,capv4l7xjfej,13157,13158,26315
17146,,1ldrfbw0rnwj,13158,13159,26317
17147,,bkhms_cjbukj,13159,13160,26319
17148,,dfjerpfnugwj,13160,13161,26321
17149,,sreyqujp61kj,13161,13162,26323
17150,,mewk-fubbv8j,13162,13163,26325
17151,,cob2qap7eqmj,13163,13164,26327
17152,,w5i-zy0c1jaj,13164,13165,26329
17153,,h_8c8ne5kqsj,13165,13166,26331
17154,,umkxye1wy3yj,13166,13167,26333
17155,,3upansplvlmj,13167,13168,26335
17156,,n9_oactp3uaj,13169,13170,26339
17157,,mqacxauwucgj,13170,13171,26341
17158,,g-iy7laejrqj,13171,13172,26343
17159,,74fa-cz1oa4j,13172,13173,26345
17160,,lfpujayoejij,13173,13174,26347
17161,,z3e4db3k-qyj,13174,13175,26349
17162,,ugcliywzkgij,13175,13176,26351
17163,,t3s2jppnfh4j,13176,13177,26353
17164,,dlxec1zbitqj,13177,13178,26355
17165,,4xly7nyhweyj,13178,13179,26357
17166,,kgv3umvbi-kj,13179,13180,26359
17167,,i1ynhahmaguj,13180,13181,26361
17168,,5yu9zkd6uywj,13181,13182,26363
17169,,m7ksiyu5pi4j,13182,13183,26365
17170,,ccwmetakfqwj,13183,13184,26367
17171,,fbcmw8a63twj,13184,13185,26369
17172,,et6snzonnfsj,13185,13186,26371
17173,,x8wxqkaoihqj,13186,13187,26373
17174,,qzgbugsms74j,13187,13188,26375
17175,,1wpa51t_vy0j,13188,13189,26377
17176,,yozo8twyvlmj,13189,13190,26379
17177,,krmpd4i9tuoj,13190,13191,26381
17178,,gqllqkocxgej,13191,13192,26383
17179,,twiatwnnmzwj,13192,13193,26385
17180,,f5ttb7wgz-kj,13193,13194,26387
17181,,url:http://portal.acm.org/citation.cfm3fid3d127239.127240,13194,13195,26389
17182,,bdc9lnqqrwsj,13195,13196,26391
17183,,7zh4jx21lkcj,13196,13197,26393
17184,,w17spsgfexyj,13197,13198,26395
17185,,fnuwr-ehhouj,13198,13199,26397
17186,,9ywfrtrnlaij,13199,13200,26399
17187,,ig8i3cc-a44j,13200,13201,26401
17188,,stshmokaercj,13201,13202,26403
17189,,h6ykwgyuv_cj,13202,13203,26405
17190,,c9-x53vb9mej,13203,13204,26407
17191,,qg95z0g4y2ij,13204,13205,26409
17192,,q629uy6oxwej,13205,13206,26411
17193,,rj98a3wlg9qj,13206,13207,26413
17194,,_i9mbf4pbtsj,13207,13208,26415
17195,,lyotem8nrdsj,13208,13209,26417
17196,,pphfe7ftwvsj,13209,13210,26419
17197,,8n3z32xe_tij,13210,13211,26421
17198,,url:http://portal.acm.org/ft_gateway.cfm3fid3d102756526type3dpdf,13211,13212,26423
17199,,1luqpoyiltmj,13212,13213,26425
17200,,kenqzttxrdgj,13213,13214,26427
17201,,03pebawdmgej,13214,13215,26429
17202,,wky51veo664j,13215,13216,26431
17203,,t_8es4slnyqj,13216,13217,26433
17204,,z2dq47oduksj,13217,13218,26435
17205,,fe6bggeqbhwj,13218,13219,26437
17206,,hf3qkabprgwj,13219,13220,26439
17207,,tmcdgi1iqvmj,13220,13221,26441
17208,,t5oh0jnls7aj,13221,13222,26443
17209,,du2kh5aufj4j,13222,13223,26445
17210,,epdonxbgjfqj,13223,13224,26447
17211,,k-qxmzs8wsyj,13224,13225,26449
17212,,z5rfioelqekj,13225,13226,26451
17213,,qtivooxzrnaj,13226,13227,26453
17214,,60gjfpzyanoj,13227,13228,26455
17215,,ck5dpjxkhvej,13228,13229,26457
17216,,v1jojw0-yskj,13229,13230,26459
17217,,cuvosfsznsej,13230,13231,26461
17218,,zso2wuwr9goj,13231,13232,26463
17219,,5u_azsfigsyj,13232,13233,26465
17220,,qgkdzghitgij,13233,13234,26467
17221,,7udss-kvsy8j,13234,13235,26469
17222,,zco22xb6pf4j,13235,13236,26471
17223,,vnolceb8e1qj,13236,13237,26473
17224,,zhtn68n42ryj,13237,13238,26475
17225,,63gvukeubzqj,13238,13239,26477
17226,,dlun8lxillaj,13240,13241,26481
17227,,o726gd7oniuj,13241,13242,26483
17228,,url:http://www.csa.com/partners/viewrecord.php3frequester3dgs26collection3dtrd26recid3d199310720496md26recid3d199310g2c0253ec,13242,13243,26485
17229,,url:http://portal.acm.org/ft_gateway.cfm3fid3d110196926type3dpdf,13243,13244,26487
17230,,q5rylh6hr5oj,13244,13245,26489
17231,,eq9sjn5u1w0j,13245,13246,26491
17232,,fulahmpuxkqj,13246,13247,26493
17233,,op_aymtvn2oj,13247,13248,26495
17234,,jri5pb6e7mij,13248,13249,26497
17235,,xftbfu2w9i4j,13249,13250,26499
17236,,tm_fi0z6payj,13250,13251,26501
17237,,s4beawpkxeuj,13251,13252,26503
17238,,lrdcynd-pf8j,13252,13253,26505
17239,,tjjvg-oiqqsj,13253,13254,26507
17240,,hk84ebg-9awj,13254,13255,26509
17241,,okyyd4lq1ncj,13255,13256,26511
17242,,mmgmzlbsqi0j,13256,13257,26513
17243,,fborhvedijyj,13257,13258,26515
17244,,url:http://www.springerlink.com/index/rr00572015q64n88.pdf,13258,13259,26517
17245,,n7bjmbybpmcj,13259,13260,26519
17246,,9w14eoae_egj,13260,13261,26521
17247,,fdjugjxmbzaj,13261,13262,26523
17248,,qag2sqgb05sj,13262,13263,26525
17249,,g6mptul2zpmj,13263,13264,26527
17250,,taa_rgzuf9uj,13264,13265,26529
17251,,q3m26oq_zaij,13265,13266,26531
17252,,rcko8_vbtq4j,13266,13267,26533
17253,,hvshxv26x60j,13267,13268,26535
17254,,ktibtxzepl8j,13268,13269,26537
17255,,z-dsecgw-98j,13269,13270,26539
17256,,denvednqyzsj,13270,13271,26541
17257,,url:http://www.springerlink.com/index/v65n53x12rv76426.pdf,13271,13272,26543
17258,,ocpa8actvzuj,13272,13273,26545
17259,,fo522bt76xqj,13273,13274,26547
17260,,eafb7yyrhkoj,13274,13275,26549
17261,,ltu9fitvlgwj,13275,13276,26551
17262,,vrghyszb-gij,13276,13277,26553
17263,,soynxacfbhij,13277,13278,26555
17264,,jvrgkpijgaej,13278,13279,26557
17265,,z-njhru_eayj,13279,13280,26559
17266,,splqt63harcj,13280,13281,26561
17267,,url:http://portal.acm.org/ft_gateway.cfm3fid3d110116726type3dpdf,13281,13282,26563
17268,,aowwkb8t3w8j,13282,13283,26565
17269,,mrnsmt4yxqkj,13283,13284,26567
17270,,cs2wt2dogg8j,13284,13285,26569
17271,,q9hgmqxsclij,13285,13286,26571
17272,,63vrmlemkbmj,13286,13287,26573
17273,,_1muxsjk7-4j,13287,13288,26575
17274,,uv_crz3zghij,13288,13289,26577
17275,,rx1it8bywayj,13289,13290,26579
17276,,luj9qthmye4j,13290,13291,26581
17277,,a106rdivkrkj,13291,13292,26583
17278,,gumjxtoqndkj,13292,13293,26585
17279,,qosonelbmsuj,13293,13294,26587
17280,,57smktzrytsj,13294,13295,26589
17281,,2kahcxathxwj,13298,13299,26597
17282,,yquqkcbc_b0j,13299,13300,26599
17283,,url:http://www.springerlink.com/index/cbhrgbhftw90n54x.pdf,13300,13301,26601
17284,,url:http://www.springerlink.com/index/x4828v2n1520w56r.pdf,13301,13302,26603
17285,,j2qhvcr-tjmj,13302,13303,26605
17286,,z8tyxx7b4hsj,13303,13304,26607
17287,,xgf_k3tokuuj,13304,13305,26609
17288,,jd9ajrmloacj,13305,13306,26611
17289,,mcrjcy_fkmaj,13306,13307,26613
17290,,url:http://portal.acm.org/ft_gateway.cfm3fid3d110125126type3dpdf,13308,13309,26617
17291,,mf-cq6ze4a4j,13309,13310,26619
17292,,s5t83rzp2ckj,13310,13311,26621
17293,,zlslvhgk0luj,13312,13313,26625
17294,,nsb8ehvvjisj,13313,13314,26627
17295,,f_dy8seviusj,13314,13315,26629
17296,,url:http://www.csa.com/partners/viewrecord.php3frequester3dgs26collection3dtrd26recid3d017203530102xai,13315,13316,26631
17297,,uuyf3ku5utqj,13316,13317,26633
17298,,gn93-vvbzjaj,13317,13318,26635
17299,,nj-y9q1m5p4j,13318,13319,26637
17300,,99rd5gr7bbwj,13319,13320,26639
17301,,ujqopskig-qj,13320,13321,26641
17302,,url:http://www.springerlink.com/index/nm6126702075t880.pdf,13321,13322,26643
17303,,vnlzllnefjyj,13322,13323,26645
17304,,url:http://www.csa.com/partners/viewrecord.php3frequester3dgs26collection3dtrd26recid3d2223158ci,13323,13324,26647
17305,,y7sejrpkgaij,13324,13325,26649
17306,,sl8wn54jx8aj,13325,13326,26651
17307,,r1rlnxtdstoj,13326,13327,26653
17308,,i14c31dejswj,13327,13328,26655
17309,,zrsjk3xatvej,13328,13329,26657
17310,,ipqthvqgdcwj,13329,13330,26659
17311,,tefiz8xxtt0j,13330,13331,26661
17312,,qt0omlwgjjcj,13331,13332,26663
17313,,wjcuyox7vwwj,13332,13333,26665
17314,,cnl0jqppb1sj,13333,13334,26667
17315,,xolvcxl3byqj,13335,13336,26671
17316,,jksobgdsjhij,13336,13337,26673
17317,,,13337,13338,26675
17318,,f_b7-z6buiyj,13338,13339,26677
17319,,nuahlpubvgmj,13339,13340,26679
17320,,tiafcv7jgl4j,13340,13341,26681
17321,,rnq-hqjmadkj,13341,13342,26683
17322,,wj_3rfbpevqj,13342,13343,26685
17323,,x1z_3sd5w1gj,13343,13344,26687
17324,,rfevftztitkj,13344,13345,26689
17325,,pxymytcr9dgj,13345,13346,26691
17326,,7bvxjt3yjcoj,13346,13347,26693
17327,,nfj3cfipt-sj,13347,13348,26695
17328,,xt1hapxbyrej,13348,13349,26697
17329,,0pb0ykfhwqwj,13349,13350,26699
17330,,nb35pwz1670j,13350,13351,26701
17331,,url:http://portal.acm.org/ft_gateway.cfm3fid3d110130926type3dpdf,13351,13352,26703
17332,,mht3dqib-gwj,13352,13353,26705
17333,,fk0glahh-8uj,13353,13354,26707
17334,,_95smzckeoej,13354,13355,26709
17335,,lzwflkoaxqqj,13355,13356,26711
17336,,jf1nh4blkwaj,13357,13358,26715
17337,,hxaxmo6vlqcj,13358,13359,26717
17338,,uzmpybmnfvmj,13359,13360,26719
17339,,3shxb3_dxpoj,13360,13361,26721
17340,,cpkivvl0vaej,13361,13362,26723
17341,,url:http://www.csa.com/partners/viewrecord.php3frequester3dgs26collection3dtrd26recid3d1249666ci,13362,13363,26725
17342,,mxnhcvqvocej,13363,13364,26727
17343,,ijgg3e1gzlcj,13364,13365,26729
17344,,nvboeojga0ej,13365,13366,26731
17345,,fi2i32qrtdqj,13366,13367,26733
17346,,uxjbbujvh68j,13367,13368,26735
17347,,s2ifusjagryj,13368,13369,26737
17348,,l4__3xwd5j0j,13369,13370,26739
17349,,snibav2en0mj,13370,13371,26741
17350,,r65bnwjza9ij,13371,13372,26743
17351,,tl1qlhxnnwkj,13372,13373,26745
17352,,7dnmpfwsdmsj,13373,13374,26747
17353,,4q4pdos45uij,13374,13375,26749
17354,,vmgv9bgxlwaj,13375,13376,26751
17355,,tfgci5bs7fkj,13376,13377,26753
17356,,d8poo41sobyj,13377,13378,26755
17357,,3tabwy4ghpyj,13378,13379,26757
17358,,scrdcf327swj,13379,13380,26759
17359,,nnngfutirf0j,13380,13381,26761
17360,,byw8gmejiusj,13381,13382,26763
17361,,zpbc0anpurqj,13382,13383,26765
17362,,fxyga5joel4j,13383,13384,26767
17363,,d_p577jtojyj,13384,13385,26769
17364,,pij2sykhf7ej,13385,13386,26771
17365,,niagpbsyvbij,13386,13387,26773
17366,,sukedfxr5gmj,13387,13388,26775
17367,,mmu6trrkq5uj,13388,13389,26777
17368,,t8nff9tmvfgj,13389,13390,26779
17369,,wpkoqvkesokj,13390,13391,26781
17370,,9aky9zdu990j,13391,13392,26783
17371,,stwkdmoktbsj,13392,13393,26785
17372,,gc92s-tgjzuj,13393,13394,26787
17373,,wylysxv9xqkj,13394,13395,26789
17374,,wumvv-cnyr4j,13395,13396,26791
17375,,3trckmkdlqyj,13396,13397,26793
17376,,zxg6ntfhrc8j,13397,13398,26795
17377,,url:http://acsinfo.acs.org/cgi-bin/abstract.cgi/achre4/2005/38/i03/abs/ar040218g.html,13398,13399,26797
17378,,d6efk-vl3l4j,13399,13400,26799
17379,,url:http://doi.ieeecomputersociety.org/10.1109/im.1999.805342,13400,13401,26801
17380,,pd_rhzqi-ywj,13401,13402,26803
17381,,no2mabibztsj,13402,13403,26805
17382,,s6z679-64uaj,13403,13404,26807
17383,,lfy2wt8_6rsj,13404,13405,26809
17384,,mg1tdhp_0rqj,13405,13406,26811
17385,,dad644ruuoqj,13406,13407,26813
17386,,ss4vsauehvsj,13407,13408,26815
17387,,mykerispd0ej,13408,13409,26817
17388,,yagpv7iwsbij,13410,13411,26821
17389,,xmnoffbdubkj,13411,13412,26823
17390,,v-d7wrwoetuj,13412,13413,26825
17391,,pp4d4bm_j_uj,13414,13415,26829
17392,,lucpudguj9oj,13415,13416,26831
17393,,863u9j4l25mj,13416,13417,26833
17394,,og09tgyqpd4j,13417,13418,26835
17395,,aldncrugaqyj,13418,13419,26837
17396,,tajmlcizumsj,13419,13420,26839
17397,,pd4v3thxj68j,13420,13421,26841
17398,,dy5eeh8jzmgj,13421,13422,26843
17399,,9iosjjqixyqj,13422,13423,26845
17400,,gwojro31zyuj,13423,13424,26847
17401,,naktiwn08wkj,13424,13425,26849
17402,,qvgfvev6khoj,13425,13426,26851
17403,,onxifv3wmb0j,13426,13427,26853
17404,,url:http://portal.acm.org/ft_gateway.cfm3fid3d13087926type3dpdf26coll3dguide26dl3dacm26cfid3d1111111126cftoken3d2222222,13427,13428,26855
17405,,ukdri3a_elgj,13428,13429,26857
17406,,p_iyxjngozkj,13429,13430,26859
17407,,turvvcixra4j,13430,13431,26861
17408,,tvefacghc5sj,13431,13432,26863
17409,,xpaadejsheoj,13432,13433,26865
17410,,o8zmutvg7gsj,13433,13434,26867
17411,,jg72g2lff4kj,13434,13435,26869
17412,,qncc4psaqhsj,13435,13436,26871
17413,,razre9xnrioj,13436,13437,26873
17414,,vdbv4c74xk4j,13437,13438,26875
17415,,url:http://portal.acm.org/ft_gateway.cfm3fid3d110133726type3dpdf,13438,13439,26877
17416,,url:http://portal.acm.org/citation.cfm3fdoid3d375663.375759,13439,13440,26879
17417,,lrtzou3moogj,13440,13441,26881
17418,,y4hdhiv4pbyj,13441,13442,26883
17419,,pdccnrhci20j,13442,13443,26885
17420,,zb21q01i7smj,13443,13444,26887
17421,,khahsifbzyej,13444,13445,26889
17422,,hxixofmatzgj,13445,13446,26891
17423,,kgiwmcjq4pej,13446,13447,26893
17424,,yz35mhi-rgsj,13447,13448,26895
17425,,dppjbzpunuuj,13448,13449,26897
17426,,ipanlavmz_gj,13449,13450,26899
17427,,piowanjvsn4j,13450,13451,26901
17428,,rozqfjuv3auj,13451,13452,26903
17429,,iaegt_otl0ij,13452,13453,26905
17430,,iqzzd_mp6gmj,13453,13454,26907
17431,,8ulwtlni1xcj,13454,13455,26909
17432,,vzptjh-rxf8j,13455,13456,26911
17433,,d-dyj3dfwgqj,13456,13457,26913
17434,,qhxomi9xmeyj,13457,13458,26915
17435,,url:http://www.csa.com/partners/viewrecord.php3frequester3dgs26collection3dtrd26recid3da8622959ah,13458,13459,26917
17436,,ft__m6kuxk4j,13461,13462,26923
17437,,eexypfa-wroj,13462,13463,26925
17438,,u67olffti1ij,13463,13464,26927
17439,,orv-ny3xswmj,13464,13465,26929
17440,,0bysk5dgsxaj,13465,13466,26931
17441,,ywjrixizazcj,13466,13467,26933
17442,,9eddlprnoa4j,13467,13468,26935
17443,,vgzzd1od2wmj,13468,13469,26937
17444,,fs4zi9ixykwj,13469,13470,26939
17445,,obabvcmqzeqj,13470,13471,26941
17446,,edwgel0ldhmj,13471,13472,26943
17447,,b8vok1eytncj,13472,13473,26945
17448,,wfagkobqvjyj,13473,13474,26947
17449,,1nckzge1z60j,13474,13475,26949
17450,,mc1aulz-_4cj,13475,13476,26951
17451,,10pbp2cbjiuj,13476,13477,26953
17452,,xghlfgtvgqwj,13477,13478,26955
17453,,p8gcba1zfxsj,13478,13479,26957
17454,,wqvrxv0ers8j,13479,13480,26959
17455,,qzs7l6y94_uj,13480,13481,26961
17456,,xzj6n0xtntej,13481,13482,26963
17457,,4zmc2hvx_vej,13482,13483,26965
17458,,o67qqld-gouj,13483,13484,26967
17459,,nn2ilwzjt9wj,13484,13485,26969
17460,,z8eqpkzmjm4j,13485,13486,26971
17461,,sbfgkhjg-tcj,13486,13487,26973
17462,,,13487,13488,26975
17463,,o9ph8csoxz0j,13488,13489,26977
17464,,r7l6xjpeaxkj,13489,13490,26979
17465,,2fo9nm2fogyj,13490,13491,26981
17466,,cvfv-7ajwfqj,13491,13492,26983
17467,,8skscerlyjwj,13492,13493,26985
17468,,tfijhxpzejij,13493,13494,26987
17469,,qqspz22thb8j,13494,13495,26989
17470,,gff5bck5taqj,13495,13496,26991
17471,,9zhdpdecmq8j,13496,13497,26993
17472,,rnpovuplkvij,13497,13498,26995
17473,,faj3wc9vlzej,13498,13499,26997
17474,,stdlxmtdqrmj,13499,13500,26999
17475,,b6ohtg3p-v8j,13500,13501,27001
17476,,hv-ggilgu-mj,13501,13502,27003
17477,,hnwofugwruyj,13502,13503,27005
17478,,lwyin6ekjqwj,13503,13504,27007
17479,,femhf09w0yij,13504,13505,27009
17480,,qskczahu758j,13505,13506,27011
17481,,fl4yq0svb5gj,13506,13507,27013
17482,,u8filndkvakj,13507,13508,27015
17483,,ajazkw2biggj,13508,13509,27017
17484,,frisqthampsj,13509,13510,27019
17485,,5knucpuk_yuj,13510,13511,27021
17486,,url:http://portal.acm.org/citation.cfm3fid3d122058.12207326coll3dguide26dl3dacm26idx3dj68926part3dperiodical26wanttype3dperiodical26title3dacm2520sigmod2520record26cfid3d1111111126cftoken3d2222222,13511,13512,27023
17487,,gstvcdzffb8j,13512,13513,27025
17488,,pzj9l3m57joj,13513,13514,27027
17489,,glvjeenaqwsj,13514,13515,27029
17490,,sv4dggpv9bsj,13515,13516,27031
17491,,,13516,13517,27033
17492,,cyazbtjnwhmj,13517,13518,27035
17493,,eipjnp3tqwwj,13518,13519,27037
17494,,jg44blczuh0j,13519,13520,27039
17495,,ntb-heabnxoj,13520,13521,27041
17496,,se5nlovk0lij,13521,13522,27043
17497,,_6iphnanqusj,13522,13523,27045
17498,,nzyrmiibtkyj,13523,13524,27047
17499,,ocq3irplky0j,13524,13525,27049
17500,,8ivucs7xqq4j,13525,13526,27051
17501,,led7dr4gcoej,13526,13527,27053
17502,,fklcs7huknkj,13527,13528,27055
17503,,url:http://doi.wiley.com/10.1002/tl.165,13528,13529,27057
17504,,vckxedc8giqj,13529,13530,27059
17505,,,13530,13531,27061
17506,,qjtmfd_aphsj,13531,13532,27063
17507,,0qmzyrfnbu4j,13532,13533,27065
17508,,xhw_bzhomsuj,13533,13534,27067
17509,,emzkk7zwk7mj,13534,13535,27069
17510,,0m9ugontmcsj,13535,13536,27071
17511,,url:http://www.springerlink.com/index/u5803062j7576h62.pdf,13536,13537,27073
17512,,mvzg8yimvzuj,13538,13539,27077
17513,,njb9mkgfyn8j,13539,13540,27079
17514,,qixecn3dhl0j,13540,13541,27081
17515,,vvfvm7w-kuuj,13541,13542,27083
17516,,lv1edjto2x0j,13542,13543,27085
17517,,xcoa55ac-haj,13543,13544,27087
17518,,eqw_tswcxkmj,13544,13545,27089
17519,,mg1fox5h9p8j,13545,13546,27091
17520,,tgcahyvc70qj,13546,13547,27093
17521,,4ekhkzsbs1ej,13547,13548,27095
17522,,zivezegzz4sj,13548,13549,27097
17523,,toya3hshuquj,13549,13550,27099
17524,,513ra6piajcj,13550,13551,27101
17525,,96dabnfcq48j,13551,13552,27103
17526,,yt3awxneg1mj,13552,13553,27105
17527,,7rm9pbznc2qj,13553,13554,27107
17528,,fuzubo3vltcj,13554,13555,27109
17529,,3deoli_h738j,13555,13556,27111
17530,,w7zabfm41skj,13556,13557,27113
17531,,jtf5mjw71iqj,13557,13558,27115
17532,,ocvej3p9c-yj,13558,13559,27117
17533,,noumvn1tzdmj,13559,13560,27119
17534,,url:http://portal.acm.org/ft_gateway.cfm3fid3d110123126type3dpdf,13560,13561,27121
17535,,ub2wqqqgd40j,13561,13562,27123
17536,,_hvw9zsidikj,13562,13563,27125
17537,,4pwvujuzeqsj,13563,13564,27127
17538,,y9l9bregaksj,13564,13565,27129
17539,,mlyqryy7yumj,13565,13566,27131
17540,,lsyfl9z8yvsj,13566,13567,27133
17541,,n4q_hinjwc8j,13567,13568,27135
17542,,5prktuvwxk0j,13568,13569,27137
17543,,zz1hwjoz-daj,13569,13570,27139
17544,,lm-c8-zm8rmj,13570,13571,27141
17545,,6ykylyhsiquj,13572,13573,27145
17546,,1_cz5wsuaqsj,13573,13574,27147
17547,,3rukoxnwc2wj,13574,13575,27149
17548,,byut9cd-tywj,13575,13576,27151
17549,,7tmjloehg4yj,13576,13577,27153
17550,,czzhyfgcqyyj,13577,13578,27155
17551,,tfn6ignwesij,13578,13579,27157
17552,,sxxcvifztx0j,13579,13580,27159
17553,,f4s8many64wj,13581,13582,27163
17554,,16qhdtjguisj,13582,13583,27165
17555,,mt68_u-tyemj,13583,13584,27167
17556,,4p6edfza2nej,13584,13585,27169
17557,,sa9z_wwfulmj,13585,13586,27171
17558,,url:http://portal.acm.org/ft_gateway.cfm3fid3d102758226type3dpdf,13586,13587,27173
17559,,5f8od7cl1kgj,13587,13588,27175
17560,,zws_rjrojcaj,13588,13589,27177
17561,,bufvhd8ohqkj,13589,13590,27179
17562,,qx7hbzrptfaj,13590,13591,27181
17563,,hlmycjwgn2aj,13591,13592,27183
17564,,url:http://ieeexplore.ieee.org/iel1/2206/325/00006492.pdf3farnumber3d6492,13592,13593,27185
17565,,0fegsy747vuj,13593,13594,27187
17566,,shhigwa3mouj,13594,13595,27189
17567,,ypbjhf-d8x0j,13595,13596,27191
17568,,iidjhckfge0j,13596,13597,27193
17569,,gi3xnixsancj,13597,13598,27195
17570,,x7me_c0ogsij,13598,13599,27197
17571,,xnz8k-seeeej,13600,13601,27201
17572,,h5gcplcqqcoj,13601,13602,27203
17573,,phz-upjksr4j,13602,13603,27205
17574,,cngoiykbrbsj,13603,13604,27207
17575,,mtlitubhw4qj,13604,13605,27209
17576,,guaq-7y_jlcj,13605,13606,27211
17577,,url:http://www.springerlink.com/index/lwq8686g53174187.pdf,13606,13607,27213
17578,,uljsdwuyuraj,13607,13608,27215
17579,,xuazlpawm2qj,13608,13609,27217
17580,,fm396yrzcwcj,13609,13610,27219
17581,,jiznnm6_h1uj,13610,13611,27221
17582,,bfxrl71vanwj,13611,13612,27223
17583,,am-kyuextpsj,13612,13613,27225
17584,,ddyzxuetgiwj,13613,13614,27227
17585,,vj_s2wgfmm0j,13614,13615,27229
17586,,url:http://www.ingentaconnect.com/search/expand3fpub3dinfobike://els/13891286/2003/00000042/00000001/art0017926unc3d,13615,13616,27231
17587,,hy4mx1jkqjyj,13616,13617,27233
17588,,h1zxjmw6er4j,13617,13618,27235
17589,,gzcqjln85tcj,13618,13619,27237
17590,,ulxfekedhngj,13619,13620,27239
17591,,hi-75yfvizqj,13620,13621,27241
17592,,ellsjepg7moj,13621,13622,27243
17593,,yrk2bu9ifwsj,13622,13623,27245
17594,,lguicgus43wj,13623,13624,27247
17595,,kjremzir5mmj,13624,13625,27249
17596,,g1x8b7zushkj,13625,13626,27251
17597,,1rcdwhvp-o8j,13626,13627,27253
17598,,0jm3psjoke8j,13627,13628,27255
17599,,url:http://www.csa.com/partners/viewrecord.php3frequester3dgs26collection3dtrd26recid3dn9210501ah,13628,13629,27257
17600,,dc8cn236zf8j,13629,13630,27259
17601,,jswllui4nsgj,13630,13631,27261
17602,,yqt88w_mda0j,13631,13632,27263
17603,,a-fddaruymij,13632,13633,27265
17604,,5-ssehcasjuj,13633,13634,27267
17605,,hce10kl2bj0j,13634,13635,27269
17606,,4neixzfcmtsj,13635,13636,27271
17607,,mkroouyigouj,13636,13637,27273
17608,,ynw8mwpkb_gj,13637,13638,27275
17609,,s16hiqepwagj,13638,13639,27277
17610,,url:http://www.geography.org.uk/journals/journals.asp3farticleid3d57,13639,13640,27279
17611,,bm-dxeofmjcj,13640,13641,27281
17612,,y4pw1taqa1mj,13641,13642,27283
17613,,url:http://portal.acm.org/citation.cfm3fid3d63854.63857,13642,13643,27285
17614,,oicdwsyfxkcj,13643,13644,27287
17615,,pssb7jsfpcgj,13644,13645,27289
17616,,,13645,13646,27291
17617,,8_j8ffovpcaj,13646,13647,27293
17618,,vmvyzlswps8j,13647,13648,27295
17619,,f90sn5_2r-wj,13648,13649,27297
17620,,juuaxq_weeyj,13649,13650,27299
17621,,zdzxjpwug8ij,13650,13651,27301
17622,,fsanj8ltcdyj,13651,13652,27303
17623,,ndrthpt7a68j,13652,13653,27305
17624,,wid_osjiwnuj,13653,13654,27307
17625,,b4jj0dvvdeej,13654,13655,27309
17626,,i7gpr1lhbayj,13655,13656,27311
17627,,inrxecteeygj,13656,13657,27313
17628,,khe9-cv77fwj,13657,13658,27315
17629,,aqbpvv26wc4j,13659,13660,27319
17630,,pw8hol_9q8kj,13660,13661,27321
17631,,frzyjby81k4j,13661,13662,27323
17632,,obd_ersn74ij,13662,13663,27325
17633,,zelvjyirto8j,13663,13664,27327
17634,,vk55ufdkiwqj,13664,13665,27329
17635,,wlzybp3m8hoj,13665,13666,27331
17636,,zilvn1q-swmj,13666,13667,27333
17637,,sbkfb-tmkbsj,13667,13668,27335
17638,,omzoawpzkckj,13668,13669,27337
17639,,aw6k-i9nlk0j,13669,13670,27339
17640,,wf8yvrhkou4j,13670,13671,27341
17641,,1ort5ua9xjoj,13671,13672,27343
17642,,rd2gpiq6wn8j,13672,13673,27345
17643,,wzqqmyyext8j,13673,13674,27347
17644,,bfdfn3omnaqj,13674,13675,27349
17645,,jvfqqqed2umj,13675,13676,27351
17646,,vn-gv9gvhamj,13676,13677,27353
17647,,eh0glugbivcj,13677,13678,27355
17648,,gkosm57ufb4j,13678,13679,27357
17649,,df6v0_j0mpsj,13679,13680,27359
17650,,po8pmbxwilij,13680,13681,27361
17651,,p79b9a6fu9oj,13681,13682,27363
17652,,vrthzbpwdnqj,13682,13683,27365
17653,,sp28rgiswu4j,13683,13684,27367
17654,,sr_yvgznypmj,13684,13685,27369
17655,,7ikxp8kvcg8j,13685,13686,27371
17656,,dx3ltv6knpqj,13686,13687,27373
17657,,0dxeomjcvb4j,13687,13688,27375
17658,,shc_ganjms0j,13688,13689,27377
17659,,url:http://www.blackwell-synergy.com/doi/abs/10.1111/j.1478-0542.0066,13689,13690,27379
17660,,qf4764q6m6yj,13690,13691,27381
17661,,r7agpmxbb04j,13691,13692,27383
17662,,q5xs6kwsuiaj,13692,13693,27385
17663,,hzt8djewke4j,13693,13694,27387
17664,,sokjnomdkhwj,13695,13696,27391
17665,,nqxeze6kvmqj,13696,13697,27393
17666,,h_9z_qfouauj,13697,13698,27395
17667,,vuvqy6kpx_ij,13698,13699,27397
17668,,5_yzis3dk_sj,13699,13700,27399
17669,,cjjegis6emaj,13700,13701,27401
17670,,vedf7vb98i8j,13701,13702,27403
17671,,v-sw13ft2gqj,13702,13703,27405
17672,,_steqtmr4yoj,13703,13704,27407
17673,,fiwky7i9m70j,13704,13705,27409
17674,,gctzh6trjxij,13705,13706,27411
17675,,okmmktlu0m8j,13706,13707,27413
17676,,runuo7oxk9oj,13707,13708,27415
17677,,im3o2atdkhcj,13709,13710,27419
17678,,dg3xq60-gzuj,13710,13711,27421
17679,,gn_wlwqkg10j,13711,13712,27423
17680,,zezn8fqklouj,13712,13713,27425
17681,,x309djksgu8j,13713,13714,27427
17682,,to0gomp8aqoj,13715,13716,27431
17683,,url:http://www.csa.com/partners/viewrecord.php3frequester3dgs26collection3dtrd26recid3d0140490ci,13716,13717,27433
17684,,zu683fkrzfqj,13717,13718,27435
17685,,1zpzjikapkuj,13718,13719,27437
17686,,hd5jhuar6z4j,13719,13720,27439
17687,,gbvrqiyzpcij,13720,13721,27441
17688,,5mznmvnp9ckj,13721,13722,27443
17689,,5d1drip7bpej,13723,13724,27447
17690,,j0vkltbffjaj,13724,13725,27449
17691,,tx0uj8if2l0j,13725,13726,27451
17692,,bgrqeufnr08j,13726,13727,27453
17693,,,13727,13728,27455
17694,,kwjbmfn4fnuj,13728,13729,27457
17695,,p0wvdn9aprsj,13729,13730,27459
17696,,w297wyr0-moj,13730,13731,27461
17697,,ksuljg9j7ngj,13731,13732,27463
17698,,fnixflrczoej,13732,13733,27465
17699,,bgx8wtzn5hyj,13733,13734,27467
17700,,lwf8gmmrbl8j,13734,13735,27469
17701,,jniymgze-wwj,13735,13736,27471
17702,,iaes2u4m538j,13736,13737,27473
17703,,ucgssxa6tfij,13737,13738,27475
17704,,_q-4g7fe7xaj,13738,13739,27477
17705,,bxuz25wgsrij,13739,13740,27479
17706,,xddjtoo3b00j,13740,13741,27481
17707,,mm05scdc4zaj,13741,13742,27483
17708,,xu85qjibfyij,13742,13743,27485
17709,,8hbfc5l6qdij,13743,13744,27487
17710,,url:http://www.csa.com/partners/viewrecord.php3frequester3dgs26collection3dtrd26recid3da8622966ah,13744,13745,27489
17711,,wwcqn_ycjeej,13745,13746,27491
17712,,url:http://links.jstor.org/sici3fsici3d0146-4949(196423)5253a3253c205253ahasati253e2.0.co253b2-0,13746,13747,27493
17713,,yiyko_0kieij,13747,13748,27495
17714,,essrui40spgj,13748,13749,27497
17715,,izincx5ffyyj,13749,13750,27499
17716,,ruwqllhfrv8j,13750,13751,27501
17717,,ia-izftfedaj,13751,13752,27503
17718,,aorjdy7qx_8j,13752,13753,27505
17719,,gstohhhopfkj,13753,13754,27507
17720,,kpmvvwjpzioj,13754,13755,27509
17721,,qe2m-mkyuisj,13755,13756,27511
17722,,gdtvsmn-vayj,13756,13757,27513
17723,,ry2h4ddppqkj,13757,13758,27515
17724,,vloyxxn6du8j,13758,13759,27517
17725,,crch80h76hsj,13759,13760,27519
17726,,ztxmpv4umtoj,13760,13761,27521
17727,,fhiaazayvpsj,13761,13762,27523
17728,,yuvfxowht94j,13763,13764,27527
17729,,fggt7easa6mj,13764,13765,27529
17730,,xryte1s4ozwj,13765,13766,27531
17731,,ko4syhwkpa4j,13766,13767,27533
17732,,vcq9ofidt2ij,13767,13768,27535
17733,,hi3vbrrnvfwj,13768,13769,27537
17734,,ii8qmpfceiqj,13769,13770,27539
17735,,rhlmfjrquu0j,13770,13771,27541
17736,,kfs7lpxpdtej,13771,13772,27543
17737,,zfix8lsnrk8j,13772,13773,27545
17738,,biimqovllhyj,13773,13774,27547
17739,,b08bsbzpshgj,13774,13775,27549
17740,,xzs6jn_xnfqj,13775,13776,27551
17741,,uabfebrutdkj,13776,13777,27553
17742,,hdljfadfprij,13777,13778,27555
17743,,nrm6ixjiihmj,13778,13779,27557
17744,,zjrie5cmdzaj,13779,13780,27559
17745,,lbwav2km58gj,13780,13781,27561
17746,,fz_6pwrvnf8j,13781,13782,27563
17747,,fvo3rko0_aij,13782,13783,27565
17748,,y6mbyfzj2c0j,13783,13784,27567
17749,,u8av2wgtndyj,13784,13785,27569
17750,,uyq7esolk2sj,13785,13786,27571
17751,,smnnhana2yyj,13786,13787,27573
17752,,iq8xwdxlzxsj,13787,13788,27575
17753,,v3pi-dfywiij,13788,13789,27577
17754,,fjmyljq2tryj,13789,13790,27579
17755,,lcpnrzqgjd4j,13790,13791,27581
17756,,4kcdzc1jw2uj,13791,13792,27583
17757,,lsm05wjmep4j,13792,13793,27585
17758,,wkqoptcdergj,13793,13794,27587
17759,,url:http://portal.acm.org/citation.cfm3fid3d4420326dl3dguide26dl3dacm26type3dissue26idx3dj68926part3dperiodical26wanttype3dperiodical26title3dacm2520sigmod2520record26cfid3d1111111126cftoken3d2222222,13794,13795,27589
17760,,szlkvciimaij,13795,13796,27591
17761,,bqsa0p52ctoj,13796,13797,27593
17762,,ynywtdmitm4j,13797,13798,27595
17763,,ivcvdhwnzqij,13798,13799,27597
17764,,cigy3bycpecj,13799,13800,27599
17765,,ue1bt3qe9e0j,13800,13801,27601
17766,,my593fgaelqj,13801,13802,27603
17767,,46qcmqwytm8j,13802,13803,27605
17768,,rghenysi7-yj,13803,13804,27607
17769,,otdmd9heh_aj,13804,13805,27609
17770,,vrsls1ezkqgj,13805,13806,27611
17771,,mymclzrmrwyj,13806,13807,27613
17772,,wlp-8ehrxwyj,13807,13808,27615
17773,,qbgc9wwv0v0j,13808,13809,27617
17774,,uqjtnoolsrmj,13809,13810,27619
17775,,l3hkj1m9xmkj,13811,13812,27623
17776,,7o_joc5anrcj,13812,13813,27625
17777,,b0yvidolcymj,13813,13814,27627
17778,,aolho5ulwcyj,13814,13815,27629
17779,,krihklb09dsj,13815,13816,27631
17780,,dxi6zfy6p2ij,13816,13817,27633
17781,,vmbjspfhotoj,13817,13818,27635
17782,,2ad8dcqcuhcj,13819,13820,27639
17783,,yklwqn95rayj,13820,13821,27641
17784,,ny4venhtkaaj,13821,13822,27643
17785,,lvjn3-gni8wj,13822,13823,27645
17786,,qcau6wphnaaj,13823,13824,27647
17787,,abnmwuvlr7aj,13824,13825,27649
17788,,mdns0-mnrlyj,13825,13826,27651
17789,,fui3eiysdjwj,13826,13827,27653
17790,,ppp4jsjbfasj,13827,13828,27655
17791,,87ny2zyxdncj,13828,13829,27657
17792,,k8go9d-4csij,13829,13830,27659
17793,,qjlnypjqngoj,13830,13831,27661
17794,,1z3c1xrdkqij,13831,13832,27663
17795,,4frn5bsyptqj,13832,13833,27665
17796,,a-fgfei6gtej,13833,13834,27667
17797,,url:http://portal.acm.org/ft_gateway.cfm3fid3d108623226type3dpdf,13834,13835,27669
17798,,fkmziybjbzuj,13835,13836,27671
17799,,mjeahb3k9j4j,13836,13837,27673
17800,,gkyumizqlm8j,13837,13838,27675
17801,,,13838,13839,27677
17802,,z6zanwdujymj,13839,13840,27679
17803,,m2rdoeuxyjij,13840,13841,27681
17804,,hbgfajfkdqqj,13841,13842,27683
17805,,63kb3m95im8j,13842,13843,27685
17806,,nioyiawftxcj,13843,13844,27687
17807,,cia1mtixf9gj,13845,13846,27691
17808,,sfmnw-c9d9ij,13846,13847,27693
17809,,2ycuihxftyij,13847,13848,27695
17810,,j7f7hfwsfcej,13848,13849,27697
17811,,mjhonzroixuj,13849,13850,27699
17812,,wleqozde7xij,13850,13851,27701
17813,,amsbalwoe6cj,13852,13853,27705
17814,,aokk0eo9of8j,13854,13855,27709
17815,,h947hatgar0j,13855,13856,27711
17816,,ts9vsaemub8j,13857,13858,27715
17817,,ob-cxbuqbd0j,13858,13859,27717
17818,,nec0fstmcnoj,13859,13860,27719
17819,,13-2ofm5j5qj,13860,13861,27721
17820,,5omqaqlmalqj,13861,13862,27723
17821,,vmaphujbrdyj,13862,13863,27725
17822,,iiyvokyruy0j,13863,13864,27727
17823,,ue42osuyjyij,13864,13865,27729
17824,,suxvcmceta8j,13865,13866,27731
17825,,eijmqr_f-74j,13866,13867,27733
17826,,svbxes_xzduj,13867,13868,27735
17827,,axaowelrx6cj,13868,13869,27737
17828,,qxippuqvwhwj,13869,13870,27739
17829,,url:http://www.csa.com/partners/viewrecord.php3frequester3dgs26collection3dtrd26recid3dn9210517ah,13870,13871,27741
17830,,krsqssb_yd4j,13871,13872,27743
17831,,7e00rilkyqoj,13872,13873,27745
17832,,9d5fbte2rfgj,13873,13874,27747
17833,,jsnr05_wzjsj,13874,13875,27749
17834,,ok75hrnnoz4j,13875,13876,27751
17835,,gkdxwcwe4ssj,13876,13877,27753
17836,,7oj2h2gqu-0j,13877,13878,27755
17837,,jc_zkbwwmrwj,13878,13879,27757
17838,,vfbj5lboqhej,13879,13880,27759
17839,,mnjmrphrqryj,13880,13881,27761
17840,,bzqsxsodofkj,13881,13882,27763
17841,,riq-w5k0n6yj,13882,13883,27765
17842,,6ouorz6acbcj,13883,13884,27767
17843,,t2o5b7vprk4j,13884,13885,27769
17844,,qjnhxx8xpmgj,13885,13886,27771
17845,,2bgkvm5uiqaj,13887,13888,27775
17846,,erl43wdgzqcj,13888,13889,27777
17847,,url:http://portal.acm.org/citation.cfm3fid3d48360.48361,13889,13890,27779
17848,,url:http://www.csa.com/partners/viewrecord.php3frequester3dgs26collection3dtrd26recid3dn9210531ah,13890,13891,27781
17849,,rnft0bokjiqj,13891,13892,27783
17850,,1qc5yymuhxaj,13892,13893,27785
17851,,7mqbyogbowej,13893,13894,27787
17852,,ifjubt_n2nyj,13894,13895,27789
17853,,6-v7jqo-oeuj,13895,13896,27791
17854,,traslzhzzdmj,13896,13897,27793
17855,,6yz5fbxezgkj,13897,13898,27795
17856,,im_izxodg54j,13898,13899,27797
17857,,g7-lx8jcepqj,13899,13900,27799
17858,,-2o0qqakidkj,13900,13901,27801
17859,,hmbfbvyccuwj,13901,13902,27803
17860,,4ak9t94l_ykj,13902,13903,27805
17861,,xosqgelyktkj,13903,13904,27807
17862,,ns8g9u_ucwcj,13904,13905,27809
17863,,yeswe-_dxakj,13905,13906,27811
17864,,vyccvoy017aj,13906,13907,27813
17865,,url:http://doi.wiley.com/10.1002/tl.181,13907,13908,27815
17866,,ep1knqugcv0j,13908,13909,27817
17867,,u5soipmw7rwj,13909,13910,27819
17868,,dairt4-8c3yj,13910,13911,27821
17869,,7zbv3ctwybwj,13911,13912,27823
17870,,x5rfang1x-gj,13912,13913,27825
17871,,qizg-zfwjl0j,13913,13914,27827
17872,,x0k9drckyjqj,13914,13915,27829
17873,,url:http://portal.acm.org/citation.cfm3fid3d1066299,13916,13917,27833
17874,,mibogheadggj,13917,13918,27835
17875,,p8ynrtzrsvwj,13918,13919,27837
17876,,ngdg6ws4vmsj,13919,13920,27839
17877,,q6gzlmeg9jcj,13920,13921,27841
17878,,njuthcbumpaj,13921,13922,27843
17879,,nfchi7oeavij,13922,13923,27845
17880,,dzrbkb-8vzwj,13923,13924,27847
17881,,knxaqkpmbk0j,13924,13925,27849
17882,,64k7j-hykucj,13926,13927,27853
17883,,rhksgu-dhquj,13927,13928,27855
17884,,ovq6avm_6h4j,13928,13929,27857
17885,,hmcwmykl7eqj,13929,13930,27859
17886,,ejfx4lfymbsj,13930,13931,27861
17887,,0uvuu-usoisj,13931,13932,27863
17888,,14vdar7yhekj,13932,13933,27865
17889,,qy7yp813dbwj,13933,13934,27867
17890,,zcszl4avy08j,13934,13935,27869
17891,,whu2jotkajsj,13935,13936,27871
17892,,fnglpt681cuj,13936,13937,27873
17893,,wm3-q44xdaej,13937,13938,27875
17894,,jkvpwuqt0m0j,13938,13939,27877
17895,,hjgusozinkqj,13939,13940,27879
17896,,yicxzmoybtqj,13940,13941,27881
17897,,7k3kusip0dcj,13941,13942,27883
17898,,fxq50mzdndsj,13942,13943,27885
17899,,mspqppeibguj,13943,13944,27887
17900,,eox_ojkgdv4j,13944,13945,27889
17901,,ldxtk47ewlgj,13945,13946,27891
17902,,eclgeurqhqaj,13946,13947,27893
17903,,_-yq7u2hgxgj,13947,13948,27895
17904,,njmueu0r0hej,13948,13949,27897
17905,,2teqslwce9aj,13949,13950,27899
17906,,f1pnb8owd7aj,13950,13951,27901
17907,,nbw8z-atojkj,13951,13952,27903
17908,,nrxmzugargoj,13953,13954,27907
17909,,vqhig7pkipaj,13954,13955,27909
17910,,url:http://doi.wiley.com/10.1002/ace.58,13955,13956,27911
17911,,eauq2lrob5kj,13956,13957,27913
17912,,jtypdpetngsj,13957,13958,27915
17913,,a8yzegfm7huj,13958,13959,27917
17914,,xz_dqbw8pesj,13959,13960,27919
17915,,pfgacnbnbqyj,13960,13961,27921
17916,,hybvj9mxiz4j,13961,13962,27923
17917,,il_0xhdeltaj,13962,13963,27925
17918,,n_q-sjjw9syj,13963,13964,27927
17919,,ap35ax7oam4j,13964,13965,27929
17920,,h6ryru0dizuj,13965,13966,27931
17921,,rjwn_yd_wysj,13966,13967,27933
17922,,bo1tnjmm_6ej,13967,13968,27935
17923,,h7uaypkdxrqj,13968,13969,27937
17924,,yzamq6wyua4j,13969,13970,27939
17925,,z_uvj40bpgqj,13970,13971,27941
17926,,nvrvkhzrrjaj,13971,13972,27943
17927,,1gq3pnreuwwj,13972,13973,27945
17928,,4rls1je-2owj,13973,13974,27947
17929,,o7tge8lem7cj,13974,13975,27949
17930,,lgvk0wvmbwcj,13975,13976,27951
17931,,h5-qkmea4bmj,13976,13977,27953
17932,,url:http://www.springerlink.com/index/j6784072l0q60318.pdf,13977,13978,27955
17933,,z_5rylbox6mj,13978,13979,27957
17934,,chbbcusf4nij,13979,13980,27959
17935,,vuhrfi-4b3yj,13980,13981,27961
17936,,ps8tdwotyqej,13981,13982,27963
17937,,fsceaexcgkej,13982,13983,27965
17938,,ikosjlj6fwej,13983,13984,27967
17939,,qgueasu5tzej,13984,13985,27969
17940,,wjk9eqipcv8j,13985,13986,27971
17941,,9ze7u6pzzhkj,13986,13987,27973
17942,,85citpnd1rej,13987,13988,27975
17943,,yk8k5uwmncaj,13988,13989,27977
17944,,job5xfdautmj,13989,13990,27979
17945,,rgxr4sm4dguj,13990,13991,27981
17946,,u5forutsw-yj,13991,13992,27983
17947,,_darixfygqej,13992,13993,27985
17948,,url:http://doi.wiley.com/10.1002/tl.115,13993,13994,27987
17949,,csac2ltxzzcj,13994,13995,27989
17950,,url:http://portal.acm.org/ft_gateway.cfm3fid3d95706026type3dpdf26dl3dguide26dl3dacm26cfid3d1111111126cftoken3d2222222,13996,13997,27993
17951,,wogyr0eku00j,13997,13998,27995
17952,,leceqbucu2uj,13998,13999,27997
17953,,rz7sgm_d6jyj,13999,14000,27999
17954,,kk29nun3wumj,14000,14001,28001
17955,,dfck6ly3loej,14001,14002,28003
17956,,zue3vwuil5kj,14002,14003,28005
17957,,gtawpfcvciij,14003,14004,28007
17958,,2ocw_4ikf_uj,14004,14005,28009
17959,,royih4yraymj,14005,14006,28011
17960,,a4qdvdslhycj,14006,14007,28013
17961,,a1dl5g8dvckj,14007,14008,28015
17962,,lwzbzm1tbswj,14008,14009,28017
17963,,qe9v2jhlheoj,14009,14010,28019
17964,,u7y-zcfnlb8j,14010,14011,28021
17965,,w9xn1gvsyhyj,14011,14012,28023
17966,,8nf_jy5z8w0j,14012,14013,28025
17967,,rxaidsythgqj,14013,14014,28027
17968,,onafiizsgmgj,14014,14015,28029
17969,,ljmfq5ygtgmj,14015,14016,28031
17970,,url:http://portal.acm.org/citation.cfm3fid3d58237126dl3dacm26coll3dportal26cfid3d1111111126cftoken3d2222222,14016,14017,28033
17971,,uedx0wgzro0j,14017,14018,28035
17972,,g7uoafffcrwj,14018,14019,28037
17973,,raal8ocawlwj,14019,14020,28039
17974,,qkvrzozhh0uj,14020,14021,28041
17975,,q3mcup8x2e4j,14021,14022,28043
17976,,s6o4ck_gcrcj,14022,14023,28045
17977,,dxwdf3oxpvwj,14023,14024,28047
17978,,zj-fhkuorroj,14024,14025,28049
17979,,url:http://portal.acm.org/ft_gateway.cfm3fid3d108368926type3dpdf,14025,14026,28051
17980,,xhdr05pw9vmj,14026,14027,28053
17981,,g9nqi2sekfsj,14027,14028,28055
17982,,7gosxmfv_fkj,14028,14029,28057
17983,,2dr_ofaormej,14029,14030,28059
17984,,h1snyx5f7fmj,14030,14031,28061
17985,,y9_jn2ozsjoj,14031,14032,28063
17986,,url:http://www.csa.com/partners/viewrecord.php3frequester3dgs26collection3dtrd26recid3d20021212023586mt26recid3da7642829ah,14032,14033,28065
17987,,m-vhnhkeckwj,14033,14034,28067
17988,,drpfy869pjuj,14034,14035,28069
17989,,octej3d0arcj,14035,14036,28071
17990,,6pcbha2v2uqj,14036,14037,28073
17991,,svjq_9vlnyej,14037,14038,28075
17992,,wuis62lwzvoj,14038,14039,28077
17993,,i6cgxxauza0j,14039,14040,28079
17994,,oihtwn3q-m4j,14040,14041,28081
17995,,xbbz3oxxfywj,14041,14042,28083
17996,,x5ljujws4y8j,14042,14043,28085
17997,,gywp6j8hvhij,14043,14044,28087
17998,,j_qkwj4hlouj,14044,14045,28089
17999,,wq_iyekiz_oj,14045,14046,28091
18000,,vg-xjjtfd_0j,14046,14047,28093
18001,,xfi71fgyyoaj,14047,14048,28095
18002,,g3zszejjo8mj,14048,14049,28097
18003,,pxjggon6v5uj,14049,14050,28099
18004,,qivppwowawcj,14050,14051,28101
18005,,url:http://links.jstor.org/sici3fsici3d0146-4949(196124)2253a1253c39253acif2522wp253e2.0.co253b2-s,14051,14052,28103
18006,,q-6xgazpsawj,14052,14053,28105
18007,,urocza6u4h0j,14053,14054,28107
18008,,url:http://portal.acm.org/ft_gateway.cfm3fid3d108371126type3dpdf,14054,14055,28109
18009,,url:http://adsabs.harvard.edu/abs/1975phdt........19n,14055,14056,28111
18010,,ccttvb6tjrij,14056,14057,28113
18011,,drmxo2zfdb8j,14057,14058,28115
18012,,ondgmemadsgj,14058,14059,28117
18013,,pcvrc2jywwkj,14059,14060,28119
18014,,ljfcoraomoej,14060,14061,28121
18015,,52hblfj4qvej,14061,14062,28123
18016,,5enoiocrmlij,14062,14063,28125
18017,,vfo-c4n9odoj,14063,14064,28127
18018,,url:http://portal.acm.org/citation.cfm3fid3d988599,14064,14065,28129
18019,,dgly1luaaycj,14065,14066,28131
18020,,uaz7no2fgv8j,14066,14067,28133
18021,,kbwbf58iqjgj,14067,14068,28135
18022,,ego53nhhikij,14068,14069,28137
18023,,rbk2dybvzfaj,14069,14070,28139
18024,,zxylvkm6kraj,14070,14071,28141
18025,,oqcch-2kt8qj,14071,14072,28143
18026,,url:http://portal.acm.org/citation.cfm3fid3d509252.509260,14072,14073,28145
18027,,url:http://links.jstor.org/sici3fsici3d0146-4949(196324)4253a1253c31253astrb253e2.0.co253b2-y,14073,14074,28147
18028,,vcpsmmoq814j,14074,14075,28149
18029,,gdueagj68rej,14075,14076,28151
18030,,iqeficp5dx0j,14076,14077,28153
18031,,uvbrfbgnqbaj,14077,14078,28155
18032,,e52bwo5tisyj,14078,14079,28157
18033,,wcdy0lkaisej,14079,14080,28159
18034,,wdl9fmmptawj,14080,14081,28161
18035,,phfpvgebnl0j,14081,14082,28163
18036,,dzhkwjilkpij,14082,14083,28165
18037,,ussdrja4fqmj,14084,14085,28169
18038,,url:http://portal.acm.org/ft_gateway.cfm3fid3d108366326type3dpdf,14085,14086,28171
18039,,jsucj8fjby0j,14086,14087,28173
18040,,url:http://portal.acm.org/citation.cfm3fid3d264351,14087,14088,28175
18041,,kn4ganxtti0j,14088,14089,28177
18042,,url:http://portal.acm.org/citation.cfm3fid3d582215,14089,14090,28179
18043,,ha1ns36ks-4j,14090,14091,28181
18044,,syxoakhhv8qj,14091,14092,28183
18045,,q7nmrnihig4j,14092,14093,28185
18046,,bsyjunkzmkaj,14093,14094,28187
18047,,f1qbahppjvkj,14094,14095,28189
18048,,url:http://portal.acm.org/citation.cfm3fid3d964750.808394,14095,14096,28191
18049,,dxhvu84cfkaj,14096,14097,28193
18050,,kp1m0j_dzk4j,14097,14098,28195
18051,,cz4xt_zjot4j,14098,14099,28197
18052,,xieks3lb18yj,14099,14100,28199
18053,,hz9mwjkc2y4j,14100,14101,28201
18054,,978pjcghagoj,14101,14102,28203
18055,,zk3gcb7noe4j,14102,14103,28205
18056,,jb8ijhszjlkj,14103,14104,28207
18057,,dicicregwjej,14104,14105,28209
18058,,v_gbe7lwteqj,14105,14106,28211
18059,,spanet6jdigj,14106,14107,28213
18060,,2rzkwedpsymj,14107,14108,28215
18061,,twktuof00h4j,14108,14109,28217
18062,,nyjpievb2kmj,14109,14110,28219
18063,,shgjccidx7uj,14110,14111,28221
18064,,goe-2r-gwbqj,14111,14112,28223
18065,,io4vbbktxs4j,14112,14113,28225
18066,,v3yqa7i9wnkj,14113,14114,28227
18067,,enyj_2u2nduj,14114,14115,28229
18068,,o5vuyn6jo5sj,14115,14116,28231
18069,,qic-bdgs7pkj,14116,14117,28233
18070,,ajqwdmfsg_ej,14117,14118,28235
18071,,aum_nirzvoij,14118,14119,28237
18072,,-3cgirgw1tyj,14119,14120,28239
18073,,j6fgv2vq40ij,14120,14121,28241
18074,,n0tnmiara3mj,14121,14122,28243
18075,,vzh-aqkztgmj,14122,14123,28245
18076,,towmbg-3bs8j,14123,14124,28247
18077,,fbqhuoa9sauj,14124,14125,28249
18078,,ilk6x2bs_byj,14125,14126,28251
18079,,aoh2xh0tksej,14126,14127,28253
18080,,kpg6qfrlitej,14127,14128,28255
18081,,5l2xueveqhqj,14128,14129,28257
18082,,jix9mf-5dpoj,14129,14130,28259
18083,,a2o47zg-essj,14130,14131,28261
18084,,swvav7ytcv4j,14131,14132,28263
18085,,at3bv_azjnwj,14132,14133,28265
18086,,ntva-nejv2oj,14133,14134,28267
18087,,fedkgg3sffqj,14134,14135,28269
18088,,ulvuraleyj4j,14135,14136,28271
18089,,oyt48x4xqxcj,14136,14137,28273
18090,,flstue3aukwj,14137,14138,28275
18091,,chw2cxarqewj,14138,14139,28277
18092,,b8-mupd-zyij,14139,14140,28279
18093,,5ctas6mug94j,14141,14142,28283
18094,,url:http://portal.acm.org/citation.cfm3fid3d192593.19744226dl3dguide26dl3dacm26type3dseries26idx3d19259326part3dproceedings26wanttype3dproceedings26title3dinternational2520multimedia2520conference26cfid3d1111111126cftoken3d2222222,14142,14143,28285
18095,,vrrxawgvxeij,14143,14144,28287
18096,,url:http://doi.wiley.com/10.1002/he.13.abs,14144,14145,28289
18097,,url:http://portal.acm.org/ft_gateway.cfm3fid3d110196526type3dpdf,14145,14146,28291
18098,,ufr5qoszcjcj,14146,14147,28293
18099,,zva0ofds2qaj,14147,14148,28295
18100,,jx-7oapd3b4j,14148,14149,28297
18101,,y41epesw6zyj,14149,14150,28299
18102,,w1tvsxw2il8j,14150,14151,28301
18103,,jzbxspvhebuj,14151,14152,28303
18104,,jbv3twnylwgj,14152,14153,28305
18105,,c5b2rce5aagj,14153,14154,28307
18106,,ziy_zalobosj,14154,14155,28309
18107,,s8hvfg_mtykj,14155,14156,28311
18108,,dadckqgvmhcj,14156,14157,28313
18109,,ufmlhdixsluj,14157,14158,28315
18110,,5csiyd3bt1ij,14158,14159,28317
18111,,lr-ylmymluyj,14159,14160,28319
18112,,0p7-i8ygzkyj,14160,14161,28321
18113,,qznnhqmmtzqj,14161,14162,28323
18114,,nupoq9rxgbsj,14162,14163,28325
18115,,h4jvh0mzp3gj,14163,14164,28327
18116,,8xok2ve4hfcj,14164,14165,28329
18117,,k2uh4r8lqqmj,14165,14166,28331
18118,,,14166,14167,28333
18119,,3jruvo_mvaej,14167,14168,28335
18120,,url:http://www.csa.com/partners/viewrecord.php3frequester3dgs26collection3dtrd26recid3d200111010699mt26recid3da0032624ah,14168,14169,28337
18121,,17abu2elmfkj,14170,14171,28341
18122,,91llkmei25gj,14171,14172,28343
18123,,pdppr-b06usj,14172,14173,28345
18124,,l3v0u9ewe4ij,14173,14174,28347
18125,,ntgeb3w0ks4j,14174,14175,28349
18126,,v6knpmkdyagj,14175,14176,28351
18127,,gm0jbyfex_mj,14176,14177,28353
18128,,eycqdnlm4vaj,14177,14178,28355
18129,,xbkph0tqpbwj,14178,14179,28357
18130,,yyd8qamzghsj,14179,14180,28359
18131,,xop8oid0zz8j,14180,14181,28361
18132,,sxf2sy38bc0j,14181,14182,28363
18133,,gvmpwmrttyaj,14182,14183,28365
18134,,wbxdoankf14j,14183,14184,28367
18135,,_ssd1imbrb4j,14184,14185,28369
18136,,nwalt8gmd80j,14185,14186,28371
18137,,4sizpxwcgsmj,14186,14187,28373
18138,,b6ykgy1d_qyj,14187,14188,28375
18139,,5og2qbzitg0j,14188,14189,28377
18140,,ecf5iejpgi4j,14189,14190,28379
18141,,fsyxnpkv7-wj,14190,14191,28381
18142,,qe3zcxe4dhqj,14191,14192,28383
18143,,nrxjtr1hyvoj,14192,14193,28385
18144,,8y3tkfd642ej,14193,14194,28387
18145,,4hnhfglctzmj,14194,14195,28389
18146,,wkdih9-e2wmj,14195,14196,28391
18147,,q4b96tcajcyj,14196,14197,28393
18148,,n0z0odyhhvsj,14199,14200,28399
18149,,mg4dmwwkxocj,14200,14201,28401
18150,,tgvnkdul5_wj,14201,14202,28403
18151,,itzpzdnoplkj,14202,14203,28405
18152,,eoc3ileqxfoj,14203,14204,28407
18153,,url:http://www.csa.com/partners/viewrecord.php3frequester3dgs26collection3dtrd26recid3d0014641ci,14204,14205,28409
18154,,ot1y8xmq1xuj,14205,14206,28411
18155,,,14206,14207,28413
18156,,8lw-vwbrvxaj,14207,14208,28415
18157,,oedvpuuskeqj,14208,14209,28417
18158,,6_o1bswykcuj,14209,14210,28419
18159,,url:http://www.csa.com/partners/viewrecord.php3frequester3dgs26collection3dtrd26recid3d20021211018627mt26recid3da8012617ah,14210,14211,28421
18160,,byak0yd64syj,14211,14212,28423
18161,,snhtguhh-fcj,14212,14213,28425
18162,,bn0dda6mmjqj,14213,14214,28427
18163,,url:http://pubs.acs.org/cgi-bin/abstract.cgi/achre4/2002/35/i08/abs/ar000198s.html,14214,14215,28429
18164,,itpfmogz-_0j,14215,14216,28431
18165,,ycfvzvqszp8j,14216,14217,28433
18166,,1ivh1i9jl9qj,14217,14218,28435
18167,,ccnmvu-obvkj,14218,14219,28437
18168,,t8v6sq1r3zoj,14219,14220,28439
18169,,9fdknxey13kj,14220,14221,28441
18170,,url:http://www.csa.com/partners/viewrecord.php3frequester3dgs26collection3dtrd26recid3d0879937ci,14221,14222,28443
18171,,zqgxjomzrvgj,14222,14223,28445
18172,,copmkwoqlyqj,14223,14224,28447
18173,,akubanrfxfej,14224,14225,28449
18174,,url:http://www.springerlink.com/index/q8m22l4714566207.pdf,14225,14226,28451
18175,,apuen5br8myj,14226,14227,28453
18176,,url:http://pubs.acs.org/cgi-bin/abstract.cgi/achre4/2005/38/i12/abs/ar0501471.html,14227,14228,28455
18177,,url:http://www.sciencemag.org/cgi/reprint/289/5483/1330.pdf,14228,14229,28457
18178,,hgkaptfabewj,14229,14230,28459
18179,,0in8deotfhkj,14230,14231,28461
18180,,x6orarjnhzkj,14231,14232,28463
18181,,uzzvzmmyrbyj,14232,14233,28465
18182,,zx5ickr6n9gj,14233,14234,28467
18183,,inbejypiehqj,14234,14235,28469
18184,,o6xnnazwbayj,14235,14236,28471
18185,,nju_j9kz8soj,14236,14237,28473
18186,,w1zuh3s5qhoj,14237,14238,28475
18187,,fhahbfkonxsj,14238,14239,28477
18188,,qf4zkqxa1uej,14239,14240,28479
18189,,8jszkknozl8j,14240,14241,28481
18190,,url:http://adsabs.harvard.edu/abs/1976scom.nasa..588o,14241,14242,28483
18191,,hn35lxlkvp8j,14242,14243,28485
18192,,08d5th2jiqcj,14243,14244,28487
18193,,p8w7eozxefwj,14244,14245,28489
18194,,k3k7dcj-6j0j,14245,14246,28491
18195,,qxisg80i4pcj,14246,14247,28493
18196,,nmfvf1nw30mj,14247,14248,28495
18197,,b9cwpd9wfcyj,14248,14249,28497
18198,,jsatxghimr0j,14249,14250,28499
18199,,dhjf-a80ic8j,14250,14251,28501
18200,,waho8deznn8j,14251,14252,28503
18201,,i7xgb6y1o8wj,14252,14253,28505
18202,,bdnk6kink7wj,14253,14254,28507
18203,,s0l7l9knbfuj,14254,14255,28509
18204,,c0jdvv-cqqwj,14255,14256,28511
18205,,1nsqrdy3lygj,14256,14257,28513
18206,,tb_iq4h_ihgj,14257,14258,28515
18207,,pnkldmul35kj,14258,14259,28517
18208,,rpu7p_xulcaj,14259,14260,28519
18209,,_cjb1ebzg7aj,14260,14261,28521
18210,,huxza9zsogcj,14261,14262,28523
18211,,uv32ks87lp0j,14262,14263,28525
18212,,wsr1f6mdiqoj,14263,14264,28527
18213,,4vqd4mme0p8j,14264,14265,28529
18214,,f8vhyqhssdyj,14265,14266,28531
18215,,welxlccdkc0j,14266,14267,28533
18216,,k2juz3ggjukj,14267,14268,28535
18217,,arzxzqozbdej,14268,14269,28537
18218,,p_ywf1jfkaaj,14269,14270,28539
18219,,o_lej2ikfyuj,14270,14271,28541
18220,,5r-jionqqyaj,14271,14272,28543
18221,,xip6rifvyysj,14272,14273,28545
18222,,vrlntuvexe4j,14273,14274,28547
18223,,zbodaemfycsj,14274,14275,28549
18224,,bbpqtvir1eej,14275,14276,28551
18225,,x4jniksglhej,14276,14277,28553
18226,,iidnwfrlcygj,14277,14278,28555
18227,,ev06qi0aqxkj,14278,14279,28557
18228,,wltobfgnz_ej,14279,14280,28559
18229,,54u-ynp5ytgj,14280,14281,28561
18230,,58adnhchqp0j,14281,14282,28563
18231,,wbfb2di6cqmj,14282,14283,28565
18232,,1ylexvfpij0j,14283,14284,28567
18233,,bv6s1lok4xwj,14284,14285,28569
18234,,ujwukmjymyyj,14285,14286,28571
18235,,url:http://www.csa.com/partners/viewrecord.php3frequester3dgs26collection3dtrd26recid3d1030382ci,14286,14287,28573
18236,,alapcyob8taj,14287,14288,28575
18237,,5ksbtshp4myj,14288,14289,28577
18238,,xiukyn0u62sj,14290,14291,28581
18239,,738ip9nht2gj,14291,14292,28583
18240,,xu9hkytpdm8j,14292,14293,28585
18241,,7s1u_epd-yuj,14293,14294,28587
18242,,rvyxwkdxy80j,14294,14295,28589
18243,,g9zecvszzqkj,14295,14296,28591
18244,,hltguqxqdw8j,14296,14297,28593
18245,,9730zewrvmwj,14297,14298,28595
18246,,a2nj3olm3pgj,14298,14299,28597
18247,,jtfaksl7qquj,14299,14300,28599
18248,,pryjrhegi2sj,14300,14301,28601
18249,,5dk1oge08smj,14301,14302,28603
18250,,vctj4-x12jmj,14302,14303,28605
18251,,brlcx3sm1lej,14303,14304,28607
18252,,jkyutlhuixej,14304,14305,28609
18253,,iidmbv3fcjaj,14305,14306,28611
18254,,yqvvtuffhdoj,14306,14307,28613
18255,,og9mp1zdtf8j,14307,14308,28615
18256,,ghle6bvsth4j,14308,14309,28617
18257,,6alluxc-dbgj,14309,14310,28619
18258,,rdywwyhulj0j,14311,14312,28623
18259,,ofby1lkehrwj,14312,14313,28625
18260,,xqkajcwm2ycj,14313,14314,28627
18261,,url:http://www.springerlink.com/index/pt6552pw010q0547.pdf,14314,14315,28629
18262,,acnql27wlhgj,14315,14316,28631
18263,,lki9bd5slkaj,14316,14317,28633
18264,,aynqssic52oj,14317,14318,28635
18265,,4mnj5wfnyzwj,14318,14319,28637
18266,,yilg3psvqtgj,14320,14321,28641
18267,,_55rq6rc80sj,14321,14322,28643
18268,,bnq3szgvrw4j,14322,14323,28645
18269,,hu1ujdnzcwqj,14323,14324,28647
18270,,5ctujo6ezuwj,14324,14325,28649
18271,,pt8hnh8grywj,14325,14326,28651
18272,,sj6j97ckenaj,14326,14327,28653
18273,,1hkvjoug8huj,14327,14328,28655
18274,,on8s9vgezhmj,14328,14329,28657
18275,,lk740c_a9voj,14329,14330,28659
18276,,zoyj9b-junsj,14330,14331,28661
18277,,z1yr8jzv7ykj,14331,14332,28663
18278,,zbirtip-tcuj,14332,14333,28665
18279,,qmpcvptex-qj,14333,14334,28667
18280,,jt1ah-msslij,14334,14335,28669
18281,,c1tjt03cusuj,14335,14336,28671
18282,,thew8obz2usj,14336,14337,28673
18283,,7wpwe6a7ljuj,14337,14338,28675
18284,,xpdyvh45p1qj,14338,14339,28677
18285,,rwakeec84aoj,14339,14340,28679
18286,,agb-ysozbwuj,14340,14341,28681
18287,,ax0bnlahbiij,14341,14342,28683
18288,,imaro7i67v8j,14342,14343,28685
18289,,so3ftunhm-uj,14345,14346,28691
18290,,6eej3jug5kyj,14346,14347,28693
18291,,,14347,14348,28695
18292,,dkk3tb3xbcaj,14348,14349,28697
18293,,f0uq5n3j2syj,14349,14350,28699
18294,,2ptkgy_vmo8j,14351,14352,28703
18295,,14xngqag2nqj,14352,14353,28705
18296,,fch3wrsw3ocj,14353,14354,28707
18297,,ccphmzaxrnsj,14354,14355,28709
18298,,bqr37pufjbuj,14355,14356,28711
18299,,ezockm9ry9sj,14356,14357,28713
18300,,joznjkmhdhwj,14357,14358,28715
18301,,url:http://www.csa.com/partners/viewrecord.php3frequester3dgs26collection3denv26recid3d7901464,14358,14359,28717
18302,,cqf8jhcokkuj,14360,14361,28721
18303,,goan1fi4o_oj,14361,14362,28723
18304,,y6bmuceldr8j,14362,14363,28725
18305,,ogguoia1zvcj,14363,14364,28727
18306,,02mwibvisvwj,14364,14365,28729
18307,,s1vs49stgmsj,14365,14366,28731
18308,,4kjmmyhvqyyj,14366,14367,28733
18309,,xpjwcid9_z8j,14367,14368,28735
18310,,url:http://portal.acm.org/citation.cfm3fid3d171926.172028,14368,14369,28737
18311,,xregd1gmcswj,14369,14370,28739
18312,,url:http://www.csa.com/partners/viewrecord.php3frequester3dgs26collection3dtrd26recid3d200111010713mt26recid3da0032649ah,14370,14371,28741
18313,,sulww3l8czij,14371,14372,28743
18314,,pq-plnpjsz4j,14372,14373,28745
18315,,7sabsvtfjj8j,14374,14375,28749
18316,,4rjjdfvmmgyj,14375,14376,28751
18317,,_j4tjels4hej,14376,14377,28753
18318,,lsnp5gda0v4j,14377,14378,28755
18319,,cogccuvum1mj,14378,14379,28757
18320,,jbujojnu7xqj,14379,14380,28759
18321,,m8emcxhuudwj,14380,14381,28761
18322,,a8xz3qt3xv0j,14381,14382,28763
18323,,0zmlbkqx6uoj,14382,14383,28765
18324,,url:http://portal.acm.org/citation.cfm3fid3d984523.98452526coll3dguide26dl3dacm26idx3dj68926part3dperiodical26wanttype3dperiodical26title3dacm2520sigmod2520record26cfid3d1111111126cftoken3d2222222,14383,14384,28767
18325,,3xroiuses1sj,14384,14385,28769
18326,,m3ihd9kb-eej,14385,14386,28771
18327,,url:http://portal.acm.org/citation.cfm3fid3d354384.37642326dl3dguide26dl3dacm26type3dseries26idx3d35438426part3dproceedings26wanttype3dproceedings26title3dinternational2520multimedia2520conference26cfid3d1111111126cftoken3d2222222,14386,14387,28773
18328,,06ezkxr6w3cj,14387,14388,28775
18329,,ypmxoswthqkj,14388,14389,28777
18330,,kgb5faqea10j,14389,14390,28779
18331,,fg5gb10cbloj,14390,14391,28781
18332,,url:http://ieeexplore.ieee.org/iel5/69/28407/01269663.pdf3farnumber3d1269663,14391,14392,28783
18333,,olczy5kejjuj,14392,14393,28785
18334,,8bcjgfyg1myj,14393,14394,28787
18335,,hlkalobg_c0j,14394,14395,28789
18336,,url:http://www.csa.com/partners/viewrecord.php3frequester3dgs26collection3dtrd26recid3d0011884ci,14396,14397,28793
18337,,o9hs6-tywagj,14397,14398,28795
18338,,2amqip9edckj,14398,14399,28797
18339,,olfhud1iituj,14399,14400,28799
18340,,rfgxqouqc7cj,14400,14401,28801
18341,,wm39qrqbomoj,14401,14402,28803
18342,,pprbnq5h5omj,14402,14403,28805
18343,,qmd1e34q5naj,14403,14404,28807
18344,,dhgu4yc8abyj,14404,14405,28809
18345,,3s20zatmlzqj,14405,14406,28811
18346,,url:http://portal.acm.org/ft_gateway.cfm3fid3d110128526type3dpdf,14406,14407,28813
18347,,uspklcuc69uj,14407,14408,28815
18348,,url:http://portal.acm.org/citation.cfm3fid3d113421,14408,14409,28817
18349,,mqi2gyh2h1cj,14409,14410,28819
18350,,f79zjl2ctduj,14410,14411,28821
18351,,jo3c00b-lxej,14411,14412,28823
18352,,rkzox3rc7fuj,14412,14413,28825
18353,,y6t0tnrttyqj,14413,14414,28827
18354,,wp2dwwha8vij,14414,14415,28829
18355,,ektvkpuhfvyj,14415,14416,28831
18356,,nctct3maajqj,14416,14417,28833
18357,,rexbrhp5hs0j,14417,14418,28835
18358,,grihymetqoij,14418,14419,28837
18359,,vfgubn8gl-mj,14419,14420,28839
18360,,w9d_byr2gqmj,14420,14421,28841
18361,,ocnozq6hmpej,14421,14422,28843
18362,,i8qfytx4fhoj,14422,14423,28845
18363,,iktnscpxqfqj,14423,14424,28847
18364,,hy2kiupq1zaj,14424,14425,28849
18365,,url:http://portal.acm.org/ft_gateway.cfm3fid3d107332826type3dpdf,14425,14426,28851
18366,,ilclwlwpnluj,14426,14427,28853
18367,,yldjke2qy7ij,14427,14428,28855
18368,,isvffsqjviwj,14428,14429,28857
18369,,zsjpzgv3_dgj,14429,14430,28859
18370,,gtdlhqmiizej,14430,14431,28861
18371,,y9h8j6a7epyj,14431,14432,28863
18372,,4ercpvt_gd0j,14432,14433,28865
18373,,idbosi5mgjuj,14433,14434,28867
18374,,wsvs3ncre8ej,14434,14435,28869
18375,,dmechtnnglkj,14437,14438,28875
18376,,,14438,14439,28877
18377,,gqofvcwo9ocj,14439,14440,28879
18378,,-59hqudndkcj,14440,14441,28881
18379,,xleycxn38cgj,14441,14442,28883
18380,,0oeagmvzgvaj,14442,14443,28885
18381,,dt0ls9kgkjyj,14443,14444,28887
18382,,jbnmnlyxo0yj,14444,14445,28889
18383,,hklcu0stzg8j,14445,14446,28891
18384,,vsbe87tx3qoj,14446,14447,28893
18385,,xyg-rhxq_z0j,14447,14448,28895
18386,,9j8c9tznayej,14448,14449,28897
18387,,cg-2oxp9m_oj,14449,14450,28899
18388,,gs-qh5-ma7sj,14450,14451,28901
18389,,iww77mep_kwj,14451,14452,28903
18390,,dn8kpor5opyj,14452,14453,28905
18391,,ggscuwyrbfmj,14453,14454,28907
18392,,khprci6gnnwj,14454,14455,28909
18393,,28qr854lvvuj,14455,14456,28911
18394,,bvwurhgl4moj,14456,14457,28913
18395,,rve9aew7m1ej,14457,14458,28915
18396,,c90vxk4yc70j,14458,14459,28917
18397,,nqg3amfrbqmj,14459,14460,28919
18398,,ldit6-lpmeaj,14460,14461,28921
18399,,r-hdsf-qxogj,14461,14462,28923
18400,,0j3uxi4zh6wj,14462,14463,28925
18401,,g3spvc1kkdaj,14463,14464,28927
18402,,nooiwlf1bowj,14464,14465,28929
18403,,h83ojvp_g2yj,14465,14466,28931
18404,,jrrfddzgd3cj,14466,14467,28933
18405,,jlpo6eoqxv0j,14467,14468,28935
18406,,opjrdqo2lgqj,14468,14469,28937
18407,,ru2bjood-u4j,14469,14470,28939
18408,,3i6z9a3qhdqj,14470,14471,28941
18409,,xihrjzpcplmj,14471,14472,28943
18410,,url:http://doi.wiley.com/10.1002/he.88,14472,14473,28945
18411,,d-ovsaxjxzgj,14473,14474,28947
18412,,i52exbkaqdaj,14474,14475,28949
18413,,gqoahcjbkhgj,14475,14476,28951
18414,,dtpuvpj-lqij,14476,14477,28953
18415,,url:http://www.blackwell-synergy.com/links/doi/10.1111/j.0033-0124.1990.00232.x/abs/,14477,14478,28955
18416,,xndkopgcksmj,14478,14479,28957
18417,,twj_d9octr4j,14480,14481,28961
18418,,ohbfmgygaquj,14481,14482,28963
18419,,url:http://links.jstor.org/sici3fsici3d0146-4949(196523)6253a3253c354253ap1253e2.0.co253b2-w,14482,14483,28965
18420,,atrievo_-g0j,14483,14484,28967
18421,,cjngybtr5h8j,14484,14485,28969
18422,,dnixhrysjysj,14485,14486,28971
18423,,gxsmsipnmn4j,14486,14487,28973
18424,,eus2lk8ksrkj,14487,14488,28975
18425,,xsathom0f3aj,14488,14489,28977
18426,,_s_j-wlnvkgj,14489,14490,28979
18427,,2cygwj1gqjyj,14490,14491,28981
18428,,cjaga3dta2qj,14491,14492,28983
18429,,5fzoj1s2rxmj,14492,14493,28985
18430,,zjvb_b8ghfwj,14493,14494,28987
18431,,avov62srqwwj,14494,14495,28989
18432,,65zkdqadxkcj,14495,14496,28991
18433,,t6iwqffigy0j,14496,14497,28993
18434,,0087thkugmuj,14497,14498,28995
18435,,4aw8dq9qrmcj,14498,14499,28997
18436,,url:http://links.jstor.org/sici3fsici3d0146-4949(196524252f21)6253a1253c106253ateodar253e2.0.co253b2-q,14499,14500,28999
18437,,qhabls8xz8oj,14500,14501,29001
18438,,zwwe8l0cq2oj,14501,14502,29003
18439,,gdqh516zrv8j,14502,14503,29005
18440,,9nelmakjqsej,14503,14504,29007
18441,,xzuaboxlxoyj,14504,14505,29009
18442,,spcuocrgd58j,14505,14506,29011
18443,,facu_ixr0fij,14506,14507,29013
18444,,ztf5z0v_nh0j,14507,14508,29015
18445,,tpb-lwpzjnmj,14508,14509,29017
18446,,t8emde_qnnwj,14509,14510,29019
18447,,i-q_1jdyezej,14510,14511,29021
18448,,url:http://www.csa.com/partners/viewrecord.php3frequester3dgs26collection3dtrd26recid3d0859189ci,14511,14512,29023
18449,,qywbkxt00wej,14512,14513,29025
18450,,edlc7xewincj,14513,14514,29027
18451,,y_rys1_kuc8j,14515,14516,29031
18452,,px5goxfjptuj,14516,14517,29033
18453,,hxium-hi8tgj,14517,14518,29035
18454,,2m-6z98dt8ij,14518,14519,29037
18455,,piyjuj_zblmj,14519,14520,29039
18456,,cjcrbtqf0yej,14520,14521,29041
18457,,,14521,14522,29043
18458,,oza5vkhagfqj,14522,14523,29045
18459,,po_hkdsdtjuj,14523,14524,29047
18460,,url:http://adsabs.harvard.edu/abs/1980phdt........64d,14524,14525,29049
18461,,lfkyxj2uj1ij,14525,14526,29051
18462,,qdvmrzpqj4oj,14526,14527,29053
18463,,k2ary2jqtbgj,14527,14528,29055
18464,,cw2-tlunggwj,14528,14529,29057
18465,,do2mappeaucj,14529,14530,29059
18466,,iogmlv2ur5qj,14530,14531,29061
18467,,zartmgymwhmj,14531,14532,29063
18468,,dgdmypknencj,14532,14533,29065
18469,,i1pevzh7zhwj,14533,14534,29067
18470,,ks4wxa8dhnij,14534,14535,29069
18471,,ocjxwjwjm-cj,14535,14536,29071
18472,,5c8victjai4j,14536,14537,29073
18473,,uf-ryjst87cj,14537,14538,29075
18474,,sscfiweec3kj,14538,14539,29077
18475,,y6ylyep8quej,14539,14540,29079
18476,,ngddtdovhhuj,14540,14541,29081
18477,,olbwgdaw5mqj,14541,14542,29083
18478,,url:http://www.ncbi.nlm.nih.gov/entrez/query.fcgi3fcmd3dretrieve26db3dpubmed26list_uids3d74842426dopt3dcitation,14542,14543,29085
18479,,1uyhbz7kyf0j,14543,14544,29087
18480,,l1qjuy-f_rwj,14544,14545,29089
18481,,g_vktsc4eaaj,14545,14546,29091
18482,,hatni2lnnpgj,14546,14547,29093
18483,,mswclmcveo4j,14547,14548,29095
18484,,w6ltrlxvegqj,14548,14549,29097
18485,,sdfxs63dyjsj,14549,14550,29099
18486,,i56eefh1hyej,14550,14551,29101
18487,,sbzspas5jaej,14551,14552,29103
18488,,kzshvzxappoj,14552,14553,29105
18489,,a794r1ms-mmj,14553,14554,29107
18490,,flb1reoc5eij,14554,14555,29109
18491,,lus7m096ccsj,14555,14556,29111
18492,,xzmfl7-b1ayj,14556,14557,29113
18493,,ipwcym-3ssmj,14557,14558,29115
18494,,ywai93xt5kij,14558,14559,29117
18495,,s9wculyjyiaj,14559,14560,29119
18496,,,14560,14561,29121
18497,,_jivsd0uewkj,14561,14562,29123
18498,,zjcvo7idoswj,14562,14563,29125
18499,,gaqqeb3jjxuj,14563,14564,29127
18500,,url:http://ieeexplore.ieee.org/iel2/233/1806/00048042.pdf3farnumber3d48042,14564,14565,29129
18501,,u2ku4g5e3iwj,14565,14566,29131
18502,,vsmy-xvyanmj,14566,14567,29133
18503,,t2c2rcwpgjqj,14567,14568,29135
18504,,cunbkue8ah4j,14568,14569,29137
18505,,url:http://portal.acm.org/ft_gateway.cfm3fid3d110197126type3dpdf,14569,14570,29139
18506,,kjzlkqh8nlqj,14570,14571,29141
18507,,zammibn34lsj,14571,14572,29143
18508,,a0oixaqs2cyj,14572,14573,29145
18509,,11rlss5peiej,14573,14574,29147
18510,,g2qui5qyymoj,14574,14575,29149
18511,,njpykr_zzpgj,14575,14576,29151
18512,,mskrsdgs08sj,14576,14577,29153
18513,,56wugl2uvksj,14577,14578,29155
18514,,url:http://www.ncbi.nlm.nih.gov/entrez/query.fcgi3fcmd3dretrieve26db3dpubmed26list_uids3d74842226dopt3dcitation,14578,14579,29157
18515,,m8lm82gwhnwj,14579,14580,29159
18516,,4wutpq8vhjyj,14580,14581,29161
18517,,url:http://www.csa.com/partners/viewrecord.php3frequester3dgs26collection3dtrd26recid3dn9210475ah,14581,14582,29163
18518,,b_cufw2syz4j,14582,14583,29165
18519,,a2f8fvoghzkj,14583,14584,29167
18520,,url:http://portal.acm.org/ft_gateway.cfm3fid3d94572726type3dpdf26dl3dguide26dl3dacm26cfid3d1111111126cftoken3d2222222,14584,14585,29169
18521,,81l35gk4oiuj,14585,14586,29171
18522,,3lx2r4jfvewj,14586,14587,29173
18523,,nm-gl2c4xzgj,14587,14588,29175
18524,,url:http://www.geography.org.uk/journals/journals.asp3farticleid3d49,14588,14589,29177
18525,,ngva3k7xheej,14589,14590,29179
18526,,vijsss-igaij,14590,14591,29181
18527,,2szgjizpyqkj,14591,14592,29183
18528,,gnjg33_saioj,14592,14593,29185
18529,,cdiawch4bwwj,14593,14594,29187
18530,,u1leqc0saaij,14594,14595,29189
18531,,c80yq-cjuc4j,14595,14596,29191
18532,,hxsjnxqqdhkj,14596,14597,29193
18533,,kypgoofdpnmj,14597,14598,29195
18534,,btolpr6nzoij,14598,14599,29197
18535,,dllqnixfxqkj,14599,14600,29199
18536,,_x2mrcwhitmj,14600,14601,29201
18537,,yq7xwrmyi5cj,14601,14602,29203
18538,,cwqullh9qiyj,14602,14603,29205
18539,,url:http://www.csa.com/partners/viewrecord.php3frequester3dgs26collection3dtrd26recid3dn9210444ah,14603,14604,29207
18540,,avoynwy188qj,14604,14605,29209
18541,,8mogtqadb3gj,14605,14606,29211
18542,,1fvznhtlhcqj,14606,14607,29213
18543,,zf-wnlywdhoj,14607,14608,29215
18544,,prftyhjm7qwj,14608,14609,29217
18545,,url:http://portal.acm.org/ft_gateway.cfm3fid3d108623326type3dpdf,14609,14610,29219
18546,,q4mkktmhqg8j,14610,14611,29221
18547,,pg-vbrbme1cj,14611,14612,29223
18548,,314hzl0qopyj,14612,14613,29225
18549,,0deq9ytk3osj,14613,14614,29227
18550,,ylntndnr65cj,14614,14615,29229
18551,,ysz1ryup7fkj,14615,14616,29231
18552,,x2h2qhnx5gqj,14616,14617,29233
18553,,3kdpeim6y6oj,14617,14618,29235
18554,,tcrt3ls83u0j,14618,14619,29237
18555,,j_xwh5z3aj8j,14619,14620,29239
18556,,s7nvaeccruaj,14620,14621,29241
18557,,3de8un2q4nyj,14621,14622,29243
18558,,lpmdtqgxmfsj,14622,14623,29245
18559,,url:http://adsabs.harvard.edu/abs/1995stin...9671096l,14623,14624,29247
18560,,bcvqcey9rhwj,14624,14625,29249
18561,,egkzoufcbhyj,14625,14626,29251
18562,,c8ust9hymqaj,14626,14627,29253
18563,,649mydvkejkj,14627,14628,29255
18564,,hh-hc489ghuj,14628,14629,29257
18565,,emmfc2_svrkj,14629,14630,29259
18566,,xw--ei3c_qwj,14630,14631,29261
18567,,7pjrigyyts4j,14631,14632,29263
18568,,itloxi3unggj,14632,14633,29265
18569,,2jo_bzywdpyj,14633,14634,29267
18570,,3bq2tdhhmuyj,14634,14635,29269
18571,,jagng-r3fuaj,14635,14636,29271
18572,,rdyy7chg5a8j,14636,14637,29273
18573,,qmuzlbudrrgj,14637,14638,29275
18574,,p9xx0udxnrcj,14638,14639,29277
18575,,fipqmq2jalmj,14639,14640,29279
18576,,a5k1n3-4qxkj,14640,14641,29281
18577,,e5d8dblyxbuj,14641,14642,29283
18578,,ypcpl203k0gj,14642,14643,29285
18579,,e5lhigibf_8j,14643,14644,29287
18580,,qblx-vp9mwij,14644,14645,29289
18581,,cysgup_cdukj,14645,14646,29291
18582,,c6uqdoxnvomj,14646,14647,29293
18583,,o4s_svvx7wij,14647,14648,29295
18584,,m4apobthx2gj,14648,14649,29297
18585,,url:http://links.jstor.org/sici3fsici3d0146-4949(196321252f22)4253a2253c209253ambamja253e2.0.co253b2-8,14649,14650,29299
18586,,v68a3jenn-wj,14650,14651,29301
18587,,miqrlbdpgowj,14651,14652,29303
18588,,gwlb4evwxw4j,14652,14653,29305
18589,,udoeygnunumj,14653,14654,29307
18590,,3cpzgu3n0bgj,14654,14655,29309
18591,,qsxnubrv-huj,14655,14656,29311
18592,,3hghdgfmwjcj,14656,14657,29313
18593,,r33imkg-0uij,14657,14658,29315
18594,,nf4olbccbgoj,14658,14659,29317
18595,,a3m7oppmjmmj,14659,14660,29319
18596,,wuin55yaf1mj,14660,14661,29321
18597,,zgfbf36-6omj,14661,14662,29323
18598,,_buph4g8l90j,14662,14663,29325
18599,,gelfwmlbhmgj,14663,14664,29327
18600,,px6aze9okukj,14664,14665,29329
18601,,3q-9o4npsksj,14665,14666,29331
18602,,zke78tzedpuj,14666,14667,29333
18603,,lemhswrv0wqj,14667,14668,29335
18604,,url:http://portal.acm.org/ft_gateway.cfm3fid3d1685726type3dpdf26dl3dguide26dl3dacm26cfid3d1111111126cftoken3d2222222,14668,14669,29337
18605,,05tbrzhmhhij,14669,14670,29339
18606,,f9t7kknuiucj,14670,14671,29341
18607,,oqykx1gdbfwj,14671,14672,29343
18608,,j-_yafmpdyej,14672,14673,29345
18609,,o6bta6acsj8j,14673,14674,29347
18610,,0geufkcu81sj,14674,14675,29349
18611,,hithmc9u_hkj,14675,14676,29351
18612,,9dk0c0xer_yj,14676,14677,29353
18613,,nr73owaqqtaj,14677,14678,29355
18614,,74aa4fj2t7cj,14678,14679,29357
18615,,9mgarekzmhij,14679,14680,29359
18616,,v_ed7bie6lcj,14680,14681,29361
18617,,k9quu_le0x0j,14681,14682,29363
18618,,0envuuqqofej,14682,14683,29365
18619,,ahsqw8s81lcj,14683,14684,29367
18620,,5h3rrznk4syj,14684,14685,29369
18621,,_-jws-vtgikj,14685,14686,29371
18622,,luh5k5ot-wqj,14686,14687,29373
18623,,6bbepbswgikj,14687,14688,29375
18624,,n_vpzv6piekj,14688,14689,29377
18625,,ej4qe2ozze8j,14689,14690,29379
18626,,jsyhaf3s1fij,14690,14691,29381
18627,,2etq6osnnv8j,14691,14692,29383
18628,,d5fqaxoeyvaj,14692,14693,29385
18629,,9ixpg7291q8j,14693,14694,29387
18630,,rp7nfehnfbwj,14694,14695,29389
18631,,2i18qvfa9buj,14695,14696,29391
18632,,url:http://www.ingentaconnect.com/search/expand3fpub3dinfobike://els/08830355/2001/00000035/00000002/art0001926unc3d,14696,14697,29393
18633,,sgbj-oi_gm4j,14697,14698,29395
18634,,adjspgrs10ij,14698,14699,29397
18635,,fopqvctv7tgj,14699,14700,29399
18636,,dr2h1rdf18sj,14700,14701,29401
18637,,5a9skr8u_20j,14701,14702,29403
18638,,c--3ma4_6zij,14702,14703,29405
18639,,gybbfanhhm8j,14703,14704,29407
18640,,6l4bz7tsegsj,14704,14705,29409
18641,,swy0np4l4tkj,14705,14706,29411
18642,,m7axocee8q0j,14706,14707,29413
18643,,pbvieuwzlc4j,14707,14708,29415
18644,,qgrcza0bq4qj,14708,14709,29417
18645,,mjgo7ahspssj,14709,14710,29419
18646,,azxoy6fxapyj,14710,14711,29421
18647,,vzreorzvcyej,14711,14712,29423
18648,,_pdepjjmadcj,14712,14713,29425
18649,,keuycaocu7aj,14713,14714,29427
18650,,ubuioat8m9mj,14714,14715,29429
18651,,uqvqfjengsuj,14715,14716,29431
18652,,lctwtz1v_kqj,14716,14717,29433
18653,,vuguewkqzvoj,14717,14718,29435
18654,,g3xlpfuo_kqj,14718,14719,29437
18655,,mafkymlpn8yj,14719,14720,29439
18656,,5u1wr_rw-g4j,14720,14721,29441
18657,,url:http://www.extenza-eps.com/woi/doi/abs/10.5555/bitp.2005.1.timor-leste.369,14721,14722,29443
18658,,ue8a9c1geiaj,14722,14723,29445
18659,,_ur0rv3ckb8j,14723,14724,29447
18660,,_6risjsdfhej,14724,14725,29449
18661,,xbajwpkiz3ij,14725,14726,29451
18662,,ptscirmzg2qj,14726,14727,29453
18663,,ogsnk_g0zyij,14727,14728,29455
18664,,lqnzu8kn7cwj,14729,14730,29459
18665,,yot9lm5suoqj,14730,14731,29461
18666,,z1fhhgvj3b8j,14731,14732,29463
18667,,f6jfkfhaww8j,14732,14733,29465
18668,,0lby7i0k6vsj,14733,14734,29467
18669,,ycsb05u8fhcj,14734,14735,29469
18670,,achq6fdd6zqj,14735,14736,29471
18671,,fxkfyf8gzgcj,14736,14737,29473
18672,,vq8gvwdrzxuj,14737,14738,29475
18673,,je9gqodu1bmj,14738,14739,29477
18674,,ofltso21kwaj,14739,14740,29479
18675,,nm9_tmukdraj,14740,14741,29481
18676,,wpluqnfyiyqj,14741,14742,29483
18677,,yoyrysswhvmj,14742,14743,29485
18678,,5ru1y3t1glcj,14743,14744,29487
18679,,v4kgrr0eurgj,14744,14745,29489
18680,,7ye_k6_wslsj,14745,14746,29491
18681,,dkqzidwcackj,14746,14747,29493
18682,,mt_hx5xlzmwj,14747,14748,29495
18683,,7z2nf7qn4uwj,14748,14749,29497
18684,,eirncjw9csij,14749,14750,29499
18685,,t_viob90ktoj,14750,14751,29501
18686,,_ykpjmmbdlqj,14751,14752,29503
18687,,2ohj_6laebuj,14752,14753,29505
18688,,xyj4tp42jgcj,14753,14754,29507
18689,,e5gm5upjqnkj,14754,14755,29509
18690,,bvl9ehrt59wj,14755,14756,29511
18691,,qqgvnoiscuij,14756,14757,29513
18692,,ynpujhhxc48j,14758,14759,29517
18693,,oqpwlrwdimgj,14759,14760,29519
18694,,tm7suvdcohyj,14760,14761,29521
18695,,j0j92nokmtsj,14761,14762,29523
18696,,8ztqdoigogkj,14762,14763,29525
18697,,2qch_jqmgsyj,14763,14764,29527
18698,,ileml-9comoj,14764,14765,29529
18699,,cxjnegiinsmj,14765,14766,29531
18700,,x8l1gew-4ysj,14766,14767,29533
18701,,yj0vmuv90zej,14767,14768,29535
18702,,8tovoplmq_uj,14768,14769,29537
18703,,c6v6jg5nu78j,14769,14770,29539
18704,,cbnv47pzoquj,14770,14771,29541
18705,,rzqxbtlbozuj,14771,14772,29543
18706,,8o94hrmwbawj,14772,14773,29545
18707,,vvmg76qmbumj,14773,14774,29547
18708,,llpkfgh5fcij,14774,14775,29549
18709,,mxnlojjg48gj,14775,14776,29551
18710,,vkttdjmvqw8j,14776,14777,29553
18711,,qdbokgxdihwj,14777,14778,29555
18712,,xaph8jhk5wsj,14778,14779,29557
18713,,cdvmb1axavcj,14779,14780,29559
18714,,wrvr5nylr9mj,14780,14781,29561
18715,,iyuucnxdzxgj,14781,14782,29563
18716,,igtf0i2oeg4j,14782,14783,29565
18717,,d_t6j9u-vygj,14783,14784,29567
18718,,ryss2ll82juj,14784,14785,29569
18719,,vbbxxpdupogj,14785,14786,29571
18720,,hkusdsk4q-cj,14786,14787,29573
18721,,zfgxeblujwij,14787,14788,29575
18722,,usco-f67vwyj,14788,14789,29577
18723,,anvjueukud8j,14789,14790,29579
18724,,qyqlb8a2c3mj,14790,14791,29581
18725,,vz0oeyqsm44j,14791,14792,29583
18726,,uwhcfa-lbgsj,14792,14793,29585
18727,,vclqs9_ck7aj,14794,14795,29589
18728,,rcgtwo6ue8oj,14795,14796,29591
18729,,1wpjwk9esgij,14796,14797,29593
18730,,nuac6nqjijkj,14797,14798,29595
18731,,x2obijghfoqj,14798,14799,29597
18732,,xks7mqv3uakj,14799,14800,29599
18733,,ujsale8v1x4j,14800,14801,29601
18734,,2-zqfnumi1oj,14802,14803,29605
18735,,cvudiqujuxkj,14803,14804,29607
18736,,dkhvb66ofzgj,14805,14806,29611
18737,,egntjistnxqj,14806,14807,29613
18738,,o2kx_adutwij,14807,14808,29615
18739,,d19jtrcbrruj,14808,14809,29617
18740,,bo4vg_tukwaj,14809,14810,29619
18741,,y2dpt_i9-rij,14810,14811,29621
18742,,kzlrs2cne1qj,14811,14812,29623
18743,,kqu3zla-cjaj,14812,14813,29625
18744,,v2awrnrn244j,14813,14814,29627
18745,,cemfmyswtvoj,14814,14815,29629
18746,,g0nrrwqlixwj,14815,14816,29631
18747,,bwpyadevlowj,14816,14817,29633
18748,,0lxiwbtyegkj,14817,14818,29635
18749,,acaygttdu4wj,14818,14819,29637
18750,,9hyx9nv_ea0j,14819,14820,29639
18751,,hn6_nbicebuj,14820,14821,29641
18752,,n5qvt3v6pfaj,14821,14822,29643
18753,,inq7jr4se54j,14822,14823,29645
18754,,ufk39vf25ycj,14823,14824,29647
18755,,iii5py_73ayj,14824,14825,29649
18756,,_fpfi2wiifwj,14825,14826,29651
18757,,rae4nyfpn7mj,14826,14827,29653
18758,,cpu3yxhamyqj,14827,14828,29655
18759,,8en0kttc4-mj,14828,14829,29657
18760,,4fvvlfaqwlqj,14829,14830,29659
18761,,qercsyi_rpkj,14830,14831,29661
18762,,ovy-oo0kqauj,14831,14832,29663
18763,,ux8jy7a7ewyj,14832,14833,29665
18764,,wfisfxaml2uj,14833,14834,29667
18765,,avdum2btldsj,14834,14835,29669
18766,,wgzuobzxhh8j,14835,14836,29671
18767,,2usacqax4vwj,14836,14837,29673
18768,,v2echdg3joej,14838,14839,29677
18769,,cs4sgsinzgyj,14839,14840,29679
18770,,31ptj30wodgj,14840,14841,29681
18771,,ncdozrza0esj,14841,14842,29683
18772,,auzh9pmomy4j,14842,14843,29685
18773,,l8v7qdpfxbij,14843,14844,29687
18774,,hnfs967esjij,14844,14845,29689
18775,,tbvk7cizaeyj,14845,14846,29691
18776,,mhin7q6thcij,14846,14847,29693
18777,,blhyvpnzov0j,14847,14848,29695
18778,,pi5yg1sonruj,14848,14849,29697
18779,,fpywhcjmlhqj,14849,14850,29699
18780,,16pthfo53uij,14850,14851,29701
18781,,hpvs7j5kybyj,14851,14852,29703
18782,,ztjud9-m6_cj,14852,14853,29705
18783,,yel2iquavluj,14853,14854,29707
18784,,goosmhdveygj,14854,14855,29709
18785,,url:http://portal.acm.org/citation.cfm3fid3d599610.599633,14855,14856,29711
18786,,jvrjmq0uagoj,14856,14857,29713
18787,,url:http://ieeexplore.ieee.org/xpl/abs_free.jsp3farnumber3d1320053,14857,14858,29715
18788,,sx3runuehxyj,14858,14859,29717
18789,,l6nus7ndowmj,14859,14860,29719
18790,,mvtzjzmppkyj,14860,14861,29721
18791,,stbx8p356eij,14861,14862,29723
18792,,m8__cnhznsqj,14862,14863,29725
18793,,ucrqo5siriwj,14863,14864,29727
18794,,url:http://www.csa.com/partners/viewrecord.php3frequester3dgs26collection3dtrd26recid3dn9210573ah,14864,14865,29729
18795,,gvv_3f_d7raj,14865,14866,29731
18796,,0r9wsz1pdp4j,14866,14867,29733
18797,,bwms7vt7bzaj,14867,14868,29735
18798,,lbjtzx5pvimj,14868,14869,29737
18799,,ymc9xs24jnaj,14869,14870,29739
18800,,tdzy5cn7dlej,14870,14871,29741
18801,,sivzihp6b3sj,14871,14872,29743
18802,,hh0gglqvawsj,14872,14873,29745
18803,,8uv_xtujdj8j,14873,14874,29747
18804,,a8tejnewtbqj,14874,14875,29749
18805,,esf4khsuaaij,14875,14876,29751
18806,,4qqlbh672vcj,14876,14877,29753
18807,,i_skit_7bf8j,14877,14878,29755
18808,,x-homh9fnhkj,14878,14879,29757
18809,,6wu_j9jaaucj,14879,14880,29759
18810,,gs8_cydm8koj,14880,14881,29761
18811,,ac7jgtsf5i8j,14881,14882,29763
18812,,pejyoapgo2yj,14882,14883,29765
18813,,a-8fygfudn8j,14883,14884,29767
18814,,xmot3fxwwsej,14884,14885,29769
18815,,w3nmvw5g6mcj,14885,14886,29771
18816,,url:http://www.ingentaconnect.com/search/expand3fpub3dinfobike://els/08830355/2001/00000035/00000002/art0001426unc3d,14886,14887,29773
18817,,t70windcgnwj,14887,14888,29775
18818,,pz-cyptw0uej,14888,14889,29777
18819,,u-8kapwyywkj,14889,14890,29779
18820,,aq43kb3xyf4j,14890,14891,29781
18821,,tiyvy5qs0h8j,14891,14892,29783
18822,,wsl3qy2fl1gj,14892,14893,29785
18823,,z4gbmddyw3cj,14893,14894,29787
18824,,utmes8_lpswj,14895,14896,29791
18825,,cdwax3ur2o8j,14896,14897,29793
18826,,hwl_qp9qhjsj,14898,14899,29797
18827,,ccsnkcfeghqj,14899,14900,29799
18828,,ethrtetv3nyj,14900,14901,29801
18829,,dcfob8d4elcj,14901,14902,29803
18830,,yyltf7rqyxsj,14902,14903,29805
18831,,,14903,14904,29807
18832,,busjv23hxj8j,14904,14905,29809
18833,,lrzhj2bucs8j,14905,14906,29811
18834,,hzdjbrgrgosj,14906,14907,29813
18835,,m6j9d0yeqacj,14907,14908,29815
18836,,7cclsf3411gj,14908,14909,29817
18837,,hsxrrcfoe9yj,14909,14910,29819
18838,,s1-potohmysj,14911,14912,29823
18839,,w6nohdog-tqj,14912,14913,29825
18840,,r6xk3nbfzrgj,14913,14914,29827
18841,,tx-y71jvftwj,14914,14915,29829
18842,,bltu5lc3j08j,14916,14917,29833
18843,,nd1tkj2g6ruj,14917,14918,29835
18844,,0mo_d5uhc3yj,14918,14919,29837
18845,,djqpau6iibmj,14919,14920,29839
18846,,mso4vermb4aj,14920,14921,29841
18847,,bumd0ewssu4j,14921,14922,29843
18848,,noiamoryshkj,14922,14923,29845
18849,,xh_1e5jpoamj,14923,14924,29847
18850,,url:http://www.csa.com/partners/viewrecord.php3frequester3dgs26collection3dtrd26recid3d7509121081md26recid3d017507540065ai,14924,14925,29849
18851,,ic3pmtt7lwyj,14925,14926,29851
18852,,atmzidzxoamj,14926,14927,29853
18853,,url:http://portal.acm.org/citation.cfm3fid3d645927,14927,14928,29855
18854,,vj9yoneijhuj,14928,14929,29857
18855,,y06hlgr_kx8j,14929,14930,29859
18856,,,14930,14931,29861
18857,,4ysyf_8qeogj,14931,14932,29863
18858,,if3g4tm4e-0j,14932,14933,29865
18859,,jtpnkk0ynfsj,14933,14934,29867
18860,,url:http://doi.wiley.com/10.1002/he.87,14934,14935,29869
18861,,ih82ien08zuj,14935,14936,29871
18862,,oddgj_oydbaj,14937,14938,29875
18863,,8jtswpmvcsij,14938,14939,29877
18864,,mhjsktx6ssyj,14939,14940,29879
18865,,raziwzvagikj,14940,14941,29881
18866,,cvrnogk-s60j,14941,14942,29883
18867,,_joaspwoi6ij,14942,14943,29885
18868,,-953ij-rwjcj,14943,14944,29887
18869,,rbrj4cpatpej,14944,14945,29889
18870,,uanapwfeu5sj,14945,14946,29891
18871,,lfzhnp4vam0j,14946,14947,29893
18872,,asi7rrprea8j,14947,14948,29895
18873,,kfr6ezvedgwj,14948,14949,29897
18874,,2duafgtrpzsj,14949,14950,29899
18875,,zlbh-b29p-uj,14950,14951,29901
18876,,zn4tr5x6_tyj,14951,14952,29903
18877,,tfiza9cyygcj,14952,14953,29905
18878,,igrat6xyu2ej,14953,14954,29907
18879,,aaxsksljbfmj,14954,14955,29909
18880,,,14955,14956,29911
18881,,nqgzzntygigj,14956,14957,29913
18882,,lbpkio2npgmj,14957,14958,29915
18883,,5l1lobq0uu4j,14958,14959,29917
18884,,url:http://doi.wiley.com/10.1002/anie.198102701,14959,14960,29919
18885,,z6ehgyebw1yj,14960,14961,29921
18886,,zis1jqc0yq4j,14961,14962,29923
18887,,m8adzqfjuhkj,14962,14963,29925
18888,,iqleh3uzga8j,14963,14964,29927
18889,,jriakv9pb7yj,14964,14965,29929
18890,,mykxhhh6t2gj,14965,14966,29931
18891,,rkqixgwlcd8j,14966,14967,29933
18892,,v3wf4djrm3oj,14967,14968,29935
18893,,h7al6g8wid8j,14968,14969,29937
18894,,url:http://www.csa.com/partners/viewrecord.php3frequester3dgs26collection3dtrd26recid3dn9210508ah,14969,14970,29939
18895,,slsdqpayar0j,14970,14971,29941
18896,,rajquhu2noij,14971,14972,29943
18897,,u3vopufgpeuj,14972,14973,29945
18898,,dkgj1uk7kb0j,14973,14974,29947
18899,,0tovct9xpbyj,14975,14976,29951
18900,,8nelguicoyyj,14976,14977,29953
18901,,u4dofqxlfsij,14977,14978,29955
18902,,nifccqtomb8j,14978,14979,29957
18903,,mr0r364eeowj,14979,14980,29959
18904,,zueaf9ybokoj,14980,14981,29961
18905,,0nemr8cbciqj,14981,14982,29963
18906,,36ibncuzkvaj,14982,14983,29965
18907,,rnrejqhldjij,14983,14984,29967
18908,,o-pbckl0f_yj,14984,14985,29969
18909,,url:http://portal.acm.org/ft_gateway.cfm3fid3d108379826type3dpdf,14985,14986,29971
18910,,ugnsboodqvwj,14986,14987,29973
18911,,du24tdljy84j,14987,14988,29975
18912,,-9ssj1wn8aij,14988,14989,29977
18913,,rdsvjosa6s8j,14989,14990,29979
18914,,9dnvzbryfqwj,14990,14991,29981
18915,,i8y8p6vsdgqj,14991,14992,29983
18916,,w89bywxuaawj,14992,14993,29985
18917,,g_fr3fubvj4j,14993,14994,29987
18918,,bdxr5mioyk8j,14994,14995,29989
18919,,9t2obqqyblyj,14995,14996,29991
18920,,vbq5ygcbk9yj,14996,14997,29993
18921,,url:http://portal.acm.org/citation.cfm3fid3d318898.318997,14997,14998,29995
18922,,kb8qpoz0qe4j,14998,14999,29997
18923,,,14999,15000,29999
18924,,wwhasqsiti4j,15000,15001,30001
18925,,d5ohjfu8v3wj,15001,15002,30003
18926,,g7qwj1nh8aej,15002,15003,30005
18927,,9jl8yjwnp-ij,15003,15004,30007
18928,,jh3ukm-06xgj,15004,15005,30009
18929,,i4gsti2sumyj,15005,15006,30011
18930,,fiybkrtt2uaj,15006,15007,30013
18931,,hp7wjjhsbnej,15007,15008,30015
18932,,jct5kdferikj,15008,15009,30017
18933,,mpkbntow5tyj,15009,15010,30019
18934,,suazzogwczsj,15010,15011,30021
18935,,qjaqmetq2j8j,15011,15012,30023
18936,,txay2nnlve0j,15012,15013,30025
18937,,_7q6rfh1ynaj,15013,15014,30027
18938,,onxwcibz7nqj,15014,15015,30029
18939,,lu6pdty-ciyj,15015,15016,30031
18940,,5t9cvuqutmqj,15016,15017,30033
18941,,url:http://links.jstor.org/sici3fsici3d0146-4949(196724)8253a1253c43253a2522lotrt253e2.0.co253b2-4,15017,15018,30035
18942,,n7t1wxfqyakj,15018,15019,30037
18943,,7voyoxoopl4j,15019,15020,30039
18944,,url:http://portal.acm.org/citation.cfm3fid3d122050.12205726dl3dguide26dl3dacm26idx3dj68926part3dperiodical26wanttype3dperiodical26title3dacm2520sigmod2520record26cfid3d1111111126cftoken3d2222222,15020,15021,30041
18945,,url:http://pubs.acs.org/cgi-bin/abstract.cgi/achre4/2005/38/i12/abs/ar040133f.html,15021,15022,30043
18946,,put4ovmbc4oj,15022,15023,30045
18947,,mvk2b11er7sj,15023,15024,30047
18948,,jfo6tdln-lej,15024,15025,30049
18949,,f9ie2jdnw0ej,15025,15026,30051
18950,,n0kutxzgbywj,15026,15027,30053
18951,,l9o-h4rocsej,15027,15028,30055
18952,,a3jsl55w3f0j,15028,15029,30057
18953,,7w0sabe1d-qj,15029,15030,30059
18954,,towd6oxsmcwj,15030,15031,30061
18955,,y5z6suaelhyj,15031,15032,30063
18956,,k-jhayyhvmyj,15032,15033,30065
18957,,zsdoc4glog0j,15033,15034,30067
18958,,s-mfsaga1zwj,15034,15035,30069
18959,,fczvggyzexmj,15035,15036,30071
18960,,mkyn4hipjkij,15036,15037,30073
18961,,igpgiqjsopej,15037,15038,30075
18962,,nkefuxgwm4oj,15038,15039,30077
18963,,kjrt7t8mfmej,15039,15040,30079
18964,,pikte6slg3yj,15040,15041,30081
18965,,yu5zkeywlwcj,15041,15042,30083
18966,,tdyqturqzvwj,15042,15043,30085
18967,,romubmzrmj8j,15043,15044,30087
18968,,zb-sj08-bswj,15044,15045,30089
18969,,tolgos5eiqyj,15045,15046,30091
18970,,pj9152ahkuwj,15046,15047,30093
18971,,tvmolbhm_wgj,15047,15048,30095
18972,,s8nhcb21c_sj,15048,15049,30097
18973,,gnurnc3yh38j,15049,15050,30099
18974,,kngfiyrz4zkj,15050,15051,30101
18975,,pifzxgoczegj,15051,15052,30103
18976,,ivwgn-cnglwj,15052,15053,30105
18977,,vhzqebwfyl4j,15053,15054,30107
18978,,8mqgqxi765aj,15054,15055,30109
18979,,svj5arj7ovuj,15055,15056,30111
18980,,fvuyfl03zakj,15056,15057,30113
18981,,ygoqyxnytr8j,15057,15058,30115
18982,,hnnj3nd9hvwj,15058,15059,30117
18983,,_hrl1osusi4j,15059,15060,30119
18984,,xmyp2hwhiqoj,15060,15061,30121
18985,,t0azkchxduwj,15061,15062,30123
18986,,sdtexrib0u0j,15062,15063,30125
18987,,nirrpq2dmx0j,15063,15064,30127
18988,,vjd2rwhemjgj,15064,15065,30129
18989,,rtjq0op1cogj,15065,15066,30131
18990,,d2s8u0fcj_4j,15066,15067,30133
18991,,4jynzfpyqymj,15067,15068,30135
18992,,m7z8pwukogej,15068,15069,30137
18993,,dabvp2wtbwwj,15069,15070,30139
18994,,extnbxpn1kij,15070,15071,30141
18995,,url:http://portal.acm.org/ft_gateway.cfm3fid3d35981426type3dpdf26coll3dguide26dl3dacm26cfid3d1111111126cftoken3d2222222,15071,15072,30143
18996,,b9rixc6980yj,15072,15073,30145
18997,,ng15bdhgewsj,15073,15074,30147
18998,,6bkgb7syqkij,15075,15076,30151
18999,,u75lisjac_mj,15076,15077,30153
19000,,_cy4zbsbsa8j,15077,15078,30155
19001,,b9uf_otthiej,15078,15079,30157
19002,,_rmzmsbr_puj,15079,15080,30159
19003,,seubworboa8j,15080,15081,30161
19004,,dxdqhiienvcj,15081,15082,30163
19005,,lkrbg0irfswj,15082,15083,30165
19006,,hi6dnacqbh0j,15083,15084,30167
19007,,amaafn7jwi4j,15084,15085,30169
19008,,xrybyhoi16kj,15085,15086,30171
19009,,pi_dcz_2qo0j,15086,15087,30173
19010,,72qafe5aawoj,15088,15089,30177
19011,,rrujaawpq6ij,15089,15090,30179
19012,,rl93ug-yxd8j,15091,15092,30183
19013,,kikckmfmfsaj,15092,15093,30185
19014,,-7nuzhqegmyj,15093,15094,30187
19015,,h6tinspjhucj,15094,15095,30189
19016,,xwda2stnuu0j,15095,15096,30191
19017,,coj6kfzc-_uj,15096,15097,30193
19018,,g0su_tyckjaj,15097,15098,30195
19019,,url:http://pubs.acs.org/cgi-bin/abstract.cgi/achre4/2004/37/i06/abs/ar030171j.html,15098,15099,30197
19020,,xvxy8nslhsuj,15099,15100,30199
19021,,petwc78qqmqj,15100,15101,30201
19022,,e1y68t3dxjmj,15101,15102,30203
19023,,hcyttieycowj,15102,15103,30205
19024,,hjgxxgodkdej,15103,15104,30207
19025,,op7oh4w4hggj,15105,15106,30211
19026,,wwx56p6cf-ij,15106,15107,30213
19027,,uznojeelaxmj,15107,15108,30215
19028,,err-iwrsnzuj,15108,15109,30217
19029,,2y3eyf9vvhoj,15109,15110,30219
19030,,grttur40e-sj,15110,15111,30221
19031,,g5xcx6ps4xej,15111,15112,30223
19032,,skx1wjolstmj,15112,15113,30225
19033,,zy_yllqtnxej,15113,15114,30227
19034,,erq1s72dtiaj,15114,15115,30229
19035,,d-yvm-9r14kj,15115,15116,30231
19036,,lokcmpwnvt4j,15116,15117,30233
19037,,nlyfqglahhgj,15117,15118,30235
19038,,kokzbx2rikwj,15118,15119,30237
19039,,xevonqtqenwj,15119,15120,30239
19040,,unqk6pv86qcj,15120,15121,30241
19041,,vfyk2wxprnmj,15121,15122,30243
19042,,p2ygubhis5ij,15122,15123,30245
19043,,0n22hra984oj,15123,15124,30247
19044,,mcgjnmexmwij,15124,15125,30249
19045,,ujojz_zcpsej,15125,15126,30251
19046,,t-b4j-df9gaj,15126,15127,30253
19047,,p-xsej1ds9yj,15127,15128,30255
19048,,d8oohn00ou4j,15128,15129,30257
19049,,lzdcgtahiyej,15129,15130,30259
19050,,mdoxm-tcbnmj,15130,15131,30261
19051,,p_ntjzlgb4ej,15131,15132,30263
19052,,otrovplt3sgj,15132,15133,30265
19053,,jpxhy-thvl4j,15133,15134,30267
19054,,blukfpv_r30j,15134,15135,30269
19055,,lkszjniaxu4j,15137,15138,30275
19056,,7gfurli8gs0j,15138,15139,30277
19057,,tsgqfunm5dgj,15139,15140,30279
19058,,03oejfazq7uj,15140,15141,30281
19059,,nyyfz9spptsj,15141,15142,30283
19060,,htpospck0uuj,15142,15143,30285
19061,,vhaspnd6ccij,15143,15144,30287
19062,,16l0fimudakj,15144,15145,30289
19063,,sazx8xf-ez8j,15145,15146,30291
19064,,isby2wlrnc0j,15146,15147,30293
19065,,gjpprzmzawoj,15147,15148,30295
19066,,ao8-ixq_688j,15148,15149,30297
19067,,url:http://www.csa.com/partners/viewrecord.php3frequester3dgs26collection3dtrd26recid3d20021212023588mt26recid3da7642837ah,15149,15150,30299
19068,,aaus5udzwquj,15150,15151,30301
19069,,dy53kj8uwbej,15151,15152,30303
19070,,ai3azn2gqqej,15152,15153,30305
19071,,qsuq1oqowl4j,15153,15154,30307
19072,,jgtoo712prcj,15154,15155,30309
19073,,j4_1krjcawij,15155,15156,30311
19074,,a8gc2ez4yt8j,15156,15157,30313
19075,,z2r6uifq6csj,15157,15158,30315
19076,,3qzyv-43aycj,15158,15159,30317
19077,,yny2jluecsij,15159,15160,30319
19078,,oqlqwjvhshwj,15160,15161,30321
19079,,ktsgcc7hntqj,15161,15162,30323
19080,,pgoilc60saoj,15162,15163,30325
19081,,lrulvheg03ej,15163,15164,30327
19082,,8jutotd8wesj,15164,15165,30329
19083,,3v_riml6iooj,15165,15166,30331
19084,,url:http://doi.wiley.com/10.1002/he.10708,15166,15167,30333
19085,,doscxzfxarwj,15167,15168,30335
19086,,2szcgwjvo3kj,15168,15169,30337
19087,,d7w6tqwate0j,15169,15170,30339
19088,,bckrnbk9ypkj,15170,15171,30341
19089,,k5pbwheo3foj,15171,15172,30343
19090,,iw2plqb2juqj,15172,15173,30345
19091,,frsvyhwlji8j,15173,15174,30347
19092,,xsundr0x9gyj,15174,15175,30349
19093,,1maiyhsvxpuj,15175,15176,30351
19094,,jqlgt2u3aeyj,15176,15177,30353
19095,,1o9wdxvqessj,15177,15178,30355
19096,,xhxjfyv1mpwj,15178,15179,30357
19097,,t3kukgownbaj,15179,15180,30359
19098,,6mufnae9ocgj,15180,15181,30361
19099,,br9vrzpyqoej,15181,15182,30363
19100,,r4t0tacjrgyj,15182,15183,30365
19101,,vmvuiqz5biwj,15183,15184,30367
19102,,f4pbzzrgh2ej,15184,15185,30369
19103,,url:http://portal.acm.org/citation.cfm3fid3d15833.1583826dl3dguide26dl3dacm26idx3d1583326part3dperiodical26wanttype3dperiodical26title3dacm2520sigmod2520record26cfid3d1111111126cftoken3d2222222,15185,15186,30371
19104,,4lf8cdnqkl8j,15186,15187,30373
19105,,lg_0oewppaoj,15187,15188,30375
19106,,iinbv0zsjpaj,15188,15189,30377
19107,,te8xe-ow0iwj,15189,15190,30379
19108,,li5vvqzewqwj,15190,15191,30381
19109,,6yg_yeaa52ij,15191,15192,30383
19110,,ntc3fqgat_yj,15192,15193,30385
19111,,61dnndrjxyyj,15193,15194,30387
19112,,yoa_wrlqxrcj,15194,15195,30389
19113,,ddwzx1o8lh8j,15195,15196,30391
19114,,xhis4jb8kjoj,15196,15197,30393
19115,,tifcawhou24j,15197,15198,30395
19116,,mqvxsbkhr_8j,15198,15199,30397
19117,,0caxmzwghqoj,15199,15200,30399
19118,,rzg1_bnpksyj,15200,15201,30401
19119,,9v45-lfyzaoj,15201,15202,30403
19120,,kczgnitwsfuj,15202,15203,30405
19121,,vk4g95e92goj,15203,15204,30407
19122,,qvroaxsfiroj,15204,15205,30409
19123,,jj9rngura6wj,15205,15206,30411
19124,,url:http://www.csa.com/partners/viewrecord.php3frequester3dgs26collection3dtrd26recid3dn9210447ah,15206,15207,30413
19125,,url:http://www.csa.com/partners/viewrecord.php3frequester3dgs26collection3dtrd26recid3d0250444ci,15207,15208,30415
19126,,xnxxmfq7wbaj,15208,15209,30417
19127,,url:http://portal.acm.org/ft_gateway.cfm3fid3d106618026type3dpdf,15209,15210,30419
19128,,uc-gcaahvfej,15210,15211,30421
19129,,xm9iyebmrymj,15211,15212,30423
19130,,sy5a74jtueij,15212,15213,30425
19131,,rpsb-jp6wzmj,15213,15214,30427
19132,,h14prbdznp4j,15214,15215,30429
19133,,xz3yypjhvnoj,15215,15216,30431
19134,,6lczja6immoj,15216,15217,30433
19135,,hwwgfwqudxoj,15218,15219,30437
19136,,k6gpq9ztg6mj,15219,15220,30439
19137,,url:http://www.csa.com/partners/viewrecord.php3frequester3dgs26collection3dtrd26recid3d0265498ci,15220,15221,30441
19138,,zbz1tyehsx4j,15222,15223,30445
19139,,p5tc1bjkjygj,15223,15224,30447
19140,,gy_w7m1xoyij,15224,15225,30449
19141,,qpnmjl9iqg8j,15225,15226,30451
19142,,ils-qifrk3ej,15226,15227,30453
19143,,sijwa7vn_gaj,15227,15228,30455
19144,,uvvmhi5lqbsj,15228,15229,30457
19145,,sremicni-ncj,15229,15230,30459
19146,,hfd-mbjhdsoj,15230,15231,30461
19147,,ov6n7lhoe_cj,15232,15233,30465
19148,,x7ftrzyobmyj,15233,15234,30467
19149,,wyokrh96djmj,15234,15235,30469
19150,,n-90g8lfrvcj,15235,15236,30471
19151,,tn-wfbspvmej,15236,15237,30473
19152,,78mlmnren8uj,15237,15238,30475
19153,,cou15jrrgdkj,15238,15239,30477
19154,,gaum2zc3d4kj,15239,15240,30479
19155,,rro76ooliioj,15240,15241,30481
19156,,gotv0fz43fwj,15241,15242,30483
19157,,bclkm5u5emgj,15242,15243,30485
19158,,qbibjjwumdqj,15243,15244,30487
19159,,9vitxta6a70j,15244,15245,30489
19160,,zcdwpbs_vhyj,15245,15246,30491
19161,,qbubaa6mqawj,15246,15247,30493
19162,,,15247,15248,30495
19163,,in96yyjjzlwj,15248,15249,30497
19164,,1wcb63aie3sj,15249,15250,30499
19165,,jipeqmmdzkqj,15250,15251,30501
19166,,tjo_6vwm3p0j,15251,15252,30503
19167,,url:http://portal.acm.org/ft_gateway.cfm3fid3d102776626type3dpdf,15252,15253,30505
19168,,ncmeay-sxcsj,15253,15254,30507
19169,,bbskcqkajnej,15254,15255,30509
19170,,uypixk89uraj,15255,15256,30511
19171,,z-s1xqtg89cj,15256,15257,30513
19172,,yxzadmcx3fqj,15257,15258,30515
19173,,zdga1uttowaj,15258,15259,30517
19174,,fczipw4gszej,15259,15260,30519
19175,,825gpp3g8cgj,15260,15261,30521
19176,,eanyjmhnn1qj,15261,15262,30523
19177,,nh2widq695uj,15262,15263,30525
19178,,1pwxyyu8btij,15263,15264,30527
19179,,vax6pgregfuj,15264,15265,30529
19180,,obeebifyxawj,15265,15266,30531
19181,,2zu-yzvfcj0j,15266,15267,30533
19182,,ffjp_n83eywj,15269,15270,30539
19183,,h6dk2huvxgyj,15270,15271,30541
19184,,eiqwyn3xh_cj,15271,15272,30543
19185,,jdblon4kbv4j,15272,15273,30545
19186,,u45ctcdc7bqj,15273,15274,30547
19187,,rydhzm31rmwj,15274,15275,30549
19188,,us_qrtstaugj,15275,15276,30551
19189,,leh1yp7c3o4j,15276,15277,30553
19190,,url:http://www.springerlink.com/index/vgvl2va44l0yah50.pdf,15277,15278,30555
19191,,ton5yjqrargj,15278,15279,30557
19192,,aawlujowaksj,15279,15280,30559
19193,,hvqcng4g_uwj,15280,15281,30561
19194,,d-iemlqc1gyj,15281,15282,30563
19195,,url:http://portal.acm.org/ft_gateway.cfm3fid3d36927726type3dpdf26dl3dguide26dl3dacm26cfid3d1111111126cftoken3d2222222,15282,15283,30565
19196,,pljqp7gmfiqj,15283,15284,30567
19197,,swuysktf0dcj,15284,15285,30569
19198,,bxm2mkfcgvmj,15285,15286,30571
19199,,iz8i017svr8j,15286,15287,30573
19200,,h9-zpx6evaij,15287,15288,30575
19201,,nyfbruwl0xyj,15288,15289,30577
19202,,jb9pneoxbhuj,15289,15290,30579
19203,,gzr2235rjlsj,15290,15291,30581
19204,,smwylwua1_uj,15291,15292,30583
19205,,url:http://www.csa.com/partners/viewrecord.php3frequester3dgs26collection3dtrd26recid3d0498494ci,15292,15293,30585
19206,,url:http://www.csa.com/partners/viewrecord.php3frequester3dgs26collection3dtrd26recid3dn9210512ah,15293,15294,30587
19207,,d1odiafnx9mj,15294,15295,30589
19208,,gw1x2xgs6r8j,15295,15296,30591
19209,,fxrgqtf3bfqj,15296,15297,30593
19210,,y7c2nmgrt2yj,15297,15298,30595
19211,,463_cdj4clij,15298,15299,30597
19212,,e0j-56kaer4j,15299,15300,30599
19213,,de0yctqdz9aj,15300,15301,30601
19214,,mbxqbvhe3r8j,15301,15302,30603
19215,,afkclgtsbo8j,15302,15303,30605
19216,,gwg4hh6xrmaj,15303,15304,30607
19217,,ea5jaqlgnioj,15304,15305,30609
19218,,kkhpafmqd_wj,15305,15306,30611
19219,,foghf2hpgyuj,15306,15307,30613
19220,,,15307,15308,30615
19221,,o7bwnbassuej,15308,15309,30617
19222,,vyetdejbkb8j,15309,15310,30619
19223,,tiwcm2cdch4j,15310,15311,30621
19224,,url:http://portal.acm.org/ft_gateway.cfm3fid3d110137726type3dpdf,15311,15312,30623
19225,,jz7ltzkqxeuj,15312,15313,30625
19226,,c3uqzf5zqukj,15313,15314,30627
19227,,9dodgncdmegj,15314,15315,30629
19228,,wqbmg1h2akej,15315,15316,30631
19229,,luotwxkjnqsj,15316,15317,30633
19230,,15mwttgugbij,15317,15318,30635
19231,,fjbf43xxf_uj,15318,15319,30637
19232,,url:http://portal.acm.org/ft_gateway.cfm3fid3d98440026type3dpdf26dl3dguide26dl3dacm26cfid3d1111111126cftoken3d2222222,15319,15320,30639
19233,,ufmnaniw-zgj,15320,15321,30641
19234,,ds2fpglxghej,15321,15322,30643
19235,,x9lckgldfaej,15322,15323,30645
19236,,url:http://www.csa.com/partners/viewrecord.php3frequester3dgs26collection3dtrd26recid3da8622957ah,15323,15324,30647
19237,,r4a_vlmfu38j,15324,15325,30649
19238,,39m5bldo1zyj,15325,15326,30651
19239,,wjggkafenp8j,15326,15327,30653
19240,,z6uegjtg7muj,15327,15328,30655
19241,,ne_l8qdkuyaj,15328,15329,30657
19242,,tyn8ri12sbgj,15329,15330,30659
19243,,flhi5haa7aqj,15330,15331,30661
19244,,wzhzqpmvelaj,15331,15332,30663
19245,,zvynj5fzqqkj,15332,15333,30665
19246,,ywjmy1uehhqj,15333,15334,30667
19247,,yh8grtxulrkj,15334,15335,30669
19248,,l3qsbwrijcgj,15335,15336,30671
19249,,vzvyzsgsdcaj,15336,15337,30673
19250,,fyvhxyfgihwj,15337,15338,30675
19251,,rvfgkf24ismj,15338,15339,30677
19252,,xgx_f6kxwxgj,15339,15340,30679
19253,,ngzmugnjxf8j,15340,15341,30681
19254,,hjh9ck2r0lgj,15341,15342,30683
19255,,h3ecutog4zqj,15342,15343,30685
19256,,gaelzcptquoj,15343,15344,30687
19257,,v6_8aibhb_aj,15344,15345,30689
19258,,fncq86so2agj,15345,15346,30691
19259,,vkdjset1lukj,15346,15347,30693
19260,,tfcvrgi-ls0j,15347,15348,30695
19261,,nqassnk12xuj,15348,15349,30697
19262,,dxe8d6kprtyj,15349,15350,30699
19263,,jlxghwnn5dcj,15350,15351,30701
19264,,hbp32fcrngaj,15351,15352,30703
19265,,wccb6ix-ttcj,15352,15353,30705
19266,,cygx1x28_m4j,15353,15354,30707
19267,,_ran_9lhiasj,15354,15355,30709
19268,,xhcnlrtrwdsj,15355,15356,30711
19269,,wf9awb8enfqj,15356,15357,30713
19270,,usih0ikv4osj,15358,15359,30717
19271,,0klcrs1co_kj,15359,15360,30719
19272,,uwy3zz9u7_sj,15361,15362,30723
19273,,dqyvte-pxg0j,15362,15363,30725
19274,,0mhuvmhmnmkj,15363,15364,30727
19275,,8zbfjcu6bpqj,15364,15365,30729
19276,,gdqf8sdlp5ij,15365,15366,30731
19277,,ly3qhbvcak0j,15366,15367,30733
19278,,kmomx2alvvyj,15367,15368,30735
19279,,1grx-nhi96mj,15368,15369,30737
19280,,zg6nx7kd3yuj,15369,15370,30739
19281,,f4wvifftb_ej,15370,15371,30741
19282,,4-ucgitdpgmj,15371,15372,30743
19283,,url:http://ieeexplore.ieee.org/xpl/abs_free.jsp3farnumber3d914868,15372,15373,30745
19284,,waa2zxhfd0wj,15373,15374,30747
19285,,sqkrmmdehp4j,15374,15375,30749
19286,,mhfbziryl0yj,15375,15376,30751
19287,,ptpbfgtarssj,15376,15377,30753
19288,,xnu8dwcygzsj,15377,15378,30755
19289,,s6ehhkiwqwcj,15378,15379,30757
19290,,q91xq6gnhrwj,15379,15380,30759
19291,,g7susknyitej,15380,15381,30761
19292,,url:http://www.csa.com/partners/viewrecord.php3frequester3dgs26collection3dtrd26recid3d0928622ci,15381,15382,30763
19293,,vli6v-7i9sqj,15382,15383,30765
19294,,c-xo_ab7d7qj,15383,15384,30767
19295,,yl1k_n6jn-4j,15384,15385,30769
19296,,pi5wohuwb3cj,15385,15386,30771
19297,,e5lp-jgxg8gj,15386,15387,30773
19298,,whmzvfabuvaj,15387,15388,30775
19299,,yd851ta-iuyj,15388,15389,30777
19300,,ccq75b6h5ocj,15389,15390,30779
19301,,l9qsfthoxnkj,15390,15391,30781
19302,,x-kgwihvezkj,15391,15392,30783
19303,,klf3coz5-foj,15392,15393,30785
19304,,ksjkpmusrvcj,15393,15394,30787
19305,,ghj6vaztmvqj,15394,15395,30789
19306,,v6qysdknwloj,15395,15396,30791
19307,,4i6bey0awm0j,15396,15397,30793
19308,,g22rt-1ziw4j,15397,15398,30795
19309,,onyorbasqakj,15398,15399,30797
19310,,aod-so6y0bej,15399,15400,30799
19311,,tl2xk4zodcqj,15400,15401,30801
19312,,xqoxzax2_eej,15401,15402,30803
19313,,e7hhnlf_diaj,15402,15403,30805
19314,,bi4zjqle2ocj,15403,15404,30807
19315,,5-hgdknxon0j,15404,15405,30809
19316,,juyzrdymryoj,15406,15407,30813
19317,,9eonvzte2buj,15407,15408,30815
19318,,yhpvrzlcnwqj,15408,15409,30817
19319,,5gmresjdsxkj,15409,15410,30819
19320,,npayw9w0gcoj,15410,15411,30821
19321,,url:http://portal.acm.org/ft_gateway.cfm3fid3d110194326type3dpdf,15411,15412,30823
19322,,uk3el8e7tdqj,15412,15413,30825
19323,,nfuie5isdgkj,15413,15414,30827
19324,,k3znuhymd0oj,15414,15415,30829
19325,,r1joi-0mzpcj,15415,15416,30831
19326,,vdsoj5ox7nqj,15416,15417,30833
19327,,0li-f61wiwij,15417,15418,30835
19328,,nfeeqrsfla4j,15418,15419,30837
19329,,i64fjgwnskcj,15419,15420,30839
19330,,zs03ewj20uoj,15420,15421,30841
19331,,vehcolguuvsj,15421,15422,30843
19332,,rriq7t6cqtgj,15422,15423,30845
19333,,s2uibuxwwz0j,15423,15424,30847
19334,,gvc0_asqhykj,15424,15425,30849
19335,,2xa_pifujs4j,15426,15427,30853
19336,,cyetvqadltyj,15427,15428,30855
19337,,cfjmg1safikj,15428,15429,30857
19338,,ky9o52zvmwej,15429,15430,30859
19339,,tybnxdtss7yj,15430,15431,30861
19340,,aozyocnbwakj,15431,15432,30863
19341,,h3xfa8dl8ygj,15432,15433,30865
19342,,ofdd41msd6cj,15433,15434,30867
19343,,qkb2zxd1isyj,15435,15436,30871
19344,,3zvuv9hznagj,15436,15437,30873
19345,,ndfxqv4oa34j,15437,15438,30875
19346,,f1egtoawib8j,15438,15439,30877
19347,,xklc0gujegsj,15439,15440,30879
19348,,dsoklms7dxuj,15440,15441,30881
19349,,zsn6xog7aokj,15441,15442,30883
19350,,url:http://doi.wiley.com/10.1002/ace.111,15442,15443,30885
19351,,huphzf6zy4oj,15443,15444,30887
19352,,jbenmh3akjwj,15444,15445,30889
19353,,f6orj3btihsj,15445,15446,30891
19354,,3il-2zdifvyj,15446,15447,30893
19355,,4zwsahydunoj,15447,15448,30895
19356,,0uadvzl6jxqj,15449,15450,30899
19357,,q0vbpj6wfu4j,15450,15451,30901
19358,,b7jbbr9okj0j,15451,15452,30903
19359,,tojpjd_kxsuj,15452,15453,30905
19360,,tzik1igtpjoj,15453,15454,30907
19361,,mkgvcn7m5ncj,15454,15455,30909
19362,,bqzfoihvjlij,15455,15456,30911
19363,,1x3x1sxmih8j,15456,15457,30913
19364,,yh_cqz8ubkuj,15457,15458,30915
19365,,yunb0vza4xuj,15458,15459,30917
19366,,uyjy-bboucij,15459,15460,30919
19367,,pya1gfi6blmj,15460,15461,30921
19368,,ndralk_ue9aj,15461,15462,30923
19369,,url:http://www.csa.com/partners/viewrecord.php3frequester3dgs26collection3dtrd26recid3d0805144ci,15462,15463,30925
19370,,p-gv3xmdh-ij,15463,15464,30927
19371,,kwnwip2gexyj,15464,15465,30929
19372,,psdjucv26roj,15465,15466,30931
19373,,y-k-k7s8xpij,15466,15467,30933
19374,,jo5qrbtimskj,15467,15468,30935
19375,,nigpzc0nawij,15468,15469,30937
19376,,mxqta2umzfej,15469,15470,30939
19377,,qcjjbljv7ggj,15470,15471,30941
19378,,url:http://portal.acm.org/ft_gateway.cfm3fid3d100766826type3dpdf,15471,15472,30943
19379,,qadjm5harqgj,15472,15473,30945
19380,,hgzowbs0afgj,15473,15474,30947
19381,,6ldwrwrokw0j,15474,15475,30949
19382,,f0wqtqcyw4yj,15475,15476,30951
19383,,2w1rulb_smuj,15476,15477,30953
19384,,e_eozjyat6ij,15477,15478,30955
19385,,7ktvpsipaogj,15478,15479,30957
19386,,vg_dxaddzbej,15479,15480,30959
19387,,iwfnixutecwj,15480,15481,30961
19388,,qrj9k-dvwh8j,15481,15482,30963
19389,,epbxysyimxqj,15482,15483,30965
19390,,i73fxw_5hhej,15483,15484,30967
19391,,zb_fvr-z_b0j,15484,15485,30969
19392,,e1rweoiibfsj,15485,15486,30971
19393,,url:http://doi.wiley.com/10.1002/ev.1453,15486,15487,30973
19394,,tp0mzf6bzuqj,15487,15488,30975
19395,,x2atltnm_wwj,15488,15489,30977
19396,,btiyanj453sj,15489,15490,30979
19397,,svjdfjpek6sj,15490,15491,30981
19398,,y3ihswa-ywwj,15491,15492,30983
19399,,sv9jrr4nuw4j,15492,15493,30985
19400,,jl3iro4qdqmj,15493,15494,30987
19401,,mhgvs7x_yfwj,15494,15495,30989
19402,,s5p6uvujdvej,15495,15496,30991
19403,,vhs4gkfrdtaj,15496,15497,30993
19404,,qqpgjuhn8vkj,15497,15498,30995
19405,,qbmhkeyya0uj,15498,15499,30997
19406,,klvqqpns_-0j,15499,15500,30999
19407,,9wo5qkd6ebyj,15500,15501,31001
19408,,rzlhe-sybfgj,15501,15502,31003
19409,,wanl7ppcou8j,15502,15503,31005
19410,,nehtctd9juwj,15503,15504,31007
19411,,tte4wm0kurij,15504,15505,31009
19412,,puirk5yijuyj,15505,15506,31011
19413,,sut3whj02qoj,15506,15507,31013
19414,,re8xteedr6sj,15507,15508,31015
19415,,888yqwmkghsj,15508,15509,31017
19416,,okwmw5fu7kaj,15509,15510,31019
19417,,46x1xrq24igj,15510,15511,31021
19418,,p3toz06mzyej,15511,15512,31023
19419,,dnuztyvne9ij,15513,15514,31027
19420,,glxhybzwuxmj,15514,15515,31029
19421,,va_m75gyvaoj,15515,15516,31031
19422,,knl3tjflev4j,15516,15517,31033
19423,,5leo8x2cofqj,15517,15518,31035
19424,,_qru773q4lcj,15518,15519,31037
19425,,aqrkmxfn67cj,15519,15520,31039
19426,,wiwnff-iuw8j,15520,15521,31041
19427,,x1ok9ynfci8j,15521,15522,31043
19428,,quhk2ijprnqj,15522,15523,31045
19429,,nk7talkgbiyj,15523,15524,31047
19430,,url:http://doi.wiley.com/10.1002/ace.30.abs,15524,15525,31049
19431,,fexxkaln2gwj,15525,15526,31051
19432,,63smbl-zvbmj,15526,15527,31053
19433,,cq81qhkwrjej,15527,15528,31055
19434,,pqeo8hxb5fmj,15528,15529,31057
19435,,jhrqkmfwwvmj,15529,15530,31059
19436,,dw8yw9yhfoyj,15530,15531,31061
19437,,313nhrr9fh0j,15531,15532,31063
19438,,oqc3dr3mfyyj,15532,15533,31065
19439,,taej3pv1qkej,15533,15534,31067
19440,,8lq49lc7pemj,15534,15535,31069
19441,,8vuikriksdaj,15535,15536,31071
19442,,53zcsebedngj,15536,15537,31073
19443,,nzd7qhfrjcyj,15537,15538,31075
19444,,whfe5ieduxej,15538,15539,31077
19445,,q8zmixannsuj,15539,15540,31079
19446,,yh4kujtervqj,15540,15541,31081
19447,,smuun1lf-9ej,15541,15542,31083
19448,,je6szjajy8oj,15542,15543,31085
19449,,jjymdewh-pwj,15543,15544,31087
19450,,nnpxmhuagrqj,15544,15545,31089
19451,,1xfgksdyud0j,15545,15546,31091
19452,,vdldp-geh6kj,15546,15547,31093
19453,,kykcwqacrtuj,15547,15548,31095
19454,,r1xwwqwr2k0j,15548,15549,31097
19455,,biipg9xnbt4j,15549,15550,31099
19456,,dh9fmrjdxtmj,15550,15551,31101
19457,,nqfesesvvaaj,15551,15552,31103
19458,,xect05nvwiqj,15552,15553,31105
19459,,yb_coad0xkaj,15553,15554,31107
19460,,d2pacer8iaoj,15554,15555,31109
19461,,cujbqo0i2h4j,15555,15556,31111
19462,,bg2fkpiapn4j,15556,15557,31113
19463,,atoreao9disj,15557,15558,31115
19464,,zuihkvpjn_ij,15558,15559,31117
19465,,rpolzpjqzy8j,15559,15560,31119
19466,,wsosxtzucj0j,15560,15561,31121
19467,,ggevvdstuk8j,15561,15562,31123
19468,,fccdkongjvyj,15562,15563,31125
19469,,0-av-nxvugej,15563,15564,31127
19470,,url:http://www.csa.com/partners/viewrecord.php3frequester3dgs26collection3dtrd26recid3d0052397ci26recid3d0052397ea,15564,15565,31129
19471,,url:http://www.csa.com/partners/viewrecord.php3frequester3dgs26collection3dtrd26recid3dn9210365ah,15565,15566,31131
19472,,url:http://portal.acm.org/ft_gateway.cfm3fid3d108625326type3dpdf,15566,15567,31133
19473,,csye1ofnqccj,15567,15568,31135
19474,,53tyenso_0ij,15568,15569,31137
19475,,url:http://ieeexplore.ieee.org/iel3/3990/11481/00547855.pdf3farnumber3d547855,15569,15570,31139
19476,,qq3jut0wfa8j,15570,15571,31141
19477,,r99u0foar-wj,15571,15572,31143
19478,,d6agckuaygwj,15572,15573,31145
19479,,b2bhq6s8dsgj,15573,15574,31147
19480,,boytaequrhmj,15574,15575,31149
19481,,hqe1epavbl0j,15575,15576,31151
19482,,p2eydklfkkoj,15576,15577,31153
19483,,x-klyl5ngeyj,15577,15578,31155
19484,,url:http://portal.acm.org/ft_gateway.cfm3fid3d109963526type3dpdf,15578,15579,31157
19485,,0aiivp9-ocej,15579,15580,31159
19486,,93m-8tcgxxuj,15580,15581,31161
19487,,2n4zczqyhzoj,15581,15582,31163
19488,,url:http://portal.acm.org/ft_gateway.cfm3fid3d102756126type3dpdf,15582,15583,31165
19489,,ltqrwntermej,15583,15584,31167
19490,,1q_lizvqpxyj,15584,15585,31169
19491,,xqaqrdmpxraj,15585,15586,31171
19492,,7obtxuqb9zsj,15586,15587,31173
19493,,ibabqalpkqmj,15587,15588,31175
19494,,_jhscsahbzoj,15588,15589,31177
19495,,msped445fc4j,15589,15590,31179
19496,,l0jssvdy8byj,15590,15591,31181
19497,,deoxi_xiyjsj,15591,15592,31183
19498,,zut79enwu2wj,15592,15593,31185
19499,,wiyyl_l8_ekj,15593,15594,31187
19500,,ptcc-gk4ttaj,15594,15595,31189
19501,,pky-zrh2jz8j,15595,15596,31191
19502,,nroxho4lrluj,15596,15597,31193
19503,,gzmcrxdglhkj,15597,15598,31195
19504,,tnm6xanct2qj,15598,15599,31197
19505,,i_zx5psirtsj,15599,15600,31199
19506,,knkwxvsxn_wj,15600,15601,31201
19507,,thnjdcbx7asj,15601,15602,31203
19508,,lalxw26xdc8j,15603,15604,31207
19509,,9p1lvaca-syj,15604,15605,31209
19510,,u1w-f1pc86aj,15605,15606,31211
19511,,8qkleszxbfuj,15606,15607,31213
19512,,b3h6yt4f7haj,15607,15608,31215
19513,,ou4vc37qvrwj,15608,15609,31217
19514,,tjh6t8rxccej,15609,15610,31219
19515,,humgow9xoxuj,15610,15611,31221
19516,,bgv1j_df7h0j,15611,15612,31223
19517,,yzl3kfsz8scj,15612,15613,31225
19518,,mt_gjpl6jg4j,15613,15614,31227
19519,,hche27bug3wj,15614,15615,31229
19520,,ntwtuze3igsj,15615,15616,31231
19521,,pccbpzdgxi0j,15616,15617,31233
19522,,hjnq2nu_gswj,15617,15618,31235
19523,,dbnnmgatnkgj,15618,15619,31237
19524,,krefjtcaz7qj,15619,15620,31239
19525,,jhxnjbt32mqj,15620,15621,31241
19526,,-1aoy3pyl-uj,15621,15622,31243
19527,,jroji2ibqgoj,15622,15623,31245
19528,,asptw8cof78j,15623,15624,31247
19529,,03pfcjvk3csj,15624,15625,31249
19530,,qfo6im0vz7cj,15625,15626,31251
19531,,nv5ccoyu-aej,15626,15627,31253
19532,,htez7173obuj,15627,15628,31255
19533,,1lmeltvztagj,15628,15629,31257
19534,,x78freoi9agj,15629,15630,31259
19535,,mtu_663p5nuj,15630,15631,31261
19536,,jac8zogayu4j,15631,15632,31263
19537,,_nb-elj_os4j,15632,15633,31265
19538,,bzfufq7c8iwj,15633,15634,31267
19539,,5m--u1ysiw0j,15634,15635,31269
19540,,8yqbc_cl6xkj,15635,15636,31271
19541,,katemk2zdlsj,15636,15637,31273
19542,,zzul2dc1mpsj,15637,15638,31275
19543,,w7h1c8tmgpuj,15638,15639,31277
19544,,bnz-mc_1dpsj,15639,15640,31279
19545,,aqqdbp1kt6ij,15640,15641,31281
19546,,2upkpm-px10j,15641,15642,31283
19547,,,15642,15643,31285
19548,,vp6titghnc8j,15643,15644,31287
19549,,tg9fehnwmtwj,15644,15645,31289
19550,,utpciba2_gmj,15645,15646,31291
19551,,nb7ni1bvhm8j,15646,15647,31293
19552,,bwavzena1mcj,15647,15648,31295
19553,,ijsnlufg9qqj,15648,15649,31297
19554,,-9vm9smz1waj,15649,15650,31299
19555,,r-y678jv0hij,15650,15651,31301
19556,,8gnypg_tklcj,15651,15652,31303
19557,,vt0c_ump_54j,15652,15653,31305
19558,,vqecw4_uq3uj,15653,15654,31307
19559,,jl9nm0ubwe0j,15654,15655,31309
19560,,nliedi5sslyj,15655,15656,31311
19561,,,15656,15657,31313
19562,,uv4aoyjjfw0j,15657,15658,31315
19563,,aumunbtf8muj,15658,15659,31317
19564,,w66ijdfg_fij,15659,15660,31319
19565,,wrbojc3rnj8j,15660,15661,31321
19566,,volfdgbw5rej,15661,15662,31323
19567,,9vlpunksytgj,15662,15663,31325
19568,,vie8npswdugj,15663,15664,31327
19569,,2byfxdowcuaj,15664,15665,31329
19570,,xvd_zq7hvt0j,15665,15666,31331
19571,,d5domeouvlcj,15666,15667,31333
19572,,1owhtjcesruj,15667,15668,31335
19573,,hr8rsyhoz0mj,15668,15669,31337
19574,,dhewjuotwd4j,15669,15670,31339
19575,,aepbjnyu1ymj,15670,15671,31341
19576,,bwwf8ipm0oqj,15671,15672,31343
19577,,l8coxijfuhuj,15672,15673,31345
19578,,em-7omguvegj,15673,15674,31347
19579,,ikvhad-sxmoj,15674,15675,31349
19580,,06ut4zq7xwqj,15675,15676,31351
19581,,ri-bp3d-gx0j,15676,15677,31353
19582,,0sn8rf60csuj,15677,15678,31355
19583,,iszcjbzlcfwj,15678,15679,31357
19584,,sxxy88miwdqj,15679,15680,31359
19585,,tsr9p6szvkaj,15680,15681,31361
19586,,bosz53dj-byj,15681,15682,31363
19587,,w7ly98xpm50j,15682,15683,31365
19588,,fqvwws6c9goj,15683,15684,31367
19589,,url:http://www.csa.com/partners/viewrecord.php3frequester3dgs26collection3dtrd26recid3dn9210465ah,15684,15685,31369
19590,,hszvxktum6gj,15685,15686,31371
19591,,poqjzvt0e7ij,15686,15687,31373
19592,,0fafnvdf-m4j,15687,15688,31375
19593,,wqciz2oyi1gj,15688,15689,31377
19594,,g2d6vvnccnmj,15689,15690,31379
19595,,url:http://www.springerlink.com/index/p60tr286834q08q6.pdf,15690,15691,31381
19596,,hqrjor6tvvoj,15691,15692,31383
19597,,ha81c9c7ciyj,15692,15693,31385
19598,,pzsqgfmngoqj,15693,15694,31387
19599,,i10xjkqgxcuj,15694,15695,31389
19600,,qjbj3rfmwnwj,15695,15696,31391
19601,,mgdi-lnj27qj,15696,15697,31393
19602,,oage_9itk1aj,15697,15698,31395
19603,,mhcxtcivxgyj,15698,15699,31397
19604,,pjc8xwhcogqj,15699,15700,31399
19605,,y3phtjfi5wsj,15700,15701,31401
19606,,q-jysic4hvyj,15701,15702,31403
19607,,zhgvo5qt1_gj,15702,15703,31405
19608,,4akbydagcmcj,15703,15704,31407
19609,,ukk2l4shp4uj,15704,15705,31409
19610,,rasjfgyakw4j,15705,15706,31411
19611,,vzgzhgpriquj,15706,15707,31413
19612,,0hw6fnqq9dcj,15707,15708,31415
19613,,vubne87zuy8j,15708,15709,31417
19614,,doktjmhhyasj,15709,15710,31419
19615,,qdw5im0akwaj,15710,15711,31421
19616,,zveojbkptvij,15711,15712,31423
19617,,w80mxqqqb3kj,15712,15713,31425
19618,,hk74afbg-maj,15713,15714,31427
19619,,cijk-bam9wuj,15714,15715,31429
19620,,poso7akokfmj,15715,15716,31431
19621,,vtafw306basj,15716,15717,31433
19622,,url:http://doi.wiley.com/10.1002/ace.8108,15717,15718,31435
19623,,u58hqyczcskj,15718,15719,31437
19624,,v4kytzuj7q4j,15719,15720,31439
19625,,e78e6bfxvpej,15720,15721,31441
19626,,s6rloarzhx0j,15721,15722,31443
19627,,,15722,15723,31445
19628,,g2ux7pilomqj,15723,15724,31447
19629,,fdr5syzt9asj,15724,15725,31449
19630,,prhhhaml938j,15725,15726,31451
19631,,x3yn4b0gfoij,15726,15727,31453
19632,,_n58hxjew_qj,15727,15728,31455
19633,,855brcgdt2oj,15728,15729,31457
19634,,1k6nrg90ogoj,15729,15730,31459
19635,,kj_37halhguj,15730,15731,31461
19636,,riac3ou0il8j,15731,15732,31463
19637,,j65pdb9bovgj,15732,15733,31465
19638,,i0yhejviahkj,15733,15734,31467
19639,,xzucj1zb7swj,15734,15735,31469
19640,,loocanixn20j,15735,15736,31471
19641,,_oluth_bifoj,15736,15737,31473
19642,,mcn_qtnifqgj,15737,15738,31475
19643,,qtixljb0b2qj,15738,15739,31477
19644,,lxor3uix5ksj,15739,15740,31479
19645,,p8rk-lyqxkqj,15740,15741,31481
19646,,1ufa_uhdjo4j,15741,15742,31483
19647,,7ci9z93tzkcj,15742,15743,31485
19648,,z3jus4k2yuej,15743,15744,31487
19649,,a4ntsz113eoj,15744,15745,31489
19650,,1gspba4ewb0j,15745,15746,31491
19651,,q4egd-b_7syj,15746,15747,31493
19652,,_letktrpybqj,15747,15748,31495
19653,,04l_friblbkj,15748,15749,31497
19654,,mlu0biublxaj,15749,15750,31499
19655,,url:http://doi.wiley.com/10.1002/ev.1275,15750,15751,31501
19656,,3hekjlbiumgj,15751,15752,31503
19657,,xnf3fonmlo4j,15752,15753,31505
19658,,b2xrmebctcgj,15753,15754,31507
19659,,url:http://portal.acm.org/ft_gateway.cfm3fid3d109964626type3dpdf,15754,15755,31509
19660,,zr3anxzk9bgj,15756,15757,31513
19661,,udy1chy0emej,15757,15758,31515
19662,,stsljcb9qfkj,15758,15759,31517
19663,,d4p4lheqfrkj,15759,15760,31519
19664,,fgpvjf3lgywj,15760,15761,31521
19665,,wddbb2fo8amj,15761,15762,31523
19666,,z9ubaha77gwj,15762,15763,31525
19667,,f2kx9os8owkj,15763,15764,31527
19668,,qh6r8ugw_l0j,15764,15765,31529
19669,,oc6h69g4caij,15765,15766,31531
19670,,t_z7qklgsouj,15766,15767,31533
19671,,3nv5zkdg9ryj,15767,15768,31535
19672,,2aumtpwby0ij,15768,15769,31537
19673,,qnotvit9xymj,15769,15770,31539
19674,,ftdeavdkhpsj,15770,15771,31541
19675,,p2fuinhghhaj,15771,15772,31543
19676,,9xxz5fxmlbqj,15772,15773,31545
19677,,ogrsw3ozniuj,15773,15774,31547
19678,,lgf8feh9lrkj,15774,15775,31549
19679,,b35hjnfotu0j,15775,15776,31551
19680,,,15776,15777,31553
19681,,dtzdng71p5oj,15777,15778,31555
19682,,km--vrbat6oj,15778,15779,31557
19683,,bvyxsfd0ikcj,15779,15780,31559
19684,,hdsg4cojka0j,15780,15781,31561
19685,,wie9qg5qc2wj,15781,15782,31563
19686,,32_pjlgfynmj,15782,15783,31565
19687,,wnqzxvlqeewj,15783,15784,31567
19688,,a6kvljyz48oj,15784,15785,31569
19689,,vdlr_uokegcj,15785,15786,31571
19690,,tld3ulbjxxej,15786,15787,31573
19691,,ahwjjxj0swgj,15787,15788,31575
19692,,o1nksdqwkp4j,15788,15789,31577
19693,,v7ehg_3x_ogj,15789,15790,31579
19694,,j8s_8yznunoj,15790,15791,31581
19695,,tko9coa1xqej,15791,15792,31583
19696,,l4ovivma5dgj,15792,15793,31585
19697,,exfpmimun-cj,15793,15794,31587
19698,,_vhk2kxqrjcj,15794,15795,31589
19699,,9zzumet53k4j,15795,15796,31591
19700,,7nkooptkoruj,15796,15797,31593
19701,,kqpbfn6tt3sj,15797,15798,31595
19702,,vtoazsxexvmj,15798,15799,31597
19703,,6qn_zrxdvp8j,15799,15800,31599
19704,,urmid2hwydij,15800,15801,31601
19705,,fngsgqsmshgj,15801,15802,31603
19706,,1fi22euok_8j,15802,15803,31605
19707,,cf8gu_w9acaj,15803,15804,31607
19708,,bn2rqunmf_kj,15804,15805,31609
19709,,ohjog-bi4ogj,15805,15806,31611
19710,,ap5xrkoacpej,15806,15807,31613
19711,,sxapsreh5zyj,15808,15809,31617
19712,,zvkqas0e9yej,15809,15810,31619
19713,,url:http://www.ingentaconnect.com/search/expand3fpub3dinfobike://pep/jae/2001/00000215/00000001/art0000826unc3d,15810,15811,31621
19714,,4mk0cvw924ej,15811,15812,31623
19715,,hresubvt4e8j,15812,15813,31625
19716,,utlpiocgytuj,15813,15814,31627
19717,,2dif85jqozwj,15814,15815,31629
19718,,wcrlru3vlmmj,15815,15816,31631
19719,,5bsr2okvx4qj,15816,15817,31633
19720,,ixhkryalhhcj,15817,15818,31635
19721,,hrr_ibvg0-yj,15818,15819,31637
19722,,7kqlmva_wqoj,15819,15820,31639
19723,,a3aecjj58nij,15820,15821,31641
19724,,txp1rzds768j,15822,15823,31645
19725,,wh0-twnenxqj,15823,15824,31647
19726,,ypvmmjpyyw4j,15824,15825,31649
19727,,bnnvklkjecmj,15825,15826,31651
19728,,01lhbmi_rucj,15826,15827,31653
19729,,url:http://links.jstor.org/sici3fsici3d0146-4949(196722)8253a3253c437253atanaso253e2.0.co253b2-w,15827,15828,31655
19730,,wg-9n3rtl1wj,15828,15829,31657
19731,,url:http://doi.wiley.com/10.1002/tl.189,15829,15830,31659
19732,,behzyidgvumj,15830,15831,31661
19733,,qwujmy5rqamj,15831,15832,31663
19734,,pepnhsyojfyj,15832,15833,31665
19735,,url:http://portal.acm.org/ft_gateway.cfm3fid3d108627126type3dpdf,15833,15834,31667
19736,,o7fq2f572xcj,15834,15835,31669
19737,,pl09fwxzad4j,15835,15836,31671
19738,,y3nt2k4jquyj,15836,15837,31673
19739,,vyo7tm5nwk8j,15837,15838,31675
19740,,hxteepiifw0j,15838,15839,31677
19741,,ijyunaacul8j,15841,15842,31683
19742,,vpow2m7-q0qj,15842,15843,31685
19743,,yfcrcoytl_gj,15843,15844,31687
19744,,z9iu12vlhtcj,15844,15845,31689
19745,,huveiyjoy7kj,15845,15846,31691
19746,,sbkzbikolr8j,15846,15847,31693
19747,,ufemz1p0w20j,15847,15848,31695
19748,,98sv6hcwa_mj,15848,15849,31697
19749,,8syw0gl_qzij,15849,15850,31699
19750,,ehpice4yspyj,15850,15851,31701
19751,,_lc5uqdhj0qj,15851,15852,31703
19752,,xdlyctbagkyj,15852,15853,31705
19753,,7rzchvgfj20j,15853,15854,31707
19754,,ifhcudppg8uj,15854,15855,31709
19755,,m5anip8mb6oj,15855,15856,31711
19756,,mecsc0tgwimj,15856,15857,31713
19757,,6vidynuddrqj,15857,15858,31715
19758,,oi4y1xxi2x8j,15858,15859,31717
19759,,hvahlguew64j,15859,15860,31719
19760,,pawpwv-ocvyj,15860,15861,31721
19761,,tg2wd85hslij,15861,15862,31723
19762,,lidzgawiziej,15862,15863,31725
19763,,budd10q1qryj,15863,15864,31727
19764,,wt0qa1pyrqij,15864,15865,31729
19765,,asb3rj6kdzsj,15865,15866,31731
19766,,x88zeyyav4ij,15866,15867,31733
19767,,url:http://portal.acm.org/ft_gateway.cfm3fid3d110191126type3dpdf,15867,15868,31735
19768,,lgsth5m4jpuj,15868,15869,31737
19769,,0bq67xdwducj,15869,15870,31739
19770,,i8fcpsrxezgj,15870,15871,31741
19771,,rip2ne68j3uj,15871,15872,31743
19772,,gwkmurgwrkij,15872,15873,31745
19773,,6d-ewyacoiwj,15873,15874,31747
19774,,fkvwjhf1ed4j,15874,15875,31749
19775,,bzipdm6gqxwj,15875,15876,31751
19776,,fkf2elpajdyj,15876,15877,31753
19777,,hdeg9vwtjzej,15877,15878,31755
19778,,qox3frqtn0ij,15878,15879,31757
19779,,1lrtrleyzioj,15879,15880,31759
19780,,d2jn9uoycbmj,15880,15881,31761
19781,,lbbcrihzidoj,15881,15882,31763
19782,,chkvuttcegej,15882,15883,31765
19783,,wn2bb8vaceaj,15883,15884,31767
19784,,8peiuplvqyej,15884,15885,31769
19785,,b-ej-kqxh_0j,15885,15886,31771
19786,,vulmwqhhy2yj,15886,15887,31773
19787,,ylvufg8epuaj,15887,15888,31775
19788,,_qx73aae_isj,15888,15889,31777
19789,,bvbeod4iwogj,15889,15890,31779
19790,,url:http://www.springerlink.com/index/jgp35l0664481167.pdf,15890,15891,31781
19791,,3hqna7oc7wmj,15891,15892,31783
19792,,5bb6cum7ytsj,15892,15893,31785
19793,,iagkrwody2sj,15893,15894,31787
19794,,3yyi2bz9em8j,15894,15895,31789
19795,,mbh4hdehmgoj,15895,15896,31791
19796,,iswrdvulwq0j,15896,15897,31793
19797,,z-x4xnf7joaj,15897,15898,31795
19798,,ge4cqu6atxoj,15898,15899,31797
19799,,mh7o45ehzwqj,15899,15900,31799
19800,,6cpbwaznmk4j,15900,15901,31801
19801,,v0qkn39nz6mj,15901,15902,31803
19802,,x5n075lvgbmj,15902,15903,31805
19803,,318znjwa2asj,15903,15904,31807
19804,,dc31capbpwaj,15904,15905,31809
19805,,1qo0chr9kggj,15905,15906,31811
19806,,vpy8dmldqsyj,15906,15907,31813
19807,,zmlgguhzbxqj,15907,15908,31815
19808,,njxb5u8sjvej,15908,15909,31817
19809,,mimzgez0sgmj,15909,15910,31819
19810,,uutpd29pwkaj,15910,15911,31821
19811,,4yghqbyhvfqj,15911,15912,31823
19812,,elcozkirocmj,15912,15913,31825
19813,,xcijeq2uhd0j,15913,15914,31827
19814,,hl1q4blvvlcj,15914,15915,31829
19815,,qflkiyy8vfyj,15915,15916,31831
19816,,zocf7dclwyyj,15917,15918,31835
19817,,kxu95jjnqqaj,15919,15920,31839
19818,,p9y-ootzq10j,15920,15921,31841
19819,,djmvginp75sj,15921,15922,31843
19820,,wey3cw9r6qoj,15922,15923,31845
19821,,iycu2st7hgyj,15923,15924,31847
19822,,hj2zufoc8poj,15924,15925,31849
19823,,21wvbg3nbwyj,15925,15926,31851
19824,,7gmhjs_ckzuj,15926,15927,31853
19825,,tmp3neemha4j,15927,15928,31855
19826,,_5qjkagvcp8j,15928,15929,31857
19827,,66qgx8axs88j,15929,15930,31859
19828,,qsd-ar0xjvgj,15930,15931,31861
19829,,y15stp2mm4sj,15931,15932,31863
19830,,0otziau5vxej,15932,15933,31865
19831,,st8wea8zclkj,15933,15934,31867
19832,,mizk11nh__wj,15934,15935,31869
19833,,fp9lj01muvaj,15935,15936,31871
19834,,_46yy0ftm4cj,15936,15937,31873
19835,,a7xpq3l0zwkj,15937,15938,31875
19836,,8syha0wriw0j,15938,15939,31877
19837,,pf2kif8rsfej,15939,15940,31879
19838,,qbkdezwb2acj,15940,15941,31881
19839,,y09refvrad0j,15941,15942,31883
19840,,6jyog902mgqj,15942,15943,31885
19841,,fp6yhjzp9f4j,15943,15944,31887
19842,,hmn2nv9qyrsj,15944,15945,31889
19843,,ipk1sirn8n4j,15945,15946,31891
19844,,v30beocmhj0j,15946,15947,31893
19845,,hzulupryvrwj,15947,15948,31895
19846,,nb9kvv7ss0uj,15948,15949,31897
19847,,url:http://doi.wiley.com/10.1002/he.170,15950,15951,31901
19848,,wrzruvgvfvoj,15951,15952,31903
19849,,itr3hhafvuoj,15952,15953,31905
19850,,dje6chdynf4j,15953,15954,31907
19851,,x_h_22mz4jij,15954,15955,31909
19852,,or70itjfmyij,15955,15956,31911
19853,,53-jpw0ljbcj,15956,15957,31913
19854,,ir0i5ervkuej,15957,15958,31915
19855,,9krxml2nvpej,15958,15959,31917
19856,,url:http://www.springerlink.com/index/g04g5w5401424278.pdf,15959,15960,31919
19857,,bttledivswcj,15960,15961,31921
19858,,4yvrgpbjubyj,15961,15962,31923
19859,,cwvbhxfmb4ij,15962,15963,31925
19860,,lstkkcxyrc0j,15963,15964,31927
19861,,g5qoylzlz9qj,15964,15965,31929
19862,,4-wzepckrykj,15965,15966,31931
19863,,id9znxrwkrqj,15966,15967,31933
19864,,ffejoa7j2icj,15967,15968,31935
19865,,2zb6aru_cj0j,15968,15969,31937
19866,,szno-qqmamij,15969,15970,31939
19867,,zti_jtk81ccj,15970,15971,31941
19868,,rerwdc7dpzuj,15971,15972,31943
19869,,ahcqhgpzajkj,15972,15973,31945
19870,,syqabdl4m5ij,15973,15974,31947
19871,,bk7fzypsww8j,15974,15975,31949
19872,,jex1usoqklqj,15975,15976,31951
19873,,k8e-lzap4lmj,15976,15977,31953
19874,,mkkof6et-pqj,15977,15978,31955
19875,,wv-rqimfk_cj,15978,15979,31957
19876,,ghuvr4jguucj,15979,15980,31959
19877,,fteydizbfxij,15980,15981,31961
19878,,lx4x69chcm4j,15981,15982,31963
19879,,jb15nc4_qrij,15982,15983,31965
19880,,gxwvgorofbwj,15983,15984,31967
19881,,wsrguwz5atej,15984,15985,31969
19882,,0jjrn3f66bcj,15985,15986,31971
19883,,zh5xii4n3kcj,15986,15987,31973
19884,,u48dkyccnisj,15987,15988,31975
19885,,mx6mx-rennkj,15988,15989,31977
19886,,zve6bl5nfb8j,15989,15990,31979
19887,,n0shzjv0cqmj,15990,15991,31981
19888,,vwmcdcxctgaj,15991,15992,31983
19889,,wep7qniyugmj,15992,15993,31985
19890,,u4al8bduxvwj,15993,15994,31987
19891,,,15994,15995,31989
19892,,t7hbl2vkohsj,15995,15996,31991
19893,,0hstglvazvqj,15996,15997,31993
19894,,yv4egkg8nz4j,15997,15998,31995
19895,,ukibipsqztyj,15998,15999,31997
19896,,2fuu_gsquzqj,15999,16000,31999
19897,,5pwgjkpz1csj,16000,16001,32001
19898,,kylm_249dhcj,16001,16002,32003
19899,,itfn3t6gqpsj,16002,16003,32005
19900,,bktulupjlqyj,16003,16004,32007
19901,,p5ilenxkeikj,16004,16005,32009
19902,,url:http://portal.acm.org/citation.cfm3fid3d234286.1057811,16005,16006,32011
19903,,xwp9g_lsnwwj,16006,16007,32013
19904,,erdppb4h388j,16007,16008,32015
19905,,url:http://portal.acm.org/ft_gateway.cfm3fid3d94480526type3dpdf26dl3dguide26dl3dacm26cfid3d1111111126cftoken3d2222222,16008,16009,32017
19906,,o696r1xhjcsj,16009,16010,32019
19907,,y43htorzqpqj,16010,16011,32021
19908,,ljghnrzhjwaj,16011,16012,32023
19909,,bjnkeuwezbkj,16012,16013,32025
19910,,spyzycnzl6oj,16013,16014,32027
19911,,rp6sjs_yx7qj,16014,16015,32029
19912,,b9jfbualtnwj,16015,16016,32031
19913,,abdho6cfs3oj,16016,16017,32033
19914,,kajqt-chlo8j,16017,16018,32035
19915,,pgwozwticbcj,16018,16019,32037
19916,,op_cxk6lmfkj,16019,16020,32039
19917,,xsnx1y_abiuj,16020,16021,32041
19918,,y7k7vld_n3aj,16021,16022,32043
19919,,otutdbprh7aj,16022,16023,32045
19920,,unhqvhpghssj,16023,16024,32047
19921,,fixl60dsbqgj,16024,16025,32049
19922,,fv3u0gkve5cj,16025,16026,32051
19923,,nsv1rzxauaqj,16026,16027,32053
19924,,dscnvgbtwumj,16027,16028,32055
19925,,eq04gzbfftij,16028,16029,32057
19926,,zhyubpzrycoj,16029,16030,32059
19927,,mrgaankgkxaj,16030,16031,32061
19928,,a2qofwsjc1aj,16031,16032,32063
19929,,ipdlpwo5p7kj,16032,16033,32065
19930,,goq6z9bdessj,16033,16034,32067
19931,,jijgbmwo0laj,16034,16035,32069
19932,,7rj35wbjooaj,16035,16036,32071
19933,,cgxnsyd3roaj,16036,16037,32073
19934,,ls71fwq4uhqj,16037,16038,32075
19935,,vl_9ka2huvej,16038,16039,32077
19936,,bvkl3hdkbpqj,16039,16040,32079
19937,,q9nop94la4qj,16040,16041,32081
19938,,nf_jjbhsvqyj,16041,16042,32083
19939,,gdsck5-abuqj,16042,16043,32085
19940,,,16043,16044,32087
19941,,fj6g74auxzwj,16044,16045,32089
19942,,pj51rsw9mioj,16045,16046,32091
19943,,3p2a2zkrcjcj,16046,16047,32093
19944,,fbu3zpbbd7oj,16047,16048,32095
19945,,x0dwqj_ukdej,16048,16049,32097
19946,,i8ps-v_ob2qj,16049,16050,32099
19947,,lq95ovnapamj,16050,16051,32101
19948,,rh9r7dvlscwj,16051,16052,32103
19949,,azywspmzne8j,16052,16053,32105
19950,,k8dgppkml38j,16053,16054,32107
19951,,qqhuzisrb_qj,16054,16055,32109
19952,,hm9bhfqbowcj,16055,16056,32111
19953,,6pfl0_3yrg4j,16056,16057,32113
19954,,url:http://portal.acm.org/citation.cfm3fid3d375487,16057,16058,32115
19955,,xc3jcwi83h8j,16058,16059,32117
19956,,m2ljbrznfp0j,16059,16060,32119
19957,,uddpcs8sznyj,16060,16061,32121
19958,,gx9rddjxllsj,16062,16063,32125
19959,,hfjyiww4py8j,16063,16064,32127
19960,,url:http://portal.acm.org/citation.cfm3fid3d100215.100277,16064,16065,32129
19961,,p1olyom43iij,16065,16066,32131
19962,,a46cpxem-8aj,16066,16067,32133
19963,,tbfu95ehbhkj,16067,16068,32135
19964,,hvmk4a5mtlwj,16068,16069,32137
19965,,qddsuyqoa2aj,16069,16070,32139
19966,,lfqkjnuytuyj,16070,16071,32141
19967,,k64ynkr0aiuj,16071,16072,32143
19968,,m_v3o_hpndwj,16072,16073,32145
19969,,,16073,16074,32147
19970,,wdlzjxgp84wj,16074,16075,32149
19971,,fnr8uyjp_34j,16075,16076,32151
19972,,xiysznb_jnmj,16076,16077,32153
19973,,v_orv43rnwoj,16077,16078,32155
19974,,url:http://links.jstor.org/sici3fsici3d0146-4949(196721)8253a2253c294253atfoaiv253e2.0.co253b2-v,16078,16079,32157
19975,,gwmkwdbpqtcj,16079,16080,32159
19976,,jsyfx5bxdc0j,16080,16081,32161
19977,,url:http://portal.acm.org/ft_gateway.cfm3fid3d4420826type3dpdf26coll3dguide26dl3dguide26cfid3d1111111126cftoken3d2222222,16081,16082,32163
19978,,fvdqo5uisw0j,16082,16083,32165
19979,,rpfzhak0zmuj,16083,16084,32167
19980,,e5ymua3cxzwj,16084,16085,32169
19981,,hpkd8asrxfoj,16085,16086,32171
19982,,dtlssyyxh1oj,16086,16087,32173
19983,,hmedvg59ouej,16087,16088,32175
19984,,bf9yikyttrgj,16088,16089,32177
19985,,zzilqo12jwaj,16089,16090,32179
19986,,v9dtpf650tyj,16090,16091,32181
19987,,dsg3mzfugicj,16091,16092,32183
19988,,v3rtp8pwiumj,16092,16093,32185
19989,,ovkdd7s-jlwj,16093,16094,32187
19990,,gnv2pqaxwp4j,16094,16095,32189
19991,,824mvopqxr4j,16095,16096,32191
19992,,wr3tozt427ej,16096,16097,32193
19993,,dqw08qhbbaqj,16097,16098,32195
19994,,-5udpmt-zxaj,16098,16099,32197
19995,,tdmgjmcghq8j,16099,16100,32199
19996,,rwrijaewquij,16100,16101,32201
19997,,lh0ixsbw5nqj,16101,16102,32203
19998,,8p8p-j8rwigj,16102,16103,32205
19999,,url:http://adsabs.harvard.edu/abs/1976scom.nasa..323l,16103,16104,32207
20000,,wdn1ji9t01yj,16104,16105,32209
20001,,nkgtdkfun98j,16105,16106,32211
20002,,g2ss4zixgpij,16106,16107,32213
20003,,kzy7c62zsqqj,16107,16108,32215
20004,,-8iwydje7fgj,16108,16109,32217
20005,,5ottaqklmfkj,16109,16110,32219
20006,,fzeew875gyoj,16110,16111,32221
20007,,9ho84ho6xuij,16111,16112,32223
20008,,url:http://portal.acm.org/citation.cfm3fid3d601858.60187026dl3dguide26dl3dacm26type3dissue26idx3dj68926part3dperiodical26wanttype3dperiodical26title3dacm2520sigmod2520record26cfid3d1111111126cftoken3d2222222,16112,16113,32225
20009,,url:http://doi.wiley.com/10.1002/he.10807,16113,16114,32227
20010,,url:http://adsabs.harvard.edu/abs/1980phdt.......132s,16114,16115,32229
20011,,epiexgnmcpij,16115,16116,32231
20012,,ozdfjspxta8j,16116,16117,32233
20013,,rgxwjhamgj8j,16117,16118,32235
20014,,zmjm73vkpc8j,16118,16119,32237
20015,,nc3gr_8se14j,16119,16120,32239
20016,,suz7-ncndmwj,16120,16121,32241
20017,,saxzdcbvmpyj,16121,16122,32243
20018,,ww7fnk4jdxij,16122,16123,32245
20019,,orjqm7ybedkj,16123,16124,32247
20020,,url:http://portal.acm.org/citation.cfm3fid3d171926.172005,16124,16125,32249
20021,,j9spz8fybjmj,16125,16126,32251
20022,,url:http://portal.acm.org/ft_gateway.cfm3fid3d26276326type3dpdf26dl3dportal26dl3dacm26cfid3d1111111126cftoken3d2222222,16126,16127,32253
20023,,kwlr4c-chhgj,16127,16128,32255
20024,,28i36c1jwuij,16128,16129,32257
20025,,a8g-kagvwxkj,16129,16130,32259
20026,,z-gk26rl-oyj,16130,16131,32261
20027,,bbtbfgnfidij,16131,16132,32263
20028,,jzpk0yns5xwj,16132,16133,32265
20029,,iw-jetla8xyj,16133,16134,32267
20030,,6ckvyvb6w1mj,16135,16136,32271
20031,,ew3dddilucmj,16136,16137,32273
20032,,gvelinclwj4j,16137,16138,32275
20033,,a671xynkkwmj,16138,16139,32277
20034,,url:http://doi.wiley.com/10.1002/he.65,16139,16140,32279
20035,,fbnhndj2zumj,16140,16141,32281
20036,,fficvgwnn2uj,16141,16142,32283
20037,,67xiv9syde8j,16142,16143,32285
20038,,zr1ee2rhb8ij,16143,16144,32287
20039,,mcdhqguny4aj,16144,16145,32289
20040,,muohn6oe7d4j,16145,16146,32291
20041,,hu4si0syzxej,16146,16147,32293
20042,,bdtfp97-jh4j,16147,16148,32295
20043,,bwvwx1yw13uj,16148,16149,32297
20044,,,16149,16150,32299
20045,,xmz0b0ynt_0j,16150,16151,32301
20046,,bvjpf-psndwj,16151,16152,32303
20047,,tyzv-atlz5sj,16152,16153,32305
20048,,url:http://doi.wiley.com/10.1002/ace.181,16153,16154,32307
20049,,url:http://www.springerlink.com/index/v4wk204141k4224g.pdf,16154,16155,32309
20050,,r-fjeojvgx8j,16155,16156,32311
20051,,fdwrdbtd0y8j,16156,16157,32313
20052,,8xcekpxj_zmj,16157,16158,32315
20053,,zknlflrnqlyj,16158,16159,32317
20054,,yb_ptqzvrhgj,16159,16160,32319
20055,,cnwmaaxcmxcj,16160,16161,32321
20056,,e_fleaf9oxij,16161,16162,32323
20057,,407kt47ecbqj,16162,16163,32325
20058,,y1scguhv0r0j,16163,16164,32327
20059,,w27_8xq-kn0j,16164,16165,32329
20060,,fc7f6_y4arkj,16165,16166,32331
20061,,cvr8akhqguej,16167,16168,32335
20062,,36mkrlstxhgj,16168,16169,32337
20063,,,16169,16170,32339
20064,,url:http://www.springerlink.com/index/g541544051u4243l.pdf,16170,16171,32341
20065,,zncz2arvcngj,16171,16172,32343
20066,,xbgfwnsn1kgj,16172,16173,32345
20067,,2mlzdn5j4huj,16173,16174,32347
20068,,iobvfqurylsj,16174,16175,32349
20069,,f5vdygl0auoj,16175,16176,32351
20070,,mpqzdrd7gy4j,16176,16177,32353
20071,,ywqwb9uowboj,16177,16178,32355
20072,,qgk3kneo8baj,16178,16179,32357
20073,,9zl8dzcrapmj,16179,16180,32359
20074,,udrd9rslcsoj,16180,16181,32361
20075,,ww2cxjcv-kij,16181,16182,32363
20076,,2b9zixpv7y0j,16182,16183,32365
20077,,rcypcvntz-0j,16183,16184,32367
20078,,vd-lspzc0cyj,16184,16185,32369
20079,,adwp0um3hxoj,16185,16186,32371
20080,,ywhrhiebpesj,16186,16187,32373
20081,,url:http://www.csa.com/partners/viewrecord.php3frequester3dgs26collection3dtrd26recid3d155961ws26recid3d199301550080md,16187,16188,32375
20082,,mlv1zjahddqj,16188,16189,32377
20083,,ynzeilitbbcj,16189,16190,32379
20084,,hsq4rvfsznej,16190,16191,32381
20085,,yr1xd2mkj9gj,16191,16192,32383
20086,,qpz-h9dk1g8j,16192,16193,32385
20087,,ldndhfprlzij,16193,16194,32387
20088,,5bodh9368rsj,16194,16195,32389
20089,,aswtcbnd13oj,16195,16196,32391
20090,,igise4swpsgj,16196,16197,32393
20091,,rjxsukljgkwj,16198,16199,32397
20092,,ncpvdrhurfgj,16199,16200,32399
20093,,4ii_ikrc5ouj,16200,16201,32401
20094,,uu4g8clwdssj,16201,16202,32403
20095,,qv9jua63nqmj,16202,16203,32405
20096,,rkbktlwjdlej,16203,16204,32407
20097,,vnal7p8vrqwj,16204,16205,32409
20098,,ttrwurkbfqwj,16205,16206,32411
20099,,url:http://doi.wiley.com/10.1002/ace.7608,16206,16207,32413
20100,,ricupzrn7ugj,16207,16208,32415
20101,,url:http://portal.acm.org/citation.cfm3fid3d115586.11559426dl3dguide26dl3dacm26cfid3d1111111126cftoken3d2222222,16208,16209,32417
20102,,hlqjgqcsurij,16209,16210,32419
20103,,wnroch9athuj,16210,16211,32421
20104,,uez2o2h3vwej,16211,16212,32423
20105,,pcd9d9ggtpaj,16212,16213,32425
20106,,p3foio7t1nej,16213,16214,32427
20107,,6vthcplapb8j,16214,16215,32429
20108,,tbwicq3hzlsj,16215,16216,32431
20109,,kdouyakgdoaj,16216,16217,32433
20110,,6tkhh2v6-gaj,16217,16218,32435
20111,,sa27duhoq-yj,16218,16219,32437
20112,,ruyzeea-uv4j,16219,16220,32439
20113,,rok09garwdcj,16220,16221,32441
20114,,h7ocunghod4j,16221,16222,32443
20115,,iqzkz8yhxqij,16222,16223,32445
20116,,tbx6rkvsu0ej,16223,16224,32447
20117,,jwt6z9eshq8j,16224,16225,32449
20118,,jrhccv5j998j,16225,16226,32451
20119,,cmtxptuftbwj,16226,16227,32453
20120,,lc6l0gwp1uqj,16227,16228,32455
20121,,gq6vhpehg34j,16228,16229,32457
20122,,feoxdaghgcmj,16229,16230,32459
20123,,ksq84zxawkaj,16230,16231,32461
20124,,homdbkn2rnuj,16231,16232,32463
20125,,jdw1wtgb6usj,16232,16233,32465
20126,,cueom_bybbuj,16233,16234,32467
20127,,7esq5yhi4xoj,16234,16235,32469
20128,,pyvcyarswcgj,16235,16236,32471
20129,,fxv7mnacsmaj,16236,16237,32473
20130,,mn7s9idhuuwj,16237,16238,32475
20131,,ojg2lyjpao4j,16239,16240,32479
20132,,e_gwa7uxfncj,16240,16241,32481
20133,,q91fmdojesij,16241,16242,32483
20134,,kqjw4bza8coj,16242,16243,32485
20135,,glqzlfsbgqqj,16243,16244,32487
20136,,url:http://journals.iucr.org/c/issues/1989/03/00/pa0026/pa0026.pdf,16245,16246,32491
20137,,j7qtltq4a5sj,16246,16247,32493
20138,,3i3b-yl9fwkj,16247,16248,32495
20139,,5rhlmak0sv8j,16248,16249,32497
20140,,oaydvuvtlvcj,16249,16250,32499
20141,,74uibvndzckj,16250,16251,32501
20142,,2m0ufnbcxiyj,16251,16252,32503
20143,,epp4t-fp2mgj,16252,16253,32505
20144,,9e6gfbzxs60j,16253,16254,32507
20145,,xak3v_peqboj,16254,16255,32509
20146,,i53lgrenfgij,16255,16256,32511
20147,,_nchwjehhnuj,16256,16257,32513
20148,,ntu7puukm1wj,16257,16258,32515
20149,,dzn_otqrukaj,16258,16259,32517
20150,,0_7deyfvyf4j,16259,16260,32519
20151,,0dzethoqxqyj,16260,16261,32521
20152,,hcymhhgbthuj,16261,16262,32523
20153,,xwos0jyf98aj,16262,16263,32525
20154,,puzvbrkqtmej,16263,16264,32527
20155,,8hy7odm8fsej,16264,16265,32529
20156,,4ujiqkvbdfwj,16265,16266,32531
20157,,4v14-g1tuaqj,16266,16267,32533
20158,,yfhkqpvsqjmj,16267,16268,32535
20159,,url:http://portal.acm.org/citation.cfm3fid3d171926.171986,16268,16269,32537
20160,,ftlo7-c9ze0j,16269,16270,32539
20161,,1asyjgfrykwj,16270,16271,32541
20162,,url:http://ieeexplore.ieee.org/iel1/2206/935/00024752.pdf3farnumber3d24752,16271,16272,32543
20163,,url:http://links.jstor.org/sici3fsici3d0146-4949(196523)6253a3253c330253aagttvc253e2.0.co253b2-e,16272,16273,32545
20164,,mfsjfsnwazaj,16273,16274,32547
20165,,ijdg4r1pw6ej,16274,16275,32549
20166,,smyplu4fnmkj,16275,16276,32551
20167,,,16276,16277,32553
20168,,rlq1xkhzkswj,16277,16278,32555
20169,,jumkfbhxpxij,16278,16279,32557
20170,,rgf2mq3nmduj,16279,16280,32559
20171,,vhkqft1ljfoj,16280,16281,32561
20172,,gur5qhwpbjoj,16281,16282,32563
20173,,75h2x_hf5jwj,16282,16283,32565
20174,,b3xgspvm-rmj,16283,16284,32567
20175,,3u8cz0tpopmj,16284,16285,32569
20176,,4u6wugqkfqgj,16285,16286,32571
20177,,axruad-82zej,16286,16287,32573
20178,,xnffbf2sn0aj,16287,16288,32575
20179,,kgzigbgduusj,16288,16289,32577
20180,,antpmko9lpqj,16289,16290,32579
20181,,ajdz2jgp6roj,16290,16291,32581
20182,,bmcp1npdmroj,16292,16293,32585
20183,,lexypq6db4sj,16293,16294,32587
20184,,ebdl-ruuejwj,16294,16295,32589
20185,,wojiunellfcj,16295,16296,32591
20186,,19e7irfoidaj,16296,16297,32593
20187,,7mxdrwtixkmj,16297,16298,32595
20188,,pgqisjrfoiwj,16298,16299,32597
20189,,m1tbbe85xdej,16299,16300,32599
20190,,uycptr5ltvaj,16300,16301,32601
20191,,jeaubhhji3gj,16301,16302,32603
20192,,d0xkggmvwwkj,16302,16303,32605
20193,,s8db_6nedd8j,16303,16304,32607
20194,,jydsemcpdiij,16304,16305,32609
20195,,uibe8em86aqj,16305,16306,32611
20196,,1sxhj7gmbh0j,16306,16307,32613
20197,,drlybzxljq0j,16307,16308,32615
20198,,url:http://adsabs.harvard.edu/abs/1982mit..reptr....a,16308,16309,32617
20199,,vursrq14dlkj,16309,16310,32619
20200,,url:http://portal.acm.org/citation.cfm3fid3d130318,16310,16311,32621
20201,,as49ggz1p4sj,16311,16312,32623
20202,,n_itns12diij,16312,16313,32625
20203,,jbaw-yysm3kj,16313,16314,32627
20204,,n22438dwebej,16314,16315,32629
20205,,auxlw3dihgkj,16315,16316,32631
20206,,hl1ayzqgevgj,16316,16317,32633
20207,,ktp2s_xbxfyj,16317,16318,32635
20208,,i85gz6dhxu4j,16318,16319,32637
20209,,xkyrurutdjyj,16319,16320,32639
20210,,pcb7mqmaglij,16320,16321,32641
20211,,8qcy3n8lclkj,16321,16322,32643
20212,,fsrynxbgwhoj,16322,16323,32645
20213,,hzcl-_ttoguj,16323,16324,32647
20214,,qai7h7f1vo8j,16324,16325,32649
20215,,wckfqhu2mpij,16325,16326,32651
20216,,n1ixxafad_ej,16326,16327,32653
20217,,f5x4jzw0pkaj,16327,16328,32655
20218,,323doamqyukj,16328,16329,32657
20219,,lywmvfzbkqyj,16329,16330,32659
20220,,umgxlkvzlouj,16331,16332,32663
20221,,fzk8kuqnogoj,16332,16333,32665
20222,,3obt47pmeloj,16333,16334,32667
20223,,w27kfdqwtzmj,16334,16335,32669
20224,,vpzpofcefvkj,16335,16336,32671
20225,,url:http://portal.acm.org/ft_gateway.cfm3fid3d105784426type3dpdf,16336,16337,32673
20226,,hgjyiuitn7qj,16338,16339,32677
20227,,giyusdnwbgkj,16339,16340,32679
20228,,o7gtopxljuej,16340,16341,32681
20229,,gxes8wt6-hij,16341,16342,32683
20230,,oosl-xz_0asj,16342,16343,32685
20231,,imfilfjtgpqj,16343,16344,32687
20232,,t75dvutvzmsj,16344,16345,32689
20233,,mb5vngge7lij,16345,16346,32691
20234,,brpqyi2zluyj,16347,16348,32695
20235,,pvtdsexw0x4j,16348,16349,32697
20236,,t9e1f-xi0vsj,16349,16350,32699
20237,,lv8gg70y2e8j,16350,16351,32701
20238,,autjsnq_yw8j,16351,16352,32703
20239,,b0-vba1gmgij,16352,16353,32705
20240,,fs6ypswubsqj,16353,16354,32707
20241,,url:http://portal.acm.org/citation.cfm3fid3d601858.60186626dl3dguide26dl3dacm26idx3dj68926part3dperiodical26wanttype3dperiodical26title3dacm2520sigmod2520record26cfid3d1111111126cftoken3d2222222,16354,16355,32709
20242,,xjdibtjyeccj,16355,16356,32711
20243,,url:http://portal.acm.org/ft_gateway.cfm3fid3d27109526type3dpdf26coll3dguide26dl3dacm26cfid3d1111111126cftoken3d2222222,16356,16357,32713
20244,,url:http://www.csa.com/partners/viewrecord.php3frequester3dgs26collection3dtrd26recid3d017509530283ai,16357,16358,32715
20245,,dn-kpzs2c6kj,16358,16359,32717
20246,,gv9hpk_0ma0j,16359,16360,32719
20247,,cy8vdliamc8j,16360,16361,32721
20248,,ywlzbmqlybyj,16361,16362,32723
20249,,cuimhhbsog0j,16362,16363,32725
20250,,qrjigok_d7sj,16363,16364,32727
20251,,4alhowrr1qij,16364,16365,32729
20252,,rlmyzvai5twj,16366,16367,32733
20253,,6rctxplrgoej,16367,16368,32735
20254,,nkfk-7gpueaj,16368,16369,32737
20255,,bueuz9nleowj,16370,16371,32741
20256,,sbmiqfufjcoj,16371,16372,32743
20257,,dsfop23vvooj,16372,16373,32745
20258,,ndt3gystiwuj,16373,16374,32747
20259,,ujmkcabolbij,16374,16375,32749
20260,,0_uoc-dg-10j,16375,16376,32751
20261,,ayjjqaaewzgj,16376,16377,32753
20262,,4jic_ipfpz4j,16377,16378,32755
20263,,7koxam-h-dkj,16378,16379,32757
20264,,azxizibnscaj,16379,16380,32759
20265,,dhmtzf9zwhoj,16380,16381,32761
20266,,glegukmeie8j,16381,16382,32763
20267,,5zv9gjzxmuuj,16382,16383,32765
20268,,lcnskflghy4j,16383,16384,32767
20269,,cotftaszhlsj,16384,16385,32769
20270,,jmqpp-hiodij,16385,16386,32771
20271,,hbvadrgpmhcj,16386,16387,32773
20272,,vzkepcbaulyj,16387,16388,32775
20273,,url:http://portal.acm.org/citation.cfm3fid3d192593.19737426dl3dguide26dl3dacm26type3dseries26idx3d19259326part3dproceedings26wanttype3dproceedings26title3dinternational2520multimedia2520conference26cfid3d1111111126cftoken3d2222222,16388,16389,32777
20274,,lf1uilor_imj,16389,16390,32779
20275,,ufppfhs22jmj,16390,16391,32781
20276,,url:http://www.geography.org.uk/journals/journals.asp3farticleid3d54,16391,16392,32783
20277,,tesn5q2_vbqj,16392,16393,32785
20278,,url:http://portal.acm.org/citation.cfm3fid3d51708.5171126dl3dguide26dl3dacm26idx3dj68926part3dperiodical26wanttype3dperiodical26title3dacm2520sigmod2520record26cfid3d1111111126cftoken3d2222222,16393,16394,32787
20279,,c3kz7s6atlaj,16394,16395,32789
20280,,qoncunrkn-uj,16395,16396,32791
20281,,g9gbhr2zsrej,16396,16397,32793
20282,,qdyhpqjp2wij,16397,16398,32795
20283,,7pz0umewm6aj,16398,16399,32797
20284,,ln1twlaua0wj,16399,16400,32799
20285,,qmkujaty3rwj,16400,16401,32801
20286,,url:http://portal.acm.org/citation.cfm3fid3d64105226dl3dacm26coll3dguide26cfid3d1111111126cftoken3d2222222,16401,16402,32803
20287,,izeipqavsoaj,16402,16403,32805
20288,,,16403,16404,32807
20289,,c9v77-wqy9cj,16404,16405,32809
20290,,-4v2r988irij,16405,16406,32811
20291,,url:http://links.jstor.org/sici3fsici3d0146-4949(196424252f21)5253a1253c18253astotto253e2.0.co253b2-n,16406,16407,32813
20292,,pp6hfkvpyeqj,16407,16408,32815
20293,,jtrpl_scfmaj,16408,16409,32817
20294,,url:http://www.csa.com/partners/viewrecord.php3frequester3dgs26collection3dtrd26recid3dn9210389ah,16409,16410,32819
20295,,url:http://portal.acm.org/citation.cfm3fid3d592095.592167,16410,16411,32821
20296,,28y7gajrrkuj,16412,16413,32825
20297,,agylxvkxhsej,16413,16414,32827
20298,,nrfpt8fl5nmj,16414,16415,32829
20299,,kip3ksu4whsj,16415,16416,32831
20300,,ltwjvjtpfskj,16416,16417,32833
20301,,a4swprkfweaj,16417,16418,32835
20302,,4ezt2vjoz0gj,16418,16419,32837
20303,,t3vtic6lil4j,16419,16420,32839
20304,,zrkqkjua2-aj,16420,16421,32841
20305,,qxdm4cqih2oj,16421,16422,32843
20306,,ydimm-unsjqj,16422,16423,32845
20307,,,16423,16424,32847
20308,,j9rq1cttbbkj,16424,16425,32849
20309,,eekt8czslewj,16425,16426,32851
20310,,8zjoebxx2h0j,16426,16427,32853
20311,,4jflbgjzq6aj,16427,16428,32855
20312,,m4ingypidcqj,16428,16429,32857
20313,,owljdxoihw0j,16429,16430,32859
20314,,jxj3-eseyokj,16430,16431,32861
20315,,umzo68dtzywj,16431,16432,32863
20316,,okbkn9d4pscj,16432,16433,32865
20317,,itvqfwqrtoqj,16433,16434,32867
20318,,x61tvwgyvbaj,16434,16435,32869
20319,,j9kapdvqj5uj,16435,16436,32871
20320,,vv1is6kakm8j,16436,16437,32873
20321,,nu-vwpdadpmj,16437,16438,32875
20322,,lgsufvl4pxmj,16438,16439,32877
20323,,sytnrlrfboej,16439,16440,32879
20324,,kbdwjvkxr88j,16440,16441,32881
20325,,rq9qlr4st8sj,16441,16442,32883
20326,,opuszwnqrwsj,16442,16443,32885
20327,,njj3suudpw4j,16443,16444,32887
20328,,url:http://portal.acm.org/citation.cfm3fid3d192593.19743826dl3dguide26dl3dacm26type3dseries26idx3d19259326part3dproceedings26wanttype3dproceedings26title3dinternational2520multimedia2520conference26cfid3d1111111126cftoken3d2222222,16444,16445,32889
20329,,idd6358gwh4j,16445,16446,32891
20330,,url:http://adsabs.harvard.edu/abs/1975rael...20q.635a,16446,16447,32893
20331,,x65yfcczkl0j,16447,16448,32895
20332,,url:http://www.csa.com/partners/viewrecord.php3frequester3dgs26collection3dtrd26recid3d8912720617md26recid3d8912g2c0313ec,16448,16449,32897
20333,,hwfatrrxfraj,16449,16450,32899
20334,,ygf_nojcmboj,16450,16451,32901
20335,,c5kmayz5xruj,16451,16452,32903
20336,,c6ub1z80fgyj,16452,16453,32905
20337,,d7tnjnelummj,16453,16454,32907
20338,,iitgtftpqcij,16454,16455,32909
20339,,99smjyjzngmj,16455,16456,32911
20340,,upsfvgfxdc4j,16456,16457,32913
20341,,iogc14zmtdcj,16457,16458,32915
20342,,tvmcgp5isvqj,16458,16459,32917
20343,,jwswb-dvto0j,16459,16460,32919
20344,,8v9dyunnzn0j,16460,16461,32921
20345,,av2vcimnfjsj,16461,16462,32923
20346,,url:http://www.csa.com/partners/viewrecord.php3frequester3dgs26collection3dtrd26recid3d0644458ci,16462,16463,32925
20347,,t4qj1rlu01sj,16463,16464,32927
20348,,url:http://www.ingentaconnect.com/search/expand3fpub3dinfobike://carfax/cjea/2001/00000009/00000002/art0000726unc3d,16464,16465,32929
20349,,w8jazpkxeuqj,16465,16466,32931
20350,,klima5_jjswj,16466,16467,32933
20351,,,16467,16468,32935
20352,,cevotxtgnhwj,16468,16469,32937
20353,,i70jtsqj0mqj,16469,16470,32939
20354,,rsy3mgwszq8j,16470,16471,32941
20355,,mvacpazeb08j,16471,16472,32943
20356,,4oa7kahemskj,16472,16473,32945
20357,,t4840gtqaaaj,16473,16474,32947
20358,,3qptxinvetyj,16474,16475,32949
20359,,bvxtpm9cxowj,16475,16476,32951
20360,,niroke9eu3sj,16476,16477,32953
20361,,_1veym3egwuj,16477,16478,32955
20362,,ofwh8fuiiuij,16478,16479,32957
20363,,8umdr_mdtdoj,16479,16480,32959
20364,,6cjavqjit6ij,16480,16481,32961
20365,,url:http://portal.acm.org/ft_gateway.cfm3fid3d110126326type3dpdf,16481,16482,32963
20366,,mlovufizj-4j,16482,16483,32965
20367,,47c9qo3kzc8j,16483,16484,32967
20368,,fbidw1ntoc0j,16484,16485,32969
20369,,czepysdkkmcj,16485,16486,32971
20370,,k5_kjvreftej,16486,16487,32973
20371,,nck_tyqfqxkj,16487,16488,32975
20372,,27ggo8i3q8sj,16488,16489,32977
20373,,znc7a9gws6qj,16489,16490,32979
20374,,46vju5okcoaj,16490,16491,32981
20375,,url:http://doi.wiley.com/10.1002/tl.190,16492,16493,32985
20376,,sudr40eruysj,16493,16494,32987
20377,,nihjtle76swj,16494,16495,32989
20378,,izqlxq07tfcj,16495,16496,32991
20379,,udl091pyfaej,16496,16497,32993
20380,,,16497,16498,32995
20381,,mvmzxyjt6zsj,16498,16499,32997
20382,,qexhst3qfysj,16499,16500,32999
20383,,j5auqc3fefqj,16500,16501,33001
20384,,vnb2js_sltwj,16501,16502,33003
20385,,bn65hlazd8ij,16503,16504,33007
20386,,r2ltovzkn08j,16504,16505,33009
20387,,zdirjnv8li8j,16505,16506,33011
20388,,to4vklg3zymj,16506,16507,33013
20389,,fmflauju7euj,16507,16508,33015
20390,,kqjjx_rbabuj,16508,16509,33017
20391,,gy7cza-dfpqj,16509,16510,33019
20392,,fqsx6xugfhej,16510,16511,33021
20393,,4zjx_knuyiyj,16511,16512,33023
20394,,osdvqhwsbxqj,16512,16513,33025
20395,,fevb9jhob-aj,16513,16514,33027
20396,,cfbgazz8q2uj,16514,16515,33029
20397,,wct9qmlpm54j,16515,16516,33031
20398,,sh4arqm925wj,16516,16517,33033
20399,,k00ik_mnlc8j,16517,16518,33035
20400,,ctkigyh-wvmj,16518,16519,33037
20401,,fysbb-tj010j,16519,16520,33039
20402,,n1n6m_tjkbcj,16520,16521,33041
20403,,hzrpm0pm3zcj,16521,16522,33043
20404,,yagtocjnhtcj,16523,16524,33047
20405,,b9ypmyr5vlgj,16524,16525,33049
20406,,wnuhmgqp-eaj,16525,16526,33051
20407,,q8cpiowkzz4j,16526,16527,33053
20408,,4zzhkd2nyjmj,16527,16528,33055
20409,,xqhpgzgzvbuj,16528,16529,33057
20410,,gmacsx8biaoj,16529,16530,33059
20411,,4ufk8u_j9ioj,16530,16531,33061
20412,,ofieyaenxe4j,16531,16532,33063
20413,,o_i4jwzc-zcj,16532,16533,33065
20414,,url:http://portal.acm.org/citation.cfm3fid3d11343626dl3dacm26coll3dguide26cfid3d1111111126cftoken3d2222222,16533,16534,33067
20415,,jzjoyle7bduj,16534,16535,33069
20416,,wz9upb7wbqoj,16535,16536,33071
20417,,9iidzsmvz4yj,16536,16537,33073
20418,,z6cs7ifhzj4j,16538,16539,33077
20419,,c53xewxkyjyj,16539,16540,33079
20420,,ndedf7ovsf8j,16540,16541,33081
20421,,nqjskercrkaj,16541,16542,33083
20422,,zv8rg8epzoaj,16542,16543,33085
20423,,r1qyuqzf0qij,16543,16544,33087
20424,,jvhsjwyjiyij,16544,16545,33089
20425,,url:http://links.jstor.org/sici3fsici3d0146-4949(196622)7253a2253c168253ac253e2.0.co253b2-m,16545,16546,33091
20426,,h78pztwcs-oj,16546,16547,33093
20427,,1ekc5k7ij6ij,16547,16548,33095
20428,,6wbp-w6hkdyj,16548,16549,33097
20429,,aomzac0ig4sj,16549,16550,33099
20430,,url:http://portal.acm.org/ft_gateway.cfm3fid3d109970326type3dpdf,16550,16551,33101
20431,,spntiygg7yej,16551,16552,33103
20432,,kowta-xzahwj,16552,16553,33105
20433,,bvrr7ja1w2uj,16553,16554,33107
20434,,kcigxxt1opej,16554,16555,33109
20435,,ybaqpwvtotuj,16555,16556,33111
20436,,,16556,16557,33113
20437,,ttyml-eads4j,16557,16558,33115
20438,,pduy5oqzs2ij,16558,16559,33117
20439,,ihcicvsfj5qj,16559,16560,33119
20440,,kxon0ejukd4j,16560,16561,33121
20441,,8wqie6oyspej,16561,16562,33123
20442,,tsvw8sm0ecgj,16562,16563,33125
20443,,js-_y9sqfp4j,16563,16564,33127
20444,,lapebmu4kpmj,16564,16565,33129
20445,,0pbvdst_mpej,16565,16566,33131
20446,,qmhdqc_piwsj,16566,16567,33133
20447,,adzrtnypvzoj,16567,16568,33135
20448,,wd9juxlvnx0j,16568,16569,33137
20449,,1rogs-a5jtuj,16569,16570,33139
20450,,pb2bezus6ssj,16570,16571,33141
20451,,dzd5b4a2obqj,16571,16572,33143
20452,,diuooenu0loj,16572,16573,33145
20453,,7uu3jij6homj,16573,16574,33147
20454,,suqi2wrgwk0j,16574,16575,33149
20455,,13nttp5wswmj,16575,16576,33151
20456,,_ainhlup2fgj,16576,16577,33153
20457,,suchweyiphoj,16577,16578,33155
20458,,url:http://ieeexplore.ieee.org/iel1/2206/3160/00101347.pdf3farnumber3d101347,16578,16579,33157
20459,,1842lerscywj,16579,16580,33159
20460,,n-_4diyncz4j,16580,16581,33161
20461,,dyafzzhcaf0j,16581,16582,33163
20462,,j0ecm-bvshwj,16582,16583,33165
20463,,url:http://ieeexplore.ieee.org/iel2/3541/10632/00494258.pdf3farnumber3d494258,16583,16584,33167
20464,,url:http://portal.acm.org/citation.cfm3fid3d277953,16584,16585,33169
20465,,grk8jyvhasuj,16586,16587,33173
20466,,nx4r2q7r3aqj,16587,16588,33175
20467,,0hftl2gx-68j,16588,16589,33177
20468,,gkdporcillej,16589,16590,33179
20469,,84mazvixtksj,16590,16591,33181
20470,,u2o6anp-uwqj,16592,16593,33185
20471,,q7fsyxnqszsj,16593,16594,33187
20472,,iofke4esmacj,16594,16595,33189
20473,,pgqq7aovojej,16595,16596,33191
20474,,ppy4johxndij,16596,16597,33193
20475,,at3gfrc_aoyj,16597,16598,33195
20476,,vb162xxugpkj,16598,16599,33197
20477,,f4kfge-xyt0j,16599,16600,33199
20478,,ladupblay2gj,16600,16601,33201
20479,,y_mpi582d9cj,16601,16602,33203
20480,,url:http://portal.acm.org/citation.cfm3fid3d565117.56513126dl3dguide26dl3dacm26idx3dj68926part3dperiodical26wanttype3dperiodical26title3dacm2520sigmod2520record26cfid3d1111111126cftoken3d2222222,16602,16603,33205
20481,,zp7ckwqzdc4j,16603,16604,33207
20482,,zryo84cargoj,16604,16605,33209
20483,,url:http://portal.acm.org/ft_gateway.cfm3fid3d23490226type3dpdf26dl3dguide26dl3dacm26cfid3d1111111126cftoken3d2222222,16605,16606,33211
20484,,u2cgwitmhxkj,16606,16607,33213
20485,,oixsmgirfbij,16607,16608,33215
20486,,kurelskbuxyj,16608,16609,33217
20487,,url:http://portal.acm.org/ft_gateway.cfm3fid3d100767426type3dpdf,16609,16610,33219
20488,,url:http://www.csa.com/partners/viewrecord.php3frequester3dgs26collection3dtrd26recid3dn9210411ah,16610,16611,33221
20489,,y8wirpjjqqoj,16611,16612,33223
20490,,nb4oo_az9n8j,16612,16613,33225
20491,,m6ec-jwz-poj,16613,16614,33227
20492,,juk8ardn4pij,16614,16615,33229
20493,,nlin4cye464j,16615,16616,33231
20494,,bid_wjneug4j,16617,16618,33235
20495,,url:http://doi.wiley.com/10.1002/he.137,16618,16619,33237
20496,,frtatb8nvlij,16619,16620,33239
20497,,ez4zg2rojfwj,16620,16621,33241
20498,,zwxlxunungij,16621,16622,33243
20499,,url:http://portal.acm.org/ft_gateway.cfm3fid3d109970126type3dpdf,16622,16623,33245
20500,,znqmoqkgrngj,16623,16624,33247
20501,,bx8mqpufurwj,16624,16625,33249
20502,,,16625,16626,33251
20503,,fbk48d5is8gj,16626,16627,33253
20504,,f5lkfmccd1ej,16627,16628,33255
20505,,3rwpln-qocoj,16628,16629,33257
20506,,3hd5ehmgdpkj,16629,16630,33259
20507,,xyurn78qvekj,16630,16631,33261
20508,,vg1x3yr4zpwj,16631,16632,33263
20509,,jms3rqx1oq0j,16632,16633,33265
20510,,eef4am2grboj,16633,16634,33267
20511,,a5riieet-laj,16634,16635,33269
20512,,ohyd1ketwgaj,16635,16636,33271
20513,,ak1bro5poomj,16636,16637,33273
20514,,juhcx4cvtyyj,16637,16638,33275
20515,,0ct6b_fkddgj,16638,16639,33277
20516,,orbxxxjhmh4j,16639,16640,33279
20517,,fwkfbzs7zcwj,16640,16641,33281
20518,,t9ojotq9c1ej,16641,16642,33283
20519,,ziuolzvmjc8j,16642,16643,33285
20520,,ks5m14e18uwj,16643,16644,33287
20521,,vq_lmeuomcsj,16644,16645,33289
20522,,zzpxckkwo_8j,16645,16646,33291
20523,,1li0_hut-scj,16646,16647,33293
20524,,ciavnyh4u8uj,16647,16648,33295
20525,,up9s0xqam-sj,16648,16649,33297
20526,,p6jclearcfij,16649,16650,33299
20527,,wkusjs8kbloj,16650,16651,33301
20528,,zuogvndfhxqj,16651,16652,33303
20529,,t3f-vej7ixoj,16652,16653,33305
20530,,hnfskfplr8sj,16653,16654,33307
20531,,pnncrmhvuomj,16654,16655,33309
20532,,xy33_pzevuoj,16655,16656,33311
20533,,9t6seuthphgj,16656,16657,33313
20534,,sfyycnsamuyj,16657,16658,33315
20535,,mujwoor-x5mj,16658,16659,33317
20536,,url:http://portal.acm.org/citation.cfm3fid3d171926.171948,16659,16660,33319
20537,,g3o_bchmocmj,16660,16661,33321
20538,,n_wh4mtijeej,16661,16662,33323
20539,,url:http://doi.wiley.com/10.1002/he.11204,16662,16663,33325
20540,,cp-13qutsxwj,16663,16664,33327
20541,,vnhiuxiako0j,16664,16665,33329
20542,,qeva0fhl2byj,16665,16666,33331
20543,,zm4lmkubbeqj,16666,16667,33333
20544,,url:http://www.springerlink.com/index/g54431563w0l2845.pdf,16667,16668,33335
20545,,waodlaz84s4j,16669,16670,33339
20546,,h0jj7lly6baj,16670,16671,33341
20547,,eolljmvki7yj,16671,16672,33343
20548,,b0dglz4e54uj,16672,16673,33345
20549,,rzzcah5gzi4j,16673,16674,33347
20550,,mmztqbsjheoj,16674,16675,33349
20551,,e5s6jqk7kycj,16675,16676,33351
20552,,b7mbuqf2hzwj,16676,16677,33353
20553,,kscg3ovvt7yj,16677,16678,33355
20554,,0cj_fm4wgpij,16678,16679,33357
20555,,igskipky4suj,16679,16680,33359
20556,,luv3lxc9csmj,16680,16681,33361
20557,,url:http://ieeexplore.ieee.org/iel1/2206/3608/00129239.pdf3farnumber3d129239,16681,16682,33363
20558,,ldombvtlswgj,16682,16683,33365
20559,,2qw1aiw7oj4j,16683,16684,33367
20560,,ndl2k1ysi8aj,16684,16685,33369
20561,,o-yg_v6houij,16685,16686,33371
20562,,obvuazzbf68j,16686,16687,33373
20563,,rwibj-ibcdsj,16687,16688,33375
20564,,w7ijymtxzzej,16688,16689,33377
20565,,znton2fdcv8j,16689,16690,33379
20566,,45ork2fkrzaj,16690,16691,33381
20567,,ifejlqqoyhuj,16691,16692,33383
20568,,url:http://portal.acm.org/ft_gateway.cfm3fid3d102770126type3dpdf,16692,16693,33385
20569,,7fjluy3hdyej,16693,16694,33387
20570,,7efvgylm5qkj,16694,16695,33389
20571,,na3jnrigk7qj,16696,16697,33393
20572,,,16697,16698,33395
20573,,xrk9ksezktaj,16698,16699,33397
20574,,pj9sehpfcxwj,16700,16701,33401
20575,,vyozhismi60j,16701,16702,33403
20576,,kolhshkhwmyj,16702,16703,33405
20577,,olqua3327g4j,16704,16705,33409
20578,,url:http://portal.acm.org/ft_gateway.cfm3fid3d18156926type3dpdf,16705,16706,33411
20579,,oqerp_wzwzaj,16706,16707,33413
20580,,sinizohkawqj,16707,16708,33415
20581,,db7sylhqogaj,16708,16709,33417
20582,,kyc-fdre9nyj,16709,16710,33419
20583,,dmee8uyeauij,16710,16711,33421
20584,,1-6fsjbjcy0j,16711,16712,33423
20585,,mzrgmz0nx-ij,16713,16714,33427
20586,,rvqoppbd4uuj,16714,16715,33429
20587,,ueirmihvjvwj,16715,16716,33431
20588,,mddjkyg5i9mj,16716,16717,33433
20589,,3ytw-qvdc4ij,16717,16718,33435
20590,,i1jsstzrhhcj,16718,16719,33437
20591,,a4oyd93vt8aj,16719,16720,33439
20592,,url:http://portal.acm.org/ft_gateway.cfm3fid3d106630726type3dpdf,16720,16721,33441
20593,,a7vzu03mhyqj,16721,16722,33443
20594,,url:http://www.springerlink.com/index/mv301h2472338044.pdf,16722,16723,33445
20595,,wuffdcrkihmj,16723,16724,33447
20596,,d-sq6tm2zraj,16724,16725,33449
20597,,edryocufbimj,16725,16726,33451
20598,,ztr9_6ijogcj,16726,16727,33453
20599,,cgmrtdzrj68j,16727,16728,33455
20600,,cusovhtjwsmj,16728,16729,33457
20601,,v3czfg1poo4j,16729,16730,33459
20602,,4qdjwc-zyssj,16730,16731,33461
20603,,2zthydd0zkqj,16731,16732,33463
20604,,igktkuis42mj,16732,16733,33465
20605,,qd22zntuolyj,16733,16734,33467
20606,,gvb8xphg9nuj,16734,16735,33469
20607,,d_a1m58gcxwj,16735,16736,33471
20608,,ag5ikom9db0j,16736,16737,33473
20609,,pnom25-zmiaj,16737,16738,33475
20610,,xtexesdwgxcj,16738,16739,33477
20611,,1tjoifekx3gj,16739,16740,33479
20612,,tqkfgp1edtqj,16740,16741,33481
20613,,galtgyzgh4ij,16741,16742,33483
20614,,vkyyjnfh51gj,16742,16743,33485
20615,,a1esmnrsk_uj,16743,16744,33487
20616,,kknuo3jdmikj,16744,16745,33489
20617,,lxoisx_fshgj,16745,16746,33491
20618,,atfq61d34cqj,16746,16747,33493
20619,,f4w7iu1idbaj,16747,16748,33495
20620,,mes4n_f03zij,16748,16749,33497
20621,,xtt6ujwfjuuj,16749,16750,33499
20622,,3i8nhbt0du8j,16750,16751,33501
20623,,qcc8jsiq688j,16751,16752,33503
20624,,udd0ocetns8j,16752,16753,33505
20625,,rj9shibafauj,16753,16754,33507
20626,,8qrda0mjpgsj,16754,16755,33509
20627,,d1h4whcxmcqj,16755,16756,33511
20628,,1vscwaa8jpgj,16756,16757,33513
20629,,ztuwtjkg_0oj,16758,16759,33517
20630,,j6o4y0rwqcuj,16759,16760,33519
20631,,ezx661hb5igj,16760,16761,33521
20632,,2fpapfdtm9yj,16761,16762,33523
20633,,zlec0iic7v8j,16762,16763,33525
20634,,url:http://doi.wiley.com/10.1002/ace.7406,16763,16764,33527
20635,,b4rgqrw2sdyj,16764,16765,33529
20636,,kf9a1mbs5x4j,16765,16766,33531
20637,,kdo6foipjlwj,16766,16767,33533
20638,,k_zyglpll8oj,16767,16768,33535
20639,,4z8r4lhgsyij,16768,16769,33537
20640,,vaihu2c-wo0j,16769,16770,33539
20641,,bmx-1d8_y6sj,16770,16771,33541
20642,,ailgcugyibij,16771,16772,33543
20643,,uf0v_zmcg4uj,16772,16773,33545
20644,,vajpmxingnuj,16773,16774,33547
20645,,dgq0aahotggj,16774,16775,33549
20646,,a0wk4h0rniej,16775,16776,33551
20647,,tvcvnneiuiaj,16776,16777,33553
20648,,i2wmfcjj2zsj,16777,16778,33555
20649,,tluirhk_dxuj,16778,16779,33557
20650,,zpenwcg-boej,16779,16780,33559
20651,,ld8mtycec9ej,16780,16781,33561
20652,,vuuhovb5djmj,16781,16782,33563
20653,,mpmpruospl4j,16782,16783,33565
20654,,5ktlbxxyumaj,16783,16784,33567
20655,,xtxccxbyb3gj,16784,16785,33569
20656,,ru_szh1gzgej,16785,16786,33571
20657,,sgjie1oger0j,16786,16787,33573
20658,,hk7r4lwzu1aj,16787,16788,33575
20659,,eygskhzmaouj,16788,16789,33577
20660,,jsqr3oydmkkj,16789,16790,33579
20661,,3rowg9vhz90j,16790,16791,33581
20662,,url:http://portal.acm.org/citation.cfm3fid3d171926.171953,16791,16792,33583
20663,,cig-w0_uua4j,16792,16793,33585
20664,,jp9jp9fdxgkj,16793,16794,33587
20665,,jqmjcqctyf0j,16794,16795,33589
20666,,ds-terqdvggj,16795,16796,33591
20667,,ahbu0rldp1ej,16796,16797,33593
20668,,ss8xrnjtvq0j,16797,16798,33595
20669,,xk8gsfzg6x8j,16798,16799,33597
20670,,tq7ubqwsisqj,16799,16800,33599
20671,,9b95upd2truj,16800,16801,33601
20672,,mq_ts1lyv1kj,16801,16802,33603
20673,,dboljtlyvjwj,16802,16803,33605
20674,,glb7assr1waj,16803,16804,33607
20675,,xqfvip3rwrmj,16804,16805,33609
20676,,w0iqgrwqasuj,16805,16806,33611
20677,,af1qzn1nk8uj,16806,16807,33613
20678,,5zrma3e_sngj,16807,16808,33615
20679,,_jep7caamz8j,16808,16809,33617
20680,,oh3_7ynqao8j,16809,16810,33619
20681,,ou7jnsncdb0j,16810,16811,33621
20682,,qexz2txc4kkj,16811,16812,33623
20683,,d1mruqjfqpmj,16812,16813,33625
20684,,0s6troo_y1aj,16813,16814,33627
20685,,cg27khtlnamj,16814,16815,33629
20686,,lor0k8qrgkgj,16815,16816,33631
20687,,ozrhmcdq4iaj,16816,16817,33633
20688,,u4ccfx3pghcj,16817,16818,33635
20689,,ivzn2tbt7ymj,16818,16819,33637
20690,,na6luysces4j,16819,16820,33639
20691,,jzw866jajlsj,16820,16821,33641
20692,,syytwwt-hskj,16821,16822,33643
20693,,jyycqvykef4j,16822,16823,33645
20694,,9awgcfjolsqj,16823,16824,33647
20695,,t4wmqktpmemj,16824,16825,33649
20696,,8j0wmqs6rfij,16825,16826,33651
20697,,drhmrsowypqj,16826,16827,33653
20698,,uwpo8yp4rrqj,16827,16828,33655
20699,,k-rvgrharkyj,16828,16829,33657
20700,,tlivguxgk4cj,16829,16830,33659
20701,,7zq010dpc2qj,16830,16831,33661
20702,,k6l2anl-sigj,16831,16832,33663
20703,,8zivrnpjhfmj,16832,16833,33665
20704,,yc3nwp247k8j,16833,16834,33667
20705,,yu3qojuofz0j,16834,16835,33669
20706,,0gjwjoovxf4j,16835,16836,33671
20707,,e-dknw3lj5ej,16836,16837,33673
20708,,r61x3hfuquej,16837,16838,33675
20709,,9zjne_enj8wj,16838,16839,33677
20710,,iozrw7ybc9mj,16839,16840,33679
20711,,vcdl39mgks0j,16840,16841,33681
20712,,vhmbkdhr7qsj,16841,16842,33683
20713,,uhhpqc33sqqj,16842,16843,33685
20714,,12ikexgf9gij,16843,16844,33687
20715,,bufcbv4e4iqj,16844,16845,33689
20716,,url:http://links.jstor.org/sici3fsici3d0146-4949(196121252f22)2253a2253c43253awatua253e2.0.co253b2-d,16845,16846,33691
20717,,url:http://portal.acm.org/ft_gateway.cfm3fid3d5171026type3dpdf26coll3dguide26dl3dacm26cfid3d1111111126cftoken3d2222222,16846,16847,33693
20718,,wta9guirjxgj,16847,16848,33695
20719,,p-xkl1fzarej,16848,16849,33697
20720,,mrwqysgvaswj,16849,16850,33699
20721,,qclch4ohxqaj,16850,16851,33701
20722,,jrf2c_oz4g4j,16851,16852,33703
20723,,yyffvofsaiwj,16852,16853,33705
20724,,aklb5rjmbxoj,16853,16854,33707
20725,,y_omp9rjlygj,16854,16855,33709
20726,,x3ona-qonsej,16855,16856,33711
20727,,url:http://www.csa.com/partners/viewrecord.php3frequester3dgs26collection3dtrd26recid3da7423802ah,16856,16857,33713
20728,,mijkjm7cdaaj,16857,16858,33715
20729,,o_0fke6hfesj,16858,16859,33717
20730,,u3ixo0elouwj,16859,16860,33719
20731,,i2md2kgpq6cj,16860,16861,33721
20732,,to0qarkak50j,16861,16862,33723
20733,,xzeqgscjgcuj,16862,16863,33725
20734,,bcgvdxl-cqej,16863,16864,33727
20735,,h94afjfsxoaj,16865,16866,33731
20736,,b0pxzgmee64j,16866,16867,33733
20737,,p7svsotcsdsj,16867,16868,33735
20738,,waoccsg9eeyj,16868,16869,33737
20739,,ci6rw2kkjtcj,16869,16870,33739
20740,,ghbeor8vsa8j,16870,16871,33741
20741,,0h1sljcuqxqj,16871,16872,33743
20742,,,16872,16873,33745
20743,,5jck6y-hdj8j,16873,16874,33747
20744,,zsv16eluan4j,16874,16875,33749
20745,,kerkttm9nfyj,16875,16876,33751
20746,,url:http://www.csa.com/partners/viewrecord.php3frequester3dgs26collection3dtrd26recid3d0833490ci,16876,16877,33753
20747,,url:http://portal.acm.org/ft_gateway.cfm3fid3d5022626type3dpdf26dl3dportal26dl3dacm26cfid3d1111111126cftoken3d2222222,16877,16878,33755
20748,,idppcaxy2cgj,16878,16879,33757
20749,,rrxxf-m6dpyj,16879,16880,33759
20750,,gnarwaqv9fwj,16880,16881,33761
20751,,dlgd2isejzyj,16881,16882,33763
20752,,migxbk7s3iej,16882,16883,33765
20753,,sqmojhyyicmj,16884,16885,33769
20754,,url:http://portal.acm.org/citation.cfm3fid3d9964426coll3dportal26dl3dacm,16885,16886,33771
20755,,6p65civ_4pcj,16886,16887,33773
20756,,44un6zqfmm4j,16887,16888,33775
20757,,l-c7aovz5okj,16888,16889,33777
20758,,,16889,16890,33779
20759,,tyf71ualnlsj,16890,16891,33781
20760,,normsfvaz34j,16891,16892,33783
20761,,1je7jqiaghuj,16892,16893,33785
20762,,08rwf74tcg0j,16893,16894,33787
20763,,txw20y1r0zwj,16894,16895,33789
20764,,jn-21b8-cpuj,16895,16896,33791
20765,,url:http://doi.wiley.com/10.1002/tl.8004,16896,16897,33793
20766,,tptokgnbvpcj,16897,16898,33795
20767,,_c49ibz2yfej,16898,16899,33797
20768,,m3vll5cwq3gj,16899,16900,33799
20769,,y1ein8q4_jmj,16900,16901,33801
20770,,berpesoxfs4j,16901,16902,33803
20771,,url:http://doi.wiley.com/10.1002/he.127,16902,16903,33805
20772,,r14mlou73t0j,16903,16904,33807
20773,,8idbozhjpx4j,16905,16906,33811
20774,,d09tzggyipyj,16906,16907,33813
20775,,b-t3fgdswlqj,16907,16908,33815
20776,,url:http://portal.acm.org/citation.cfm3fid3d192593.197398,16908,16909,33817
20777,,ewphfx13-zij,16909,16910,33819
20778,,6m2oy0jcgmaj,16910,16911,33821
20779,,,16911,16912,33823
20780,,x0ayjaofq8cj,16913,16914,33827
20781,,seb9vbw8yr8j,16914,16915,33829
20782,,b-trrvylswgj,16915,16916,33831
20783,,8fbvfqpfbgwj,16916,16917,33833
20784,,mfwlcmh_jtwj,16917,16918,33835
20785,,url:http://ieeexplore.ieee.org/iel3/3990/11481/00547886.pdf3farnumber3d547886,16918,16919,33837
20786,,rlblpoynv74j,16919,16920,33839
20787,,url:http://www.csa.com/partners/viewrecord.php3frequester3dgs26collection3dtrd26recid3d1105290so,16920,16921,33841
20788,,r_vcrzwfgnsj,16921,16922,33843
20789,,ov5ymv_hqg8j,16922,16923,33845
20790,,w1iqjgsvkroj,16923,16924,33847
20791,,gw13pxofi7uj,16924,16925,33849
20792,,b5j94hgoi04j,16925,16926,33851
20793,,7kfubsc5iigj,16926,16927,33853
20794,,rozopcrhvq8j,16927,16928,33855
20795,,dqsgb9_qv4ij,16928,16929,33857
20796,,zeh9ufmj3-ej,16929,16930,33859
20797,,ie80_3460goj,16930,16931,33861
20798,,yhfbzt3b6fqj,16931,16932,33863
20799,,wbtf8qvambgj,16932,16933,33865
20800,,rxq5fcfpvxej,16933,16934,33867
20801,,sa3djiqyseyj,16934,16935,33869
20802,,3dtkhlio3cij,16935,16936,33871
20803,,url:http://taylorandfrancis.metapress.com/index/mqttnm7a2b6fq0jl.pdf,16936,16937,33873
20804,,0dvwt1enxouj,16937,16938,33875
20805,,wrue2ikpgyej,16938,16939,33877
20806,,vnbnhxkaih0j,16939,16940,33879
20807,,7cs9f1zokigj,16940,16941,33881
20808,,hgv0tfkczuoj,16941,16942,33883
20809,,c-fl9o_qi0mj,16942,16943,33885
20810,,2a5m1qot3tqj,16943,16944,33887
20811,,zethospze88j,16944,16945,33889
20812,,scwxqgn4icoj,16946,16947,33893
20813,,cgen9qyfon4j,16947,16948,33895
20814,,8logpx6uwzwj,16948,16949,33897
20815,,usuabbndoyaj,16949,16950,33899
20816,,mopy3yg3i60j,16950,16951,33901
20817,,ee49gxhhsraj,16951,16952,33903
20818,,3gpc7dpy-ucj,16952,16953,33905
20819,,dow5ul3fqk8j,16953,16954,33907
20820,,gtd5zrc0rb4j,16954,16955,33909
20821,,onxnyqv7q-uj,16955,16956,33911
20822,,a9ci3p1oz3gj,16956,16957,33913
20823,,jzmvjpsywrqj,16957,16958,33915
20824,,t9ovdhd8sooj,16958,16959,33917
20825,,ihy3bqausouj,16959,16960,33919
20826,,nixnjesmiw8j,16960,16961,33921
20827,,gufuxzixg7qj,16961,16962,33923
20828,,url:http://links.jstor.org/sici3fsici3d0146-4949(196524252f21)6253a1253c97253atgoem253e2.0.co253b2-8,16963,16964,33927
20829,,kdxndtmmklwj,16964,16965,33929
20830,,jnssimfidcgj,16965,16966,33931
20831,,oaowsqhf0_0j,16966,16967,33933
20832,,bwp-ubyxuyij,16967,16968,33935
20833,,4o_muauks9cj,16968,16969,33937
20834,,hvcvf-h_pocj,16969,16970,33939
20835,,ofrub5-wvbij,16970,16971,33941
20836,,a2iocyjuroqj,16971,16972,33943
20837,,dbu10bhzdm8j,16972,16973,33945
20838,,x_hjdx7z3dij,16973,16974,33947
20839,,yt2tetxokpgj,16974,16975,33949
20840,,ssuu_tkfpukj,16975,16976,33951
20841,,iazyw1pvcpgj,16976,16977,33953
20842,,1griyvhyj_yj,16978,16979,33957
20843,,zlx8qn8iebij,16979,16980,33959
20844,,l73f8ovuhnqj,16980,16981,33961
20845,,ajg_dwy6deqj,16981,16982,33963
20846,,botvccaukv8j,16982,16983,33965
20847,,oxxi5noxkzqj,16983,16984,33967
20848,,ucvnncgp1ygj,16984,16985,33969
20849,,bzwpnfcecqmj,16985,16986,33971
20850,,eg2xk1kmg_sj,16987,16988,33975
20851,,iastij5r1bmj,16988,16989,33977
20852,,4vt_kwiha5gj,16989,16990,33979
20853,,zpitahlsiwaj,16990,16991,33981
20854,,eicjxml9fs4j,16991,16992,33983
20855,,zjftc-c1h3mj,16992,16993,33985
20856,,url:http://www.springerlink.com/index/m2p6764105750155.pdf,16993,16994,33987
20857,,jqc7mi-u7g4j,16994,16995,33989
20858,,cjz5crvr8awj,16995,16996,33991
20859,,wjdg2zg5deej,16996,16997,33993
20860,,znd7vfazxykj,16997,16998,33995
20861,,wsnuaymg0qej,16998,16999,33997
20862,,3gfwzt1rvbgj,16999,17000,33999
20863,,giwnki_hfpij,17000,17001,34001
20864,,xopweynzmz8j,17001,17002,34003
20865,,fewz9gmkhasj,17002,17003,34005
20866,,swaqtdchdaoj,17003,17004,34007
20867,,9dtuq5dybvqj,17004,17005,34009
20868,,x1ojoeazfe0j,17005,17006,34011
20869,,vrakiv8s3vsj,17006,17007,34013
20870,,ivsbdcxr5ouj,17007,17008,34015
20871,,7qkb8rprrxqj,17008,17009,34017
20872,,m5irgch6-iuj,17009,17010,34019
20873,,abezjlwwx4ij,17010,17011,34021
20874,,ol8xlqmybyej,17011,17012,34023
20875,,05upsqzb-gqj,17013,17014,34027
20876,,slewdhm3croj,17014,17015,34029
20877,,c1sdor3jzq4j,17015,17016,34031
20878,,a-hrwyfw_r0j,17016,17017,34033
20879,,iw65oi0bbryj,17017,17018,34035
20880,,eia9hvof2isj,17018,17019,34037
20881,,m-3mgd3wpcsj,17020,17021,34041
20882,,yrbqf8krxnkj,17023,17024,34047
20883,,fhek09ljkfwj,17024,17025,34049
20884,,pxchrb4a_bij,17025,17026,34051
20885,,opryw2-imz0j,17026,17027,34053
20886,,yuzfosxq2oej,17027,17028,34055
20887,,zgoisajcogej,17028,17029,34057
20888,,2zlmsuik_a8j,17029,17030,34059
20889,,u00ahzfhjtcj,17030,17031,34061
20890,,u-ptdhlyghwj,17031,17032,34063
20891,,5lmhbuijteej,17032,17033,34065
20892,,6yzdnxw814mj,17033,17034,34067
20893,,uzi57qu_ztwj,17034,17035,34069
20894,,3emyrufohsej,17035,17036,34071
20895,,s8reuooqdqgj,17036,17037,34073
20896,,0mgtqfqnj-4j,17037,17038,34075
20897,,ujidvzdfm_sj,17038,17039,34077
20898,,vjmea4gbrroj,17039,17040,34079
20899,,hlgwwnilxv8j,17040,17041,34081
20900,,etpjye7as6yj,17041,17042,34083
20901,,d4uevbmunmuj,17042,17043,34085
20902,,atjjfl5idbcj,17043,17044,34087
20903,,6abyhllojxij,17044,17045,34089
20904,,dzblutqetkij,17045,17046,34091
20905,,thv-yceows0j,17046,17047,34093
20906,,fnj7u8hbwtqj,17048,17049,34097
20907,,znq7c5eifuyj,17049,17050,34099
20908,,jzbrhg4cpdwj,17050,17051,34101
20909,,ymuw3v0hbkmj,17051,17052,34103
20910,,wfdxe9dcvcyj,17052,17053,34105
20911,,rv87hpxkekyj,17053,17054,34107
20912,,drr-iqp83hgj,17054,17055,34109
20913,,hfeu4mtunwgj,17055,17056,34111
20914,,wfu1mbxs72qj,17056,17057,34113
20915,,6y3mfk6sxeyj,17057,17058,34115
20916,,2xglxexlceoj,17059,17060,34119
20917,,ywe7qzk4e5mj,17060,17061,34121
20918,,ltpcvcmqucej,17061,17062,34123
20919,,jdyrdp9xajsj,17062,17063,34125
20920,,url:http://www.ingentaconnect.com/content/els/08830355/2001/00000035/00000003/art00021,17063,17064,34127
20921,,hvnv6kelmemj,17064,17065,34129
20922,,jv5tzpxcsvij,17065,17066,34131
20923,,pt6e9aj9iosj,17066,17067,34133
20924,,gfhteak__58j,17067,17068,34135
20925,,pzwfcbrhqgej,17068,17069,34137
20926,,url:http://doi.wiley.com/10.1002/he.10908,17069,17070,34139
20927,,wqv16mmbghej,17070,17071,34141
20928,,url:http://portal.acm.org/ft_gateway.cfm3fid3d110198326type3dpdf,17071,17072,34143
20929,,7iekesnoow0j,17072,17073,34145
20930,,url:http://portal.acm.org/ft_gateway.cfm3fid3d108364426type3dpdf,17073,17074,34147
20931,,g8zia8qevtkj,17074,17075,34149
20932,,lm05ek_bznwj,17075,17076,34151
20933,,vqhpiimnm7mj,17076,17077,34153
20934,,dydu_b_4_cmj,17078,17079,34157
20935,,xe-rxpn1mtaj,17079,17080,34159
20936,,27rbmf7-ptej,17080,17081,34161
20937,,mcaf0yv7odkj,17081,17082,34163
20938,,6yc4p7qh_xwj,17082,17083,34165
20939,,md0oleq4jmej,17083,17084,34167
20940,,olbsxrtgos4j,17084,17085,34169
20941,,hcqjqzuexkaj,17085,17086,34171
20942,,qvtm-vjbe6sj,17086,17087,34173
20943,,5ssqgud2ctyj,17087,17088,34175
20944,,nw6qd_s4m_qj,17088,17089,34177
20945,,ext7nvd060mj,17089,17090,34179
20946,,umbiwu6vzs0j,17090,17091,34181
20947,,c0fqugft0fqj,17091,17092,34183
20948,,kjy7l8ltwwkj,17092,17093,34185
20949,,orpw0ack1ooj,17093,17094,34187
20950,,i1wzeepdwjyj,17094,17095,34189
20951,,aczmuwogs6uj,17095,17096,34191
20952,,gj8u-hynczgj,17096,17097,34193
20953,,y7h4mqzytrkj,17097,17098,34195
20954,,9aovu7qfvqoj,17098,17099,34197
20955,,hdsf3aotd34j,17099,17100,34199
20956,,jhpsrquzrwgj,17100,17101,34201
20957,,shai_5xc1w8j,17101,17102,34203
20958,,42nchcgaicgj,17102,17103,34205
20959,,zdtzyhfgvgyj,17103,17104,34207
20960,,zmveq33nfkkj,17104,17105,34209
20961,,leqiau26hxoj,17105,17106,34211
20962,,ul1hrqwg1ekj,17106,17107,34213
20963,,qjkriukavvij,17107,17108,34215
20964,,nbll1xkw9xwj,17108,17109,34217
20965,,ox8wt7ftfz0j,17109,17110,34219
20966,,ociytua_vlcj,17110,17111,34221
20967,,wdhnam-tsaaj,17111,17112,34223
20968,,drla-hyd_10j,17112,17113,34225
20969,,5ypvbraqqzuj,17113,17114,34227
20970,,5vu2vivngw8j,17114,17115,34229
20971,,oo2yoty0gpoj,17115,17116,34231
20972,,qtl0cvx5cjuj,17116,17117,34233
20973,,bapqwhkbi9ej,17117,17118,34235
20974,,3tjvssfxancj,17118,17119,34237
20975,,3yiie_e4x7yj,17119,17120,34239
20976,,8_zvxdavqn0j,17120,17121,34241
20977,,url:http://doi.wiley.com/10.1002/tl.7508,17121,17122,34243
20978,,qybldu5g-4yj,17122,17123,34245
20979,,eyibwxwx8dgj,17123,17124,34247
20980,,pfr2kuxqehyj,17124,17125,34249
20981,,whqpkknjgsgj,17125,17126,34251
20982,,tuckjflb8ksj,17126,17127,34253
20983,,1ymhdq7k7ugj,17127,17128,34255
20984,,url:http://doi.wiley.com/10.1002/he.164,17128,17129,34257
20985,,8_5a88esaq0j,17129,17130,34259
20986,,0v4tn6-6gmmj,17130,17131,34261
20987,,viwssogqowaj,17131,17132,34263
20988,,7ou0jn2vqi8j,17132,17133,34265
20989,,aj8iygeu8ecj,17133,17134,34267
20990,,z6icyl-v3bcj,17135,17136,34271
20991,,ilnus4w62ukj,17136,17137,34273
20992,,ykp_xep06kyj,17137,17138,34275
20993,,v0hgx47n2nej,17138,17139,34277
20994,,v-jht_ksp68j,17139,17140,34279
20995,,url:http://www.geography.org.uk/journals/download.asp3farticleid3d149,17140,17141,34281
20996,,xwfixggspmsj,17141,17142,34283
20997,,sdeymwljnhij,17142,17143,34285
20998,,hmge3y7mb5wj,17143,17144,34287
20999,,o48jxxvy_ggj,17144,17145,34289
21000,,tpdtqe6qausj,17145,17146,34291
21001,,jrxvkjdk5haj,17146,17147,34293
21002,,yt3m9lsdchsj,17147,17148,34295
21003,,xb7uai9i1zgj,17148,17149,34297
21004,,cca9qsnykeuj,17149,17150,34299
21005,,r3wczgqy0nyj,17151,17152,34303
21006,,l2qtazxtbzyj,17152,17153,34305
21007,,nqqwjd9q46cj,17153,17154,34307
21008,,vvpwghdcissj,17154,17155,34309
21009,,xa2vr6wh1zoj,17155,17156,34311
21010,,r4ldxmqxed0j,17156,17157,34313
21011,,npxjp8h5wvgj,17157,17158,34315
21012,,5cez0szyaryj,17158,17159,34317
21013,,rvuvdekfatsj,17159,17160,34319
21014,,r_v4vb4jgboj,17160,17161,34321
21015,,0ostkab-cycj,17161,17162,34323
21016,,y5spvla8zocj,17162,17163,34325
21017,,z0i3_iqlxz0j,17163,17164,34327
21018,,hiap4u9wb-oj,17164,17165,34329
21019,,1i6px2n_3j0j,17165,17166,34331
21020,,zcglw-bpwqwj,17166,17167,34333
21021,,gfcznyvaj5uj,17167,17168,34335
21022,,xstmwccf9fkj,17168,17169,34337
21023,,fjw9svgitraj,17169,17170,34339
21024,,gnupxd5xflcj,17170,17171,34341
21025,,qthnvsuyslmj,17171,17172,34343
21026,,u9ou0wpyygaj,17172,17173,34345
21027,,u3g531zdxqcj,17173,17174,34347
21028,,xukkvhidpeaj,17174,17175,34349
21029,,j0b7w2yito4j,17175,17176,34351
21030,,hnxrxyjz3iyj,17176,17177,34353
21031,,8c_vebqmysgj,17177,17178,34355
21032,,5ty9srbee7gj,17178,17179,34357
21033,,mxs9vxayw78j,17179,17180,34359
21034,,3bycefumxr8j,17180,17181,34361
21035,,617gnv2ieqkj,17181,17182,34363
21036,,yemfun7bsw8j,17182,17183,34365
21037,,url:http://portal.acm.org/ft_gateway.cfm3fid3d108378626type3dpdf,17183,17184,34367
21038,,,17184,17185,34369
21039,,t1gjaqyfqlqj,17185,17186,34371
21040,,aqf83fpflfqj,17186,17187,34373
21041,,b2am3rxioxij,17187,17188,34375
21042,,url:http://www.springerlink.com/index/jjjg5825415765x2.pdf,17188,17189,34377
21043,,wdma7yy0n5sj,17189,17190,34379
21044,,url:http://doi.wiley.com/10.1002/tl.6,17190,17191,34381
21045,,38f42ekkchsj,17191,17192,34383
21046,,wsjjm49ggfij,17192,17193,34385
21047,,z9e9dqy5kbgj,17193,17194,34387
21048,,bv6bhyxh_aej,17194,17195,34389
21049,,3uqcbr_15ayj,17195,17196,34391
21050,,th1pbvgqzw4j,17196,17197,34393
21051,,6i-scid7gxkj,17197,17198,34395
21052,,6voa0trjeioj,17198,17199,34397
21053,,iull9n3yu-mj,17199,17200,34399
21054,,ficntdv4fh0j,17200,17201,34401
21055,,2gx7lobz3wkj,17201,17202,34403
21056,,ngmfdufeglwj,17202,17203,34405
21057,,gaurio4hiwwj,17203,17204,34407
21058,,fbgf7tfc8woj,17204,17205,34409
21059,,re01w_bd2_oj,17205,17206,34411
21060,,e6wjtpbhbp0j,17206,17207,34413
21061,,h9gnzliuh_qj,17207,17208,34415
21062,,acvcz2wg854j,17208,17209,34417
21063,,url:http://portal.acm.org/ft_gateway.cfm3fid3d24588526type3dpdf26dl3dguide26dl3dacm26cfid3d1111111126cftoken3d2222222,17209,17210,34419
21064,,,17210,17211,34421
21065,,oz70_jokevwj,17211,17212,34423
21066,,_qq_-lyajwsj,17212,17213,34425
21067,,duimezjeeicj,17213,17214,34427
21068,,7csqwydlgg8j,17214,17215,34429
21069,,pmyjqnewetwj,17215,17216,34431
21070,,mion-dz3xnkj,17216,17217,34433
21071,,v3c6q9ki3faj,17218,17219,34437
21072,,lpabsvebbfoj,17219,17220,34439
21073,,hnts5cd6izej,17220,17221,34441
21074,,rkidcfth4juj,17221,17222,34443
21075,,j7luged7samj,17222,17223,34445
21076,,3eatu6sk1uuj,17223,17224,34447
21077,,j28mmenrts4j,17224,17225,34449
21078,,cf_nqmhdtqwj,17225,17226,34451
21079,,kg-k9420fgmj,17226,17227,34453
21080,,ukzzpsqklqij,17227,17228,34455
21081,,pks3m2moxn0j,17228,17229,34457
21082,,qcvprnwjznej,17229,17230,34459
21083,,dja1wbyo-_ej,17230,17231,34461
21084,,pluc-qeeqzmj,17231,17232,34463
21085,,g2dia_pr5jyj,17232,17233,34465
21086,,hzqcwls0fwij,17233,17234,34467
21087,,ujkkulopjf4j,17234,17235,34469
21088,,url:http://ieeexplore.ieee.org/iel5/9217/29235/01320067.pdf3farnumber3d1320067,17235,17236,34471
21089,,ersjdm4mg0qj,17236,17237,34473
21090,,4vnolyefbz0j,17237,17238,34475
21091,,2nwsqm_e63mj,17238,17239,34477
21092,,uakxrkiigrgj,17239,17240,34479
21093,,ssunpsjag1aj,17240,17241,34481
21094,,gjda3tcfagij,17241,17242,34483
21095,,s0afi_cg1qaj,17242,17243,34485
21096,,7edv9vn_-8qj,17243,17244,34487
21097,,n6fd9sbtqzgj,17244,17245,34489
21098,,fpiaccbpnrej,17245,17246,34491
21099,,c_kgnz7gynyj,17246,17247,34493
21100,,5lqhxyuoqguj,17247,17248,34495
21101,,b5jhmdfeox0j,17248,17249,34497
21102,,duw8at2ijs0j,17249,17250,34499
21103,,acumhlmuyvcj,17250,17251,34501
21104,,f0ar66dw55mj,17251,17252,34503
21105,,dhates4yzyyj,17252,17253,34505
21106,,wjxzzkfjwnij,17253,17254,34507
21107,,cpfne-oo6m0j,17254,17255,34509
21108,,8skjwbbpiisj,17255,17256,34511
21109,,rmc0h5qsqygj,17256,17257,34513
21110,,t21o027yucyj,17257,17258,34515
21111,,7k9iks4bcrcj,17258,17259,34517
21112,,vpccftttrdgj,17260,17261,34521
21113,,ciqyletmmraj,17261,17262,34523
21114,,bs5tf7law_yj,17262,17263,34525
21115,,vmycbxrw7j4j,17263,17264,34527
21116,,c5mszcxrn6mj,17264,17265,34529
21117,,nsry0o3_-uqj,17265,17266,34531
21118,,afy1gk_abl8j,17266,17267,34533
21119,,myngzjdjoqqj,17267,17268,34535
21120,,emiq-rraouej,17268,17269,34537
21121,,burbdayfsagj,17269,17270,34539
21122,,nljhftjqspmj,17270,17271,34541
21123,,5qsllixqlkyj,17272,17273,34545
21124,,mwcrrv_xztyj,17273,17274,34547
21125,,a9cnj9wqbtcj,17274,17275,34549
21126,,8j9u2zupjesj,17275,17276,34551
21127,,zdmcwklm6jwj,17276,17277,34553
21128,,aulwf95kkl8j,17277,17278,34555
21129,,h0l-acg2y7ij,17278,17279,34557
21130,,l2xaxs8wgwqj,17279,17280,34559
21131,,9fnwl1z0zwaj,17281,17282,34563
21132,,odpsma8hmcej,17282,17283,34565
21133,,nyxkyyijmouj,17283,17284,34567
21134,,8j_7thpdijkj,17284,17285,34569
21135,,b_xbur2pcf8j,17285,17286,34571
21136,,bvshaljoszkj,17286,17287,34573
21137,,gxppj0dzvroj,17287,17288,34575
21138,,cwyey-v5vngj,17288,17289,34577
21139,,eehut4ztrqoj,17289,17290,34579
21140,,cfcpeld0aamj,17290,17291,34581
21141,,kicdxvheiaej,17291,17292,34583
21142,,mongixbkrnkj,17292,17293,34585
21143,,n8lgsbkmf1sj,17293,17294,34587
21144,,551mhicjrjoj,17294,17295,34589
21145,,23gbcclzy6gj,17295,17296,34591
21146,,mrnvup9mxpgj,17297,17298,34595
21147,,p_nbnjnjzayj,17298,17299,34597
21148,,zaxnw_ldhscj,17300,17301,34601
21149,,hbqxnaapui4j,17301,17302,34603
21150,,n1mcwtwnrbkj,17302,17303,34605
21151,,ali-0i9bvv0j,17303,17304,34607
21152,,3mztom30simj,17304,17305,34609
21153,,pxbfvgtxjd8j,17305,17306,34611
21154,,_yeazqlvcgqj,17306,17307,34613
21155,,1wpbvefcyx4j,17307,17308,34615
21156,,dvhhlogcu7cj,17308,17309,34617
21157,,x65xypwwn_uj,17309,17310,34619
21158,,jxbz3pmap-yj,17310,17311,34621
21159,,nolhdf9vxgij,17311,17312,34623
21160,,3dpw08q2ln0j,17312,17313,34625
21161,,v6rokk9eht8j,17313,17314,34627
21162,,url:http://portal.acm.org/citation.cfm3fid3d1073204.1073255,17314,17315,34629
21163,,url:http://portal.acm.org/ft_gateway.cfm3fid3d35321326type3dpdf26dl3dguide26dl3dacm26cfid3d1111111126cftoken3d2222222,17315,17316,34631
21164,,jdjpjuw6a0mj,17316,17317,34633
21165,,url:http://www.csa.com/partners/viewrecord.php3frequester3dgs26collection3dtrd26recid3d20021214040860mt26recid3da7340042ah,17317,17318,34635
21166,,hlyd3vxbk-yj,17318,17319,34637
21167,,dbh8u9xhcocj,17319,17320,34639
21168,,zdcqe1fbkmsj,17320,17321,34641
21169,,bwso3vjpgn4j,17321,17322,34643
21170,,j8-h6elrnoyj,17322,17323,34645
21171,,kyoox2b9f7qj,17323,17324,34647
21172,,40cq9ovvxn8j,17324,17325,34649
21173,,cbvblrkaoooj,17325,17326,34651
21174,,grluyc-u9x8j,17326,17327,34653
21175,,url:http://www.springerlink.com/index/x5782x1j74h4434p.pdf,17328,17329,34657
21176,,y9dakhgh9aqj,17329,17330,34659
21177,,90oyaluxs5kj,17330,17331,34661
21178,,7aadeu0trfqj,17331,17332,34663
21179,,vg5-qjigpvoj,17332,17333,34665
21180,,cknay9iebmmj,17333,17334,34667
21181,,url:http://links.jstor.org/sici3fsici3d0146-4949(196722)8253a3253c377253asii253e2.0.co253b2-0,17334,17335,34669
21182,,h7_owhjhslqj,17335,17336,34671
21183,,xtws5jgf7s4j,17336,17337,34673
21184,,a5boeffsjmoj,17337,17338,34675
21185,,xeirdrdxwbqj,17338,17339,34677
21186,,losextbq0ikj,17339,17340,34679
21187,,wun1qrcpwlqj,17340,17341,34681
21188,,bvmroy2pqo4j,17341,17342,34683
21189,,url:http://links.jstor.org/sici3fsici3d0146-4949(196423)5253a3253c237253ap1253e2.0.co253b2-1,17342,17343,34685
21190,,1aaqlprfbqkj,17343,17344,34687
21191,,rqjbpktumtgj,17344,17345,34689
21192,,kdu4iiwlli8j,17345,17346,34691
21193,,hrogz0uy9doj,17346,17347,34693
21194,,fzb0pn9kn3wj,17347,17348,34695
21195,,yhmk5oxr45oj,17348,17349,34697
21196,,t-yaoxhef58j,17350,17351,34701
21197,,oua6mrwhd08j,17351,17352,34703
21198,,8-8vn7juwtsj,17352,17353,34705
21199,,p1f_-y0o8eqj,17353,17354,34707
21200,,2tz6p98ysygj,17354,17355,34709
21201,,url:http://adsabs.harvard.edu/abs/1982aero.rept.....z,17355,17356,34711
21202,,qtjfwigtev4j,17356,17357,34713
21203,,faf43m9fziuj,17357,17358,34715
21204,,kw8-qyax-l4j,17358,17359,34717
21205,,s9euklnlkbkj,17359,17360,34719
21206,,emmbeexqcdsj,17361,17362,34723
21207,,bdqvxxwqsqgj,17362,17363,34725
21208,,56mvycatq3qj,17363,17364,34727
21209,,lyyqwcdn5d0j,17364,17365,34729
21210,,6d-z_z4ayumj,17365,17366,34731
21211,,cbdc0kk02_gj,17366,17367,34733
21212,,vygb2dhnmpuj,17367,17368,34735
21213,,a-vulxqjhyaj,17368,17369,34737
21214,,vi-lshvmotsj,17369,17370,34739
21215,,zn5nfre_mlej,17370,17371,34741
21216,,sgym2wfckemj,17371,17372,34743
21217,,vkpck5johrsj,17372,17373,34745
21218,,qyvh2uj94toj,17373,17374,34747
21219,,fsrqzpzbknej,17374,17375,34749
21220,,jipgtmtgmtmj,17375,17376,34751
21221,,rek9pwgbzmoj,17376,17377,34753
21222,,s5ydycz_a2cj,17377,17378,34755
21223,,mtzdbbk3mqsj,17378,17379,34757
21224,,el9rfv7oo_0j,17379,17380,34759
21225,,iweiuijezj0j,17380,17381,34761
21226,,82lflstcj5sj,17381,17382,34763
21227,,ift_4vkaet8j,17382,17383,34765
21228,,qnqocrrapa4j,17383,17384,34767
21229,,ed9upbsl0iqj,17384,17385,34769
21230,,0kkridwxxa0j,17385,17386,34771
21231,,url:http://www.csa.com/partners/viewrecord.php3frequester3dgs26collection3dtrd26recid3dn9210367ah,17386,17387,34773
21232,,url:http://doi.wiley.com/10.1002/he.47,17387,17388,34775
21233,,r1xwrhy7wvuj,17388,17389,34777
21234,,qiza4yk08m8j,17389,17390,34779
21235,,url:http://www.csa.com/partners/viewrecord.php3frequester3dgs26collection3denv26recid3d8603849,17390,17391,34781
21236,,tqt_vvhausij,17391,17392,34783
21237,,url:http://portal.acm.org/citation.cfm3fid3d525590.837941,17392,17393,34785
21238,,8sh_0vwysnuj,17393,17394,34787
21239,,nx4la_ogqqij,17394,17395,34789
21240,,lqdscssoxgij,17395,17396,34791
21241,,izqyahd4liaj,17397,17398,34795
21242,,idjmg6vh5euj,17398,17399,34797
21243,,dm6djwotr1wj,17399,17400,34799
21244,,2h6la5szgtuj,17400,17401,34801
21245,,es_3dp3hpqcj,17401,17402,34803
21246,,ryepgxjgawkj,17402,17403,34805
21247,,4epshzpe3vmj,17403,17404,34807
21248,,l0bc6yhkhzsj,17404,17405,34809
21249,,wt53rwy0kf4j,17405,17406,34811
21250,,jn0nfy5inc4j,17406,17407,34813
21251,,n3c4jaubaywj,17407,17408,34815
21252,,lseqdfq5fwaj,17408,17409,34817
21253,,a6y0dcq4h3ej,17409,17410,34819
21254,,ioxee_zyutgj,17410,17411,34821
21255,,dakuj8vdshsj,17411,17412,34823
21256,,rfn5cvvlptej,17412,17413,34825
21257,,url:http://doi.wiley.com/10.1002/ev.1695,17413,17414,34827
21258,,yucyfvxns_kj,17415,17416,34831
21259,,3cs3sxow9-qj,17417,17418,34835
21260,,gzt2jvtoo4mj,17418,17419,34837
21261,,umxjzsgvuvaj,17419,17420,34839
21262,,gxndro70rkoj,17420,17421,34841
21263,,ml60kfvvlfmj,17421,17422,34843
21264,,ibgsc2lmm-8j,17422,17423,34845
21265,,41bcasy1mhqj,17423,17424,34847
21266,,o03aootvfmuj,17424,17425,34849
21267,,kxx7qh-welij,17425,17426,34851
21268,,kwk7vfctvbij,17426,17427,34853
21269,,bj3ay11nucej,17427,17428,34855
21270,,2kw1inf4fc0j,17428,17429,34857
21271,,f3fx5ppzujmj,17429,17430,34859
21272,,ybhdf9phnnej,17430,17431,34861
21273,,tlafxfneynqj,17431,17432,34863
21274,,4pdu2szbcwej,17432,17433,34865
21275,,0z3_0frp29qj,17433,17434,34867
21276,,dg0x9q3yjiij,17434,17435,34869
21277,,gc8cxg2rixkj,17435,17436,34871
21278,,,17436,17437,34873
21279,,bddz0i-ryyqj,17437,17438,34875
21280,,dbou8xooktuj,17439,17440,34879
21281,,url:http://doi.ieeecomputersociety.org/10.1109/icnp.2001.992900,17440,17441,34881
21282,,fpf7i-ehq-yj,17441,17442,34883
21283,,vstmv_n1zcaj,17442,17443,34885
21284,,xbm5vfgoymoj,17443,17444,34887
21285,,cyk5cgsyejqj,17444,17445,34889
21286,,zmghfw1_ewkj,17445,17446,34891
21287,,ziodybyl2ngj,17446,17447,34893
21288,,_tk9nlhmxjkj,17447,17448,34895
21289,,efiqms5czc0j,17448,17449,34897
21290,,aj9eic6n44gj,17449,17450,34899
21291,,4bu48i8o_xij,17450,17451,34901
21292,,ikyzaxnt8a0j,17451,17452,34903
21293,,t7v6eqtpxhij,17452,17453,34905
21294,,w8efyd3itoaj,17453,17454,34907
21295,,j2r0s4aimsaj,17455,17456,34911
21296,,mcfylq1jsw0j,17456,17457,34913
21297,,kahkttsimsgj,17457,17458,34915
21298,,,17458,17459,34917
21299,,n9qfzdr2ptmj,17460,17461,34921
21300,,sicf9ytktj8j,17461,17462,34923
21301,,45rdij60xo0j,17462,17463,34925
21302,,eh8fzxb84twj,17463,17464,34927
21303,,3r9idp0br-sj,17464,17465,34929
21304,,7wlqlx5jgyoj,17465,17466,34931
21305,,oruf3bcxn5gj,17466,17467,34933
21306,,2etgthg_77oj,17467,17468,34935
21307,,3wyvfvoafeaj,17468,17469,34937
21308,,u53fqlpzujsj,17469,17470,34939
21309,,eqi5chi-iywj,17470,17471,34941
21310,,cmmo3-fol9uj,17471,17472,34943
21311,,wufvw010qxcj,17472,17473,34945
21312,,ldoloodcy5cj,17473,17474,34947
21313,,6ar3vaf0vbaj,17474,17475,34949
21314,,jpb_5918klkj,17475,17476,34951
21315,,nsxgtdomuv4j,17476,17477,34953
21316,,lu8l-qr4f2uj,17477,17478,34955
21317,,uupfdscm1guj,17478,17479,34957
21318,,url:http://adsabs.harvard.edu/abs/1983mit..reptv....b,17479,17480,34959
21319,,ecl1_osbou8j,17480,17481,34961
21320,,h0ntpbxif7kj,17481,17482,34963
21321,,capyzk88dsoj,17482,17483,34965
21322,,yay3of1lvesj,17483,17484,34967
21323,,f8dkmfgrn1oj,17484,17485,34969
21324,,sfvtxk-r9cgj,17485,17486,34971
21325,,gumffjgyg3wj,17486,17487,34973
21326,,chj3ick7f4gj,17487,17488,34975
21327,,_bj-wiadft0j,17488,17489,34977
21328,,ucnkdobnilgj,17490,17491,34981
21329,,url:http://portal.acm.org/citation.cfm3fid3d342009.335474,17491,17492,34983
21330,,9coxhknje2ij,17492,17493,34985
21331,,0rfkpxpygekj,17493,17494,34987
21332,,x8xvh1yur0yj,17494,17495,34989
21333,,em-sbuvvejmj,17495,17496,34991
21334,,tfjdvdzs8-4j,17496,17497,34993
21335,,0vzqs5dwztkj,17497,17498,34995
21336,,c8tpnxrbnnij,17498,17499,34997
21337,,qms1e_vbqomj,17499,17500,34999
21338,,99a7abc0zmqj,17500,17501,35001
21339,,x27nojzqivyj,17501,17502,35003
21340,,353covwnlgej,17502,17503,35005
21341,,fekisszmec0j,17503,17504,35007
21342,,ejslt4kxzfcj,17505,17506,35011
21343,,u9al_oqxpxyj,17506,17507,35013
21344,,ojrprntgjsyj,17507,17508,35015
21345,,,17508,17509,35017
21346,,1aaw4ptmouuj,17509,17510,35019
21347,,,17510,17511,35021
21348,,iqx4msw_he8j,17511,17512,35023
21349,,irfzv8ifysaj,17512,17513,35025
21350,,tibcnsxpzdaj,17513,17514,35027
21351,,nlstijs1knkj,17514,17515,35029
21352,,xry7jvjk8gkj,17515,17516,35031
21353,,zjgvqvmfszmj,17516,17517,35033
21354,,mnftu35ljuyj,17517,17518,35035
21355,,06ol3yyfwaej,17518,17519,35037
21356,,aikbe5xxzmqj,17519,17520,35039
21357,,_yqioomgcqaj,17520,17521,35041
21358,,5of4ekvxdogj,17521,17522,35043
21359,,pfntkkmwjloj,17522,17523,35045
21360,,fpcaguhosmgj,17523,17524,35047
21361,,g7be_75kllsj,17524,17525,35049
21362,,fbugy1yvwhmj,17525,17526,35051
21363,,icpbwst_-ikj,17526,17527,35053
21364,,j-9t-_9setyj,17527,17528,35055
21365,,9wqm-ots1aej,17528,17529,35057
21366,,pcpiri_twbqj,17529,17530,35059
21367,,d0hvgv2omu0j,17530,17531,35061
21368,,wavqepdbby8j,17531,17532,35063
21369,,x8c1grj5h9sj,17532,17533,35065
21370,,ixkf8bx3k2ij,17533,17534,35067
21371,,o1smqcpghhoj,17534,17535,35069
21372,,n-4ogdip6caj,17535,17536,35071
21373,,mqua6zgrni4j,17536,17537,35073
21374,,nayftgntuxij,17537,17538,35075
21375,,jn8dt28k3aqj,17538,17539,35077
21376,,_c4lcp7hnj4j,17539,17540,35079
21377,,cxncrhgblbwj,17540,17541,35081
21378,,rx6ksejfjoej,17541,17542,35083
21379,,i45xv_tchtkj,17542,17543,35085
21380,,3amndgb5t74j,17543,17544,35087
21381,,gc3qgboaln0j,17544,17545,35089
21382,,ruhuulnv6buj,17545,17546,35091
21383,,gpekh-uohlyj,17546,17547,35093
21384,,53nbvi03-caj,17547,17548,35095
21385,,ghf2ofiarxuj,17548,17549,35097
21386,,96hv28d5xpaj,17549,17550,35099
21387,,e9mpszmx2i4j,17550,17551,35101
21388,,zr3zmcrefyqj,17551,17552,35103
21389,,sm8kckchl6oj,17552,17553,35105
21390,,_nytao9zo-cj,17553,17554,35107
21391,,esfif77jppqj,17554,17555,35109
21392,,ir6f_hek8buj,17555,17556,35111
21393,,niqzo9rocucj,17556,17557,35113
21394,,tmfrfajyoggj,17557,17558,35115
21395,,e6z68tql1bsj,17558,17559,35117
21396,,lljbqxzlr2qj,17559,17560,35119
21397,,mursaxr0xiwj,17560,17561,35121
21398,,bkk_ufdc6_wj,17561,17562,35123
21399,,n4wo7alaqagj,17562,17563,35125
21400,,zhwwue8a76gj,17563,17564,35127
21401,,bqualpdkegsj,17564,17565,35129
21402,,url:http://portal.acm.org/ft_gateway.cfm3fid3d110134626type3dpdf,17565,17566,35131
21403,,psi2n6z5cbaj,17566,17567,35133
21404,,url:http://portal.acm.org/ft_gateway.cfm3fid3d106627726type3dpdf,17567,17568,35135
21405,,h8pm5jny_kmj,17568,17569,35137
21406,,hbsnz9gub6wj,17569,17570,35139
21407,,oq-q0e4ssvmj,17570,17571,35141
21408,,gogpx-o6ydij,17571,17572,35143
21409,,url:http://www.geography.org.uk/journals/download.asp3farticleid3d146,17573,17574,35147
21410,,fiz-ds7ndq0j,17574,17575,35149
21411,,75byy_wpg7ej,17575,17576,35151
21412,,tidx1c5zo2kj,17576,17577,35153
21413,,o1irlfhqe-oj,17577,17578,35155
21414,,url:http://www.csa.com/partners/viewrecord.php3frequester3dgs26collection3dtrd26recid3d200111010690mt26recid3da0032608ah,17578,17579,35157
21415,,url:http://www.csa.com/partners/viewrecord.php3frequester3dgs26collection3denv26recid3d8913266,17579,17580,35159
21416,,s8lcvnorbsij,17580,17581,35161
21417,,url:http://www.csa.com/partners/viewrecord.php3frequester3dgs26collection3denv26recid3d8913259,17581,17582,35163
21418,,url:http://www.csa.com/partners/viewrecord.php3frequester3dgs26collection3dtrd26recid3d1030287ci,17582,17583,35165
21419,,ldkx5yno6tcj,17583,17584,35167
21420,,te7m9lvta08j,17584,17585,35169
21421,,0swy3m_rugsj,17585,17586,35171
21422,,c3fyb_bqr-8j,17586,17587,35173
21423,,url:http://doi.wiley.com/10.1002/ev.1333,17587,17588,35175
21424,,hmqqkuzlciqj,17588,17589,35177
21425,,bamc29xzsvsj,17589,17590,35179
21426,,hpu6xotsesmj,17590,17591,35181
21427,,u53snqtbfs4j,17591,17592,35183
21428,,beuu4a7csbuj,17592,17593,35185
21429,,kozqyxa0b1cj,17593,17594,35187
21430,,z7jzydc4rq0j,17594,17595,35189
21431,,ntjyj1nfkkqj,17595,17596,35191
21432,,hrxmhnxqxv4j,17596,17597,35193
21433,,url:http://www.csa.com/partners/viewrecord.php3frequester3dgs26collection3dtrd26recid3dn9210436ah,17597,17598,35195
21434,,tfcyebykfwaj,17598,17599,35197
21435,,mgk_kulzibmj,17599,17600,35199
21436,,obs0xre_syyj,17600,17601,35201
21437,,o3xez9_l2luj,17601,17602,35203
21438,,fw7xity4kzcj,17602,17603,35205
21439,,mndaemdps3cj,17603,17604,35207
21440,,gcmrvvgqlhaj,17604,17605,35209
21441,,o1jvnd0g278j,17605,17606,35211
21442,,bibbqnosuncj,17606,17607,35213
21443,,v_tejbe-q6ej,17607,17608,35215
21444,,ltisbjjyfv8j,17608,17609,35217
21445,,1_khut11hpwj,17609,17610,35219
21446,,i9vjcrtn8ioj,17610,17611,35221
21447,,zyrxp7trpaaj,17611,17612,35223
21448,,szjzehyjdgkj,17612,17613,35225
21449,,hbisi6-c2v8j,17613,17614,35227
21450,,znckmwmlzagj,17614,17615,35229
21451,,url:http://www.csa.com/partners/viewrecord.php3frequester3dgs26collection3dtrd26recid3dn9210458ah,17615,17616,35231
21452,,hg-pqgbsuluj,17616,17617,35233
21453,,0fcteosfk4ej,17617,17618,35235
21454,,ov8bdacunz0j,17618,17619,35237
21455,,r5kybp8zsnuj,17619,17620,35239
21456,,9mlong4sh4qj,17620,17621,35241
21457,,ifkrg8fh54wj,17621,17622,35243
21458,,de2rq1qtwasj,17622,17623,35245
21459,,imvffo5mtqcj,17623,17624,35247
21460,,vu3y1wuowxmj,17624,17625,35249
21461,,m9m-kz-jduaj,17625,17626,35251
21462,,ijfu--hwfmoj,17626,17627,35253
21463,,v7cbni6xn0yj,17627,17628,35255
21464,,tsditbxqjuyj,17630,17631,35261
21465,,cjlj_isoddyj,17631,17632,35263
21466,,rqzobls-gwkj,17632,17633,35265
21467,,wmyoushmf2ij,17633,17634,35267
21468,,yd3q9iiskngj,17634,17635,35269
21469,,1-othgghcc8j,17635,17636,35271
21470,,6x6fxq-n6cej,17636,17637,35273
21471,,tz5tx-30husj,17637,17638,35275
21472,,url:http://portal.acm.org/citation.cfm3fid3d80002526dl3dguide26dl3dacm26type3dproceeding26idx3dseries00326part3dproceedings26wanttype3dproceedings26title3dhistory2520of2520programming2520languages26cfid3d1111111126cftoken3d2222222,17638,17639,35277
21473,,4nyodkbe7wkj,17639,17640,35279
21474,,url:http://adsabs.harvard.edu/abs/1973phdt.........2v,17640,17641,35281
21475,,jniylntcpu4j,17641,17642,35283
21476,,2ldp3j-x0ioj,17642,17643,35285
21477,,gnrebrw3rk4j,17643,17644,35287
21478,,yyn1ubkxcpkj,17644,17645,35289
21479,,qjf9-b78vjij,17645,17646,35291
21480,,iijuhxopvb8j,17646,17647,35293
21481,,4vixy6efebgj,17647,17648,35295
21482,,vgz6ur8hezsj,17648,17649,35297
21483,,,17649,17650,35299
21484,,6prm-x2fyrwj,17650,17651,35301
21485,,f0cbypwc7_gj,17651,17652,35303
21486,,lzyu6lkeqi8j,17652,17653,35305
21487,,7ngigvmb4xqj,17653,17654,35307
21488,,txqlhgpdzi8j,17654,17655,35309
21489,,ffjtxyq1bzoj,17655,17656,35311
21490,,yrdhjbm9jtij,17656,17657,35313
21491,,lojl-d5tb5ij,17657,17658,35315
21492,,tmrqddyjioij,17658,17659,35317
21493,,fwgomvrmtuaj,17659,17660,35319
21494,,v1knzdekxekj,17660,17661,35321
21495,,upesvrsi9w8j,17661,17662,35323
21496,,jzt-zhstrwwj,17662,17663,35325
21497,,url:http://www.geography.org.uk/journals/journals.asp3farticleid3d9,17665,17666,35331
21498,,7ts1msk_lysj,17666,17667,35333
21499,,b1kuhr62xamj,17667,17668,35335
21500,,68uhowrsgwuj,17668,17669,35337
21501,,3qzbbbq9d1sj,17669,17670,35339
21502,,azw5jqeyfboj,17670,17671,35341
21503,,6hsgn36rg7ej,17671,17672,35343
21504,,70owv9bdahwj,17672,17673,35345
21505,,rwf_lfnp6p8j,17673,17674,35347
21506,,cjg7epzj_6gj,17674,17675,35349
21507,,knka2cpk9a4j,17675,17676,35351
21508,,hsl2renrfhej,17676,17677,35353
21509,,zpu_-magg1kj,17677,17678,35355
21510,,jbhz84qw1vgj,17678,17679,35357
21511,,uwyni72ys3sj,17679,17680,35359
21512,,rl_vjpspbhej,17680,17681,35361
21513,,oj-rswa2sgwj,17681,17682,35363
21514,,e495ojiqrqkj,17682,17683,35365
21515,,lykml5jlblmj,17683,17684,35367
21516,,kanttfhmfhaj,17684,17685,35369
21517,,mdrdnf3a-bqj,17685,17686,35371
21518,,fdgqwgxp8_gj,17686,17687,35373
21519,,b-cnqkpbq5qj,17687,17688,35375
21520,,zgmkacbvlugj,17688,17689,35377
21521,,phju6oz7owkj,17689,17690,35379
21522,,46lyv6vki_gj,17690,17691,35381
21523,,n5usdazfwocj,17691,17692,35383
21524,,s99uohk5il0j,17692,17693,35385
21525,,zynsli6mz2cj,17694,17695,35389
21526,,e11cnbw7b3sj,17695,17696,35391
21527,,gfrgthbthzmj,17696,17697,35393
21528,,url:http://portal.acm.org/citation.cfm3fid3d509252.509282,17697,17698,35395
21529,,ne7whisl9qyj,17698,17699,35397
21530,,ut-7k_gzdxaj,17699,17700,35399
21531,,7m85sb9h0fuj,17700,17701,35401
21532,,ghnqq9zn3kmj,17701,17702,35403
21533,,xeparm8yzfqj,17702,17703,35405
21534,,40-eteurle0j,17703,17704,35407
21535,,heppxgdnjtej,17704,17705,35409
21536,,nbmmz6j6vicj,17705,17706,35411
21537,,7iwlmnpi_qsj,17706,17707,35413
21538,,dckiljfktkwj,17707,17708,35415
21539,,ln15lt5oupcj,17708,17709,35417
21540,,gjnvzydy0-kj,17709,17710,35419
21541,,vjqdlxkhfzoj,17710,17711,35421
21542,,mzl0gx_xioaj,17711,17712,35423
21543,,rbzw8i6awroj,17712,17713,35425
21544,,o1d7glkex-sj,17713,17714,35427
21545,,olzjq7mxvz8j,17714,17715,35429
21546,,wjhzhsxliigj,17715,17716,35431
21547,,zc18xto7grqj,17716,17717,35433
21548,,zhhzj24xs2kj,17717,17718,35435
21549,,eyaxkyww9kcj,17718,17719,35437
21550,,kic2yvptkx8j,17719,17720,35439
21551,,gkceyy9spsqj,17720,17721,35441
21552,,,17721,17722,35443
21553,,ofseklzwl4cj,17722,17723,35445
21554,,w95qb1imh6gj,17723,17724,35447
21555,,huig38fy6zej,17724,17725,35449
21556,,fgilrulj_dqj,17725,17726,35451
21557,,pborwmlfpkwj,17726,17727,35453
21558,,qfcln6dkak4j,17727,17728,35455
21559,,ronnumlbo-ej,17728,17729,35457
21560,,hfgsg9lz9sej,17729,17730,35459
21561,,2xy6gb40twej,17730,17731,35461
21562,,hjwajtc_szsj,17731,17732,35463
21563,,ahwacduollij,17732,17733,35465
21564,,wewwcp15tlej,17733,17734,35467
21565,,hbzcxugezbej,17734,17735,35469
21566,,v_v4ru1m688j,17735,17736,35471
21567,,mxioqxyymiqj,17736,17737,35473
21568,,2f4tdood3t0j,17737,17738,35475
21569,,2n8hbvxrtyqj,17738,17739,35477
21570,,tpl-lvecax0j,17739,17740,35479
21571,,npxqgx8mfsmj,17740,17741,35481
21572,,c9t2ytesw78j,17741,17742,35483
21573,,u2d6p6julq4j,17742,17743,35485
21574,,cneudhir4cgj,17743,17744,35487
21575,,h5wfixstafej,17744,17745,35489
21576,,7l977tiv_vyj,17745,17746,35491
21577,,yeuwo79e1kuj,17746,17747,35493
21578,,qmqpfmue5mej,17747,17748,35495
21579,,22mlytr-mkcj,17748,17749,35497
21580,,8t74wofhvdmj,17749,17750,35499
21581,,ygt8w46gmiuj,17750,17751,35501
21582,,jckfvv8lx3oj,17751,17752,35503
21583,,jiutalc5aq0j,17753,17754,35507
21584,,0ppvqkwf9zkj,17754,17755,35509
21585,,3nxl8d4c0t4j,17755,17756,35511
21586,,da-sokpuis8j,17756,17757,35513
21587,,edm6xb0wvxuj,17757,17758,35515
21588,,cfhis97b_0qj,17758,17759,35517
21589,,mhite7pdfsyj,17759,17760,35519
21590,,y3e-zyafqcij,17761,17762,35523
21591,,ozm3yui50noj,17763,17764,35527
21592,,qovnxsv2aiij,17764,17765,35529
21593,,zx7wle9dgwgj,17765,17766,35531
21594,,vf08l5bjrhej,17766,17767,35533
21595,,qqth6hkshtij,17767,17768,35535
21596,,wfzyyhjk3i4j,17768,17769,35537
21597,,nov8udnqiewj,17769,17770,35539
21598,,ytlaojrlf38j,17770,17771,35541
21599,,url:http://doi.wiley.com/10.1002/he.89,17771,17772,35543
21600,,dvzxmzec9o8j,17772,17773,35545
21601,,y4quhxze5k8j,17773,17774,35547
21602,,_hqit9e1sjgj,17774,17775,35549
21603,,ykxrlfkdz1mj,17775,17776,35551
21604,,kmqxbxl8rr8j,17776,17777,35553
21605,,72gqajura_oj,17777,17778,35555
21606,,leo04dnlrxaj,17778,17779,35557
21607,,vbldklyxeqkj,17779,17780,35559
21608,,6qyii-x7niqj,17780,17781,35561
21609,,4fwoybttip4j,17781,17782,35563
21610,,v0wqrahpmlgj,17782,17783,35565
21611,,jrm7oujqk7yj,17783,17784,35567
21612,,hekiedmsfcyj,17784,17785,35569
21613,,tgcqc93lamcj,17785,17786,35571
21614,,yfrqwwdm3ioj,17786,17787,35573
21615,,gmdxbatrqamj,17787,17788,35575
21616,,a1ovjxol8usj,17788,17789,35577
21617,,u1h9osvythkj,17789,17790,35579
21618,,zn9dsoki13uj,17790,17791,35581
21619,,fa67vqqhqzwj,17791,17792,35583
21620,,m6dsbdjckq0j,17792,17793,35585
21621,,2gabmdewahaj,17793,17794,35587
21622,,h0u_l4ktur8j,17794,17795,35589
21623,,_92ceiajfbyj,17795,17796,35591
21624,,cm4zksyd4ouj,17796,17797,35593
21625,,uhwed4kmpdyj,17797,17798,35595
21626,,zdx0v74jttmj,17798,17799,35597
21627,,fjop5p_rvcgj,17799,17800,35599
21628,,zrkmvygfnxmj,17800,17801,35601
21629,,c9vdlrbo26mj,17801,17802,35603
21630,,mt2fdsdsllkj,17802,17803,35605
21631,,kvfopg6maoyj,17803,17804,35607
21632,,url:http://portal.acm.org/citation.cfm3fid3d171926.171946,17804,17805,35609
21633,,551zk87o_qyj,17805,17806,35611
21634,,i4cewgponfqj,17806,17807,35613
21635,,bu7wsvkvhscj,17807,17808,35615
21636,,piwmyab0mhyj,17808,17809,35617
21637,,iyiav5olovgj,17809,17810,35619
21638,,l45p_iu7kx8j,17810,17811,35621
21639,,rlqrovfabxcj,17811,17812,35623
21640,,wvkpqzho5euj,17812,17813,35625
21641,,4wisolvzdqcj,17813,17814,35627
21642,,c427ehsxedyj,17814,17815,35629
21643,,bbvzmwoe1ayj,17815,17816,35631
21644,,ait3gyjzjpaj,17816,17817,35633
21645,,url:http://doi.wiley.com/10.1002/he.128,17817,17818,35635
21646,,hfjd1dsuf9sj,17818,17819,35637
21647,,cckhntktq7oj,17819,17820,35639
21648,,fqf9btqfbwyj,17820,17821,35641
21649,,ftchquw85iej,17821,17822,35643
21650,,9sjpquktvw8j,17822,17823,35645
21651,,,17823,17824,35647
21652,,3wg_xe_j4woj,17824,17825,35649
21653,,kfpmkmq7gjmj,17825,17826,35651
21654,,gl5cgolsxkej,17826,17827,35653
21655,,ciqbwv7c2jij,17827,17828,35655
21656,,url:http://doi.wiley.com/10.1002/ev.1294,17828,17829,35657
21657,,bhm19ybzcfgj,17829,17830,35659
21658,,fflh1x1b8suj,17830,17831,35661
21659,,v2luuojatx0j,17831,17832,35663
21660,,thagps8653ej,17832,17833,35665
21661,,x3zrctyeeigj,17833,17834,35667
21662,,url:http://portal.acm.org/ft_gateway.cfm3fid3d27635526type3dpdf26dl3dguide26dl3dacm26cfid3d1111111126cftoken3d2222222,17835,17836,35671
21663,,n1ibwzkf5egj,17836,17837,35673
21664,,drq1sldkthqj,17837,17838,35675
21665,,id63acagbbkj,17838,17839,35677
21666,,zbpsogsikbqj,17839,17840,35679
21667,,rqdq3l2hw7uj,17840,17841,35681
21668,,ohnsx9bloeoj,17841,17842,35683
21669,,oyxnfxg8odgj,17842,17843,35685
21670,,kxt1ylbl1tgj,17843,17844,35687
21671,,e-1nax7gc-8j,17844,17845,35689
21672,,5irgbroyqwij,17845,17846,35691
21673,,3kk6ah3k8x4j,17846,17847,35693
21674,,esnnybslb8yj,17847,17848,35695
21675,,o1n3pixzlf8j,17848,17849,35697
21676,,url:http://portal.acm.org/ft_gateway.cfm3fid3d110115526type3dpdf,17849,17850,35699
21677,,wwiut0pvhf4j,17850,17851,35701
21678,,6ydvxfgjiigj,17851,17852,35703
21679,,phiz2kwipg8j,17852,17853,35705
21680,,prsnkxe-jlcj,17853,17854,35707
21681,,,17854,17855,35709
21682,,url:http://portal.acm.org/ft_gateway.cfm3fid3d110115326type3dpdf,17855,17856,35711
21683,,fkvwdo0ifpsj,17856,17857,35713
21684,,j2uytk4awhej,17857,17858,35715
21685,,ubbjybojxmwj,17858,17859,35717
21686,,url:http://ieeexplore.ieee.org/iel5/69/28801/01294890.pdf3farnumber3d1294890,17859,17860,35719
21687,,lhetpusuiqaj,17860,17861,35721
21688,,wqln213598gj,17861,17862,35723
21689,,3i2labt9fjsj,17862,17863,35725
21690,,rotbxqeqaoyj,17863,17864,35727
21691,,c0a8zs4sl2ij,17864,17865,35729
21692,,q1mc2oapikqj,17865,17866,35731
21693,,udncsfdpvgmj,17866,17867,35733
21694,,c2ygdutip1cj,17867,17868,35735
21695,,muklf55wlcoj,17868,17869,35737
21696,,bgvt71_dknoj,17869,17870,35739
21697,,toqefip7ucoj,17870,17871,35741
21698,,mrljwr4rf5gj,17871,17872,35743
21699,,6pbrmrd7x74j,17872,17873,35745
21700,,ylx_hgu1nrsj,17873,17874,35747
21701,,t-a4ox_ay8ej,17874,17875,35749
21702,,v5qitgl4wxoj,17875,17876,35751
21703,,zvrbqkxcgxsj,17876,17877,35753
21704,,h-mh9pa8vr0j,17877,17878,35755
21705,,ctoyrlj2o8wj,17878,17879,35757
21706,,url:http://doi.wiley.com/10.1002/ev.1607,17879,17880,35759
21707,,qist-kngj_0j,17880,17881,35761
21708,,xed0gbzagxoj,17881,17882,35763
21709,,0u53ml-ey0sj,17882,17883,35765
21710,,stxmbtck2gyj,17883,17884,35767
21711,,iut1uakg-xcj,17884,17885,35769
21712,,fwuuktn4sr0j,17885,17886,35771
21713,,2x3tlhhtdcyj,17886,17887,35773
21714,,qbokqhih1poj,17887,17888,35775
21715,,zojrypjwecqj,17888,17889,35777
21716,,4tumhzrkrtcj,17889,17890,35779
21717,,gq-jbnb4-7yj,17890,17891,35781
21718,,nwfnpy7gufqj,17891,17892,35783
21719,,scylspm9chej,17892,17893,35785
21720,,ng7ddq_qcouj,17893,17894,35787
21721,,m9ei-g89uagj,17894,17895,35789
21722,,usqa5osqf3aj,17895,17896,35791
21723,,5nczv90ypeij,17896,17897,35793
21724,,5il8vzpwqy0j,17897,17898,35795
21725,,url:http://adsabs.harvard.edu/abs/1974mit..reptr....m,17898,17899,35797
21726,,b7hv3rqdky8j,17899,17900,35799
21727,,bdcxrtuneyoj,17900,17901,35801
21728,,5i0arbmdrcej,17901,17902,35803
21729,,uhjvvdn0rwyj,17902,17903,35805
21730,,lsgghf8de0ej,17903,17904,35807
21731,,1d7kkitwnzmj,17904,17905,35809
21732,,npmq_u3f4tej,17905,17906,35811
21733,,ts8lb2a13rwj,17907,17908,35815
21734,,url:http://portal.acm.org/ft_gateway.cfm3fid3d8794326type3dpdf26dl3dguide26dl3dacm26cfid3d1111111126cftoken3d2222222,17908,17909,35817
21735,,s0kfkfcvs_gj,17909,17910,35819
21736,,xt3zb79yjqyj,17910,17911,35821
21737,,vlmkxqlgd_qj,17911,17912,35823
21738,,iphimraizi0j,17912,17913,35825
21739,,k-e1fau2xuej,17913,17914,35827
21740,,gqtvpehfmymj,17914,17915,35829
21741,,cfrkfgj17bgj,17915,17916,35831
21742,,0bng0svgppkj,17916,17917,35833
21743,,5sgfjzdt_gqj,17917,17918,35835
21744,,srpx9iqerncj,17918,17919,35837
21745,,7wvklqjeg58j,17919,17920,35839
21746,,eonzgwe6780j,17920,17921,35841
21747,,n-luiwc0ijwj,17921,17922,35843
21748,,evulcpyvqwgj,17922,17923,35845
21749,,a8rtvu4lmtaj,17923,17924,35847
21750,,h3heelsnnncj,17924,17925,35849
21751,,n9l_rdy0v9ej,17925,17926,35851
21752,,xxytrjct_nsj,17927,17928,35855
21753,,vshdmklpffej,17928,17929,35857
21754,,url:http://www.ingentaconnect.com/content/els/09505849/1995/00000037/00000003/art98927,17929,17930,35859
21755,,j45ybvwrkxij,17930,17931,35861
21756,,iknunbaaslij,17931,17932,35863
21757,,ibmj8jsxm-sj,17932,17933,35865
21758,,yktpkixp4s8j,17933,17934,35867
21759,,j7uezpa-3hgj,17934,17935,35869
21760,,p-ocha4m88kj,17935,17936,35871
21761,,i6950iprq7yj,17936,17937,35873
21762,,ub1spyeccm0j,17937,17938,35875
21763,,sq2k_ybexxmj,17938,17939,35877
21764,,j21hguinczcj,17939,17940,35879
21765,,jiu9h3aadhmj,17940,17941,35881
21766,,gobembfg40ij,17941,17942,35883
21767,,url:http://portal.acm.org/ft_gateway.cfm3fid3d110195326type3dpdf,17942,17943,35885
21768,,ds5hx6dhz_0j,17943,17944,35887
21769,,ef-7qiyppk0j,17944,17945,35889
21770,,zmoniwjb2moj,17945,17946,35891
21771,,vuhsrf5owhyj,17946,17947,35893
21772,,i3jaulw3_xsj,17947,17948,35895
21773,,waxg0pxojsuj,17948,17949,35897
21774,,7y5abxqj_9kj,17949,17950,35899
21775,,9ohhajpku8wj,17950,17951,35901
21776,,ddxrgcjirbmj,17951,17952,35903
21777,,vyahujivkukj,17953,17954,35907
21778,,79wtikuijdgj,17954,17955,35909
21779,,qsu3ile4kz0j,17955,17956,35911
21780,,vnsgwpuaktkj,17956,17957,35913
21781,,mysim5myajaj,17957,17958,35915
21782,,ez1neupsyhyj,17958,17959,35917
21783,,vbwjr666c2aj,17959,17960,35919
21784,,thwh-sh2tbmj,17960,17961,35921
21785,,qghfp3631csj,17961,17962,35923
21786,,w1obiuboft8j,17962,17963,35925
21787,,qao7k3o3kryj,17963,17964,35927
21788,,81oh7edayeoj,17964,17965,35929
21789,,vhncgcs5dl4j,17965,17966,35931
21790,,m_lsdvcildkj,17966,17967,35933
21791,,url:http://portal.acm.org/ft_gateway.cfm3fid3d109338526type3dpdf,17967,17968,35935
21792,,z831rzps9lwj,17968,17969,35937
21793,,ouoylddc6kmj,17969,17970,35939
21794,,8vphliwbzpsj,17970,17971,35941
21795,,tdg9cfj9iosj,17971,17972,35943
21796,,g_7fzqblln8j,17972,17973,35945
21797,,nvmlyarg9dgj,17973,17974,35947
21798,,fxlyonn13cmj,17974,17975,35949
21799,,y_tuhgqrmx0j,17975,17976,35951
21800,,8wobhow5ae4j,17976,17977,35953
21801,,d6s2nnj4tycj,17977,17978,35955
21802,,eryim13feroj,17978,17979,35957
21803,,ay4vn5yydgkj,17979,17980,35959
21804,,url:http://portal.acm.org/citation.cfm3fid3d645922,17980,17981,35961
21805,,0nwtrarkqamj,17981,17982,35963
21806,,9nxwgviagboj,17982,17983,35965
21807,,bqruwjjjf_aj,17983,17984,35967
21808,,url:http://adsabs.harvard.edu/abs/1976phdt........77r,17984,17985,35969
21809,,shu4ysgvrugj,17985,17986,35971
21810,,ikjrofv4o9qj,17986,17987,35973
21811,,8hhdapjqrfgj,17987,17988,35975
21812,,mp5gikws-vyj,17988,17989,35977
21813,,pmdamvdq07sj,17989,17990,35979
21814,,fhnju1yhinuj,17990,17991,35981
21815,,cxtlkcnwqsqj,17991,17992,35983
21816,,xrhlarkdgoej,17992,17993,35985
21817,,humoertaqjkj,17993,17994,35987
21818,,url:http://portal.acm.org/citation.cfm3fid3d48360.48364,17994,17995,35989
21819,,hrdavzbhfw8j,17995,17996,35991
21820,,ch3vsiqhadsj,17996,17997,35993
21821,,3w3wsdi2rnqj,17997,17998,35995
21822,,ggzamhxessgj,17998,17999,35997
21823,,mvsfc7shaqyj,17999,18000,35999
21824,,uugdn9iymb8j,18000,18001,36001
21825,,dhnbaumzmxsj,18001,18002,36003
21826,,url:http://www.ncbi.nlm.nih.gov/entrez/query.fcgi3fcmd3dretrieve26db3dpubmed26list_uids3d64130226dopt3dcitation,18002,18003,36005
21827,,0lbrtkdws3kj,18004,18005,36009
21828,,url:http://portal.acm.org/citation.cfm3fid3d192593.19736726dl3dguide26dl3dacm26type3dseries26idx3d19259326part3dproceedings26wanttype3dproceedings26title3dinternational2520multimedia2520conference26cfid3d1111111126cftoken3d2222222,18005,18006,36011
21829,,zlpclnqzntaj,18006,18007,36013
21830,,8vrckhoqomaj,18007,18008,36015
21831,,f0a2v6okkn0j,18008,18009,36017
21832,,yzdemotx-yej,18009,18010,36019
21833,,7whnnb5i2oij,18010,18011,36021
21834,,mswqtc5tc08j,18011,18012,36023
21835,,h9p9nw0eldcj,18012,18013,36025
21836,,8bpa2fidozgj,18013,18014,36027
21837,,ukxq5mlir8ij,18014,18015,36029
21838,,pwilpets8xqj,18015,18016,36031
21839,,hozx0hs-rekj,18016,18017,36033
21840,,7k_l2cum5dij,18017,18018,36035
21841,,lzzzof2__9mj,18018,18019,36037
21842,,fs7vzrd0gpcj,18019,18020,36039
21843,,9vg9jbfj3j0j,18020,18021,36041
21844,,b-zgdnh7w0cj,18021,18022,36043
21845,,,18022,18023,36045
21846,,kxhzxcrnup0j,18023,18024,36047
21847,,vmfporlqax4j,18024,18025,36049
21848,,lartwqxdatcj,18025,18026,36051
21849,,ypt_bdzqim4j,18026,18027,36053
21850,,ckgnk8cwpvaj,18027,18028,36055
21851,,ay4ssapul-aj,18028,18029,36057
21852,,uqg6mlcinxoj,18029,18030,36059
21853,,zfz9eqpvjxmj,18030,18031,36061
21854,,ebhpr2ftescj,18031,18032,36063
21855,,kfhyys3gnucj,18032,18033,36065
21856,,a-fi-3ysz0ij,18033,18034,36067
21857,,gffqx26_1eoj,18034,18035,36069
21858,,ppyufw_gkoaj,18035,18036,36071
21859,,yr-sujzkuzij,18036,18037,36073
21860,,dczolg7yeuwj,18037,18038,36075
21861,,eeiatp9kcmwj,18038,18039,36077
21862,,vcrvm73grrej,18039,18040,36079
21863,,f9jbcuzdugsj,18040,18041,36081
21864,,q7-5lg_wikkj,18041,18042,36083
21865,,zicpw9lpyvkj,18042,18043,36085
21866,,url:http://pubs.acs.org/cgi-bin/abstract.cgi/achre4/2005/38/i10/abs/ar0402513.html,18043,18044,36087
21867,,apssnhtpibmj,18044,18045,36089
21868,,rtmcrr84kqcj,18045,18046,36091
21869,,ftd1owrwqewj,18046,18047,36093
21870,,3lxortxgnwaj,18047,18048,36095
21871,,8auicru-p6mj,18048,18049,36097
21872,,zjxiliccj94j,18049,18050,36099
21873,,lnemi-fxbfqj,18050,18051,36101
21874,,sv3cm34rme8j,18051,18052,36103
21875,,v2xrz4zhknaj,18052,18053,36105
21876,,ccdrf1vlka8j,18053,18054,36107
21877,,inw18w_dvvgj,18054,18055,36109
21878,,nqe206yp5qgj,18055,18056,36111
21879,,tdxg7a1ncm0j,18056,18057,36113
21880,,_f_fnxnasbsj,18057,18058,36115
21881,,unlrwa3azfcj,18058,18059,36117
21882,,xrfekurtr2ej,18059,18060,36119
21883,,url:http://portal.acm.org/ft_gateway.cfm3fid3d10108226type3dpdf26coll3dguide26dl3dacm26cfid3d1111111126cftoken3d2222222,18060,18061,36121
21884,,aqvatprsef8j,18061,18062,36123
21885,,smt4a5lp2iqj,18062,18063,36125
21886,,rtnjbtpb4jaj,18063,18064,36127
21887,,6ym5quxz_5oj,18064,18065,36129
21888,,sye2asmvhiwj,18065,18066,36131
21889,,4xl4iaxadcgj,18066,18067,36133
21890,,pdtfnwfccxkj,18067,18068,36135
21891,,kkfbuihn9uyj,18068,18069,36137
21892,,h2tgcwszftyj,18069,18070,36139
21893,,xft44a-rubqj,18070,18071,36141
21894,,peavsg3oqi4j,18071,18072,36143
21895,,rhyqqg6d0ikj,18072,18073,36145
21896,,url:http://portal.acm.org/ft_gateway.cfm3fid3d98453726type3dpdf26dl3dguide26dl3dacm26cfid3d1111111126cftoken3d2222222,18073,18074,36147
21897,,url:http://portal.acm.org/ft_gateway.cfm3fid3d106626226type3dpdf,18074,18075,36149
21898,,1sqezsfzkfgj,18075,18076,36151
21899,,okz3segx4ouj,18076,18077,36153
21900,,cy6irepfw3kj,18077,18078,36155
21901,,vkm-fajsyq4j,18078,18079,36157
21902,,sqj8bb3wzl0j,18079,18080,36159
21903,,xvzv9imc41yj,18080,18081,36161
21904,,if0e3cun4baj,18081,18082,36163
21905,,ozrx6kasvtgj,18082,18083,36165
21906,,yittr8l2mq4j,18083,18084,36167
21907,,url:http://www.csa.com/partners/viewrecord.php3frequester3dgs26collection3dtrd26recid3d0458865ci,18084,18085,36169
21908,,rgh6gep4ym8j,18085,18086,36171
21909,,ljt5mgijximj,18086,18087,36173
21910,,vtiblvdzpukj,18087,18088,36175
21911,,g3xlw8zsbp0j,18088,18089,36177
21912,,p01bvvhxarwj,18089,18090,36179
21913,,ernhxdnpypyj,18090,18091,36181
21914,,url:http://www.csa.com/partners/viewrecord.php3frequester3dgs26collection3dtrd26recid3d0234325ci,18091,18092,36183
21915,,l1qzoxdssbqj,18092,18093,36185
21916,,jlzrcdjisfkj,18093,18094,36187
21917,,0jfvngc79bmj,18094,18095,36189
21918,,pqa0l-x04ouj,18095,18096,36191
21919,,k8povpn4dsaj,18096,18097,36193
21920,,6gc5tn-yce8j,18097,18098,36195
21921,,wesnft-jkguj,18098,18099,36197
21922,,yqdhxoksgv4j,18099,18100,36199
21923,,url:http://portal.acm.org/ft_gateway.cfm3fid3d109961326type3dpdf,18100,18101,36201
21924,,rlkrj-swp4oj,18101,18102,36203
21925,,qvxjjrasgjkj,18102,18103,36205
21926,,ppjujdyo39wj,18103,18104,36207
21927,,1relrv51aoej,18104,18105,36209
21928,,ayuzthq_w7cj,18105,18106,36211
21929,,f7tub2u3yfwj,18106,18107,36213
21930,,hahbtryekdej,18107,18108,36215
21931,,u-0axyivpayj,18108,18109,36217
21932,,xbn8wdzvb-gj,18109,18110,36219
21933,,uqnaar6cbxcj,18110,18111,36221
21934,,fnt5g2r4mayj,18111,18112,36223
21935,,url:http://www.csa.com/partners/viewrecord.php3frequester3dgs26collection3dtrd26recid3d0532536ci,18112,18113,36225
21936,,s9m5r_o-pqkj,18113,18114,36227
21937,,xfvqaox1qo4j,18114,18115,36229
21938,,1p0xt_gscuwj,18115,18116,36231
21939,,a2r0hu-k12mj,18116,18117,36233
21940,,ij06bigtnpcj,18117,18118,36235
21941,,qrfjv_lrapmj,18119,18120,36239
21942,,kb6k6cb1eumj,18120,18121,36241
21943,,i8jzg7qdkiyj,18121,18122,36243
21944,,q4tg9lbz33cj,18122,18123,36245
21945,,bkmf6eib7uwj,18123,18124,36247
21946,,sj1q8dofdzij,18124,18125,36249
21947,,ow8ndeab2v4j,18125,18126,36251
21948,,bi_nqtg9pscj,18126,18127,36253
21949,,5sqp6xgwmnqj,18128,18129,36257
21950,,lnt29frdmruj,18129,18130,36259
21951,,n66ikc8zboej,18130,18131,36261
21952,,qwfa2xeyblcj,18131,18132,36263
21953,,b6hqwd7_r4gj,18132,18133,36265
21954,,reroqlhp3xuj,18133,18134,36267
21955,,sg6fz_cnzguj,18134,18135,36269
21956,,36dpvsddzqij,18135,18136,36271
21957,,uh7ying3dqij,18136,18137,36273
21958,,s5o9gmgbfeaj,18137,18138,36275
21959,,dc4n7o4ks-0j,18138,18139,36277
21960,,bl15winuqdsj,18139,18140,36279
21961,,8_olnhndt0kj,18140,18141,36281
21962,,mhiymtgdrjwj,18141,18142,36283
21963,,vmlfljgcohyj,18142,18143,36285
21964,,ah5avbl88woj,18143,18144,36287
21965,,pftrehiwssmj,18144,18145,36289
21966,,yhb8u7g1lz8j,18145,18146,36291
21967,,e7tr0udcrv4j,18146,18147,36293
21968,,sy1dengr7nwj,18147,18148,36295
21969,,5fhnnf5sawuj,18148,18149,36297
21970,,4ua3_4270hkj,18149,18150,36299
21971,,hmim6-jjbk8j,18150,18151,36301
21972,,nkqfmwypph8j,18151,18152,36303
21973,,lrne3ln4jw4j,18152,18153,36305
21974,,_-q_l4f_bp0j,18153,18154,36307
21975,,url:http://portal.acm.org/ft_gateway.cfm3fid3d31006026type3dpdf26dl3dguide26dl3dacm26cfid3d1111111126cftoken3d2222222,18154,18155,36309
21976,,sulysuryxcuj,18155,18156,36311
21977,,hobei0uuu4gj,18156,18157,36313
21978,,url:http://portal.acm.org/citation.cfm3fid3d645926,18157,18158,36315
21979,,dit_sp3idvmj,18158,18159,36317
21980,,u-4ylogmay4j,18159,18160,36319
21981,,a6i26xyenjcj,18160,18161,36321
21982,,san1emx6n5mj,18161,18162,36323
21983,,r1hcxq7vl3mj,18162,18163,36325
21984,,bupssggulf0j,18163,18164,36327
21985,,bb2zztmyhumj,18164,18165,36329
21986,,3qr5fijzyaqj,18165,18166,36331
21987,,h7tcehytmcej,18166,18167,36333
21988,,p3dd-0mprhyj,18167,18168,36335
21989,,5ihgqrechvkj,18168,18169,36337
21990,,skxguhmj4e4j,18169,18170,36339
21991,,jegy6thacxmj,18170,18171,36341
21992,,igewgj8ksjsj,18171,18172,36343
21993,,mokekoaerh0j,18172,18173,36345
21994,,uuhex89cbr0j,18173,18174,36347
21995,,hef7huwp4suj,18174,18175,36349
21996,,tvoxh2kshqij,18175,18176,36351
21997,,zbsr_y8zeeuj,18176,18177,36353
21998,,lzjb0qnf4u8j,18177,18178,36355
21999,,thuvd9g1ntkj,18178,18179,36357
22000,,nxy82hitr9qj,18179,18180,36359
22001,,vb2tm0lxzboj,18180,18181,36361
22002,,tsjpd5ij6icj,18181,18182,36363
22003,,om-g_cddfcmj,18182,18183,36365
22004,,xgk3seg0mn4j,18183,18184,36367
22005,,4j0p-jply7kj,18184,18185,36369
22006,,kvfmuopcb4wj,18185,18186,36371
22007,,ssr4gjjji5mj,18186,18187,36373
22008,,d1zzcjfezs8j,18187,18188,36375
22009,,tgsxdg1ic1kj,18188,18189,36377
22010,,kt2eeqs5wzkj,18189,18190,36379
22011,,bo9ac0ljmvgj,18190,18191,36381
22012,,qwb3uw2jkouj,18191,18192,36383
22013,,thqw-dgg4qoj,18192,18193,36385
22014,,nriqed_anfcj,18193,18194,36387
22015,,t-ipyauf-iwj,18194,18195,36389
22016,,qk2vt8tgynqj,18195,18196,36391
22017,,_ehzbthwwrsj,18196,18197,36393
22018,,5a6smp1nbeaj,18197,18198,36395
22019,,x-qxnl-2m1ej,18198,18199,36397
22020,,folne-yqmo8j,18199,18200,36399
22021,,85sswl_s_foj,18200,18201,36401
22022,,wydrvxrmxo4j,18201,18202,36403
22023,,gkwwjktsdtwj,18202,18203,36405
22024,,t8xlbnbowngj,18203,18204,36407
22025,,rivdgatoi3yj,18204,18205,36409
22026,,at7rtd-fvvgj,18205,18206,36411
22027,,kvmbxvnjg3ej,18206,18207,36413
22028,,f0m4vzehs2kj,18207,18208,36415
22029,,57uqxdaorpoj,18208,18209,36417
22030,,2tpehehg2q0j,18209,18210,36419
22031,,_bldv3up-gmj,18210,18211,36421
22032,,hcpysseohz0j,18211,18212,36423
22033,,h82aakqvbkcj,18212,18213,36425
22034,,zmbuc2ew_ryj,18213,18214,36427
22035,,dch_0zsbngej,18214,18215,36429
22036,,9kfj-kheb34j,18215,18216,36431
22037,,yfosjc3uaokj,18217,18218,36435
22038,,uday4500r3oj,18218,18219,36437
22039,,url:http://ieeexplore.ieee.org/iel1/2206/2510/00075472.pdf3farnumber3d75472,18219,18220,36439
22040,,sfqlmm3sxpaj,18220,18221,36441
22041,,0jxw-oujslij,18221,18222,36443
22042,,jwhpaytwrzuj,18222,18223,36445
22043,,iwea-gpfwxej,18223,18224,36447
22044,,wqnangljfeaj,18224,18225,36449
22045,,eb8_bz6fozkj,18225,18226,36451
22046,,lwzqzfcvrgqj,18226,18227,36453
22047,,rdqytbnkiiij,18227,18228,36455
22048,,ayh67-ekyo4j,18228,18229,36457
22049,,hfwcox_vcs0j,18229,18230,36459
22050,,so9mxiaibmcj,18230,18231,36461
22051,,q15eb1zdilgj,18231,18232,36463
22052,,bhafyf4vdegj,18232,18233,36465
22053,,bwbqejvve7yj,18233,18234,36467
22054,,f4dtzxvvznoj,18234,18235,36469
22055,,y9jmlb0wnhaj,18235,18236,36471
22056,,zhmeijulpysj,18236,18237,36473
22057,,em_iiniqlakj,18237,18238,36475
22058,,x9vdiqgu428j,18238,18239,36477
22059,,nrm2sv4g3kcj,18239,18240,36479
22060,,dnhm9uotch8j,18240,18241,36481
22061,,ycp5twrhs_ej,18241,18242,36483
22062,,e1m1tdny8auj,18242,18243,36485
22063,,39cu8bn4pqaj,18243,18244,36487
22064,,okykkzda9aij,18244,18245,36489
22065,,c8d-gqyw-qij,18246,18247,36493
22066,,e4antb3f8egj,18247,18248,36495
22067,,b1gbvxgd070j,18248,18249,36497
22068,,ts7drfaktuyj,18249,18250,36499
22069,,k9juyjxracwj,18250,18251,36501
22070,,gxgwcwiqci0j,18251,18252,36503
22071,,0p1kha67qd4j,18252,18253,36505
22072,,url:http://www.springerlink.com/index/p543770h580m7884.pdf,18253,18254,36507
22073,,1_g448rjyzuj,18255,18256,36511
22074,,rjswahpqinej,18256,18257,36513
22075,,0mj8n23h1qej,18257,18258,36515
22076,,l1zg2fdw3m4j,18259,18260,36519
22077,,url:http://www.springerlink.com/index/m034h4h63472723j.pdf,18260,18261,36521
22078,,klin59rcgccj,18261,18262,36523
22079,,zpskoepiqjij,18262,18263,36525
22080,,_sptgefbig4j,18263,18264,36527
22081,,,18264,18265,36529
22082,,qtisvzjkhsuj,18265,18266,36531
22083,,fcvqfhrqtyqj,18266,18267,36533
22084,,ux1ygflkn08j,18267,18268,36535
22085,,g-xhppue6bwj,18268,18269,36537
22086,,be7ok9flbqaj,18269,18270,36539
22087,,cyvvzee4yt0j,18270,18271,36541
22088,,uiljtxhgpfij,18271,18272,36543
22089,,wmr7ruuljwkj,18272,18273,36545
22090,,5wu8jap_spgj,18273,18274,36547
22091,,ivjyjinwdzaj,18274,18275,36549
22092,,nwyrkazw9eqj,18275,18276,36551
22093,,url:http://portal.acm.org/ft_gateway.cfm3fid3d37370926type3dpdf26dl3dguide26dl3dacm26cfid3d1111111126cftoken3d2222222,18276,18277,36553
22094,,irlhq1w58ekj,18277,18278,36555
22095,,xatfeilf5rsj,18278,18279,36557
22096,,ggt28hlx1doj,18279,18280,36559
22097,,assdkx9p_cuj,18280,18281,36561
22098,,url:http://portal.acm.org/citation.cfm3fid3d592195.592302,18281,18282,36563
22099,,hdqxdqggz2gj,18282,18283,36565
22100,,url:http://portal.acm.org/ft_gateway.cfm3fid3d109960426type3dpdf,18283,18284,36567
22101,,5l6ychdlgmwj,18284,18285,36569
22102,,x8ilprs9vvuj,18285,18286,36571
22103,,50k23ka_aw4j,18286,18287,36573
22104,,7xfr7qkmzuqj,18287,18288,36575
22105,,url:http://adsabs.harvard.edu/abs/1976scom.nasa..622w,18288,18289,36577
22106,,bhq_jls9m0ej,18289,18290,36579
22107,,ax9mzaynbvij,18290,18291,36581
22108,,url:http://adsabs.harvard.edu/abs/1985stin...8710112r,18291,18292,36583
22109,,ubpdmaqe9mmj,18292,18293,36585
22110,,sts2l-is-nqj,18293,18294,36587
22111,,i3dbxw7wwwkj,18294,18295,36589
22112,,vpepu-opsxqj,18295,18296,36591
22113,,url:http://portal.acm.org/ft_gateway.cfm3fid3d97475126type3dpdf26dl3dacm26dl3dacm26cfid3d1111111126cftoken3d2222222,18296,18297,36593
22114,,hlle1txxu64j,18299,18300,36599
22115,,v-scatahtosj,18300,18301,36601
22116,,wupdvo_dwhij,18301,18302,36603
22117,,jx9jum-0ydcj,18302,18303,36605
22118,,oqwbr_sbytej,18303,18304,36607
22119,,4pkdrl98wmqj,18305,18306,36611
22120,,mpnnrdfuujqj,18306,18307,36613
22121,,r9ybexv82umj,18307,18308,36615
22122,,4lxbwhgtmpuj,18308,18309,36617
22123,,0acdlc-p_6kj,18309,18310,36619
22124,,opdn1bvluy4j,18310,18311,36621
22125,,vprz0t5m4ccj,18311,18312,36623
22126,,url:http://www.springerlink.com/index/t22k273644t91014.pdf,18312,18313,36625
22127,,url:http://links.jstor.org/sici3fsici3d0146-4949(196023)1253a3253c43253aoae2522go253e2.0.co253b2-t,18313,18314,36627
22128,,xbknjnrvckij,18314,18315,36629
22129,,xf4cyehgtoej,18315,18316,36631
22130,,yhl0k4jax24j,18316,18317,36633
22131,,r4e6iac-rz4j,18317,18318,36635
22132,,rgrdhgkr39uj,18318,18319,36637
22133,,niktsglk6ngj,18319,18320,36639
22134,,7glkhynv0xaj,18320,18321,36641
22135,,f7cs9wdnzcij,18321,18322,36643
22136,,oudoj24wdqqj,18322,18323,36645
22137,,,18324,18325,36649
22138,,m4xr6tsjtnaj,18325,18326,36651
22139,,1qtll_efmmuj,18326,18327,36653
22140,,hxb38a5drkoj,18327,18328,36655
22141,,jqv63f6w9gkj,18328,18329,36657
22142,,k1mmfhklhqcj,18329,18330,36659
22143,,mj5qtzvxldej,18330,18331,36661
22144,,ugmsryimdu4j,18331,18332,36663
22145,,abkp-pofui0j,18332,18333,36665
22146,,imtamkimbzkj,18333,18334,36667
22147,,ivkcsv0swyoj,18334,18335,36669
22148,,ykqvplbakuwj,18335,18336,36671
22149,,fbexqronyhqj,18336,18337,36673
22150,,kehgbmy5yswj,18337,18338,36675
22151,,bgag_gmmkagj,18338,18339,36677
22152,,2i_wy_bjmiwj,18339,18340,36679
22153,,5hrhsbxdnj0j,18340,18341,36681
22154,,yuyk0uwmfqaj,18341,18342,36683
22155,,wgxjnd3ywscj,18342,18343,36685
22156,,djyrar00qtuj,18343,18344,36687
22157,,jhdsocvdiimj,18344,18345,36689
22158,,bujijq--odej,18345,18346,36691
22159,,mcko5bii74cj,18346,18347,36693
22160,,qctu6n21an4j,18347,18348,36695
22161,,fd6or5e7bikj,18348,18349,36697
22162,,a5ovjrr0uuoj,18349,18350,36699
22163,,yvnb7s12wn0j,18350,18351,36701
22164,,opdpbiajcisj,18352,18353,36705
22165,,qjzsjlkrydmj,18353,18354,36707
22166,,fkim5tqeesoj,18354,18355,36709
22167,,d3qeeo83fmcj,18355,18356,36711
22168,,sjaapegay9gj,18356,18357,36713
22169,,ubrkrvhgqlsj,18357,18358,36715
22170,,url:http://www.springerlink.com/index/k75m5659w8x33q57.pdf,18358,18359,36717
22171,,utbrmoclz-mj,18359,18360,36719
22172,,msfixv8xnwyj,18360,18361,36721
22173,,lhtwoefehecj,18361,18362,36723
22174,,fnzj4pqrp5cj,18362,18363,36725
22175,,wersypoi3koj,18363,18364,36727
22176,,j2i4pviuoyej,18364,18365,36729
22177,,aokbfsm727ij,18365,18366,36731
22178,,96byjez_1i4j,18366,18367,36733
22179,,xqw3adycxdcj,18367,18368,36735
22180,,9j-0zftfvkcj,18368,18369,36737
22181,,aqov2dgsvkwj,18369,18370,36739
22182,,ebwodgzg77oj,18370,18371,36741
22183,,e-zazhybgewj,18371,18372,36743
22184,,url:http://doi.wiley.com/10.1002/ace.8509,18372,18373,36745
22185,,o17flygsj9oj,18373,18374,36747
22186,,k-muwval2wqj,18374,18375,36749
22187,,471b4zvgocyj,18375,18376,36751
22188,,ragp9dteg0qj,18376,18377,36753
22189,,aawcjr1xaocj,18378,18379,36757
22190,,c_x4frh2whij,18379,18380,36759
22191,,9ceaarzvk70j,18380,18381,36761
22192,,x_8kbrgbbsoj,18381,18382,36763
22193,,77igp9nh9z0j,18382,18383,36765
22194,,rviij1nqecoj,18383,18384,36767
22195,,e41h-gfr1fgj,18384,18385,36769
22196,,gtkxutlkeicj,18385,18386,36771
22197,,2dh91bub37aj,18387,18388,36775
22198,,o98belvqaa0j,18388,18389,36777
22199,,zkgtpp9m5z4j,18389,18390,36779
22200,,0s0j1_xowpyj,18390,18391,36781
22201,,u5zvfqjv_waj,18391,18392,36783
22202,,url:http://www.csa.com/partners/viewrecord.php3frequester3dgs26collection3dtrd26recid3d0250843ci,18392,18393,36785
22203,,ci3vdjxqj-gj,18393,18394,36787
22204,,cwivdyyfkvwj,18394,18395,36789
22205,,e4bxmh8gbqaj,18395,18396,36791
22206,,rigzzpulbn8j,18396,18397,36793
22207,,ts2ubc8iud0j,18397,18398,36795
22208,,rnpbdu7lyawj,18399,18400,36799
22209,,s9bjwq7_k6wj,18400,18401,36801
22210,,url:http://portal.acm.org/ft_gateway.cfm3fid3d102762926type3dpdf,18401,18402,36803
22211,,qxxshp8utauj,18402,18403,36805
22212,,qq6gik3kqjoj,18403,18404,36807
22213,,b1f7yotbu0yj,18404,18405,36809
22214,,y9nqm2imdk4j,18405,18406,36811
22215,,o9tjcx8mbvaj,18406,18407,36813
22216,,l2uihmckrv4j,18407,18408,36815
22217,,ipudmykkjvij,18408,18409,36817
22218,,3bssmmwafpoj,18409,18410,36819
22219,,q4jdstbf5_oj,18410,18411,36821
22220,,zwp9kdl8ougj,18411,18412,36823
22221,,z2rwzcgb_dcj,18412,18413,36825
22222,,prtmbhrsjqoj,18413,18414,36827
22223,,mzrtwfdvu4qj,18415,18416,36831
22224,,3ussbtuccfgj,18416,18417,36833
22225,,jsngo53hl-gj,18417,18418,36835
22226,,ntc7kszei3cj,18418,18419,36837
22227,,i4d--dfwz0oj,18419,18420,36839
22228,,qqwub_oetcsj,18420,18421,36841
22229,,hmhqlcukhosj,18421,18422,36843
22230,,lfv7nf4ziv0j,18422,18423,36845
22231,,j-xk1hxoloyj,18423,18424,36847
22232,,hmwyisclf5kj,18424,18425,36849
22233,,976mpern4y8j,18425,18426,36851
22234,,uekp42ozrsqj,18427,18428,36855
22235,,e8ndhjden2gj,18428,18429,36857
22236,,l9nggcodjywj,18429,18430,36859
22237,,url:http://www.csa.com/partners/viewrecord.php3frequester3dgs26collection3dtrd26recid3d8204540541md,18430,18431,36861
22238,,wvjsaw_kmn8j,18431,18432,36863
22239,,x5mipdwhjucj,18432,18433,36865
22240,,,18433,18434,36867
22241,,kn_gfquym4ij,18434,18435,36869
22242,,gwxvm2ztmmcj,18435,18436,36871
22243,,gi1j6tqi6u0j,18436,18437,36873
22244,,xk3rb5qctqgj,18437,18438,36875
22245,,rkq_ze6luk4j,18438,18439,36877
22246,,l2yutu5bjxgj,18439,18440,36879
22247,,hyxyaagjbkmj,18440,18441,36881
22248,,rzc_txf36usj,18441,18442,36883
22249,,0vv5suenjwwj,18442,18443,36885
22250,,exi2mm3ipx8j,18443,18444,36887
22251,,t2vsqdj-jdwj,18444,18445,36889
22252,,eo3cm-mlihij,18445,18446,36891
22253,,21mtdjio0okj,18446,18447,36893
22254,,wjxlsh9_oqaj,18447,18448,36895
22255,,i6vvxgl3h90j,18448,18449,36897
22256,,ayqgar3tudgj,18449,18450,36899
22257,,b5-qh1xqq6ij,18450,18451,36901
22258,,4w_r39jpagyj,18451,18452,36903
22259,,8k8fj-o-v2aj,18452,18453,36905
22260,,gbhqtoldcyqj,18453,18454,36907
22261,,souwrnjm-xgj,18454,18455,36909
22262,,dttvyhedfbmj,18456,18457,36913
22263,,22yvva1stfkj,18457,18458,36915
22264,,sq_0gg81fqcj,18458,18459,36917
22265,,pvzgttbltu4j,18459,18460,36919
22266,,ygu25ezb4sgj,18460,18461,36921
22267,,p0qbf9z31aqj,18461,18462,36923
22268,,vlc_v-n5k9wj,18462,18463,36925
22269,,q60owo7l5qsj,18463,18464,36927
22270,,mfe70r6mjnij,18464,18465,36929
22271,,dhnwai9kvwuj,18465,18466,36931
22272,,tws-0utkctuj,18466,18467,36933
22273,,vkftynsy8vej,18467,18468,36935
22274,,qzwciirmskuj,18468,18469,36937
22275,,hmejocrcehqj,18469,18470,36939
22276,,tayg-spdvaaj,18470,18471,36941
22277,,1ci0r5fu7rcj,18471,18472,36943
22278,,e9_ou7vsui4j,18472,18473,36945
22279,,hameef6uzjmj,18473,18474,36947
22280,,url:http://portal.acm.org/ft_gateway.cfm3fid3d104141626type3dpdf,18474,18475,36949
22281,,zgrzt_urnayj,18475,18476,36951
22282,,0wit4zzpgbsj,18476,18477,36953
22283,,f6xke1kqcjaj,18477,18478,36955
22284,,url:http://www.ncbi.nlm.nih.gov/entrez/query.fcgi3fcmd3dretrieve26db3dpubmed26list_uids3d73911626dopt3dcitation,18478,18479,36957
22285,,wryon8eutoqj,18479,18480,36959
22286,,url:http://www.csa.com/partners/viewrecord.php3frequester3dgs26collection3dtrd26recid3d017405550036ai,18480,18481,36961
22287,,uyeepiokx7kj,18481,18482,36963
22288,,nvddr7jpcfaj,18482,18483,36965
22289,,mh3nt_xdonij,18483,18484,36967
22290,,9vjzbel64vkj,18484,18485,36969
22291,,zbowmwon3saj,18485,18486,36971
22292,,kyivzfh5unaj,18486,18487,36973
22293,,aqako0uvj68j,18487,18488,36975
22294,,x9iouc3t_aqj,18488,18489,36977
22295,,ijglb00i5swj,18489,18490,36979
22296,,784izl73_luj,18491,18492,36983
22297,,xtwoyaemymij,18492,18493,36985
22298,,t2fr86fsqcsj,18493,18494,36987
22299,,gw0pieiogkqj,18494,18495,36989
22300,,_vewvm0sjwij,18495,18496,36991
22301,,a6hyc40n5vcj,18496,18497,36993
22302,,r7fh1v6sa28j,18497,18498,36995
22303,,svresuqzkoij,18498,18499,36997
22304,,xssxpbcmrpwj,18499,18500,36999
22305,,9usc4jvlfaij,18500,18501,37001
22306,,uaeapaaf2w0j,18501,18502,37003
22307,,43jpbypglukj,18502,18503,37005
22308,,zq4siqziaboj,18503,18504,37007
22309,,ghskizlpemyj,18504,18505,37009
22310,,87uydfkmebwj,18505,18506,37011
22311,,qp04wenmavoj,18506,18507,37013
22312,,mehrl_vml2kj,18507,18508,37015
22313,,99ttlcnyddkj,18508,18509,37017
22314,,xqizgq_uuluj,18509,18510,37019
22315,,i_gvr3biexgj,18510,18511,37021
22316,,url:http://doi.wiley.com/10.1002/tl.7112,18511,18512,37023
22317,,hy3hoqhw38sj,18512,18513,37025
22318,,k87jcs1cpx4j,18513,18514,37027
22319,,2fz9h-tfdcsj,18514,18515,37029
22320,,gkxylt7yeo4j,18515,18516,37031
22321,,ugshfqt2jpyj,18516,18517,37033
22322,,p5jmfnadwncj,18517,18518,37035
22323,,h-qnv8jfq8uj,18518,18519,37037
22324,,tj63bzrxfbaj,18519,18520,37039
22325,,url:http://pubs.acs.org/cgi-bin/abstract.cgi/achre4/2005/38/i02/abs/ar040106p.html,18520,18521,37041
22326,,9oejthuruzsj,18521,18522,37043
22327,,wtbsauxo_y0j,18523,18524,37047
22328,,rlry_pt83jwj,18524,18525,37049
22329,,vct9ku4qkamj,18525,18526,37051
22330,,qclht-l5qt8j,18526,18527,37053
22331,,xa_4daxahd4j,18527,18528,37055
22332,,l99-z1_unpmj,18528,18529,37057
22333,,czkreabp75kj,18529,18530,37059
22334,,lkngibbst0mj,18530,18531,37061
22335,,jmjeuiggng4j,18531,18532,37063
22336,,3yirh_zfn4qj,18532,18533,37065
22337,,rj9quofggwaj,18533,18534,37067
22338,,edppmxjoypoj,18534,18535,37069
22339,,bctygpnuno0j,18535,18536,37071
22340,,qkhmikguomkj,18536,18537,37073
22341,,n42gs0lkwucj,18537,18538,37075
22342,,7tk0ctachmkj,18538,18539,37077
22343,,hsehqln4ssgj,18539,18540,37079
22344,,aakisc1klw8j,18540,18541,37081
22345,,url:http://www.csa.com/partners/viewrecord.php3frequester3dgs26collection3dtrd26recid3dn9210391ah,18541,18542,37083
22346,,joe7vtjbr08j,18542,18543,37085
22347,,2iwirakfu_8j,18543,18544,37087
22348,,e02lexydrywj,18544,18545,37089
22349,,5yep5qsjjp8j,18545,18546,37091
22350,,albfcidipxmj,18546,18547,37093
22351,,hlaw7fgunr8j,18547,18548,37095
22352,,sopeorftqbcj,18548,18549,37097
22353,,58dzabknzsej,18549,18550,37099
22354,,cxd83nkvaskj,18550,18551,37101
22355,,u5fnibfrn6uj,18551,18552,37103
22356,,pgtc_1idm08j,18552,18553,37105
22357,,2psgd0jrty8j,18553,18554,37107
22358,,liedfvuppcqj,18554,18555,37109
22359,,m3iof6rnfrsj,18555,18556,37111
22360,,3lhkbcc0hxuj,18556,18557,37113
22361,,wrawb4sw3m4j,18557,18558,37115
22362,,de6wq2epmsij,18558,18559,37117
22363,,z_toxnnmxi4j,18559,18560,37119
22364,,vlswvbzr5imj,18560,18561,37121
22365,,_bk3lh9d8wij,18561,18562,37123
22366,,j9wqfaglbpmj,18562,18563,37125
22367,,8kwwoo1va2qj,18563,18564,37127
22368,,08raivbm66sj,18564,18565,37129
22369,,bxre2fo8g8mj,18565,18566,37131
22370,,tovdhc0kpxij,18566,18567,37133
22371,,owycpf742cuj,18567,18568,37135
22372,,r2twyhadyecj,18568,18569,37137
22373,,hm1ov_snpnwj,18569,18570,37139
22374,,jqkybr7u8asj,18570,18571,37141
22375,,py-ouascp5oj,18571,18572,37143
22376,,yuaekrc7d60j,18572,18573,37145
22377,,wkmaheqehx4j,18573,18574,37147
22378,,yzeze_q4ssqj,18574,18575,37149
22379,,cfjqvq7vijcj,18575,18576,37151
22380,,tsci5ifxdkaj,18576,18577,37153
22381,,yl-gpkruye0j,18577,18578,37155
22382,,pmepoffrruej,18578,18579,37157
22383,,nx3lufvz7kaj,18579,18580,37159
22384,,zputatglb1sj,18580,18581,37161
22385,,rsfzpvkv4a0j,18581,18582,37163
22386,,qc2r7o8q3tqj,18582,18583,37165
22387,,sf4_sfyd0vuj,18583,18584,37167
22388,,kxwkdhgqgeij,18584,18585,37169
22389,,hjcdmn_kaj0j,18585,18586,37171
22390,,4wpck4tjz9mj,18586,18587,37173
22391,,o_0kepqzmimj,18587,18588,37175
22392,,hyzx76bp3o0j,18588,18589,37177
22393,,bcdzhd17nkej,18589,18590,37179
22394,,1uei4ivv-pgj,18590,18591,37181
22395,,4c06ufq8ujkj,18591,18592,37183
22396,,darwcyzjzhcj,18592,18593,37185
22397,,dits2isoa9uj,18593,18594,37187
22398,,qd0tw_gqca8j,18594,18595,37189
22399,,6dokt8gfvigj,18595,18596,37191
22400,,swhmrpwl9lqj,18596,18597,37193
22401,,rf9knmtzat4j,18598,18599,37197
22402,,g0upnarrxuyj,18599,18600,37199
22403,,uexel5cdu4wj,18600,18601,37201
22404,,2kpeoa9cdnmj,18601,18602,37203
22405,,vxopxatqfswj,18602,18603,37205
22406,,x4aiwho9fwwj,18603,18604,37207
22407,,46myxoqwdlwj,18604,18605,37209
22408,,l_had_nln0gj,18605,18606,37211
22409,,s0kwjfdzkaij,18606,18607,37213
22410,,wlsvclanhuqj,18607,18608,37215
22411,,mj4xggskpmuj,18608,18609,37217
22412,,lm0co-tzy8oj,18609,18610,37219
22413,,31oh64sxprcj,18610,18611,37221
22414,,vjjrdsnhhiuj,18611,18612,37223
22415,,hvggsioza20j,18612,18613,37225
22416,,a9xib4yml2kj,18613,18614,37227
22417,,5lq-dymelfmj,18614,18615,37229
22418,,8ck-tosuhdmj,18615,18616,37231
22419,,gekifc_fcqej,18616,18617,37233
22420,,r5o2turo03mj,18617,18618,37235
22421,,3plakhflx0gj,18618,18619,37237
22422,,faqy-swickkj,18619,18620,37239
22423,,k3tabyt1w90j,18620,18621,37241
22424,,umocoqkc1uwj,18622,18623,37245
22425,,us1aqe-o7_cj,18623,18624,37247
22426,,m_wukt7k-aej,18624,18625,37249
22427,,zwax_59m8fgj,18625,18626,37251
22428,,wxwuv6jd3-ej,18626,18627,37253
22429,,fzlfm1kjbeaj,18627,18628,37255
22430,,lsvqdw-irvwj,18628,18629,37257
22431,,fcs16jugchij,18629,18630,37259
22432,,_6kkw3xuyouj,18630,18631,37261
22433,,_3t97dkhlmej,18631,18632,37263
22434,,abybailwnfej,18632,18633,37265
22435,,r6ioei23mzqj,18633,18634,37267
22436,,ycb5x-wrlpej,18634,18635,37269
22437,,icj5yjg1mnuj,18635,18636,37271
22438,,eszmxjhax7aj,18637,18638,37275
22439,,url:http://portal.acm.org/citation.cfm3fid3d645921.673318,18638,18639,37277
22440,,ddnzoord_jyj,18639,18640,37279
22441,,aeyfvewxmdsj,18640,18641,37281
22442,,w3jiknoeacwj,18641,18642,37283
22443,,hv4x4zr_ousj,18642,18643,37285
22444,,pomes9cxkxcj,18643,18644,37287
22445,,qw0qskqiwd0j,18644,18645,37289
22446,,7jn4hf25wasj,18645,18646,37291
22447,,hnsi84yrbuwj,18646,18647,37293
22448,,nlkmgv63ivwj,18647,18648,37295
22449,,76x91rvs8bqj,18648,18649,37297
22450,,esay4haim0qj,18649,18650,37299
22451,,yakrqmdxzg4j,18650,18651,37301
22452,,wtfdyrijuhuj,18651,18652,37303
22453,,ttm8f00yhdmj,18652,18653,37305
22454,,eazr8qmayt4j,18653,18654,37307
22455,,nbcxao5ifcsj,18654,18655,37309
22456,,nnwqbynllrgj,18655,18656,37311
22457,,fmu5t2ppd5qj,18656,18657,37313
22458,,mxvdy6cxomej,18657,18658,37315
22459,,r_tqw0j-yqij,18658,18659,37317
22460,,hj23l7pkskij,18659,18660,37319
22461,,mpwhnuf4gquj,18660,18661,37321
22462,,url:http://www.geography.org.uk/journals/journals.asp3farticleid3d135,18662,18663,37325
22463,,gk9_dsa7lsaj,18663,18664,37327
22464,,wzckw4jodhqj,18664,18665,37329
22465,,cfssrkwhk6uj,18665,18666,37331
22466,,rozhhbjv_owj,18666,18667,37333
22467,,o0nhw5xc89sj,18667,18668,37335
22468,,zogr7odiytkj,18668,18669,37337
22469,,6vuzxprkwnkj,18669,18670,37339
22470,,zguqi3bypd4j,18670,18671,37341
22471,,odo642gzco8j,18671,18672,37343
22472,,7uuc6q_zi4ej,18672,18673,37345
22473,,url:http://portal.acm.org/citation.cfm3fid3d217279.21528026dl3dguide26dl3dacm26type3dseries26idx3dseries31626part3dproceedings26wanttype3dproceedings26title3dinternational2520multimedia2520conference26cfid3d1111111126cftoken3d2222222,18673,18674,37347
22474,,4klssmcavtkj,18674,18675,37349
22475,,vhkhc3atkxoj,18675,18676,37351
22476,,e7yztvja2xaj,18676,18677,37353
22477,,gfw2tyeanmaj,18678,18679,37357
22478,,ywlst49j6ruj,18679,18680,37359
22479,,dym7wvwdp7ej,18680,18681,37361
22480,,qdmoefowklsj,18681,18682,37363
22481,,r81qzmbfnbyj,18682,18683,37365
22482,,b_zzradntwuj,18683,18684,37367
22483,,lcfamassmjej,18684,18685,37369
22484,,4npsbqim3kcj,18685,18686,37371
22485,,zluo-gcgx5ej,18686,18687,37373
22486,,z-yx5t9k1qsj,18687,18688,37375
22487,,5ec9eoelwnoj,18688,18689,37377
22488,,x-p89-ai6z8j,18689,18690,37379
22489,,e1oixxvyfxwj,18690,18691,37381
22490,,wdi1xo3fc7aj,18691,18692,37383
22491,,jyfjfet4hf0j,18692,18693,37385
22492,,c197wdfapx4j,18693,18694,37387
22493,,url:http://links.jstor.org/sici3fsici3d0146-4949(196123)2253a3253c20253a2522a2522ld253e2.0.co253b2-m,18694,18695,37389
22494,,-nf-3svjwwmj,18695,18696,37391
22495,,qdcmmbdcp8uj,18696,18697,37393
22496,,ewa3x05w_guj,18697,18698,37395
22497,,nyn-vlk1uzwj,18698,18699,37397
22498,,fgjtdsvs49aj,18699,18700,37399
22499,,lxgu32tieaaj,18700,18701,37401
22500,,j5qefdg3mwij,18701,18702,37403
22501,,jxbhqietwhyj,18702,18703,37405
22502,,_puqfzq8truj,18703,18704,37407
22503,,xrmwgb323d0j,18704,18705,37409
22504,,ctihj5fip4sj,18705,18706,37411
22505,,6dnjenrfgegj,18706,18707,37413
22506,,f6h0e4vrxnkj,18708,18709,37417
22507,,axirqadx9p4j,18709,18710,37419
22508,,rn3men4f8yij,18711,18712,37423
22509,,snrr91u3d5mj,18712,18713,37425
22510,,jb4m-nrhdlij,18713,18714,37427
22511,,uip1zvbzvhuj,18715,18716,37431
22512,,tqtnevt1kfkj,18716,18717,37433
22513,,hfnedwudza8j,18717,18718,37435
22514,,url:http://www.kluweronline.com/article.asp3fpips3d526823226pdf3d1,18718,18719,37437
22515,,0_lktn3djgaj,18719,18720,37439
22516,,bxzahrsvsrgj,18720,18721,37441
22517,,omzy4ngm3owj,18721,18722,37443
22518,,4rxrdfudgq4j,18722,18723,37445
22519,,cinaubiurnaj,18723,18724,37447
22520,,kua9e6yp8igj,18724,18725,37449
22521,,4plfigtovmaj,18725,18726,37451
22522,,_djtk_xlthsj,18726,18727,37453
22523,,qzor9odgjvej,18727,18728,37455
22524,,q_kmfsur_aaj,18728,18729,37457
22525,,e0d0otznp3cj,18729,18730,37459
22526,,ro-p9yjkugwj,18730,18731,37461
22527,,5ysd0sjmqfcj,18731,18732,37463
22528,,v7i1i5y_nhgj,18732,18733,37465
22529,,ttrn4xtq24uj,18733,18734,37467
22530,,ctdkk0wu78uj,18734,18735,37469
22531,,wbymqsm2ur8j,18735,18736,37471
22532,,ce4jluosqtcj,18736,18737,37473
22533,,63geuoix9aaj,18737,18738,37475
22534,,j9nmid7soe8j,18738,18739,37477
22535,,2is_6mnp83yj,18739,18740,37479
22536,,wwwvavbdtq8j,18740,18741,37481
22537,,nfk8qssuhjwj,18741,18742,37483
22538,,nqfjstdnllmj,18742,18743,37485
22539,,,18743,18744,37487
22540,,b-yit8xwqpoj,18744,18745,37489
22541,,vul5pw36dioj,18746,18747,37493
22542,,irxhyq6be8aj,18747,18748,37495
22543,,nwtk-zzknxqj,18748,18749,37497
22544,,ehljgvog6pqj,18749,18750,37499
22545,,wlfvgs3rdmmj,18750,18751,37501
22546,,6rprt9btsjoj,18751,18752,37503
22547,,s4qgkkqxryuj,18752,18753,37505
22548,,l1drcokgwzij,18753,18754,37507
22549,,o0guyfkncwkj,18754,18755,37509
22550,,mqe5p_4gziaj,18755,18756,37511
22551,,url:http://www.springerlink.com/index/t07xx2802r3x0001.pdf,18756,18757,37513
22552,,xjvz8hiw-8sj,18757,18758,37515
22553,,hnouq0un8yej,18758,18759,37517
22554,,2tstk-jiqyaj,18759,18760,37519
22555,,tegw4ir94emj,18760,18761,37521
22556,,_wucaiaof4gj,18761,18762,37523
22557,,cckiwkygbvqj,18762,18763,37525
22558,,e00nf0aalwsj,18763,18764,37527
22559,,cqtwgvc1tb0j,18764,18765,37529
22560,,ey8lvpizm00j,18765,18766,37531
22561,,rpfzbubqki4j,18766,18767,37533
22562,,locmpjqvxkgj,18767,18768,37535
22563,,url:http://portal.acm.org/ft_gateway.cfm3fid3d110129426type3dpdf,18768,18769,37537
22564,,ezfhneaoxbqj,18769,18770,37539
22565,,7jedbdg9uj8j,18770,18771,37541
22566,,gqabvz5vi8aj,18771,18772,37543
22567,,e3zz2ba5uryj,18772,18773,37545
22568,,vtw_uupb1q4j,18773,18774,37547
22569,,kamrjhxs4jgj,18774,18775,37549
22570,,xkyi7v5fizij,18775,18776,37551
22571,,xc6qvpdkadkj,18776,18777,37553
22572,,d5sxcj4nw0yj,18777,18778,37555
22573,,gqdwvzad5wkj,18778,18779,37557
22574,,c6dhf27pjb4j,18779,18780,37559
22575,,o5s8qv9toxaj,18780,18781,37561
22576,,ana0nc2zqrwj,18781,18782,37563
22577,,,18782,18783,37565
22578,,npbdhgocigwj,18783,18784,37567
22579,,297af7tbhbaj,18784,18785,37569
22580,,yqvkh7nn2iqj,18785,18786,37571
22581,,zho9leqmcpwj,18786,18787,37573
22582,,ded27juovoqj,18787,18788,37575
22583,,xnqfmsic0q8j,18788,18789,37577
22584,,b767dyhb5b0j,18789,18790,37579
22585,,fdznud2byywj,18790,18791,37581
22586,,n2ewrayhk7qj,18791,18792,37583
22587,,tt71v3f7aewj,18792,18793,37585
22588,,mefqzmxfzmkj,18793,18794,37587
22589,,jcscuwjne8uj,18794,18795,37589
22590,,yzvoyge0zggj,18795,18796,37591
22591,,e4s-nqtawxwj,18796,18797,37593
22592,,skqywspyg3sj,18797,18798,37595
22593,,url:http://portal.acm.org/ft_gateway.cfm3fid3d108378026type3dpdf,18798,18799,37597
22594,,yihod0gpepyj,18799,18800,37599
22595,,3worgybpzl8j,18800,18801,37601
22596,,u2gaimcdqqoj,18801,18802,37603
22597,,tkxrqnwnnkij,18802,18803,37605
22598,,url:http://doi.ieeecomputersociety.org/10.1109/tkde.2004.75,18803,18804,37607
22599,,m6eo2khjeywj,18804,18805,37609
22600,,nnentz2bcv8j,18805,18806,37611
22601,,rahgiww6newj,18806,18807,37613
22602,,9ih6qqfjcl0j,18807,18808,37615
22603,,2eejycocb8sj,18808,18809,37617
22604,,qn1r9cohyk4j,18809,18810,37619
22605,,hv9qxg6u7hcj,18810,18811,37621
22606,,mu00z4ke-mmj,18811,18812,37623
22607,,2s57czxljh8j,18812,18813,37625
22608,,aftxicxdq_ej,18813,18814,37627
22609,,wtxunetzhpwj,18814,18815,37629
22610,,8v9oawcetvsj,18815,18816,37631
22611,,fiyet456v2cj,18816,18817,37633
22612,,te1ytm19o5ej,18817,18818,37635
22613,,x-c2do67ykuj,18818,18819,37637
22614,,url:http://www.csa.com/partners/viewrecord.php3frequester3dgs26collection3dtrd26recid3d200111010670mt26recid3da0032573ah,18819,18820,37639
22615,,url:http://portal.acm.org/citation.cfm3fid3d602902.602976,18820,18821,37641
22616,,robtztevi7gj,18821,18822,37643
22617,,cft1ekkgrikj,18822,18823,37645
22618,,czohde1v3mkj,18823,18824,37647
22619,,a9r6plty7xkj,18824,18825,37649
22620,,jfixxk5xyr0j,18825,18826,37651
22621,,bdctkwlv2r0j,18826,18827,37653
22622,,mabppagcafej,18827,18828,37655
22623,,8wda73pjppmj,18828,18829,37657
22624,,,18829,18830,37659
22625,,jr-qq2hlpu4j,18830,18831,37661
22626,,7jc5y7krk9sj,18831,18832,37663
22627,,vidsqomlsr8j,18832,18833,37665
22628,,w8zc0btrhucj,18833,18834,37667
22629,,url:http://portal.acm.org/ft_gateway.cfm3fid3d110128226type3dpdf,18834,18835,37669
22630,,jrwt-sgnatkj,18836,18837,37673
22631,,2ycui31lq7oj,18837,18838,37675
22632,,ppcajiq4yb8j,18839,18840,37679
22633,,,18840,18841,37681
22634,,url:http://www.springerlink.com/index/j64p07r71x87wlw0.pdf,18841,18842,37683
22635,,ukyv0nkzri4j,18842,18843,37685
22636,,9q3nm72dls4j,18843,18844,37687
22637,,w-cdj38orzij,18844,18845,37689
22638,,yyqahvc_bmoj,18845,18846,37691
22639,,rdy8-hw9nsaj,18846,18847,37693
22640,,9o83yihncsyj,18847,18848,37695
22641,,plghkgmidgsj,18848,18849,37697
22642,,cklldtxsjicj,18849,18850,37699
22643,,gypwienkic0j,18850,18851,37701
22644,,8gtu2k-ycjwj,18851,18852,37703
22645,,gwxfa7a-hr0j,18852,18853,37705
22646,,upnl13tjbcoj,18853,18854,37707
22647,,i56ehwegh8aj,18854,18855,37709
22648,,i6qlqeclksqj,18855,18856,37711
22649,,rb2japagt5uj,18856,18857,37713
22650,,oovcs_1stqcj,18857,18858,37715
22651,,r5x4y6veapgj,18858,18859,37717
22652,,pahrwo0nulsj,18859,18860,37719
22653,,ksyktrs_qmaj,18860,18861,37721
22654,,s2gq0lihwaaj,18861,18862,37723
22655,,wuvai4knndwj,18862,18863,37725
22656,,,18863,18864,37727
22657,,r_zeu_6tvquj,18864,18865,37729
22658,,jkreetwbejej,18865,18866,37731
22659,,xmcb4qg3gmsj,18866,18867,37733
22660,,ic2nzgpkn6gj,18867,18868,37735
22661,,db0lhwn56q8j,18868,18869,37737
22662,,w3ifbjmmjtkj,18869,18870,37739
22663,,d_6q-lvfb7ej,18870,18871,37741
22664,,l3l20pjtmlqj,18871,18872,37743
22665,,ulhdqeetk6ij,18872,18873,37745
22666,,wgvnqa-ub_ij,18873,18874,37747
22667,,o_11yxvvf8oj,18874,18875,37749
22668,,ymri5_wekqkj,18875,18876,37751
22669,,we2mw93okl4j,18876,18877,37753
22670,,onrertp5ai4j,18877,18878,37755
22671,,njhwiri8ox0j,18878,18879,37757
22672,,xfc9opmqbuij,18879,18880,37759
22673,,rzpqv_ctbrmj,18880,18881,37761
22674,,url:http://adsabs.harvard.edu/abs/1986phdt........11j,18881,18882,37763
22675,,9dzvnartmmaj,18882,18883,37765
22676,,upyyospt8dij,18883,18884,37767
22677,,u5tz1f1olkyj,18884,18885,37769
22678,,u9utriqyqagj,18885,18886,37771
22679,,o5uwp_0q1iaj,18886,18887,37773
22680,,rgpux0rikc8j,18887,18888,37775
22681,,f_qr5qmcmmij,18888,18889,37777
22682,,glrgw11azwyj,18889,18890,37779
22683,,nqossm46lckj,18890,18891,37781
22684,,9fo_pfxstg8j,18891,18892,37783
22685,,abwz_t-woqaj,18892,18893,37785
22686,,9c4zl1iljiij,18893,18894,37787
22687,,ornkn5b-jcaj,18894,18895,37789
22688,,o2g5iwn_vqmj,18895,18896,37791
22689,,url:http://portal.acm.org/citation.cfm3fid3d192593.197420,18896,18897,37793
22690,,om_1kgmobwmj,18897,18898,37795
22691,,abiazfzxbnej,18898,18899,37797
22692,,url:http://doi.ieeecomputersociety.org/10.1109/tkde.2004.78,18899,18900,37799
22693,,qvpjqted33sj,18900,18901,37801
22694,,9rcn1datbu8j,18901,18902,37803
22695,,6bxnvhip7faj,18902,18903,37805
22696,,mtqnk4zqbaoj,18903,18904,37807
22697,,03tnye4g_jyj,18904,18905,37809
22698,,2yyvyiykamwj,18905,18906,37811
22699,,tmiute4v7zkj,18907,18908,37815
22700,,y0a_4q4vznwj,18908,18909,37817
22701,,gli8wxhs7yej,18909,18910,37819
22702,,n93wgett_-ej,18910,18911,37821
22703,,w420zv-xo6kj,18911,18912,37823
22704,,b7rcjxpg0kwj,18912,18913,37825
22705,,gk8apdgfqz4j,18913,18914,37827
22706,,kayrm2tcqjcj,18914,18915,37829
22707,,url:http://portal.acm.org/citation.cfm3fid3d645927.67203826coll3dportal26dl3dacm26cfid3d1111111126cftoken3d2222222,18915,18916,37831
22708,,vjiry7px4zmj,18916,18917,37833
22709,,koqz6qmalmwj,18917,18918,37835
22710,,xngprve2ukaj,18918,18919,37837
22711,,cyy28jqtu84j,18919,18920,37839
22712,,jiftutimejsj,18920,18921,37841
22713,,url:http://links.jstor.org/sici3fsici3d0146-4949(196323)4253a3253c319253asiitsb253e2.0.co253b2-8,18921,18922,37843
22714,,pty9qxgb8moj,18922,18923,37845
22715,,mekida7omrqj,18923,18924,37847
22716,,url:http://portal.acm.org/ft_gateway.cfm3fid3d102761126type3dpdf,18924,18925,37849
22717,,4gm0gmvp3tmj,18925,18926,37851
22718,,xglwpueaevqj,18926,18927,37853
22719,,84brxlvhigqj,18927,18928,37855
22720,,atx0h2hzuxyj,18928,18929,37857
22721,,cmupowmoqzkj,18929,18930,37859
22722,,zvtzr0ky7eqj,18930,18931,37861
22723,,hf3gzhicm58j,18931,18932,37863
22724,,2crdwmb5tnyj,18932,18933,37865
22725,,url:http://portal.acm.org/ft_gateway.cfm3fid3d109961426type3dpdf,18933,18934,37867
22726,,qnbtfuct0aaj,18934,18935,37869
22727,,x90a1bsakhoj,18935,18936,37871
22728,,ffybcjmpsskj,18936,18937,37873
22729,,17kvoaqecj4j,18937,18938,37875
22730,,j0qrj6kiecoj,18938,18939,37877
22731,,url:http://portal.acm.org/citation.cfm3fid3d1083592.1083611,18939,18940,37879
22732,,mms7cw2meaaj,18940,18941,37881
22733,,__s8jc-m1moj,18941,18942,37883
22734,,mldv3k2rxrmj,18942,18943,37885
22735,,hrvcv8ekxzmj,18943,18944,37887
22736,,rgbyjncgdsgj,18944,18945,37889
22737,,e2joi0f0xpqj,18945,18946,37891
22738,,iimycmj8lsyj,18946,18947,37893
22739,,jbd7-mlv9aej,18947,18948,37895
22740,,ho_rxpa3btyj,18948,18949,37897
22741,,luflwxykpuuj,18949,18950,37899
22742,,bsqtfzrn3fsj,18950,18951,37901
22743,,04n1fdgxu0aj,18951,18952,37903
22744,,fjrcnrdpwhsj,18952,18953,37905
22745,,bpchudzkky4j,18953,18954,37907
22746,,11d-bwnupqkj,18955,18956,37911
22747,,url:http://portal.acm.org/ft_gateway.cfm3fid3d110135726type3dpdf,18957,18958,37915
22748,,m8lpnvxge9mj,18958,18959,37917
22749,,4l2akokjzgkj,18959,18960,37919
22750,,ggbfbn10pt0j,18960,18961,37921
22751,,yc7ermodjm0j,18961,18962,37923
22752,,v2qcsq7cr1kj,18962,18963,37925
22753,,ru1whqhoxogj,18963,18964,37927
22754,,e4qg34qxkk8j,18964,18965,37929
22755,,mmwq0c3cgvij,18965,18966,37931
22756,,r1jass3lvlsj,18966,18967,37933
22757,,firbsg8jxtkj,18967,18968,37935
22758,,,18968,18969,37937
22759,,kqtfiphj_smj,18969,18970,37939
22760,,wsm47zordjej,18970,18971,37941
22761,,hme315qu2u0j,18971,18972,37943
22762,,ebaglmylgnej,18972,18973,37945
22763,,uwx3qehynwsj,18973,18974,37947
22764,,oywsa05zsbyj,18974,18975,37949
22765,,czfoajlb2nyj,18975,18976,37951
22766,,xdc94oztaukj,18976,18977,37953
22767,,8ppow2cg_z8j,18977,18978,37955
22768,,5eqloqazytcj,18978,18979,37957
22769,,2dxqkdg8igqj,18979,18980,37959
22770,,s2jmp3ltx3cj,18981,18982,37963
22771,,tbwau_rkt5kj,18982,18983,37965
22772,,sfc1lxxw_s4j,18983,18984,37967
22773,,kl22kgzyx5ej,18984,18985,37969
22774,,fqyzswydvowj,18985,18986,37971
22775,,bln7lmr6gqmj,18986,18987,37973
22776,,1gz6awakar8j,18987,18988,37975
22777,,drxbhfg6iggj,18988,18989,37977
22778,,itbxsxtqn7wj,18989,18990,37979
22779,,ssdwvx5ynxqj,18990,18991,37981
22780,,vnv-tbktxgaj,18991,18992,37983
22781,,qyuahxs81nmj,18992,18993,37985
22782,,_h08tsng9b0j,18993,18994,37987
22783,,44rqdnr2nwgj,18994,18995,37989
22784,,loyvxypbi04j,18995,18996,37991
22785,,kmlcbsslsosj,18996,18997,37993
22786,,6mfopws-gmej,18997,18998,37995
22787,,sxervqssbe0j,18998,18999,37997
22788,,0r0djqrih_4j,19000,19001,38001
22789,,rhk2yr944zgj,19001,19002,38003
22790,,svo520wyp2yj,19002,19003,38005
22791,,snxufqxwwa8j,19003,19004,38007
22792,,iln1z8uc688j,19004,19005,38009
22793,,url:http://portal.acm.org/ft_gateway.cfm3fid3d108623026type3dpdf,19005,19006,38011
22794,,ncx11sceth8j,19006,19007,38013
22795,,28t_9fgna-wj,19007,19008,38015
22796,,fdbqhird3oej,19008,19009,38017
22797,,5o1vayoz03cj,19009,19010,38019
22798,,url:http://www.springerlink.com/index/1ek9emkk9x89qqj9.pdf,19010,19011,38021
22799,,imjrz_sslzaj,19011,19012,38023
22800,,wxlxroxpbxsj,19012,19013,38025
22801,,97tmkwymu3aj,19013,19014,38027
22802,,imxrksbktbcj,19014,19015,38029
22803,,rj_wzm94nxej,19015,19016,38031
22804,,ysinrxcqhgij,19016,19017,38033
22805,,url:http://adsabs.harvard.edu/abs/1976infph..16..269a,19017,19018,38035
22806,,ntdupv_3hqoj,19018,19019,38037
22807,,jq6yvkzuazcj,19019,19020,38039
22808,,e3u5lfuiapqj,19020,19021,38041
22809,,uf1tnyicvgaj,19021,19022,38043
22810,,uv2jiaekuksj,19022,19023,38045
22811,,url:http://portal.acm.org/citation.cfm3fid3d319878.31993626dl3dguide26dl3dacm26type3dseries26idx3d31987826part3dproceedings26wanttype3dproceedings26title3dinternational2520multimedia2520conference26cfid3d1111111126cftoken3d2222222,19023,19024,38047
22812,,aoqakotp0eij,19024,19025,38049
22813,,wqbkcynphiej,19025,19026,38051
22814,,kzu6enjqh2ej,19026,19027,38053
22815,,j_efjbypiwej,19027,19028,38055
22816,,89ynaggbjtsj,19028,19029,38057
22817,,1pn7vpezitqj,19029,19030,38059
22818,,qiaxdg2req4j,19030,19031,38061
22819,,2fskkqsit-mj,19031,19032,38063
22820,,mskoombps54j,19032,19033,38065
22821,,vxz0apchrlyj,19034,19035,38069
22822,,cjhl-lb-evsj,19035,19036,38071
22823,,n3ipexgnsmej,19036,19037,38073
22824,,ebmu6dis1h8j,19037,19038,38075
22825,,wmszgjgxiasj,19038,19039,38077
22826,,2xlmgqr-segj,19039,19040,38079
22827,,z_ncms7ndpcj,19041,19042,38083
22828,,xndzelm2t1qj,19042,19043,38085
22829,,lowpu5ptlhyj,19043,19044,38087
22830,,4beidfgw-s8j,19044,19045,38089
22831,,x_adrdqzfkgj,19045,19046,38091
22832,,wlkxjju_tyej,19046,19047,38093
22833,,gr544ddjc_8j,19047,19048,38095
22834,,jpvbuvausd8j,19048,19049,38097
22835,,yve4sv0guikj,19049,19050,38099
22836,,url:http://pubs.acs.org/cgi-bin/abstract.cgi/achre4/2004/37/i12/abs/ar0402154.html,19050,19051,38101
22837,,p9tjyspzhogj,19051,19052,38103
22838,,az6irr9srr0j,19052,19053,38105
22839,,fvgxkp7bl90j,19053,19054,38107
22840,,ucrhvovuxikj,19054,19055,38109
22841,,btszkkuvnrmj,19055,19056,38111
22842,,vqisogq_0wwj,19056,19057,38113
22843,,wifvv40myegj,19057,19058,38115
22844,,fcqgfpvljwmj,19058,19059,38117
22845,,9ub9y4a4x8ij,19059,19060,38119
22846,,hbmx2-szbkij,19060,19061,38121
22847,,p_zn-9bwircj,19062,19063,38125
22848,,vviudv3t0tgj,19063,19064,38127
22849,,url:http://www.csa.com/partners/viewrecord.php3frequester3dgs26collection3dtrd26recid3d0804576ci,19064,19065,38129
22850,,esr-v4yyvagj,19065,19066,38131
22851,,bu3ngmpxbpyj,19066,19067,38133
22852,,9tsjszv5yloj,19067,19068,38135
22853,,_bzvenccdsmj,19068,19069,38137
22854,,153pgfsresoj,19069,19070,38139
22855,,jocowzo36bgj,19070,19071,38141
22856,,vgdeuwni7xyj,19071,19072,38143
22857,,6cvr1ksn7n4j,19072,19073,38145
22858,,oc1beoaqky0j,19073,19074,38147
22859,,fzsnaecme7kj,19074,19075,38149
22860,,-3cz3v-auywj,19075,19076,38151
22861,,tfoefwwgkfej,19076,19077,38153
22862,,fvur5etaafcj,19077,19078,38155
22863,,sgejauzpphyj,19078,19079,38157
22864,,url:http://www.csa.com/partners/viewrecord.php3frequester3dgs26collection3denv26recid3d8913245,19079,19080,38159
22865,,yqmhgoxk_tsj,19080,19081,38161
22866,,faupxftjmamj,19081,19082,38163
22867,,0_rzwtatbzcj,19082,19083,38165
22868,,url:http://www.csa.com/partners/viewrecord.php3frequester3dgs26collection3dtrd26recid3dn9210491ah,19083,19084,38167
22869,,yjdnnpizjboj,19084,19085,38169
22870,,tz9f0adrp_ij,19085,19086,38171
22871,,v4h7vtkvozej,19086,19087,38173
22872,,url:http://portal.acm.org/citation.cfm3fid3d872851,19087,19088,38175
22873,,b1ccjhc94x4j,19088,19089,38177
22874,,8zbiywy6hg4j,19089,19090,38179
22875,,inmjfg8g0m0j,19090,19091,38181
22876,,z6kczliq8ioj,19091,19092,38183
22877,,zoz1xs0qyzgj,19092,19093,38185
22878,,4yygtt_hxboj,19093,19094,38187
22879,,d_wjkg0jglwj,19094,19095,38189
22880,,fydfc6sffd8j,19095,19096,38191
22881,,n7l-ocvjksqj,19096,19097,38193
22882,,riqc1gr0_kcj,19097,19098,38195
22883,,a13gwm09jdqj,19098,19099,38197
22884,,fkt6o5k4axij,19099,19100,38199
22885,,zy4bdwowzfmj,19100,19101,38201
22886,,kpy2c5rxrdaj,19101,19102,38203
22887,,d4jjbyiqhfyj,19102,19103,38205
22888,,3lfghfwpmcij,19103,19104,38207
22889,,aqxtggvibggj,19104,19105,38209
22890,,ntvfxbc8gqwj,19105,19106,38211
22891,,9v3cuszjhioj,19106,19107,38213
22892,,pxp_gg3peiyj,19107,19108,38215
22893,,eoduwssgprcj,19108,19109,38217
22894,,8h2hqg5kseyj,19109,19110,38219
22895,,tzmaicln5gsj,19110,19111,38221
22896,,pdow3bmfsbqj,19111,19112,38223
22897,,b02p4xk5soaj,19112,19113,38225
22898,,gc8itix_wwuj,19113,19114,38227
22899,,sdazlxwadjgj,19114,19115,38229
22900,,gfzjtgeml1yj,19115,19116,38231
22901,,tmxszfmipygj,19116,19117,38233
22902,,j6guitovngmj,19117,19118,38235
22903,,xkie69pk0zaj,19118,19119,38237
22904,,tt9xkzpyfvij,19119,19120,38239
22905,,d0aypccxjcaj,19120,19121,38241
22906,,ax-j3hdnbiuj,19121,19122,38243
22907,,pymxubu7eryj,19122,19123,38245
22908,,zmamiwxralyj,19123,19124,38247
22909,,w9nsg0ngbl0j,19124,19125,38249
22910,,nd2iyhidwp4j,19125,19126,38251
22911,,uqn14xs211oj,19126,19127,38253
22912,,citxtyr5bzij,19127,19128,38255
22913,,3x4hf-8w7ymj,19128,19129,38257
22914,,ovb4fqtpkgkj,19129,19130,38259
22915,,q5hyoc5230uj,19130,19131,38261
22916,,url:http://www.csa.com/partners/viewrecord.php3frequester3dgs26collection3denv26recid3d8913261,19131,19132,38263
22917,,qpnyp4snirqj,19132,19133,38265
22918,,h1jxb_3pzy4j,19133,19134,38267
22919,,wlvtp8otpwgj,19134,19135,38269
22920,,6rfxiw4evkuj,19135,19136,38271
22921,,yiep3zhjtrgj,19136,19137,38273
22922,,q7athp0udomj,19137,19138,38275
22923,,0d6s9zpwhboj,19138,19139,38277
22924,,rn34vxyq84yj,19139,19140,38279
22925,,_i3r2oo2wcsj,19140,19141,38281
22926,,b9lvwdu-tm4j,19141,19142,38283
22927,,aajfc2masvkj,19142,19143,38285
22928,,et7qrerdpryj,19143,19144,38287
22929,,zr3le4_v47qj,19144,19145,38289
22930,,pcx9kj5rtsij,19145,19146,38291
22931,,po7ojhzmacsj,19146,19147,38293
22932,,fvylglptf_ij,19147,19148,38295
22933,,url:http://portal.acm.org/ft_gateway.cfm3fid3d102771626type3dpdf,19148,19149,38297
22934,,7ujbuafghkcj,19149,19150,38299
22935,,94wkotdesykj,19150,19151,38301
22936,,_uu2qprmdwcj,19151,19152,38303
22937,,cxysc36hrngj,19152,19153,38305
22938,,yg2abfdixiej,19153,19154,38307
22939,,wuss_whd9ikj,19154,19155,38309
22940,,paolt1hbdjyj,19156,19157,38313
22941,,eztazygx6yoj,19157,19158,38315
22942,,92p4ihl-lfsj,19158,19159,38317
22943,,o9bvrn0_jhqj,19159,19160,38319
22944,,r128of6zyggj,19160,19161,38321
22945,,zyfw5zf4vscj,19162,19163,38325
22946,,homqq9na8wgj,19163,19164,38327
22947,,dolwxg5dsnaj,19164,19165,38329
22948,,w5fj2o-abtaj,19165,19166,38331
22949,,hfaygrc7lucj,19166,19167,38333
22950,,lyw5hnaawpqj,19167,19168,38335
22951,,yengmhfplxuj,19168,19169,38337
22952,,g9m5gut6fpaj,19169,19170,38339
22953,,gk6gfic6xgkj,19170,19171,38341
22954,,ykbagpc4zrwj,19171,19172,38343
22955,,_gzob9uyjlwj,19172,19173,38345
22956,,ij2zdne0c8mj,19173,19174,38347
22957,,ke6aqkeuqg0j,19174,19175,38349
22958,,raarqo8x4imj,19175,19176,38351
22959,,9afr-xkajoqj,19176,19177,38353
22960,,mq-x7wraznwj,19177,19178,38355
22961,,nyw4tqralwmj,19178,19179,38357
22962,,-1eztnjim08j,19179,19180,38359
22963,,viwyg2eqstaj,19181,19182,38363
22964,,evcpdmxq1iyj,19183,19184,38367
22965,,0ufbedf4hfwj,19184,19185,38369
22966,,yudoy6hxxm8j,19185,19186,38371
22967,,y3askrodwgoj,19186,19187,38373
22968,,lpiqzeyvrqmj,19187,19188,38375
22969,,ifwompdjhboj,19188,19189,38377
22970,,atrd3dh_xgoj,19189,19190,38379
22971,,9anudpcemmwj,19190,19191,38381
22972,,url:http://www.csa.com/partners/viewrecord.php3frequester3dgs26collection3denv26recid3d4005074,19191,19192,38383
22973,,qtkkwdhiwbqj,19192,19193,38385
22974,,et-24ywytb4j,19193,19194,38387
22975,,o71fxuomv6oj,19194,19195,38389
22976,,5548ow5kxpmj,19195,19196,38391
22977,,odhz-luogfmj,19196,19197,38393
22978,,osiu6vh84ngj,19197,19198,38395
22979,,9tlzmynjdk0j,19198,19199,38397
22980,,knkgi6g579gj,19199,19200,38399
22981,,hpswd_frjuij,19200,19201,38401
22982,,,19201,19202,38403
22983,,m3iwmxl0d2aj,19202,19203,38405
22984,,cfluyzwssvkj,19203,19204,38407
22985,,wwinzuiiqpmj,19204,19205,38409
22986,,bf1530nsqnsj,19205,19206,38411
22987,,asvhjppefjkj,19206,19207,38413
22988,,dxtczw8dv4mj,19207,19208,38415
22989,,urm-kvql0kuj,19208,19209,38417
22990,,1j5akuwrfk8j,19209,19210,38419
22991,,ei4mkkvcojgj,19210,19211,38421
22992,,url:http://www.csa.com/partners/viewrecord.php3frequester3dgs26collection3dtrd26recid3dn9210399ah,19211,19212,38423
22993,,yyekawzjtcyj,19212,19213,38425
22994,,r8rkzezvi7sj,19213,19214,38427
22995,,oqo-zxobnjgj,19214,19215,38429
22996,,hgop5zwkit4j,19215,19216,38431
22997,,yrfwutaqmh4j,19216,19217,38433
22998,,zojvvrsqhrij,19217,19218,38435
22999,,xtyidpdhutwj,19218,19219,38437
23000,,aursolobbq4j,19219,19220,38439
23001,,dujcnb5_dg4j,19220,19221,38441
23002,,aerbsilvnawj,19221,19222,38443
23003,,xflajwqi6huj,19222,19223,38445
23004,,13cyzggemvwj,19223,19224,38447
23005,,,19224,19225,38449
23006,,wah9gpgyj5kj,19225,19226,38451
23007,,5mizvfnfsc0j,19226,19227,38453
23008,,nzqtclnzzqoj,19227,19228,38455
23009,,h1d291geq3kj,19228,19229,38457
23010,,kybelz71d5gj,19229,19230,38459
23011,,pq5wmxwfhwcj,19230,19231,38461
23012,,bfnvvozwhm8j,19231,19232,38463
23013,,w68rhcttuvej,19232,19233,38465
23014,,huxepn3vnycj,19233,19234,38467
23015,,ihfyf-f3d34j,19234,19235,38469
23016,,jxyflajfrl0j,19235,19236,38471
23017,,yimjpsss8quj,19236,19237,38473
23018,,cjcfbuuujw0j,19237,19238,38475
23019,,7g96hzgecryj,19238,19239,38477
23020,,2gdvdfgxkisj,19239,19240,38479
23021,,iprtdkotscsj,19240,19241,38481
23022,,b_elqy7c2xaj,19241,19242,38483
23023,,cmtzb1tx0ggj,19242,19243,38485
23024,,svgnd2w_lksj,19243,19244,38487
23025,,angbobsups8j,19244,19245,38489
23026,,qkjci3qn69gj,19246,19247,38493
23027,,nbo_vmufe-cj,19247,19248,38495
23028,,sqpaal02fmyj,19248,19249,38497
23029,,fbyix_gsuhej,19249,19250,38499
23030,,fz0aldpiddqj,19250,19251,38501
23031,,ihpgxvyl1w0j,19251,19252,38503
23032,,tgbhwhhu7hsj,19252,19253,38505
23033,,vknugiumer4j,19253,19254,38507
23034,,9ul5j0-gjaej,19254,19255,38509
23035,,g1dvrgyd0paj,19255,19256,38511
23036,,wvhtuyar71ij,19256,19257,38513
23037,,pimr6uv89sqj,19257,19258,38515
23038,,ne7u8sin4vyj,19258,19259,38517
23039,,hadfdkvqrwcj,19259,19260,38519
23040,,5ei2aqfalacj,19260,19261,38521
23041,,v_txopiqgacj,19262,19263,38525
23042,,qu1sexdxehij,19263,19264,38527
23043,,0bmhvoganqoj,19264,19265,38529
23044,,3ny6tgwuflcj,19265,19266,38531
23045,,eohuijzroosj,19266,19267,38533
23046,,c8pnagjm5jaj,19267,19268,38535
23047,,ej2zprnd0yqj,19268,19269,38537
23048,,jhmgz1ppppyj,19269,19270,38539
23049,,ifvk1wyrtiej,19270,19271,38541
23050,,xgirm5zy41yj,19271,19272,38543
23051,,u0156h5pb9gj,19272,19273,38545
23052,,svcekk7gamkj,19273,19274,38547
23053,,uvl6ke5xq1aj,19274,19275,38549
23054,,s1cs-etolduj,19275,19276,38551
23055,,tueyr0u2azaj,19276,19277,38553
23056,,zkdtkjwtbrqj,19277,19278,38555
23057,,si1_5n69rkgj,19278,19279,38557
23058,,znfkx6pwa2cj,19279,19280,38559
23059,,jgrw--utkacj,19280,19281,38561
23060,,jctbigr4hhgj,19281,19282,38563
23061,,vtss_wsxdmkj,19282,19283,38565
23062,,mgzuocqxbocj,19283,19284,38567
23063,,iv1qkr9okvcj,19284,19285,38569
23064,,nvh_kcrsu-oj,19285,19286,38571
23065,,2u51tm41qs8j,19286,19287,38573
23066,,62aa4dyb0mqj,19287,19288,38575
23067,,xopwjfvrpv4j,19288,19289,38577
23068,,,19289,19290,38579
23069,,rni9gop_ufyj,19290,19291,38581
23070,,a1c1q8cqzagj,19291,19292,38583
23071,,wrivnl33ojij,19292,19293,38585
23072,,h5jvfb_l6iyj,19293,19294,38587
23073,,o6st1vntegcj,19294,19295,38589
23074,,ypv2ah520moj,19295,19296,38591
23075,,wb5qgcnk63uj,19296,19297,38593
23076,,fho7ssnhgggj,19297,19298,38595
23077,,dhblu52vkhcj,19298,19299,38597
23078,,9lxt0b9t0duj,19299,19300,38599
23079,,ubgnklekcw8j,19300,19301,38601
23080,,vlqhz9wr7m8j,19301,19302,38603
23081,,xqwlmibs_d8j,19302,19303,38605
23082,,iqbtpwlafvwj,19303,19304,38607
23083,,4s_21_ui4wuj,19304,19305,38609
23084,,piqdurcsqqsj,19305,19306,38611
23085,,l8h9eftueiyj,19306,19307,38613
23086,,k18twuyszsmj,19307,19308,38615
23087,,szwmh33tdz8j,19308,19309,38617
23088,,xdijahyb5zmj,19309,19310,38619
23089,,et4mvk_yjdcj,19310,19311,38621
23090,,oe_rsxw-mnmj,19311,19312,38623
23091,,uhw1nz1cayej,19312,19313,38625
23092,,mwm3rgkce7wj,19313,19314,38627
23093,,l6r4bxb05aej,19314,19315,38629
23094,,isbbsr4yik8j,19315,19316,38631
23095,,_i4cnrp3wsqj,19316,19317,38633
23096,,rz67d8ockl4j,19317,19318,38635
23097,,od_mvz6cv-0j,19318,19319,38637
23098,,xxoe3kj73wsj,19319,19320,38639
23099,,url:http://www.csa.com/partners/viewrecord.php3frequester3dgs26collection3dtrd26recid3d0086220ci,19320,19321,38641
23100,,a9dpwpgtnp0j,19321,19322,38643
23101,,emcqdvemfswj,19322,19323,38645
23102,,48miukrhxv0j,19323,19324,38647
23103,,ertnuk0bi7qj,19324,19325,38649
23104,,bqcdhpoulwmj,19325,19326,38651
23105,,pw3d1gcjgguj,19326,19327,38653
23106,,vnwud_ruuzaj,19328,19329,38657
23107,,ktgi3d83etgj,19329,19330,38659
23108,,psfo90msskwj,19330,19331,38661
23109,,apfopc48qx4j,19331,19332,38663
23110,,url:http://portal.acm.org/ft_gateway.cfm3fid3d110200226type3dpdf,19332,19333,38665
23111,,4tq-5onib4qj,19333,19334,38667
23112,,lagbj5ou5xyj,19334,19335,38669
23113,,mikwyajss8sj,19335,19336,38671
23114,,rj-fwwtyalsj,19336,19337,38673
23115,,ytvg0hvxfi8j,19337,19338,38675
23116,,szarprag7d4j,19338,19339,38677
23117,,kuujwqhviygj,19339,19340,38679
23118,,inx3vfvxtb0j,19340,19341,38681
23119,,808res-gkjsj,19341,19342,38683
23120,,wapocjphgngj,19342,19343,38685
23121,,8g3soqteutgj,19343,19344,38687
23122,,gzybwuyrs-kj,19344,19345,38689
23123,,w8p3mzxpaioj,19345,19346,38691
23124,,url:http://portal.acm.org/citation.cfm3fid3d234286.1057827,19346,19347,38693
23125,,s3nusocxewuj,19347,19348,38695
23126,,uxizyjh68r4j,19348,19349,38697
23127,,ow0vqco7o4yj,19349,19350,38699
23128,,6ixy8afzltuj,19350,19351,38701
23129,,qds6iu_-y0cj,19351,19352,38703
23130,,9peqv5ufun4j,19352,19353,38705
23131,,nxnf7gyym2gj,19353,19354,38707
23132,,co7txoto7yij,19354,19355,38709
23133,,isrk4x5_bsoj,19355,19356,38711
23134,,qgwrhqmt6xkj,19356,19357,38713
23135,,91x0hlavjkej,19357,19358,38715
23136,,pf8yla8cm08j,19358,19359,38717
23137,,_fzlj8rtkhaj,19359,19360,38719
23138,,yuysuihhym0j,19360,19361,38721
23139,,gbh5ot8-0wej,19361,19362,38723
23140,,urj5vkjuffgj,19362,19363,38725
23141,,29rpukpwmiqj,19363,19364,38727
23142,,fmlz3l9hn50j,19364,19365,38729
23143,,arg2zjoioyqj,19365,19366,38731
23144,,kpdr9cnvyeaj,19366,19367,38733
23145,,b8tiiht0f78j,19367,19368,38735
23146,,gl_txqujuzej,19368,19369,38737
23147,,wimxxhjgrzyj,19369,19370,38739
23148,,oi9p9caz1ogj,19370,19371,38741
23149,,xkzb3b0hvigj,19371,19372,38743
23150,,jrrbqqoc1c4j,19372,19373,38745
23151,,ntvx5uotyyaj,19373,19374,38747
23152,,jvkylfla11cj,19374,19375,38749
23153,,ptjj-czwemuj,19375,19376,38751
23154,,ywyvtmavvzwj,19376,19377,38753
23155,,japls6nr4swj,19377,19378,38755
23156,,p2yna2e1h24j,19378,19379,38757
23157,,z5z9vsnoznmj,19379,19380,38759
23158,,9nblj-e8aiwj,19380,19381,38761
23159,,tjphphmultij,19381,19382,38763
23160,,txd_doic1lwj,19382,19383,38765
23161,,k-plc654vhej,19383,19384,38767
23162,,raa3qfnt1bsj,19384,19385,38769
23163,,7wrnx5leuoyj,19385,19386,38771
23164,,ktsqr81e7ioj,19386,19387,38773
23165,,0zcdp2xrahaj,19387,19388,38775
23166,,n23crmqsxn8j,19388,19389,38777
23167,,zh3o3awyfyqj,19389,19390,38779
23168,,nvzto7rviiyj,19390,19391,38781
23169,,qseari0o3vqj,19391,19392,38783
23170,,zkp6rll4mluj,19392,19393,38785
23171,,tk_icwikiisj,19393,19394,38787
23172,,jvpv7xnn5jej,19394,19395,38789
23173,,ia7mqhkbpdaj,19395,19396,38791
23174,,w3jptw_shgoj,19397,19398,38795
23175,,drlcjnie0zqj,19398,19399,38797
23176,,br5m-8ishkoj,19399,19400,38799
23177,,jsuazwmbyogj,19400,19401,38801
23178,,ugsj0owpm7mj,19401,19402,38803
23179,,1idmqawkzlgj,19402,19403,38805
23180,,zpeqz2mkwiuj,19403,19404,38807
23181,,jroi5fim4hwj,19404,19405,38809
23182,,sxg51ejihoej,19405,19406,38811
23183,,xwrxsdn_mnmj,19406,19407,38813
23184,,r-a0b7-qynej,19407,19408,38815
23185,,1b5vcgnhm7aj,19408,19409,38817
23186,,kgxdfel9jemj,19409,19410,38819
23187,,nk30qccmyumj,19410,19411,38821
23188,,ieui-mirvckj,19411,19412,38823
23189,,plgfdyfhgpcj,19412,19413,38825
23190,,3xcskwpvccoj,19413,19414,38827
23191,,sjycdxtgom8j,19414,19415,38829
23192,,e1gkxk7fkeij,19415,19416,38831
23193,,3_jdc4qvjmmj,19416,19417,38833
23194,,3aaxgol67zyj,19417,19418,38835
23195,,rv2ceycxwqyj,19418,19419,38837
23196,,xacu-77khrwj,19419,19420,38839
23197,,bjzr4k6rzywj,19420,19421,38841
23198,,2fbotimx6haj,19421,19422,38843
23199,,ytgl21atj54j,19422,19423,38845
23200,,jxryo1iud5gj,19423,19424,38847
23201,,a7dhtldfcbwj,19424,19425,38849
23202,,-9izlukjtryj,19425,19426,38851
23203,,ipdny1v3szmj,19426,19427,38853
23204,,zkovtilw6qkj,19427,19428,38855
23205,,thaqzm5nf1oj,19428,19429,38857
23206,,xxorwyyd--qj,19429,19430,38859
23207,,jwe9a0kluyqj,19430,19431,38861
23208,,r3w2mjh1rmij,19431,19432,38863
23209,,sq-nolu2qa0j,19432,19433,38865
23210,,l6mxo3uwdyqj,19433,19434,38867
23211,,v9ve6ezijm8j,19434,19435,38869
23212,,owxvue1w98sj,19435,19436,38871
23213,,e4nijdtn_fsj,19436,19437,38873
23214,,j7nrnwaegqyj,19438,19439,38877
23215,,bzt6ls2lwaej,19439,19440,38879
23216,,qusad5_msyuj,19440,19441,38881
23217,,xgl0ltaq3vsj,19441,19442,38883
23218,,xfmiulhu95kj,19442,19443,38885
23219,,a29i6jtok5sj,19443,19444,38887
23220,,url:http://doi.wiley.com/10.1002/tl.7703,19444,19445,38889
23221,,4bd50dllu9gj,19445,19446,38891
23222,,zkgpz6zsutsj,19446,19447,38893
23223,,kxwqnvgilewj,19448,19449,38897
23224,,l8ytle8qq2ej,19449,19450,38899
23225,,qculsywv4cwj,19450,19451,38901
23226,,7sljr-09mfkj,19451,19452,38903
23227,,sghdm4zz2qsj,19452,19453,38905
23228,,4wbbjfiz7-sj,19453,19454,38907
23229,,uppp0jsttncj,19454,19455,38909
23230,,wqqyxcyila4j,19455,19456,38911
23231,,ltx8g9fj7cuj,19456,19457,38913
23232,,knqsehkumjaj,19457,19458,38915
23233,,jki-h-ba86kj,19458,19459,38917
23234,,jcqvwnf8x8gj,19459,19460,38919
23235,,szwq84m3bgyj,19460,19461,38921
23236,,z8iukn3fmvmj,19461,19462,38923
23237,,jpb9g07q198j,19462,19463,38925
23238,,6i0hhoszqfkj,19463,19464,38927
23239,,2zmbsxrr5uyj,19464,19465,38929
23240,,url:http://portal.acm.org/ft_gateway.cfm3fid3d98860026type3dpdf,19465,19466,38931
23241,,d7bggqwcpw4j,19466,19467,38933
23242,,uxw-kruu-skj,19467,19468,38935
23243,,pkffrseuotwj,19468,19469,38937
23244,,d-lmhda6d1kj,19470,19471,38941
23245,,vtw-ih5ddvej,19471,19472,38943
23246,,0cxpcexv_fmj,19472,19473,38945
23247,,yoxeaoysyqaj,19473,19474,38947
23248,,oxth1krpp4sj,19474,19475,38949
23249,,ixjqqzcoh1yj,19475,19476,38951
23250,,7qo-_fbzufuj,19476,19477,38953
23251,,srjtpthcwrwj,19477,19478,38955
23252,,url:http://www.springerlink.com/index/r0g02h631818wm15.pdf,19478,19479,38957
23253,,hhscijisglqj,19479,19480,38959
23254,,65szkowrnpej,19480,19481,38961
23255,,kqakfhyji7wj,19481,19482,38963
23256,,5x4fgb65ryyj,19482,19483,38965
23257,,xj3ty3bb42qj,19483,19484,38967
23258,,ki_73beptv0j,19484,19485,38969
23259,,fpgteqv986ij,19485,19486,38971
23260,,2lt6ii012_mj,19486,19487,38973
23261,,lp4fth_msmkj,19487,19488,38975
23262,,5rq_5hpcek8j,19488,19489,38977
23263,,url:http://www.springerlink.com/index/kwq9jn162n701tk0.pdf,19489,19490,38979
23264,,jl6m370kcy0j,19490,19491,38981
23265,,wezeg1vz9zmj,19491,19492,38983
23266,,a__4xk3kfs0j,19492,19493,38985
23267,,k3ec0jvms9cj,19493,19494,38987
23268,,nr10grs3650j,19495,19496,38991
23269,,cury0uzqbcyj,19496,19497,38993
23270,,dpkr_lqqblmj,19497,19498,38995
23271,,awnoeadizyij,19498,19499,38997
23272,,55633ii7l7wj,19499,19500,38999
23273,,obqsypscbegj,19500,19501,39001
23274,,kwqaq5m_vg8j,19501,19502,39003
23275,,mesfcpc38bqj,19502,19503,39005
23276,,tvurdvqh3c0j,19503,19504,39007
23277,,url:http://adsabs.harvard.edu/abs/1976mit..reptr....l,19504,19505,39009
23278,,url:http://www.csa.com/partners/viewrecord.php3frequester3dgs26collection3dtrd26recid3dn9210406ah,19505,19506,39011
23279,,eodyumyflnwj,19506,19507,39013
23280,,aumh4f8taloj,19507,19508,39015
23281,,f3letuw3o0yj,19508,19509,39017
23282,,pgxoeivvf1qj,19509,19510,39019
23283,,lqa0my9vaxqj,19510,19511,39021
23284,,url:http://www.csa.com/partners/viewrecord.php3frequester3dgs26collection3dtrd26recid3dn9210388ah,19511,19512,39023
23285,,qwxzc-mqtqcj,19512,19513,39025
23286,,g6gctmurlhqj,19513,19514,39027
23287,,gssjbcemq1qj,19514,19515,39029
23288,,url:http://portal.acm.org/ft_gateway.cfm3fid3d37579226type3dpdf26dl3dguide26dl3dacm26cfid3d1111111126cftoken3d2222222,19515,19516,39031
23289,,eto956ylz78j,19516,19517,39033
23290,,fndvhjmyenuj,19517,19518,39035
23291,,vue6rnplz4uj,19518,19519,39037
23292,,url:http://portal.acm.org/ft_gateway.cfm3fid3d106520426type3dpdf,19519,19520,39039
23293,,gcnfbzufbxcj,19520,19521,39041
23294,,spy1obybquuj,19521,19522,39043
23295,,bt16lhoe6jkj,19522,19523,39045
23296,,url:http://www.csa.com/partners/viewrecord.php3frequester3dgs26collection3dtrd26recid3dn9210493ah,19523,19524,39047
23297,,ibeye2vmrrkj,19524,19525,39049
23298,,url:http://portal.acm.org/citation.cfm3fid3d171926.171949,19525,19526,39051
23299,,azgxt8va1smj,19526,19527,39053
23300,,4aoxlyvw200j,19527,19528,39055
23301,,bankyztdtyej,19528,19529,39057
23302,,eaqbtzn5juoj,19529,19530,39059
23303,,w9ubasmuztaj,19530,19531,39061
23304,,h9fzdfdjwrej,19531,19532,39063
23305,,wa52h-tcvkmj,19532,19533,39065
23306,,zsu3vyeeph8j,19533,19534,39067
23307,,lpaejej3d-oj,19534,19535,39069
23308,,k-aoj_oczcoj,19535,19536,39071
23309,,ud0nkv4awaqj,19536,19537,39073
23310,,url:http://portal.acm.org/ft_gateway.cfm3fid3d108375926type3dpdf,19537,19538,39075
23311,,eobq2-_lol8j,19538,19539,39077
23312,,ewbcbumnoluj,19539,19540,39079
23313,,ujclw_yexjej,19540,19541,39081
23314,,kmm9ileuwruj,19541,19542,39083
23315,,y73jaqhzczej,19542,19543,39085
23316,,61sfp1z1-wmj,19543,19544,39087
23317,,5njt7f4h2iaj,19544,19545,39089
23318,,4z-lgwulb9wj,19545,19546,39091
23319,,yiqynljqdqoj,19546,19547,39093
23320,,osjdwtdgz-qj,19547,19548,39095
23321,,lwkkhdf9degj,19548,19549,39097
23322,,aqc3h0ifo_aj,19549,19550,39099
23323,,v84jxex-jvoj,19550,19551,39101
23324,,sq7zjaxvtcuj,19551,19552,39103
23325,,em6zggduzhaj,19552,19553,39105
23326,,,19553,19554,39107
23327,,o7worvbzr30j,19554,19555,39109
23328,,9uwzrxqrtgyj,19555,19556,39111
23329,,e8hjgrufyt4j,19556,19557,39113
23330,,qdx2sicqs0gj,19557,19558,39115
23331,,_ehl311mgpgj,19558,19559,39117
23332,,26ql0pr3xh0j,19559,19560,39119
23333,,blsuqmd2pa4j,19560,19561,39121
23334,,k9pamdmc2tij,19561,19562,39123
23335,,byomaze-eqoj,19562,19563,39125
23336,,ik5txf5twi0j,19563,19564,39127
23337,,ol1oryeat20j,19564,19565,39129
23338,,0-kgtlzn5yej,19565,19566,39131
23339,,_xo3jiqan_oj,19566,19567,39133
23340,,uusugp94cc0j,19567,19568,39135
23341,,g2yiw7ro6gmj,19568,19569,39137
23342,,url:http://portal.acm.org/citation.cfm3fid3d641269,19569,19570,39139
23343,,fdkhuck1ocuj,19570,19571,39141
23344,,wmhxlybxez8j,19571,19572,39143
23345,,mtclhmxsagyj,19572,19573,39145
23346,,qlpou9o3vxej,19573,19574,39147
23347,,0yeiysjsefgj,19574,19575,39149
23348,,tn97o2th4b0j,19576,19577,39153
23349,,phdsypohh1cj,19577,19578,39155
23350,,nk-01l0kabwj,19578,19579,39157
23351,,ljdssmam7omj,19579,19580,39159
23352,,dvfhvllzo4mj,19580,19581,39161
23353,,r0vxelg_nwaj,19581,19582,39163
23354,,url:http://doi.wiley.com/10.1002/ace.8606,19582,19583,39165
23355,,l72e-b-dhbej,19583,19584,39167
23356,,vfkkt9bkahqj,19584,19585,39169
23357,,sncexomafxqj,19585,19586,39171
23358,,f8hslyfeh6yj,19586,19587,39173
23359,,gk8arvpgphyj,19587,19588,39175
23360,,za13boxpyaej,19588,19589,39177
23361,,url:http://portal.acm.org/citation.cfm3fid3d171926.171990,19589,19590,39179
23362,,11ybrfnmcwqj,19590,19591,39181
23363,,c0uejgkyqgqj,19591,19592,39183
23364,,mk-tanoh12kj,19592,19593,39185
23365,,lvhb_cxyry4j,19593,19594,39187
23366,,m87_hf92xquj,19594,19595,39189
23367,,mwuvjxjcsfsj,19595,19596,39191
23368,,habvzupo2xaj,19596,19597,39193
23369,,bc3o69u6i5wj,19598,19599,39197
23370,,t3jtohn8ppgj,19599,19600,39199
23371,,0sfvwsfewrij,19600,19601,39201
23372,,url:http://www.springerlink.com/index/g7747882254678h9.pdf,19601,19602,39203
23373,,3weqfbqfuwcj,19602,19603,39205
23374,,cxxnbwjvh6uj,19603,19604,39207
23375,,lwcsnktmhs8j,19604,19605,39209
23376,,yjeng7buto4j,19605,19606,39211
23377,,vdlcwcm5fuoj,19606,19607,39213
23378,,odq7hi_v6wqj,19607,19608,39215
23379,,mzm-oiznmr0j,19608,19609,39217
23380,,4xp24_ifvpsj,19609,19610,39219
23381,,6ygirddwh64j,19610,19611,39221
23382,,fp1w0xzodhkj,19611,19612,39223
23383,,8wbvrocydh4j,19612,19613,39225
23384,,4qwswneelo8j,19613,19614,39227
23385,,lud892raik4j,19614,19615,39229
23386,,jyov-gfnfcwj,19615,19616,39231
23387,,i08dublks40j,19616,19617,39233
23388,,ympj7uosawqj,19617,19618,39235
23389,,qteowaooiq0j,19618,19619,39237
23390,,xs5mszax7laj,19619,19620,39239
23391,,ywt0vo6dvk8j,19620,19621,39241
23392,,ysvr6vo3xq4j,19621,19622,39243
23393,,b_ogangnwymj,19622,19623,39245
23394,,wvgbo8f2ftij,19623,19624,39247
23395,,brhr940q4paj,19624,19625,39249
23396,,jtvzsca0lkmj,19625,19626,39251
23397,,qnrm-by-kjuj,19626,19627,39253
23398,,vbppsqwjpgij,19627,19628,39255
23399,,5tolqp2diraj,19628,19629,39257
23400,,ljjb6fsk7qkj,19629,19630,39259
23401,,2psgde181xej,19630,19631,39261
23402,,qffmejccptyj,19631,19632,39263
23403,,wevyvpz3930j,19632,19633,39265
23404,,c7jpz6pgtg0j,19633,19634,39267
23405,,52aax32z0yqj,19634,19635,39269
23406,,ugnj0ntzpjgj,19635,19636,39271
23407,,cm7u25ciwzuj,19636,19637,39273
23408,,kwx9ly-c0nyj,19637,19638,39275
23409,,sds-e3d9gpoj,19638,19639,39277
23410,,url:http://portal.acm.org/ft_gateway.cfm3fid3d108378226type3dpdf,19639,19640,39279
23411,,vsivm50asaaj,19642,19643,39285
23412,,kvj3y7lvlloj,19643,19644,39287
23413,,nugooee883aj,19644,19645,39289
23414,,lexo9-7l_naj,19645,19646,39291
23415,,mrbnurr0u14j,19646,19647,39293
23416,,qzc0ddvggeuj,19647,19648,39295
23417,,dpq7j905uhmj,19648,19649,39297
23418,,ixjjilazz8oj,19649,19650,39299
23419,,2y6wyh71fo0j,19650,19651,39301
23420,,yfidccfhnrej,19651,19652,39303
23421,,7oqlv9ry1skj,19652,19653,39305
23422,,g6vfp1nntmoj,19653,19654,39307
23423,,_xxkq6oy_pqj,19654,19655,39309
23424,,url:http://www.springerlink.com/index/w212q0h058v12323.pdf,19655,19656,39311
23425,,kz2b7pyap70j,19656,19657,39313
23426,,cdpv3s4xbi8j,19657,19658,39315
23427,,xnif-6bzteij,19658,19659,39317
23428,,f3kz_wiwx50j,19659,19660,39319
23429,,6lzxe-kww1ij,19660,19661,39321
23430,,9qqyh9dgem4j,19661,19662,39323
23431,,lqi3iljp8rwj,19662,19663,39325
23432,,er-p0kedfm4j,19663,19664,39327
23433,,j6svlijw1uyj,19664,19665,39329
23434,,vmx9zilc2swj,19665,19666,39331
23435,,050_pkr0bgsj,19666,19667,39333
23436,,pdjbdk0zzsmj,19667,19668,39335
23437,,_nguhclwt3uj,19668,19669,39337
23438,,fmf9lgrsesuj,19669,19670,39339
23439,,nwr1apl-ve0j,19670,19671,39341
23440,,j0gchfxscz8j,19671,19672,39343
23441,,3sm6badopiwj,19672,19673,39345
23442,,9twqirqunt4j,19673,19674,39347
23443,,bjfwehaive4j,19674,19675,39349
23444,,lgdojp2ak4yj,19675,19676,39351
23445,,irnuszrdbkkj,19676,19677,39353
23446,,lqmu_xsfk68j,19677,19678,39355
23447,,v_5gg6o-08gj,19678,19679,39357
23448,,nvq5tryaumwj,19679,19680,39359
23449,,shyvb5cebzij,19681,19682,39363
23450,,o1zjho7e8fwj,19682,19683,39365
23451,,6pcratxx8wij,19683,19684,39367
23452,,pje1jefc-saj,19684,19685,39369
23453,,afmcwng1lpwj,19685,19686,39371
23454,,sto7f2ii2zyj,19686,19687,39373
23455,,oukyk-howy0j,19687,19688,39375
23456,,aqbs5wvol6gj,19688,19689,39377
23457,,rbjsb94ysg8j,19689,19690,39379
23458,,hbgac_v5rr4j,19690,19691,39381
23459,,url:http://portal.acm.org/ft_gateway.cfm3fid3d110129926type3dpdf,19691,19692,39383
23460,,1hazaaeogtaj,19692,19693,39385
23461,,xly7qlpwxukj,19693,19694,39387
23462,,qumwjq-knogj,19694,19695,39389
23463,,url:http://pubs.acs.org/cgi-bin/abstract.cgi/achre4/2005/38/i09/abs/ar020264l.html,19695,19696,39391
23464,,18pbiot9et4j,19696,19697,39393
23465,,5uimonc4q_qj,19697,19698,39395
23466,,zr-wxiz_0-wj,19698,19699,39397
23467,,2c-8hr07ewuj,19699,19700,39399
23468,,fmrf-h5oi8kj,19700,19701,39401
23469,,pn4pq6qelakj,19701,19702,39403
23470,,url:http://portal.acm.org/citation.cfm3fid3d1107499.1107509,19702,19703,39405
23471,,j2abcmpraimj,19703,19704,39407
23472,,llvxtelsf8kj,19704,19705,39409
23473,,,19705,19706,39411
23474,,eac3oqvfcgoj,19706,19707,39413
23475,,a5dtddw-djgj,19707,19708,39415
23476,,j0vfhtfd8ymj,19708,19709,39417
23477,,url:http://www.csa.com/partners/viewrecord.php3frequester3dgs26collection3dtrd26recid3dn9210569ah,19709,19710,39419
23478,,r7dyjjgv-3mj,19710,19711,39421
23479,,url:http://www.csa.com/partners/viewrecord.php3frequester3dgs26collection3dtrd26recid3dn9210579ah,19711,19712,39423
23480,,tcsxcbwfbmij,19712,19713,39425
23481,,xsja9vw0ftyj,19713,19714,39427
23482,,dux-7sonelwj,19714,19715,39429
23483,,n5bfod4hosmj,19715,19716,39431
23484,,mvk5wsdenguj,19716,19717,39433
23485,,5yeetuh6gpmj,19717,19718,39435
23486,,,19718,19719,39437
23487,,q3fzyxbi3roj,19719,19720,39439
23488,,_u9enztinsoj,19720,19721,39441
23489,,2ccgp46bnycj,19721,19722,39443
23490,,url:http://portal.acm.org/ft_gateway.cfm3fid3d102774226type3dpdf,19722,19723,39445
23491,,rqkdwm1ivqgj,19723,19724,39447
23492,,vkuniy7-wpqj,19724,19725,39449
23493,,gu1b3lsbktij,19725,19726,39451
23494,,pg7frpgzrjgj,19726,19727,39453
23495,,bdnmvqllzzoj,19727,19728,39455
23496,,guaabz6iikcj,19728,19729,39457
23497,,v7gm9aev2-yj,19730,19731,39461
23498,,b7mc9ycehkej,19731,19732,39463
23499,,g1vou7ks9wij,19732,19733,39465
23500,,ai6tkobwlpwj,19733,19734,39467
23501,,ykd-jh2tqg8j,19734,19735,39469
23502,,bboiippsd0oj,19735,19736,39471
23503,,c0jucwexpluj,19736,19737,39473
23504,,snsk5krs4syj,19737,19738,39475
23505,,url:http://www.csa.com/partners/viewrecord.php3frequester3dgs26collection3dtrd26recid3dn9210414ah,19738,19739,39477
23506,,tng1sl1k8ocj,19739,19740,39479
23507,,kkjmpiym3s0j,19740,19741,39481
23508,,36o-jp9uosqj,19741,19742,39483
23509,,hm0v1tajrv8j,19742,19743,39485
23510,,tyj8hoh4lx8j,19743,19744,39487
23511,,br0ojfq5lrej,19744,19745,39489
23512,,yrezqavz_vgj,19745,19746,39491
23513,,umuglh1yua0j,19746,19747,39493
23514,,xncoithkyqqj,19747,19748,39495
23515,,w3oq3zvadbyj,19748,19749,39497
23516,,yvniy_mtylej,19749,19750,39499
23517,,hkxjb_kat1ej,19750,19751,39501
23518,,0_eps_aqcloj,19751,19752,39503
23519,,w-d1jdhdpiij,19752,19753,39505
23520,,mgye16jolqmj,19753,19754,39507
23521,,tqp1rhns72wj,19754,19755,39509
23522,,jjxjclk53bcj,19755,19756,39511
23523,,ylapifxbqrqj,19756,19757,39513
23524,,qprk9yckoxsj,19757,19758,39515
23525,,ib7-rszznfij,19758,19759,39517
23526,,vsr7crgbvgyj,19759,19760,39519
23527,,ncdonvp-w9kj,19760,19761,39521
23528,,mbgdgwgzciuj,19761,19762,39523
23529,,dlgzywkikbyj,19762,19763,39525
23530,,url:http://www.csa.com/partners/viewrecord.php3frequester3dgs26collection3dtrd26recid3da8622945ah,19763,19764,39527
23531,,oniva3lk5kaj,19764,19765,39529
23532,,42x8v50tqkuj,19765,19766,39531
23533,,411fqqy99yij,19766,19767,39533
23534,,lesnvem0q50j,19767,19768,39535
23535,,ptqrrcmbi7oj,19768,19769,39537
23536,,gf4npxsccomj,19769,19770,39539
23537,,deolqvakdagj,19770,19771,39541
23538,,sbtnhrsx0dmj,19771,19772,39543
23539,,xecquwncvquj,19772,19773,39545
23540,,9vxs3289hlgj,19773,19774,39547
23541,,ih135vpxuryj,19774,19775,39549
23542,,69lycynybggj,19775,19776,39551
23543,,hyh6vns1qgcj,19776,19777,39553
23544,,a7xcool5980j,19777,19778,39555
23545,,qgbqnrty6rwj,19778,19779,39557
23546,,mvu1kqatilsj,19779,19780,39559
23547,,njgz_86lklej,19780,19781,39561
23548,,bm7sl6ggt8qj,19781,19782,39563
23549,,cp7_r7yjrjqj,19782,19783,39565
23550,,rdfkwp8j7vcj,19783,19784,39567
23551,,gdjjummccvgj,19784,19785,39569
23552,,lgpckarhxmej,19785,19786,39571
23553,,oxtmttoyw1cj,19786,19787,39573
23554,,nl8jsuv2xzij,19787,19788,39575
23555,,ha3q6xord1cj,19788,19789,39577
23556,,_mqkvnqsbjyj,19789,19790,39579
23557,,z2caabdqg5uj,19790,19791,39581
23558,,gzh8z6tmsi8j,19791,19792,39583
23559,,url:http://portal.acm.org/ft_gateway.cfm3fid3d110123826type3dpdf,19792,19793,39585
23560,,cckdkmi4u3wj,19793,19794,39587
23561,,jahqrw3yex0j,19794,19795,39589
23562,,cd8_pnxt5voj,19795,19796,39591
23563,,ljpkq7mpqeej,19796,19797,39593
23564,,dmzbloyl70uj,19797,19798,39595
23565,,dt5j7oinfzwj,19798,19799,39597
23566,,udtdqwugaqsj,19799,19800,39599
23567,,afs9kkjnoraj,19800,19801,39601
23568,,bmahjewploej,19801,19802,39603
23569,,g3qsnmr1_awj,19802,19803,39605
23570,,url:http://ieeexplore.ieee.org/iel5/9217/29235/01320052.pdf3farnumber3d1320052,19803,19804,39607
23571,,5zdbbcjlrsgj,19804,19805,39609
23572,,tjv6a_lmqa0j,19805,19806,39611
23573,,zcz25uj11gyj,19806,19807,39613
23574,,url:http://links.jstor.org/sici3fsici3d0146-4949(196323)4253a3253c298253a2522estso253e2.0.co253b2-f,19807,19808,39615
23575,,xdjrmlnjbb0j,19808,19809,39617
23576,,vlecr109v4yj,19809,19810,39619
23577,,f5aaikzqg-ij,19810,19811,39621
23578,,5try51b5g3mj,19811,19812,39623
23579,,jsdxzblr6bqj,19812,19813,39625
23580,,1wqeil9-f0gj,19813,19814,39627
23581,,hbjvxbhwks8j,19814,19815,39629
23582,,r_6bnts5qhij,19815,19816,39631
23583,,url:http://www.csa.com/partners/viewrecord.php3frequester3dgs26collection3dtrd26recid3d0655727ci,19816,19817,39633
23584,,vry1-y-mff8j,19817,19818,39635
23585,,fsrbnhreyysj,19818,19819,39637
23586,,gipp-edrogij,19819,19820,39639
23587,,c3pe9-uultqj,19820,19821,39641
23588,,s9h1kxx9o6sj,19821,19822,39643
23589,,rr_k4biqza0j,19822,19823,39645
23590,,tmqntfwosqcj,19823,19824,39647
23591,,lymeyupn6ayj,19825,19826,39651
23592,,x_i4nfc4ivwj,19826,19827,39653
23593,,yr2xue4b4v8j,19827,19828,39655
23594,,pff8fr-lzcaj,19828,19829,39657
23595,,jforh3ywva8j,19829,19830,39659
23596,,url:http://www.csa.com/partners/viewrecord.php3frequester3dgs26collection3dtrd26recid3dn9210488ah,19830,19831,39661
23597,,ztszfwfxuhwj,19831,19832,39663
23598,,gja6-_mdzugj,19832,19833,39665
23599,,ln-vrvfibtoj,19833,19834,39667
23600,,3fhpohttjz4j,19834,19835,39669
23601,,dpbp-jstre0j,19835,19836,39671
23602,,zt2bfupzohij,19836,19837,39673
23603,,uspquwwvxoyj,19837,19838,39675
23604,,igyaarfzygej,19838,19839,39677
23605,,uin1-ajytwij,19839,19840,39679
23606,,loz0ttrbtxij,19840,19841,39681
23607,,qpppwdu0bxsj,19841,19842,39683
23608,,ds7wrhwyoloj,19842,19843,39685
23609,,ejqcks1skxuj,19843,19844,39687
23610,,dsoc2gd87gij,19844,19845,39689
23611,,cdkn04jdbwmj,19845,19846,39691
23612,,sgcfkvn74_cj,19846,19847,39693
23613,,qpch8m_rswej,19847,19848,39695
23614,,1_4zqwcgh5uj,19849,19850,39699
23615,,48bijm0rwhqj,19850,19851,39701
23616,,bmsttyw6zggj,19851,19852,39703
23617,,yv1tg17xd08j,19852,19853,39705
23618,,ozmmnpbq3sqj,19853,19854,39707
23619,,yk7wstrpitaj,19854,19855,39709
23620,,sedexl57-pcj,19855,19856,39711
23621,,dzxpdqakcnkj,19856,19857,39713
23622,,fr1f65yj58ej,19857,19858,39715
23623,,haud9fqla7ej,19858,19859,39717
23624,,qq-snlbcfk0j,19859,19860,39719
23625,,cu1u5d0yfyej,19860,19861,39721
23626,,mrkuvpxcfpsj,19861,19862,39723
23627,,im262veoqssj,19862,19863,39725
23628,,u3fcbsrqdf8j,19863,19864,39727
23629,,j5izwmjdfhej,19864,19865,39729
23630,,ccq-sg362o4j,19865,19866,39731
23631,,oe8gpnwz8mkj,19866,19867,39733
23632,,2-lny3jf23oj,19867,19868,39735
23633,,crm7sr8joroj,19868,19869,39737
23634,,uaaakwdvormj,19869,19870,39739
23635,,mwuqhqlvlcoj,19870,19871,39741
23636,,yx7mm1dmsqij,19871,19872,39743
23637,,76ogsap87-yj,19872,19873,39745
23638,,qpyrj0bgqz4j,19873,19874,39747
23639,,llwd-puotssj,19874,19875,39749
23640,,agzyg5e7nroj,19875,19876,39751
23641,,ouy1sxuwdkoj,19876,19877,39753
23642,,,19877,19878,39755
23643,,od2csu0zqkgj,19878,19879,39757
23644,,ggwmy-elijwj,19879,19880,39759
23645,,ewvuordzdpwj,19880,19881,39761
23646,,psscyi3ods4j,19881,19882,39763
23647,,lkzrnjfdho0j,19882,19883,39765
23648,,n09hpyap7auj,19883,19884,39767
23649,,fkwbpd6woamj,19884,19885,39769
23650,,3ou_kjmna30j,19885,19886,39771
23651,,yq93qw8icgmj,19887,19888,39775
23652,,rdu0xkvpcwoj,19888,19889,39777
23653,,ee5vutqprlcj,19889,19890,39779
23654,,rtelsqptlhkj,19890,19891,39781
23655,,z6a1me5eu2ej,19891,19892,39783
23656,,bxbukz3kzzwj,19892,19893,39785
23657,,1o9h5bog2qsj,19893,19894,39787
23658,,dkkir7wvxpaj,19894,19895,39789
23659,,ix9niwleaw4j,19895,19896,39791
23660,,cmjkd8txdn8j,19896,19897,39793
23661,,k7_spz5q_gyj,19897,19898,39795
23662,,jsql3k6orhaj,19898,19899,39797
23663,,osv0lth_qhij,19899,19900,39799
23664,,fntq4lgh0lkj,19900,19901,39801
23665,,enf903kcelyj,19901,19902,39803
23666,,dbsb25jnmzcj,19902,19903,39805
23667,,pafiruwvvakj,19903,19904,39807
23668,,hdyclbmt7boj,19904,19905,39809
23669,,kxmpjub5tsij,19905,19906,39811
23670,,url:http://www.ingentaconnect.com/search/expand3fpub3dinfobike://pep/jae/2003/00000217/00000004/art0000526unc3d,19906,19907,39813
23671,,mnwukn1lpq4j,19907,19908,39815
23672,,me63tvmxktwj,19908,19909,39817
23673,,9kbhbwvwkzsj,19909,19910,39819
23674,,hs8kmw__4vej,19910,19911,39821
23675,,ac-se1zliswj,19911,19912,39823
23676,,z3tchfp_cuoj,19912,19913,39825
23677,,u9pgratblesj,19913,19914,39827
23678,,ndq7iu-elysj,19914,19915,39829
23679,,my0mxw-_uksj,19915,19916,39831
23680,,zi9je52o_nej,19916,19917,39833
23681,,_y7zfpfg2_4j,19917,19918,39835
23682,,ng3ylzjzlvij,19918,19919,39837
23683,,41tmfi5ur_0j,19919,19920,39839
23684,,oxt_87871uyj,19920,19921,39841
23685,,p6eac5jryyqj,19921,19922,39843
23686,,50zh7euvri0j,19922,19923,39845
23687,,mr-avkqgihmj,19923,19924,39847
23688,,k7uhjooesgkj,19924,19925,39849
23689,,xo2zkxiw0duj,19925,19926,39851
23690,,ljns48yqufcj,19926,19927,39853
23691,,vnxk7yflangj,19927,19928,39855
23692,,dcragegx_fej,19928,19929,39857
23693,,ng2otymcvmkj,19929,19930,39859
23694,,ib4ebmbqw4kj,19930,19931,39861
23695,,wzuyaz1vmnsj,19932,19933,39865
23696,,g0aqqis_8wmj,19933,19934,39867
23697,,08bwdey_oy8j,19934,19935,39869
23698,,dqui2gwd4cuj,19935,19936,39871
23699,,kprrajbg66cj,19936,19937,39873
23700,,url:http://portal.acm.org/citation.cfm3fid3d181551,19937,19938,39875
23701,,sdp6nzjdq5qj,19938,19939,39877
23702,,qa_su4mxty0j,19939,19940,39879
23703,,p1ox9-k6evkj,19940,19941,39881
23704,,bksmgewksbsj,19941,19942,39883
23705,,_aewxh-vk-ej,19942,19943,39885
23706,,n099rzohqi8j,19943,19944,39887
23707,,5pfmw0_0quyj,19944,19945,39889
23708,,ptttsrwgbvqj,19945,19946,39891
23709,,mkevvutfugkj,19946,19947,39893
23710,,7lc0qi0-brcj,19947,19948,39895
23711,,tgczct04q4cj,19949,19950,39899
23712,,z_p3qo8boamj,19950,19951,39901
23713,,2spmmuckdfgj,19951,19952,39903
23714,,_e5tw79e-6wj,19952,19953,39905
23715,,y8xqp9aus64j,19953,19954,39907
23716,,2v5smbt8njcj,19955,19956,39911
23717,,gm9ft0hpibgj,19956,19957,39913
23718,,g04oemyrxpsj,19957,19958,39915
23719,,znfsziwi3hkj,19958,19959,39917
23720,,jdtzyxrsybuj,19959,19960,39919
23721,,vfykm7y58nyj,19960,19961,39921
23722,,12khekng9ncj,19961,19962,39923
23723,,u6jckio_-wej,19962,19963,39925
23724,,3srprqmp5i0j,19963,19964,39927
23725,,26mm4rtel1gj,19964,19965,39929
23726,,3wvbsnvkic4j,19965,19966,39931
23727,,ixgu2hxjcusj,19966,19967,39933
23728,,su5hanrxk5gj,19967,19968,39935
23729,,qos2ijko0tej,19968,19969,39937
23730,,llyowsydcy4j,19969,19970,39939
23731,,fs6zm3jwng8j,19970,19971,39941
23732,,8b0ghqj8aoaj,19971,19972,39943
23733,,mitqj84ejisj,19972,19973,39945
23734,,pkpd6lfdc94j,19973,19974,39947
23735,,8rh-vqytaegj,19975,19976,39951
23736,,rsy2u5mjmmsj,19976,19977,39953
23737,,zsoytsze1bmj,19977,19978,39955
23738,,zn-kpqozguij,19978,19979,39957
23739,,h8reg5wdrpmj,19979,19980,39959
23740,,3zbnk5fb4sij,19980,19981,39961
23741,,ftvjjwx_odgj,19981,19982,39963
23742,,pcegxgsmuomj,19982,19983,39965
23743,,zwvwii6slqyj,19983,19984,39967
23744,,peaeh5wst9qj,19984,19985,39969
23745,,psvuc6w12i4j,19985,19986,39971
23746,,walbpd9yuygj,19986,19987,39973
23747,,r7vc17ou48yj,19987,19988,39975
23748,,8efqvo3muhyj,19988,19989,39977
23749,,1sdhq8xyhomj,19989,19990,39979
23750,,url:http://www.csa.com/partners/viewrecord.php3frequester3dgs26collection3dtrd26recid3d200111010668mt26recid3da0032571ah,19990,19991,39981
23751,,bc-tmpymmpcj,19991,19992,39983
23752,,ypvsbwm890ij,19992,19993,39985
23753,,gcxmsszaygaj,19993,19994,39987
23754,,huoytdste7sj,19994,19995,39989
23755,,mrecdts1bjqj,19995,19996,39991
23756,,ct0msugjdnaj,19996,19997,39993
23757,,rawlj0qgawoj,19997,19998,39995
23758,,da5bzwshai8j,19998,19999,39997
23759,,url:http://doi.wiley.com/10.1002/ace.8102,19999,20000,39999
23760,,6zmlmvs4hbmj,20000,20001,40001
23761,,acamevxt_yoj,20001,20002,40003
23762,,oduavpmbumkj,20002,20003,40005
23763,,kdypg4mljlkj,20003,20004,40007
23764,,22jqkxmvcloj,20004,20005,40009
23765,,6ubbqykmhh8j,20005,20006,40011
23766,,4pru_gg0gkej,20006,20007,40013
23767,,qw_efud-6gsj,20007,20008,40015
23768,,ywnzay_av44j,20008,20009,40017
23769,,bionktqieo0j,20009,20010,40019
23770,,hjx9-11vvjij,20011,20012,40023
23771,,bvilh5-jvsaj,20012,20013,40025
23772,,stdsu3e3qvmj,20013,20014,40027
23773,,fil-cdhmwsgj,20014,20015,40029
23774,,dy-6kuge_maj,20015,20016,40031
23775,,yam4arfq5daj,20016,20017,40033
23776,,chcxqcblknwj,20017,20018,40035
23777,,njtsgwdvzbyj,20018,20019,40037
23778,,9e9jogov9yaj,20019,20020,40039
23779,,3gkdljsrvdyj,20020,20021,40041
23780,,jsltgtsvxsqj,20021,20022,40043
23781,,retnyk7vdpkj,20022,20023,40045
23782,,fp6dsz3m40cj,20023,20024,40047
23783,,vaygpkd86kmj,20024,20025,40049
23784,,kpsdrm4zwrmj,20025,20026,40051
23785,,y1zxtwv-qeuj,20026,20027,40053
23786,,dpkbplqgaa8j,20027,20028,40055
23787,,url:http://portal.acm.org/citation.cfm3fid3d233013.233043,20028,20029,40057
23788,,0rhpxgkxtzyj,20029,20030,40059
23789,,1ag4prpoecgj,20030,20031,40061
23790,,url:http://portal.acm.org/ft_gateway.cfm3fid3d110120826type3dpdf,20031,20032,40063
23791,,url:http://portal.acm.org/citation.cfm3fid3d1101149.1101222,20032,20033,40065
23792,,cf90hywugc8j,20033,20034,40067
23793,,zghdrp10k_wj,20034,20035,40069
23794,,dmxre6s8hz0j,20035,20036,40071
23795,,3o0zwu3bu80j,20036,20037,40073
23796,,pwmbj0o1n3yj,20037,20038,40075
23797,,jqyeivs0cigj,20038,20039,40077
23798,,uuecjgfngt8j,20039,20040,40079
23799,,qqbssnfuq_gj,20040,20041,40081
23800,,nkp9hgh3rzyj,20041,20042,40083
23801,,rkqmhuzv8_4j,20042,20043,40085
23802,,7lkwsy-onhmj,20043,20044,40087
23803,,f7jggriey-aj,20044,20045,40089
23804,,jwtitvh1ve0j,20045,20046,40091
23805,,tmc5weufbbaj,20046,20047,40093
23806,,kh1pyk7lhzyj,20047,20048,40095
23807,,c4o--ggsqrkj,20048,20049,40097
23808,,b2pzg5qihayj,20049,20050,40099
23809,,url:http://www.ingentaconnect.com/search/expand3fpub3dinfobike://els/08830355/2001/00000035/00000002/art0001826unc3d,20050,20051,40101
23810,,xlkdrnzj2xej,20051,20052,40103
23811,,url:http://adsabs.harvard.edu/abs/1976rael...21q1069f,20052,20053,40105
23812,,kpxepxkhkggj,20053,20054,40107
23813,,h01s63dgj2ej,20054,20055,40109
23814,,adqywrbmciuj,20055,20056,40111
23815,,r43ssyrp674j,20056,20057,40113
23816,,l2u2ykoh1r4j,20057,20058,40115
23817,,vy_zs8qir_cj,20058,20059,40117
23818,,klwua49g8a0j,20059,20060,40119
23819,,3sefcozz6lej,20060,20061,40121
23820,,xdyrccrpm-8j,20061,20062,40123
23821,,qnogn0svo2gj,20062,20063,40125
23822,,zwmoogbpzdij,20063,20064,40127
23823,,db3avm_4d_ej,20064,20065,40129
23824,,jymxum35cxsj,20065,20066,40131
23825,,wnwf9ovr0o8j,20066,20067,40133
23826,,uqlulalyaxoj,20067,20068,40135
23827,,zokrpclp5kqj,20068,20069,40137
23828,,tk6qapqpmu0j,20069,20070,40139
23829,,ktimqsxo484j,20070,20071,40141
23830,,pt1jirde1y4j,20071,20072,40143
23831,,nzgzcymd_ngj,20072,20073,40145
23832,,dba4sj9wyu0j,20073,20074,40147
23833,,8fclhr8ym_uj,20074,20075,40149
23834,,wtmhkp1stisj,20075,20076,40151
23835,,droyt9es9xqj,20076,20077,40153
23836,,p1rmehh3bzmj,20077,20078,40155
23837,,bj3gwcb5mcoj,20078,20079,40157
23838,,cilgytju-kgj,20079,20080,40159
23839,,_d0nfsktkycj,20080,20081,40161
23840,,1heatk1znt8j,20081,20082,40163
23841,,pzie6gfnxrkj,20082,20083,40165
23842,,qntckj69x04j,20083,20084,40167
23843,,fvpfm7rkdg0j,20084,20085,40169
23844,,d92yxsvtexoj,20085,20086,40171
23845,,n2qojqbintyj,20086,20087,40173
23846,,if2n2c__tdcj,20087,20088,40175
23847,,7prk7udu3r0j,20088,20089,40177
23848,,bpa_o6vevv0j,20089,20090,40179
23849,,b904_qg3dnaj,20090,20091,40181
23850,,bui_8bm6hsaj,20091,20092,40183
23851,,yos50tgi1haj,20092,20093,40185
23852,,nof9dwutrr0j,20093,20094,40187
23853,,peb7dctb5lij,20094,20095,40189
23854,,kkardluzj4ej,20095,20096,40191
23855,,pv01xvbzroyj,20096,20097,40193
23856,,9xt-vnr5cxgj,20097,20098,40195
23857,,g39dixqr3pwj,20098,20099,40197
23858,,lvibcynvrz0j,20099,20100,40199
23859,,url:http://portal.acm.org/ft_gateway.cfm3fid3d106629326type3dpdf,20100,20101,40201
23860,,gvlvdamrhlcj,20101,20102,40203
23861,,tz-y8cf5qpyj,20103,20104,40207
23862,,xmp8zgcdpn4j,20104,20105,40209
23863,,1hilnsacmykj,20105,20106,40211
23864,,o9mltz_2nvmj,20106,20107,40213
23865,,xcdkcn2xajyj,20107,20108,40215
23866,,f4smejw_riaj,20108,20109,40217
23867,,mg0ss3jpizuj,20109,20110,40219
23868,,nfca0ei9l8gj,20110,20111,40221
23869,,_5pkt7limj4j,20111,20112,40223
23870,,5jfa8npfrxwj,20112,20113,40225
23871,,bwed1rt9sxyj,20113,20114,40227
23872,,zfqnint7qf8j,20114,20115,40229
23873,,qnqrcxmt8-oj,20115,20116,40231
23874,,opvkha35vusj,20116,20117,40233
23875,,ovxcftmxuvyj,20117,20118,40235
23876,,jw27tz_tw8uj,20118,20119,40237
23877,,ge8gz9frzwgj,20119,20120,40239
23878,,k-vthvrbodej,20120,20121,40241
23879,,yebye0rkneij,20121,20122,40243
23880,,qqf5ylj4ge4j,20122,20123,40245
23881,,prdcervl9duj,20123,20124,40247
23882,,tc9gtwelnygj,20124,20125,40249
23883,,7ldd9w-ieuuj,20125,20126,40251
23884,,moxuiegwzp0j,20126,20127,40253
23885,,s55s6sb9segj,20127,20128,40255
23886,,fzdtepkpqr8j,20128,20129,40257
23887,,wprhrcoja8cj,20129,20130,40259
23888,,7ns7fve9p0aj,20130,20131,40261
23889,,ooib5q0c6oej,20131,20132,40263
23890,,vwmgdnnfcpsj,20133,20134,40267
23891,,lo_qw_ryqasj,20134,20135,40269
23892,,hf1oztfo7gqj,20135,20136,40271
23893,,6--pdbu2ms4j,20136,20137,40273
23894,,h8-chrfjbksj,20137,20138,40275
23895,,m5ci3voys-0j,20138,20139,40277
23896,,url:http://adsabs.harvard.edu/abs/1987mit..reptq....r,20139,20140,40279
23897,,exov1thwjiyj,20140,20141,40281
23898,,havvf0c-zwyj,20141,20142,40283
23899,,,20142,20143,40285
23900,,tol6zv3_afaj,20143,20144,40287
23901,,l2adj7rmromj,20144,20145,40289
23902,,fgnrewstaasj,20145,20146,40291
23903,,wib4o_wegzgj,20146,20147,40293
23904,,eydcfdipq0aj,20147,20148,40295
23905,,url:http://portal.acm.org/ft_gateway.cfm3fid3d105784626type3dpdf,20148,20149,40297
23906,,oislritid-aj,20149,20150,40299
23907,,,20150,20151,40301
23908,,at7n9grky18j,20151,20152,40303
23909,,url:http://portal.acm.org/citation.cfm3fid3d171926.172002,20152,20153,40305
23910,,c1ugckjxms8j,20153,20154,40307
23911,,tbgilvgmzosj,20154,20155,40309
23912,,uao36wxe26gj,20155,20156,40311
23913,,14fvoepqbiaj,20156,20157,40313
23914,,bqhhjtifwzqj,20157,20158,40315
23915,,wibqjxn9f3uj,20158,20159,40317
23916,,hrex16e-zdyj,20159,20160,40319
23917,,dvpunscw1joj,20160,20161,40321
23918,,q9pmm0jpbn4j,20161,20162,40323
23919,,zngdyw5xig8j,20162,20163,40325
23920,,to0ovpz2o9sj,20163,20164,40327
23921,,url:http://ieeexplore.ieee.org/iel5/9436/29944/01369035.pdf3farnumber3d1369035,20164,20165,40329
23922,,vgn1otuyshij,20165,20166,40331
23923,,72gr66lljdgj,20166,20167,40333
23924,,2j-wmyyvdsmj,20167,20168,40335
23925,,vvhdullcq3qj,20168,20169,40337
23926,,wc0qsvqxe-yj,20169,20170,40339
23927,,waofymqvesij,20170,20171,40341
23928,,p9n_psrxlsej,20171,20172,40343
23929,,_xjz8xd9stmj,20172,20173,40345
23930,,-n-0kfx_g3qj,20173,20174,40347
23931,,xdgkc0qbxwuj,20174,20175,40349
23932,,qwk8icblneij,20175,20176,40351
23933,,byupccir_tuj,20176,20177,40353
23934,,bx_a3qeqkhej,20177,20178,40355
23935,,url:http://adsabs.harvard.edu/abs/1980phdt........29p,20178,20179,40357
23936,,pfl_konxuywj,20179,20180,40359
23937,,dthz8bq3k-kj,20180,20181,40361
23938,,wbss76jvl30j,20181,20182,40363
23939,,6yji0ps4i1qj,20183,20184,40367
23940,,ow7ywxq9tqyj,20184,20185,40369
23941,,jnfbcn0yzsgj,20185,20186,40371
23942,,q44p188dfgqj,20186,20187,40373
23943,,bu7mmbetis0j,20187,20188,40375
23944,,qpbx6hcpaaij,20188,20189,40377
23945,,u9sgxxdkg_qj,20189,20190,40379
23946,,aefgsleqscmj,20190,20191,40381
23947,,zml9ildyuuuj,20191,20192,40383
23948,,w6lymcbco3mj,20193,20194,40387
23949,,scjj9n_lfa0j,20194,20195,40389
23950,,lld3yq7ygv8j,20195,20196,40391
23951,,qroq-pronq0j,20196,20197,40393
23952,,lnvw4tc-b2ej,20197,20198,40395
23953,,eoxd6br8gmoj,20198,20199,40397
23954,,09ma0-swuiaj,20199,20200,40399
23955,,url:http://portal.acm.org/ft_gateway.cfm3fid3d108375226type3dpdf,20200,20201,40401
23956,,url:http://www.csa.com/partners/viewrecord.php3frequester3dgs26collection3dtrd26recid3dn9210453ah,20201,20202,40403
23957,,8eko7dhwmvqj,20202,20203,40405
23958,,url:http://www.csa.com/partners/viewrecord.php3frequester3dgs26collection3dtrd26recid3d8701g2d0011ed,20203,20204,40407
23959,,url:http://portal.acm.org/citation.cfm3fid3d217279.215318,20204,20205,40409
23960,,zww78f6qofgj,20205,20206,40411
23961,,fxoncw4qwj0j,20206,20207,40413
23962,,raado_auhkaj,20207,20208,40415
23963,,qxw1wnvdk-qj,20208,20209,40417
23964,,xh2r5yostrwj,20209,20210,40419
23965,,chaxu_nvrycj,20210,20211,40421
23966,,llzvmd1hjfkj,20211,20212,40423
23967,,btht56ohyiej,20212,20213,40425
23968,,ivxohtw5lt0j,20213,20214,40427
23969,,url:http://links.jstor.org/sici3fsici3d0146-4949(196524252f21)6253a1253c132253afc253e2.0.co253b2-a,20214,20215,40429
23970,,2to04jjep88j,20215,20216,40431
23971,,mdjdx__3g1oj,20216,20217,40433
23972,,zdepo63c3ekj,20217,20218,40435
23973,,pc7yhu72b8yj,20219,20220,40439
23974,,jizfhuwnzucj,20220,20221,40441
23975,,uwmme7j8fnaj,20221,20222,40443
23976,,url:http://www.springerlink.com/index/mp14u61n19u75602.pdf,20222,20223,40445
23977,,vy7tejux72kj,20223,20224,40447
23978,,qjmpa4d5f6aj,20224,20225,40449
23979,,jxytfvx915qj,20225,20226,40451
23980,,pyrqstr6i-ij,20226,20227,40453
23981,,z_3qiyl1uv4j,20227,20228,40455
23982,,yfssr2lc4msj,20228,20229,40457
23983,,ktnwokfidu4j,20229,20230,40459
23984,,lwvrcyolc1kj,20230,20231,40461
23985,,gmpnuuego7qj,20231,20232,40463
23986,,l2bdmppjvqaj,20232,20233,40465
23987,,ypn5outxf7mj,20233,20234,40467
23988,,neeznvstkm8j,20234,20235,40469
23989,,5ycrgnveqw8j,20235,20236,40471
23990,,6wgozkc-i8ej,20236,20237,40473
23991,,abvgzagqybyj,20237,20238,40475
23992,,pr0tyep7sesj,20238,20239,40477
23993,,kqh0dkzadqej,20239,20240,40479
23994,,bkp266-v6guj,20240,20241,40481
23995,,sqdz0uqkjbyj,20241,20242,40483
23996,,uut7admpd_4j,20242,20243,40485
23997,,gbzi0qrbcxaj,20243,20244,40487
23998,,ya8tzopr3gaj,20244,20245,40489
23999,,g-1ve3rexxmj,20245,20246,40491
24000,,sbljj6vxoogj,20246,20247,40493
24001,,zz6edaqyupoj,20247,20248,40495
24002,,q8sck0apksoj,20248,20249,40497
24003,,r5vnpfh4oykj,20249,20250,40499
24004,,url:http://www.springerlink.com/index/p86160527882109l.pdf,20250,20251,40501
24005,,l6ylpp5ll7aj,20251,20252,40503
24006,,wlp4fdbfrnej,20252,20253,40505
24007,,wjk5c57ittaj,20253,20254,40507
24008,,zy1ewntagykj,20254,20255,40509
24009,,ukidbku8i70j,20255,20256,40511
24010,,6c9mvhrqug0j,20256,20257,40513
24011,,pbmxfmevlbqj,20257,20258,40515
24012,,0sowkesa4f4j,20258,20259,40517
24013,,5npyk9cgljaj,20259,20260,40519
24014,,url:http://doi.wiley.com/10.1002/ace.96,20260,20261,40521
24015,,3ezhshpfracj,20261,20262,40523
24016,,,20262,20263,40525
24017,,0yfx5gan8-kj,20263,20264,40527
24018,,4v1gr8a7lsuj,20264,20265,40529
24019,,ewhhk0xj8igj,20265,20266,40531
24020,,vt0parukihcj,20266,20267,40533
24021,,uky2wbhcyzwj,20267,20268,40535
24022,,19mtelay98uj,20268,20269,40537
24023,,t3plmgos26ej,20269,20270,40539
24024,,xqwon2vaxpoj,20270,20271,40541
24025,,3g_eebmdu2cj,20271,20272,40543
24026,,4wth2hznxdaj,20272,20273,40545
24027,,ne8wzrwei7uj,20273,20274,40547
24028,,y10pmnta5sqj,20275,20276,40551
24029,,_sccjmurqnkj,20276,20277,40553
24030,,ykunk1uclaqj,20277,20278,40555
24031,,nyos-ay4iewj,20278,20279,40557
24032,,bmgjxgftggcj,20279,20280,40559
24033,,vztgh9y6_tqj,20280,20281,40561
24034,,url:http://portal.acm.org/citation.cfm3fid3d30120.30122,20281,20282,40563
24035,,ezyg5o-2q0qj,20282,20283,40565
24036,,4xjfwuwtatqj,20283,20284,40567
24037,,4gcl-f-cqlmj,20284,20285,40569
24038,,mdmdcc38z4uj,20285,20286,40571
24039,,ppgz8x9cucmj,20286,20287,40573
24040,,gtjf13diw4kj,20287,20288,40575
24041,,sqbsggq7ylcj,20288,20289,40577
24042,,ho3iandhcrcj,20289,20290,40579
24043,,mybu7xyt4nqj,20290,20291,40581
24044,,jn8ws_ldhnuj,20291,20292,40583
24045,,vt_vppmeieij,20292,20293,40585
24046,,1y1f6sycdpyj,20293,20294,40587
24047,,nd3xjass7u4j,20294,20295,40589
24048,,sgct2hyiscyj,20295,20296,40591
24049,,yrvmadf-qtwj,20296,20297,40593
24050,,ph1otw-6y6gj,20297,20298,40595
24051,,q0klcvdabg8j,20298,20299,40597
24052,,yky2uwa0cwqj,20299,20300,40599
24053,,bjbez446yc0j,20300,20301,40601
24054,,8cn5yolucfuj,20301,20302,40603
24055,,dc2iwd0r_dwj,20303,20304,40607
24056,,em_mb-ifc80j,20304,20305,40609
24057,,ze1at0kntjsj,20305,20306,40611
24058,,1wcolvgentaj,20306,20307,40613
24059,,82j6pgzvl3ij,20307,20308,40615
24060,,nooh1nzzno4j,20308,20309,40617
24061,,dpdrccbek68j,20309,20310,40619
24062,,jvxiczpns0kj,20310,20311,40621
24063,,idxskenxkbij,20311,20312,40623
24064,,7mwv01l2dlwj,20312,20313,40625
24065,,uxspjjddshmj,20313,20314,40627
24066,,62dyhkyvknyj,20314,20315,40629
24067,,xckyekqsy4kj,20315,20316,40631
24068,,url:http://portal.acm.org/ft_gateway.cfm3fid3d110136326type3dpdf,20316,20317,40633
24069,,zuraw-i--nyj,20317,20318,40635
24070,,u62ugcxo6zuj,20318,20319,40637
24071,,vdowb-jottyj,20319,20320,40639
24072,,w_jbvkkptiij,20320,20321,40641
24073,,xvkzosxkgkuj,20321,20322,40643
24074,,gh2urk_qyl0j,20322,20323,40645
24075,,url:http://portal.acm.org/citation.cfm3fid3d1066157.1066255,20323,20324,40647
24076,,di-acxpnh-kj,20324,20325,40649
24077,,,20325,20326,40651
24078,,yil9jtjiwhcj,20326,20327,40653
24079,,wce2zcrxnx4j,20327,20328,40655
24080,,iwbbdn-mc5kj,20328,20329,40657
24081,,pialt2duniaj,20329,20330,40659
24082,,ww4xdynnnhoj,20330,20331,40661
24083,,xurt3nri5hej,20331,20332,40663
24084,,lvsszfdgwzkj,20333,20334,40667
24085,,9vg83epjahaj,20334,20335,40669
24086,,76s19lz839cj,20335,20336,40671
24087,,b0u-y4m6famj,20336,20337,40673
24088,,96a-swrnfywj,20337,20338,40675
24089,,1ea5j5dmik8j,20338,20339,40677
24090,,rmdpcex-cyqj,20339,20340,40679
24091,,b3j7jf7ruysj,20341,20342,40683
24092,,brdaerslblmj,20342,20343,40685
24093,,cke_xoyu6bkj,20343,20344,40687
24094,,5drwr1vhxyoj,20344,20345,40689
24095,,_0fyvrfohjej,20345,20346,40691
24096,,sigvziepa88j,20346,20347,40693
24097,,h6z_-1woueoj,20347,20348,40695
24098,,ztokgea-afsj,20348,20349,40697
24099,,_yzyiicyzrej,20349,20350,40699
24100,,4lfldf-scesj,20350,20351,40701
24101,,nbun0dffouoj,20351,20352,40703
24102,,6qdear1ru10j,20352,20353,40705
24103,,ttnxvte2a3yj,20353,20354,40707
24104,,2gzwzmkjb5ij,20354,20355,40709
24105,,igj2j3ezwnij,20355,20356,40711
24106,,z1pbip8whiqj,20356,20357,40713
24107,,ajf7hxrmm9qj,20357,20358,40715
24108,,oacfxlcwtlij,20358,20359,40717
24109,,tdre9dyzrrwj,20359,20360,40719
24110,,7fngvsclitij,20360,20361,40721
24111,,swmkteaasscj,20361,20362,40723
24112,,xcaezqvauigj,20362,20363,40725
24113,,1i0uevi8hv0j,20363,20364,40727
24114,,tz21fmgvk4ej,20364,20365,40729
24115,,zbmnnnr91yaj,20365,20366,40731
24116,,hwik3uc4uxij,20366,20367,40733
24117,,tl1rroi0pigj,20368,20369,40737
24118,,na8defbji3ij,20369,20370,40739
24119,,mapwiyr-igaj,20370,20371,40741
24120,,aqbjca2ehjgj,20371,20372,40743
24121,,3rdoev-h7dkj,20372,20373,40745
24122,,uzvgcdlbehqj,20373,20374,40747
24123,,0_xzugjswv0j,20374,20375,40749
24124,,7rcaq0i6dhkj,20375,20376,40751
24125,,f0z0qljpcuuj,20376,20377,40753
24126,,_es5nzlgfc4j,20377,20378,40755
24127,,hbgcwelxnoqj,20378,20379,40757
24128,,url:http://doi.wiley.com/10.1002/tl.7906,20379,20380,40759
24129,,,20380,20381,40761
24130,,tiesxeg3zx4j,20381,20382,40763
24131,,zscbc2kategj,20382,20383,40765
24132,,w6elnj-b9lyj,20383,20384,40767
24133,,wtcv9hbvmeqj,20384,20385,40769
24134,,ylwd1x0bjsej,20385,20386,40771
24135,,e4tatmvl2s8j,20386,20387,40773
24136,,su9uquhgzboj,20387,20388,40775
24137,,x8zdosy2mnmj,20388,20389,40777
24138,,bogsdhxm_kij,20389,20390,40779
24139,,vt_lthxusy4j,20390,20391,40781
24140,,tspf4plczdej,20391,20392,40783
24141,,yl_d31gwufoj,20392,20393,40785
24142,,jzdrqavpwdcj,20393,20394,40787
24143,,neunjqqeul4j,20394,20395,40789
24144,,6ldjkluldkuj,20395,20396,40791
24145,,jxhxi8h8xl0j,20396,20397,40793
24146,,gado6c6tgoqj,20397,20398,40795
24147,,8okszy9gfsij,20398,20399,40797
24148,,_mhvdkwbo2ij,20399,20400,40799
24149,,6trmuuoylzij,20400,20401,40801
24150,,n-tt-g9rucaj,20401,20402,40803
24151,,b9bvluu3p0yj,20402,20403,40805
24152,,nv7lq2woioqj,20403,20404,40807
24153,,gkjk1-mzn-mj,20404,20405,40809
24154,,h2mgfn5r8juj,20405,20406,40811
24155,,tcf4fpvqcxoj,20406,20407,40813
24156,,z9wpak_igiaj,20407,20408,40815
24157,,url:http://doi.wiley.com/10.1002/ace.147,20408,20409,40817
24158,,wofk0e0laqcj,20409,20410,40819
24159,,n5sufpxu-kkj,20410,20411,40821
24160,,cvz03b3eow8j,20411,20412,40823
24161,,ahnsjnjlnv4j,20412,20413,40825
24162,,rye39nuprhcj,20413,20414,40827
24163,,kil883gykccj,20414,20415,40829
24164,,yzamaexu8aaj,20415,20416,40831
24165,,hz5j5ggthdkj,20416,20417,40833
24166,,n3thrvsxtywj,20417,20418,40835
24167,,egyqmknvmjwj,20418,20419,40837
24168,,npl9wsk5b_yj,20419,20420,40839
24169,,h9kp04yya4qj,20420,20421,40841
24170,,rcvppzod10yj,20421,20422,40843
24171,,bn92orbnie8j,20422,20423,40845
24172,,hirjvxjfzkkj,20423,20424,40847
24173,,g2fcvrabwpsj,20424,20425,40849
24174,,qlbhpkcp7kaj,20425,20426,40851
24175,,fbgsqm_a8jcj,20426,20427,40853
24176,,fkqvrrz_j6qj,20427,20428,40855
24177,,09qu-r8mn6ej,20428,20429,40857
24178,,5x7gnrhgb6ij,20429,20430,40859
24179,,qjdvfoasjz4j,20431,20432,40863
24180,,0lho2dge05kj,20432,20433,40865
24181,,ijq3ey9jhc8j,20433,20434,40867
24182,,rzdx8izo6pmj,20434,20435,40869
24183,,wu6-eggs9aaj,20435,20436,40871
24184,,url:http://portal.acm.org/citation.cfm3fid3d192593.197423,20436,20437,40873
24185,,pwbhd3m4bu8j,20438,20439,40877
24186,,qnbifqvxdjej,20439,20440,40879
24187,,wd5mjtt634wj,20440,20441,40881
24188,,cpozzayjcyuj,20441,20442,40883
24189,,llr0ikq8yiij,20442,20443,40885
24190,,4bf7meqdoqoj,20443,20444,40887
24191,,js4mwluof90j,20444,20445,40889
24192,,kuw_pkpvjxcj,20445,20446,40891
24193,,,20446,20447,40893
24194,,dwprss0ujyaj,20447,20448,40895
24195,,url:http://portal.acm.org/citation.cfm3fid3d983055.98305826coll3dguide26dl3dacm26idx3dj68926part3dperiodical26wanttype3dperiodical26title3dacm2520sigmod2520record26cfid3d1111111126cftoken3d2222222,20448,20449,40897
24196,,yjusi8i6irwj,20449,20450,40899
24197,,eljpq64otfmj,20450,20451,40901
24198,,amwu7rdd6tmj,20451,20452,40903
24199,,9hfxkftzz0kj,20452,20453,40905
24200,,29-iocctavgj,20453,20454,40907
24201,,1er7_nwftnej,20454,20455,40909
24202,,k42enlw6lc4j,20455,20456,40911
24203,,lzb_wudur8ej,20456,20457,40913
24204,,wgnsvirkbywj,20457,20458,40915
24205,,,20458,20459,40917
24206,,jvvofawti0sj,20459,20460,40919
24207,,kmsgjx8qjyoj,20460,20461,40921
24208,,76m6ow4hyd4j,20461,20462,40923
24209,,url:http://portal.acm.org/ft_gateway.cfm3fid3d108369626type3dpdf,20462,20463,40925
24210,,uxu38uioqjqj,20463,20464,40927
24211,,ujt56dve14uj,20465,20466,40931
24212,,njpjwwbqurej,20466,20467,40933
24213,,im00k8tehtoj,20467,20468,40935
24214,,url:http://portal.acm.org/ft_gateway.cfm3fid3d102757426type3dpdf,20468,20469,40937
24215,,6cwluidu4fyj,20469,20470,40939
24216,,kd3vvlyyzsmj,20470,20471,40941
24217,,xuv28tgci6sj,20471,20472,40943
24218,,8-wkjrkfjhgj,20472,20473,40945
24219,,tjjsnu9umrgj,20473,20474,40947
24220,,amah-coerjuj,20474,20475,40949
24221,,qinbmakv1haj,20475,20476,40951
24222,,d9ptfciyefqj,20476,20477,40953
24223,,q-f3llhatckj,20477,20478,40955
24224,,at1s65kget4j,20478,20479,40957
24225,,0chz95goxhmj,20479,20480,40959
24226,,dtuae-actuwj,20481,20482,40963
24227,,odvdsk1veicj,20483,20484,40967
24228,,gbrbnh3pcq4j,20484,20485,40969
24229,,ficzexoz4bij,20485,20486,40971
24230,,url:http://portal.acm.org/ft_gateway.cfm3fid3d109967826type3dpdf,20486,20487,40973
24231,,url:http://www.geography.org.uk/journals/journals.asp3farticleid3d53,20487,20488,40975
24232,,ublxl4nncdoj,20488,20489,40977
24233,,url:http://portal.acm.org/ft_gateway.cfm3fid3d110134526type3dpdf,20489,20490,40979
24234,,9v7uq1mdnl0j,20490,20491,40981
24235,,gfoovv_p1mcj,20491,20492,40983
24236,,6epmrpbjzvwj,20492,20493,40985
24237,,ew3lukjmlmij,20493,20494,40987
24238,,egwb3bt4-2aj,20494,20495,40989
24239,,7ugj3lwbromj,20495,20496,40991
24240,,kw_s1iaxnu0j,20496,20497,40993
24241,,71borudgcxwj,20497,20498,40995
24242,,zujj8dinvo4j,20498,20499,40997
24243,,q3zrmie11-wj,20499,20500,40999
24244,,gwi75zrbtsoj,20500,20501,41001
24245,,616vwlz4rvmj,20501,20502,41003
24246,,iwvrc9d5nb8j,20502,20503,41005
24247,,ufeunia7pn8j,20503,20504,41007
24248,,optsrk2fdm4j,20504,20505,41009
24249,,omizvtvdkxaj,20505,20506,41011
24250,,nizlkrimt7kj,20506,20507,41013
24251,,txo8y0krmpgj,20507,20508,41015
24252,,psqrgx4uof0j,20508,20509,41017
24253,,ifd4sov1rygj,20509,20510,41019
24254,,8b6blec26e8j,20510,20511,41021
24255,,27quv-nrj6ej,20511,20512,41023
24256,,fdrujto0f0uj,20513,20514,41027
24257,,d8wasqh4znaj,20514,20515,41029
24258,,url:http://links.jstor.org/sici3fsici3d0146-4949(196723)8253a4253c578253ahm253e2.0.co253b2-y,20515,20516,41031
24259,,povkg8nd28ij,20516,20517,41033
24260,,kac4dmab06kj,20517,20518,41035
24261,,jnhtuksaq60j,20518,20519,41037
24262,,1xb3aonoi7uj,20519,20520,41039
24263,,sbdaeov7hoej,20520,20521,41041
24264,,1_sc8sgtqqyj,20521,20522,41043
24265,,,20522,20523,41045
24266,,byf934bmasgj,20523,20524,41047
24267,,zfqlrb8m-rqj,20524,20525,41049
24268,,auwcmuodocqj,20525,20526,41051
24269,,gieo36f1syyj,20526,20527,41053
24270,,url:http://www.springerlink.com/index/x8351wwp723u0652.pdf,20527,20528,41055
24271,,vk5rjnrlud8j,20528,20529,41057
24272,,gnzsuqjchm0j,20529,20530,41059
24273,,wkltd6-vjo4j,20530,20531,41061
24274,,v9jw-ujcd-yj,20531,20532,41063
24275,,ysl5jv8jtwkj,20532,20533,41065
24276,,0xc1rgn6r1ij,20533,20534,41067
24277,,jhppfnfwj1uj,20534,20535,41069
24278,,x6bezdtbqtmj,20535,20536,41071
24279,,url:http://pubs.acs.org/cgi-bin/abstract.cgi/achre4/2005/38/i03/abs/ar0402457.html,20536,20537,41073
24280,,jabqwidsinmj,20537,20538,41075
24281,,k1ymypp3qmyj,20538,20539,41077
24282,,orgfvsjwwn0j,20539,20540,41079
24283,,tuf6vy62aigj,20540,20541,41081
24284,,eyw1urf42noj,20541,20542,41083
24285,,n5i__tzjyhkj,20542,20543,41085
24286,,hirsgxgioycj,20543,20544,41087
24287,,pz9co-fgdpcj,20544,20545,41089
24288,,q6ftanqq1nqj,20545,20546,41091
24289,,uuqmgwx9dzgj,20546,20547,41093
24290,,dmqfdv5felsj,20547,20548,41095
24291,,yzfmc7rzdbwj,20548,20549,41097
24292,,my8ftpiv1tsj,20549,20550,41099
24293,,oxgdj2stujkj,20550,20551,41101
24294,,yi-y_g0tfxaj,20551,20552,41103
24295,,7yn0aoqkqt0j,20552,20553,41105
24296,,utsqspkziqqj,20553,20554,41107
24297,,wnudx1ltgtyj,20554,20555,41109
24298,,zjcrwoimtfgj,20555,20556,41111
24299,,dcn9wsdjbysj,20556,20557,41113
24300,,zyq25ruv3noj,20557,20558,41115
24301,,kbzpgm5yl1mj,20558,20559,41117
24302,,4ybzidmxgzsj,20559,20560,41119
24303,,msfwdhsjgt4j,20560,20561,41121
24304,,xfjp6i_wgj0j,20561,20562,41123
24305,,d3xkwdnl1xuj,20563,20564,41127
24306,,iiwijhzkokoj,20564,20565,41129
24307,,dyv-sr-bjkcj,20565,20566,41131
24308,,jpslnalepvwj,20566,20567,41133
24309,,njziw3sddhej,20568,20569,41137
24310,,qczsgzre-q0j,20569,20570,41139
24311,,url:http://www.csa.com/partners/viewrecord.php3frequester3dgs26collection3dtrd26recid3d0235375ci,20570,20571,41141
24312,,lu0ppumue50j,20571,20572,41143
24313,,ndmt4xkaahcj,20572,20573,41145
24314,,8ay0as0o1naj,20573,20574,41147
24315,,xqhosuvat1sj,20574,20575,41149
24316,,nt1dujicfraj,20575,20576,41151
24317,,kptsnoxgdyaj,20576,20577,41153
24318,,xp6trohqwgsj,20577,20578,41155
24319,,ygfhw0aoyqyj,20578,20579,41157
24320,,e1uoepii6daj,20579,20580,41159
24321,,bk7bppwmq8sj,20580,20581,41161
24322,,url:http://doi.wiley.com/10.1002/he.11206,20581,20582,41163
24323,,sg4kcqvnzhmj,20582,20583,41165
24324,,ixhkeobxn48j,20583,20584,41167
24325,,hjjdhefa87yj,20584,20585,41169
24326,,dn_qw6lb0quj,20585,20586,41171
24327,,wkxm8o_flrej,20586,20587,41173
24328,,1ozxrr67riyj,20587,20588,41175
24329,,bjd4u0_fkmaj,20588,20589,41177
24330,,9ukc-tgj8hwj,20589,20590,41179
24331,,iv9jsehwoe4j,20590,20591,41181
24332,,f7adjoh_utcj,20591,20592,41183
24333,,maptadfzdtmj,20592,20593,41185
24334,,efcru3ltbxuj,20593,20594,41187
24335,,9omugc2qno8j,20594,20595,41189
24336,,url:http://www.csa.com/partners/viewrecord.php3frequester3dgs26collection3denv26recid3d9201932,20595,20596,41191
24337,,url:http://www.ingentaconnect.com/content/els/09505849/1995/00000037/00000008/art98037,20596,20597,41193
24338,,1tizgfeoffwj,20597,20598,41195
24339,,url:http://adsabs.harvard.edu/abs/1974phdt........34k,20598,20599,41197
24340,,url:http://doi.wiley.com/10.1002/he.72,20599,20600,41199
24341,,b38lp5xcbdyj,20600,20601,41201
24342,,52z7uy9hxr8j,20601,20602,41203
24343,,jjisgv4u0zqj,20602,20603,41205
24344,,url:http://www.csa.com/partners/viewrecord.php3frequester3dgs26collection3dtrd26recid3d0116697ci,20603,20604,41207
24345,,twbttuqwq0uj,20604,20605,41209
24346,,sozi3xabq98j,20605,20606,41211
24347,,uixyb263xquj,20606,20607,41213
24348,,oocg6ppo_tcj,20607,20608,41215
24349,,iopc-c88t3gj,20608,20609,41217
24350,,ctrfdjcgdg8j,20609,20610,41219
24351,,jq0o4k8qwtsj,20610,20611,41221
24352,,t6flogz83smj,20611,20612,41223
24353,,s1jykv0sbfmj,20612,20613,41225
24354,,4i7szcgjmrqj,20613,20614,41227
24355,,c5huxotaynaj,20614,20615,41229
24356,,059bmo-rvccj,20615,20616,41231
24357,,url:http://www.csa.com/partners/viewrecord.php3frequester3dgs26collection3dtrd26recid3d1027570ci,20616,20617,41233
24358,,0xhtsnbgbxaj,20617,20618,41235
24359,,m92wumwab4wj,20618,20619,41237
24360,,ciqourlhykej,20619,20620,41239
24361,,lzp9elbqsgij,20620,20621,41241
24362,,kzkyympyeqej,20621,20622,41243
24363,,0dv_h5-aaggj,20622,20623,41245
24364,,ivz3pwfqktcj,20623,20624,41247
24365,,eroz-bf4hyqj,20624,20625,41249
24366,,rdx4akdjusmj,20626,20627,41253
24367,,lfdxca8c1joj,20627,20628,41255
24368,,oeqestxhtlyj,20628,20629,41257
24369,,url:http://www.ingentaconnect.com/content/els/13891286/2003/00000041/00000006/art00201,20629,20630,41259
24370,,url:http://adsabs.harvard.edu/abs/1976infph..16...75l,20630,20631,41261
24371,,zzhb7cyz5dij,20631,20632,41263
24372,,i2f9qpu3wwoj,20632,20633,41265
24373,,vw6oem_gbl8j,20633,20634,41267
24374,,zz6bh8-v76mj,20634,20635,41269
24375,,pjtsmo1yhhkj,20635,20636,41271
24376,,url:http://www.csa.com/partners/viewrecord.php3frequester3dgs26collection3dtrd26recid3d0014645ci,20636,20637,41273
24377,,rnahp7d1taaj,20637,20638,41275
24378,,_x0afhtibtqj,20638,20639,41277
24379,,qb3lnduczeij,20639,20640,41279
24380,,l3645wlsrrmj,20641,20642,41283
24381,,d6j8tc9zytqj,20642,20643,41285
24382,,jprjhxblvycj,20643,20644,41287
24383,,inppl3li3ccj,20644,20645,41289
24384,,cg1iyab8orsj,20645,20646,41291
24385,,url:http://portal.acm.org/citation.cfm3fid3d276305.27636126dl3dguide26dl3dacm26idx3d27630526part3dperiodical26wanttype3dperiodical26title3dacm2520sigmod2520record26cfid3d1111111126cftoken3d2222222,20646,20647,41293
24386,,6ymlwn93as0j,20647,20648,41295
24387,,vszggi2simaj,20648,20649,41297
24388,,kqqc_6t54uoj,20649,20650,41299
24389,,url:http://portal.acm.org/citation.cfm3fid3d197445,20650,20651,41301
24390,,bilibj491dyj,20651,20652,41303
24391,,93o6tmycl9ij,20652,20653,41305
24392,,dzcizgozxioj,20653,20654,41307
24393,,aom9jsp2l80j,20654,20655,41309
24394,,url:http://www.ingentaconnect.com/search/expand3fpub3dinfobike://els/09505849/1998/00000040/00000009/art0007726unc3d,20655,20656,41311
24395,,xluhpcqyrgaj,20656,20657,41313
24396,,4c8bhktncg8j,20657,20658,41315
24397,,nsyrnqqrau0j,20658,20659,41317
24398,,ytuegy0v2baj,20659,20660,41319
24399,,ycmfrfj5rkcj,20660,20661,41321
24400,,au2pe9fkka0j,20661,20662,41323
24401,,quesfnuptj0j,20662,20663,41325
24402,,mg2p79huzsyj,20663,20664,41327
24403,,fwltha3ur-0j,20664,20665,41329
24404,,url:http://portal.acm.org/citation.cfm3fid3d171926.172003,20665,20666,41331
24405,,4tnd9xi-czkj,20666,20667,41333
24406,,nhgp6jixxjoj,20667,20668,41335
24407,,8hqz6v4jeauj,20668,20669,41337
24408,,ogf-l-ibkc0j,20669,20670,41339
24409,,szskxhzoesmj,20670,20671,41341
24410,,oectcu0y840j,20671,20672,41343
24411,,hh_p5rmsjqgj,20672,20673,41345
24412,,735f2pox7qaj,20673,20674,41347
24413,,icnafwvki2uj,20674,20675,41349
24414,,naelinbxe8ij,20675,20676,41351
24415,,xelfhnkzl1ej,20676,20677,41353
24416,,gkokdjj0vzqj,20677,20678,41355
24417,,zaylpex-nbqj,20678,20679,41357
24418,,nkgfzlcqlsoj,20679,20680,41359
24419,,_wfr_3gkdcaj,20680,20681,41361
24420,,zacdm5owpqqj,20681,20682,41363
24421,,fjzwrx7-5pmj,20682,20683,41365
24422,,z-gas0pfrvej,20683,20684,41367
24423,,6bhrn962oauj,20684,20685,41369
24424,,a7ykpfvp-t0j,20685,20686,41371
24425,,gexoxln09eej,20686,20687,41373
24426,,pyzhbvs-dckj,20687,20688,41375
24427,,kgb3pezwy-mj,20688,20689,41377
24428,,frdbn22cowuj,20689,20690,41379
24429,,z0ugjkelhvoj,20690,20691,41381
24430,,11ibumzy45sj,20691,20692,41383
24431,,fmgdd71mnnaj,20692,20693,41385
24432,,url:http://adsabs.harvard.edu/abs/1976phdt........40g,20693,20694,41387
24433,,6isjgx8tglqj,20694,20695,41389
24434,,6zmayrxztoij,20695,20696,41391
24435,,8grlm7nuhyoj,20696,20697,41393
24436,,jvfcgdciyicj,20697,20698,41395
24437,,c7-btel4exqj,20698,20699,41397
24438,,grsm0n8um3mj,20699,20700,41399
24439,,ndc4zxidor8j,20700,20701,41401
24440,,cekmczhxrumj,20701,20702,41403
24441,,zrasxoh9zzoj,20702,20703,41405
24442,,dkjeirzzo0wj,20703,20704,41407
24443,,642qb6wdplmj,20704,20705,41409
24444,,2-zagy7sot4j,20705,20706,41411
24445,,ssmazhk20h8j,20706,20707,41413
24446,,hesaien6zcej,20707,20708,41415
24447,,bajyvxntcsuj,20708,20709,41417
24448,,zen3ahhmyq4j,20709,20710,41419
24449,,fvujgtwsbpaj,20710,20711,41421
24450,,fln_0wv31rgj,20711,20712,41423
24451,,p_97uhnd9twj,20712,20713,41425
24452,,url:http://ieeexplore.ieee.org/iel1/2206/2685/00081886.pdf3farnumber3d81886,20713,20714,41427
24453,,nt1rewxx4lsj,20714,20715,41429
24454,,6vmmc8akub0j,20716,20717,41433
24455,,vszswrkxhgij,20717,20718,41435
24456,,gq4f2no1pugj,20718,20719,41437
24457,,hszcg-pdcykj,20719,20720,41439
24458,,uujuj4ihhhmj,20720,20721,41441
24459,,_jhurewmvbcj,20721,20722,41443
24460,,mequu1e4vdoj,20722,20723,41445
24461,,z_sbmhaaj8yj,20723,20724,41447
24462,,ir8urzbgt1ij,20724,20725,41449
24463,,url:http://portal.acm.org/citation.cfm3fid3d126482.12649426dl3dguide26dl3dacm26idx3dj68926part3dperiodical26wanttype3dperiodical26title3dacm2520sigmod2520record26cfid3d1111111126cftoken3d2222222,20725,20726,41451
24464,,0g_qwcemucyj,20726,20727,41453
24465,,5wwbcvujnzkj,20727,20728,41455
24466,,waahopqt2ykj,20728,20729,41457
24467,,xn3f8keptpgj,20729,20730,41459
24468,,mi059fdbb-4j,20730,20731,41461
24469,,imovi4geaquj,20731,20732,41463
24470,,skubnr5c5f8j,20732,20733,41465
24471,,5cwd317nrukj,20733,20734,41467
24472,,um9jvdl3ekej,20734,20735,41469
24473,,r7a24ys_f-wj,20735,20736,41471
24474,,ad_e-hv1l3wj,20736,20737,41473
24475,,ogjtphi1vwoj,20737,20738,41475
24476,,jybsdcw2q5uj,20738,20739,41477
24477,,5e0f8zw2jn4j,20739,20740,41479
24478,,cbfnesoq5j8j,20740,20741,41481
24479,,xqlxczjeczkj,20741,20742,41483
24480,,gtvnq4sgjcsj,20742,20743,41485
24481,,vwhf4nlcl_8j,20743,20744,41487
24482,,txhqa0re8oej,20744,20745,41489
24483,,sa9zbdbap-sj,20745,20746,41491
24484,,jz-eksbv5foj,20746,20747,41493
24485,,0tgc7i3um-oj,20747,20748,41495
24486,,6hyjyllssvqj,20748,20749,41497
24487,,mx2l1qhfzlaj,20749,20750,41499
24488,,jux1eht7ghqj,20750,20751,41501
24489,,xz0clgbw45qj,20751,20752,41503
24490,,r61_mg3y_ssj,20752,20753,41505
24491,,gg1bzkmlntcj,20753,20754,41507
24492,,y0caia847iqj,20754,20755,41509
24493,,ndl-pid20cmj,20755,20756,41511
24494,,url:http://doi.wiley.com/10.1002/tl.7910,20756,20757,41513
24495,,qjcvhkbasyyj,20757,20758,41515
24496,,uku2y7czag4j,20758,20759,41517
24497,,-1ghkcfocamj,20759,20760,41519
24498,,yqdrtnxo6smj,20760,20761,41521
24499,,bfaikg2ksquj,20761,20762,41523
24500,,url:http://www.csa.com/partners/viewrecord.php3frequester3dgs26collection3dtrd26recid3d200131008762ce,20762,20763,41525
24501,,xzbiqkv20c4j,20763,20764,41527
24502,,rfuvlkc3bcaj,20764,20765,41529
24503,,sywisbzhmbej,20765,20766,41531
24504,,1j3mnzc_gi8j,20766,20767,41533
24505,,n5q57m5_xk8j,20767,20768,41535
24506,,wyujkhg9kw8j,20768,20769,41537
24507,,vww5sgnssosj,20769,20770,41539
24508,,8ppnu0up394j,20770,20771,41541
24509,,qwhcauzb76mj,20771,20772,41543
24510,,0cmkqfpu1_0j,20772,20773,41545
24511,,cd6i07_tefgj,20773,20774,41547
24512,,_va8sqkrp2kj,20774,20775,41549
24513,,v7y4cai0sywj,20775,20776,41551
24514,,ylqpbm_n-icj,20776,20777,41553
24515,,fdkgalldw84j,20777,20778,41555
24516,,url:http://ieeexplore.ieee.org/xpl/abs_free.jsp3farnumber3d331731,20778,20779,41557
24517,,j5wyynot0roj,20779,20780,41559
24518,,ayfnnqjsynyj,20780,20781,41561
24519,,dxgcifnnxuyj,20781,20782,41563
24520,,otlscu8jjtwj,20782,20783,41565
24521,,hhjbfsocdgij,20783,20784,41567
24522,,scnfyxivhysj,20784,20785,41569
24523,,em2oxytrucoj,20785,20786,41571
24524,,ulnczn1wwoej,20786,20787,41573
24525,,2safm2tg8s8j,20787,20788,41575
24526,,dendddfephwj,20788,20789,41577
24527,,jtlxk5l1kmcj,20789,20790,41579
24528,,t6ypum4p2dwj,20790,20791,41581
24529,,esxizrdyygyj,20791,20792,41583
24530,,lq3bafjlxw4j,20792,20793,41585
24531,,nszahncqoggj,20793,20794,41587
24532,,rtgmdvu5veuj,20794,20795,41589
24533,,url:http://portal.acm.org/citation.cfm3fid3d968663.968683,20795,20796,41591
24534,,tvngcztquvuj,20796,20797,41593
24535,,yp7i3vx1zeqj,20797,20798,41595
24536,,url:http://portal.acm.org/citation.cfm3fid3d171926.171944,20798,20799,41597
24537,,72jgbtchrrej,20799,20800,41599
24538,,q1d3zg1xc-4j,20800,20801,41601
24539,,ov1i7zsbdcaj,20801,20802,41603
24540,,_wygpaok_4ij,20802,20803,41605
24541,,irvgastqnlmj,20803,20804,41607
24542,,ttxwqfs2mtij,20804,20805,41609
24543,,,20805,20806,41611
24544,,hp6ukfxuzjkj,20806,20807,41613
24545,,us06fy-ndtsj,20807,20808,41615
24546,,0conc5jgbvuj,20808,20809,41617
24547,,eqow4bjxl1aj,20809,20810,41619
24548,,zbk3xblgiuqj,20810,20811,41621
24549,,iodfqhmecfij,20811,20812,41623
24550,,c5-qcyg6tjuj,20812,20813,41625
24551,,g-xwkfwnyz4j,20813,20814,41627
24552,,omfmywmwp5oj,20814,20815,41629
24553,,u2zu4yaeotkj,20815,20816,41631
24554,,pajcwriz_vij,20816,20817,41633
24555,,joid8hp1yiej,20817,20818,41635
24556,,yo30iudmg_0j,20818,20819,41637
24557,,qxsfxelaa4ij,20819,20820,41639
24558,,8jn3pm4sltgj,20820,20821,41641
24559,,q9ji3aiwhkaj,20821,20822,41643
24560,,,20822,20823,41645
24561,,c9rrkr6fy0mj,20823,20824,41647
24562,,ptkn85urdiuj,20824,20825,41649
24563,,236ajjqn6twj,20825,20826,41651
24564,,m0gx3yj3gqaj,20826,20827,41653
24565,,m4pmadr7iimj,20827,20828,41655
24566,,mwq8dsyel9aj,20828,20829,41657
24567,,ifax55lj0twj,20829,20830,41659
24568,,cyt2n1lgyxwj,20830,20831,41661
24569,,url:http://portal.acm.org/ft_gateway.cfm3fid3d110129026type3dpdf,20831,20832,41663
24570,,la9jdx4tmn4j,20832,20833,41665
24571,,mz1_a-bkyqsj,20833,20834,41667
24572,,vhmwsbwzwp0j,20834,20835,41669
24573,,phrtxaagg4mj,20835,20836,41671
24574,,qkx1x_ezwbqj,20836,20837,41673
24575,,url:http://portal.acm.org/citation.cfm3fid3d1685626dl3dguide26dl3dacm26type3dissue26idx3d1685626part3dperiodical26wanttype3dperiodical26title3dacm2520sigmod2520record26cfid3d1111111126cftoken3d2222222,20837,20838,41675
24576,,lvycljeeg9qj,20838,20839,41677
24577,,jdm4qyqmpzej,20839,20840,41679
24578,,url:http://portal.acm.org/citation.cfm3fid3d615164.615165,20840,20841,41681
24579,,kbtw6g8rea0j,20841,20842,41683
24580,,gagwm812hnuj,20842,20843,41685
24581,,rkoyeygrvsej,20843,20844,41687
24582,,_d7qfd3mhyaj,20844,20845,41689
24583,,hawojw3aya8j,20845,20846,41691
24584,,1v6faus-waoj,20846,20847,41693
24585,,url:http://www.csa.com/partners/viewrecord.php3frequester3dgs26collection3dtrd26recid3d017311530372ai,20847,20848,41695
24586,,ai5lc7fxzuij,20848,20849,41697
24587,,url:http://www.csa.com/partners/viewrecord.php3frequester3dgs26collection3dtrd26recid3d8204540531md,20849,20850,41699
24588,,kcc3yzwi-pij,20850,20851,41701
24589,,url:http://www.springerlink.com/index/k756m46120606k62.pdf,20851,20852,41703
24590,,zffgngev1kej,20852,20853,41705
24591,,69_whrhvwfaj,20853,20854,41707
24592,,6n8jtt9y6sqj,20854,20855,41709
24593,,eawfzdbohdmj,20855,20856,41711
24594,,xswnkdcdq3wj,20856,20857,41713
24595,,wqptcie6_c0j,20857,20858,41715
24596,,ej_b_awfr48j,20858,20859,41717
24597,,_8lbcs-leluj,20859,20860,41719
24598,,smtx1hrguvoj,20860,20861,41721
24599,,xgzsyjpzpvcj,20861,20862,41723
24600,,rdbmwazm1-gj,20862,20863,41725
24601,,url:http://portal.acm.org/citation.cfm3fid3d984480.98448126dl3dportal26dl3dacm26idx3d98448026part3dperiodical26wanttype3dperiodical26title3dacm2520sigmod2520record26cfid3d1111111126cftoken3d2222222,20863,20864,41727
24602,,akbujo2caeej,20864,20865,41729
24603,,vdqygw6kevaj,20865,20866,41731
24604,,dv9j9rtdefyj,20866,20867,41733
24605,,fiesofrx55yj,20867,20868,41735
24606,,48f30zmfy3oj,20868,20869,41737
24607,,url:http://www.csa.com/partners/viewrecord.php3frequester3dgs26collection3dtrd26recid3d2664434ci,20869,20870,41739
24608,,3enyiaeqbswj,20870,20871,41741
24609,,krzxzpqdg6wj,20871,20872,41743
24610,,asopngvugbyj,20872,20873,41745
24611,,g4wyecxovskj,20873,20874,41747
24612,,k6oim0ysxrgj,20874,20875,41749
24613,,mu7lyym7vn8j,20875,20876,41751
24614,,xlqby8m7dfsj,20876,20877,41753
24615,,ozf1wo1ko-yj,20877,20878,41755
24616,,lcbk3fw2wdqj,20878,20879,41757
24617,,guxfoxbdgssj,20879,20880,41759
24618,,ilxfvcagf1kj,20880,20881,41761
24619,,mkmzvs7u4mij,20881,20882,41763
24620,,orenmybnhumj,20882,20883,41765
24621,,1n54u5w0ldij,20883,20884,41767
24622,,bi6mqjfm0rgj,20884,20885,41769
24623,,c0qb8ou_a1wj,20885,20886,41771
24624,,cxyuw7rq9k0j,20886,20887,41773
24625,,p0y9wz5hofoj,20887,20888,41775
24626,,xis-67pcqgaj,20888,20889,41777
24627,,fyg-tplssxij,20889,20890,41779
24628,,tp0nol-skyqj,20890,20891,41781
24629,,url:http://portal.acm.org/citation.cfm3fid3d30829.30830,20891,20892,41783
24630,,_hb7jvkdltcj,20892,20893,41785
24631,,tq3ggaystw0j,20893,20894,41787
24632,,dqprh7jgmfmj,20894,20895,41789
24633,,qz-uryhxkx0j,20895,20896,41791
24634,,adu9duozzdqj,20896,20897,41793
24635,,rtlpi_bwgryj,20897,20898,41795
24636,,hjlnsjiokugj,20899,20900,41799
24637,,v1hchxhokhej,20900,20901,41801
24638,,osvoo0hr7vcj,20901,20902,41803
24639,,,20902,20903,41805
24640,,kj7_0qqq_48j,20903,20904,41807
24641,,yvk-b-mxa2qj,20904,20905,41809
24642,,ttbq-qqrmhcj,20905,20906,41811
24643,,ttnwkwqs-eij,20906,20907,41813
24644,,k0o2gplha7sj,20907,20908,41815
24645,,dd-rlwkliqmj,20908,20909,41817
24646,,ancxd01_fw8j,20909,20910,41819
24647,,oqmwbjlu_gej,20910,20911,41821
24648,,bdjuamjziugj,20911,20912,41823
24649,,izju4t9ocaej,20912,20913,41825
24650,,pqktrze7cruj,20913,20914,41827
24651,,wyu0ll5wnk4j,20914,20915,41829
24652,,dsxjnwshjm4j,20915,20916,41831
24653,,d9_updi8c28j,20916,20917,41833
24654,,ohjumuh-2mqj,20917,20918,41835
24655,,ismgfqu0ojqj,20918,20919,41837
24656,,boy4aviz4bwj,20919,20920,41839
24657,,fgot5wtkeagj,20920,20921,41841
24658,,at87h6izyk4j,20921,20922,41843
24659,,0mmoypiw24ej,20922,20923,41845
24660,,ov9gj0b7-3kj,20923,20924,41847
24661,,s6c3h6jeegyj,20924,20925,41849
24662,,g4jbqlnklfuj,20925,20926,41851
24663,,qjjo8x9kq2mj,20927,20928,41855
24664,,lzbkl6khhmcj,20928,20929,41857
24665,,zvmesfrqdsaj,20929,20930,41859
24666,,o8j1ki4a_loj,20930,20931,41861
24667,,moz0p-gpsc8j,20931,20932,41863
24668,,o7tn7zkdlmij,20932,20933,41865
24669,,owj96waya7ij,20933,20934,41867
24670,,djnlr4bnxqqj,20934,20935,41869
24671,,url:http://www.csa.com/partners/viewrecord.php3frequester3dgs26collection3dtrd26recid3d2005092515524ci,20935,20936,41871
24672,,vyrknmpafqgj,20936,20937,41873
24673,,9wvw7mh-ub0j,20937,20938,41875
24674,,hmi4ocqm65qj,20938,20939,41877
24675,,nubynwzdtm0j,20939,20940,41879
24676,,6kq6lceihwcj,20940,20941,41881
24677,,url:http://ieeexplore.ieee.org/iel1/2206/2685/00081884.pdf3farnumber3d81884,20941,20942,41883
24678,,q144dthzlfwj,20942,20943,41885
24679,,aetcarmqiyij,20943,20944,41887
24680,,lfyurpwsulsj,20944,20945,41889
24681,,zcgo8gngw4oj,20945,20946,41891
24682,,cdxdvyur0tsj,20946,20947,41893
24683,,cv8hmhzpjtsj,20947,20948,41895
24684,,vjhq7wptcaoj,20948,20949,41897
24685,,uqcpu38wbwqj,20950,20951,41901
24686,,2ig-838oduyj,20951,20952,41903
24687,,q-cttlnqeeij,20952,20953,41905
24688,,p5wtnxt7bs4j,20953,20954,41907
24689,,c_sahmske-0j,20955,20956,41911
24690,,3_x-dmpuewmj,20956,20957,41913
24691,,zrybfblkiu8j,20957,20958,41915
24692,,vpx_sy9ebokj,20958,20959,41917
24693,,ukffkqrkbl8j,20959,20960,41919
24694,,2e6efb6h2b4j,20960,20961,41921
24695,,zpntj-pnxl0j,20961,20962,41923
24696,,xxafjvs7remj,20962,20963,41925
24697,,douij_qcomuj,20963,20964,41927
24698,,t28uhmv1ru4j,20964,20965,41929
24699,,y1xfy5ixafsj,20965,20966,41931
24700,,ubjbv_r0tcuj,20966,20967,41933
24701,,j-fdbowlcawj,20968,20969,41937
24702,,vh2s6wn1ly8j,20969,20970,41939
24703,,2eaf2aaectkj,20970,20971,41941
24704,,cmcqwoh2168j,20971,20972,41943
24705,,yk-uoqvalewj,20972,20973,41945
24706,,vikphcojpfgj,20973,20974,41947
24707,,qo6r7ek79aej,20974,20975,41949
24708,,udvxmjrpksuj,20975,20976,41951
24709,,tmr1ongdkpkj,20976,20977,41953
24710,,nsad9s2iry4j,20977,20978,41955
24711,,rl7j60iwj-4j,20978,20979,41957
24712,,odo1zltetmsj,20979,20980,41959
24713,,01nbe8r8b-0j,20980,20981,41961
24714,,rwfeprctamkj,20981,20982,41963
24715,,pdfdugwxwnkj,20982,20983,41965
24716,,nevgx_eqrs0j,20983,20984,41967
24717,,g7gwpfog8moj,20984,20985,41969
24718,,8flrhwoffhgj,20985,20986,41971
24719,,4ouqod2i52sj,20986,20987,41973
24720,,pvectd-im6mj,20987,20988,41975
24721,,5jdpxi6sthij,20988,20989,41977
24722,,09ncxgk1-_cj,20989,20990,41979
24723,,rxiuespwreoj,20990,20991,41981
24724,,aps6ykpyff4j,20991,20992,41983
24725,,url:http://www.springerlink.com/index/q4q36748k07p2l47.pdf,20992,20993,41985
24726,,0_hzq0-ygg0j,20993,20994,41987
24727,,iwu2tdzgsnkj,20994,20995,41989
24728,,zmqzjkwby1oj,20995,20996,41991
24729,,ggv87tiwh04j,20996,20997,41993
24730,,ldok60_ofxsj,20997,20998,41995
24731,,lx_ydcavtgej,20998,20999,41997
24732,,u0noyaginzkj,20999,21000,41999
24733,,qryuejj8ncyj,21000,21001,42001
24734,,yrmlxdzt7t4j,21001,21002,42003
24735,,kl4uzdsuwdej,21002,21003,42005
24736,,4k4wsmubercj,21003,21004,42007
24737,,url:http://portal.acm.org/ft_gateway.cfm3fid3d107333226type3dpdf,21004,21005,42009
24738,,2ozddb5hmpij,21005,21006,42011
24739,,wg4dtxitoeij,21006,21007,42013
24740,,ihq9lnelozyj,21007,21008,42015
24741,,tki9y2gxofej,21008,21009,42017
24742,,xvvaclh3fasj,21009,21010,42019
24743,,rqyyick05dej,21010,21011,42021
24744,,laya1no1nisj,21011,21012,42023
24745,,ogbsnzmsvhuj,21012,21013,42025
24746,,fwir8mrfshkj,21013,21014,42027
24747,,5eup8dwubjsj,21014,21015,42029
24748,,b408sdgcy3uj,21015,21016,42031
24749,,sx-nnpffrlcj,21016,21017,42033
24750,,d6arlxslse4j,21017,21018,42035
24751,,aymvgedzdzwj,21018,21019,42037
24752,,dbpqai0tf1qj,21019,21020,42039
24753,,fchxzke0z3ej,21020,21021,42041
24754,,wed778p3anuj,21021,21022,42043
24755,,ntrmulgz2cuj,21022,21023,42045
24756,,r_zqapfghpuj,21023,21024,42047
24757,,xrgrqlzvsruj,21024,21025,42049
24758,,iqiebpz-dasj,21025,21026,42051
24759,,,21026,21027,42053
24760,,hpkgn-ubzxej,21027,21028,42055
24761,,ad2-hkwlm8kj,21028,21029,42057
24762,,b1kr0mvqsnwj,21029,21030,42059
24763,,5fiybez3v70j,21030,21031,42061
24764,,cvafznz98mgj,21031,21032,42063
24765,,vjxj_rbwdmkj,21032,21033,42065
24766,,w6k66c_jmq0j,21033,21034,42067
24767,,it8hrjwsgasj,21034,21035,42069
24768,,_rhftvptwgyj,21035,21036,42071
24769,,v81tctj-4aaj,21036,21037,42073
24770,,0beilgyr2iqj,21037,21038,42075
24771,,7qfuql2hnwgj,21038,21039,42077
24772,,dmq7n94c6doj,21039,21040,42079
24773,,ugnrdbuvrgyj,21040,21041,42081
24774,,50xyuvcwln4j,21041,21042,42083
24775,,gyxna2mgze0j,21042,21043,42085
24776,,icw9yddedtgj,21044,21045,42089
24777,,azxamr4fd6gj,21045,21046,42091
24778,,xlaowmijp3sj,21046,21047,42093
24779,,guogyslstasj,21047,21048,42095
24780,,aokqe1yw9bgj,21048,21049,42097
24781,,yxerqem4pywj,21049,21050,42099
24782,,ncc8sezrpi0j,21050,21051,42101
24783,,h9r5g-tvxxgj,21051,21052,42103
24784,,tozrxesxeeoj,21052,21053,42105
24785,,vl1jobazrgwj,21053,21054,42107
24786,,5iahja4dl2qj,21054,21055,42109
24787,,xk-s6wu4hrwj,21055,21056,42111
24788,,,21056,21057,42113
24789,,ugecojzn-k4j,21057,21058,42115
24790,,oau-bco5hnwj,21058,21059,42117
24791,,zms0_r5uvnwj,21059,21060,42119
24792,,zfnnpw_g25mj,21060,21061,42121
24793,,wqkslyakgxmj,21061,21062,42123
24794,,68xm7volruij,21062,21063,42125
24795,,ulj7rxyzgeej,21063,21064,42127
24796,,md3dwyujcrqj,21064,21065,42129
24797,,fgdvh2wn5boj,21065,21066,42131
24798,,wgbi9gh-fwej,21066,21067,42133
24799,,9tlmfoorphwj,21067,21068,42135
24800,,ssdysfctd_8j,21068,21069,42137
24801,,pham2gkpxykj,21070,21071,42141
24802,,yxdjhquynxaj,21071,21072,42143
24803,,mdnxunia850j,21072,21073,42145
24804,,qpndtedcjc4j,21073,21074,42147
24805,,zrmjnfupni0j,21074,21075,42149
24806,,vhp6l0jzryij,21075,21076,42151
24807,,dgzqrmk825uj,21076,21077,42153
24808,,tdze3syva0kj,21077,21078,42155
24809,,bnhkeweqfhmj,21078,21079,42157
24810,,p1mvueuzixoj,21079,21080,42159
24811,,ifhgyz_wngcj,21080,21081,42161
24812,,l1zzptvlnq8j,21081,21082,42163
24813,,zfxjr99sptgj,21082,21083,42165
24814,,8glwx5dxh7wj,21083,21084,42167
24815,,iieopjalodqj,21084,21085,42169
24816,,cfjrbkjtsdwj,21085,21086,42171
24817,,aihrsew-psqj,21086,21087,42173
24818,,gjmgniawdzwj,21087,21088,42175
24819,,rggeoluf4ioj,21088,21089,42177
24820,,aumdurm8p-mj,21090,21091,42181
24821,,syvzgrjfurgj,21091,21092,42183
24822,,1qklgbesercj,21092,21093,42185
24823,,5kbbocv6hcoj,21093,21094,42187
24824,,o3saqzgoqwaj,21094,21095,42189
24825,,sd5fshxwh5cj,21095,21096,42191
24826,,csweklcxsaej,21096,21097,42193
24827,,tcx9mwvhztgj,21097,21098,42195
24828,,ps6wubwatfwj,21098,21099,42197
24829,,ie1ebzuftnmj,21099,21100,42199
24830,,4dhltvxqvqwj,21100,21101,42201
24831,,url:http://portal.acm.org/ft_gateway.cfm3fid3d104142526type3dpdf,21101,21102,42203
24832,,q9fqtinagpij,21102,21103,42205
24833,,eltdwvj1kguj,21103,21104,42207
24834,,xxp4im8og9aj,21104,21105,42209
24835,,zzr1tcwshicj,21105,21106,42211
24836,,fgbp8ndirbuj,21106,21107,42213
24837,,j8q-vn4okryj,21107,21108,42215
24838,,3sgwnxnejycj,21108,21109,42217
24839,,4ac13bgnrsmj,21109,21110,42219
24840,,9qmfxslipkcj,21110,21111,42221
24841,,qbrkg2dru3aj,21111,21112,42223
24842,,fxg__ucpzbuj,21112,21113,42225
24843,,fitsvcasbeej,21113,21114,42227
24844,,url:http://www.springerlink.com/index/pm8280m8u350004n.pdf,21114,21115,42229
24845,,lvxrxq-sncej,21115,21116,42231
24846,,fuj6sx8qtayj,21116,21117,42233
24847,,zck-harhuwoj,21117,21118,42235
24848,,grzquczl_ouj,21118,21119,42237
24849,,2oql9fu5cvyj,21119,21120,42239
24850,,nda7ddszeiij,21120,21121,42241
24851,,lwaewrr8jl4j,21121,21122,42243
24852,,nw5bjyfoeiqj,21122,21123,42245
24853,,mmxixqbpptij,21123,21124,42247
24854,,pzsckdfid4cj,21124,21125,42249
24855,,ku5ba849jnij,21125,21126,42251
24856,,n-aidzydeusj,21126,21127,42253
24857,,jte-mfm5j0ej,21127,21128,42255
24858,,hgecaehemrmj,21128,21129,42257
24859,,hwbwulklaiej,21129,21130,42259
24860,,pr1avd1rznsj,21130,21131,42261
24861,,e2-yeaunwiej,21131,21132,42263
24862,,uvjyhsbdo04j,21132,21133,42265
24863,,2eecheffqiwj,21133,21134,42267
24864,,wrywdvxybz8j,21134,21135,42269
24865,,zu529rkeiiyj,21135,21136,42271
24866,,n4gbecw_g1uj,21136,21137,42273
24867,,y2agwx27tugj,21137,21138,42275
24868,,c_fpibgyyn4j,21139,21140,42279
24869,,jd41fd0rup0j,21140,21141,42281
24870,,hf4qtfvqsqsj,21141,21142,42283
24871,,8qlyprb0ohgj,21142,21143,42285
24872,,dqyofipf5c4j,21143,21144,42287
24873,,fl_wooridaoj,21144,21145,42289
24874,,tfhr3wiaqd4j,21145,21146,42291
24875,,17qal1ra-i4j,21146,21147,42293
24876,,9ntuzlfwojyj,21147,21148,42295
24877,,rub-_owdgfoj,21148,21149,42297
24878,,zuk4gy_soy0j,21149,21150,42299
24879,,gymi-krdsqgj,21150,21151,42301
24880,,itzus5b3m7yj,21151,21152,42303
24881,,l5ux6xe8y_8j,21152,21153,42305
24882,,nvmvdxva6qcj,21153,21154,42307
24883,,mpn0pxooe0aj,21154,21155,42309
24884,,4dszdbw3s4ej,21155,21156,42311
24885,,eiku-e_mtcsj,21156,21157,42313
24886,,h7bja7yodwqj,21157,21158,42315
24887,,punzd47aqewj,21158,21159,42317
24888,,pgb67sladtoj,21159,21160,42319
24889,,xfqwx4m8e2yj,21160,21161,42321
24890,,opck0-elt6wj,21161,21162,42323
24891,,wnej2fumcycj,21162,21163,42325
24892,,m4grn4nikfaj,21163,21164,42327
24893,,url:http://portal.acm.org/ft_gateway.cfm3fid3d102772526type3dpdf,21164,21165,42329
24894,,url:http://www.csa.com/partners/viewrecord.php3frequester3dgs26collection3dtrd26recid3dn9210437ah,21165,21166,42331
24895,,v1goq6jqgdaj,21166,21167,42333
24896,,url:http://www.springerlink.com/index/p12116p8m7211245.pdf,21167,21168,42335
24897,,kzhu2ds1g2oj,21168,21169,42337
24898,,ptjrunf9zlcj,21169,21170,42339
24899,,zqb0albc0lcj,21171,21172,42343
24900,,gw_wux0xwuoj,21172,21173,42345
24901,,mrunbwzjbpsj,21173,21174,42347
24902,,url:http://portal.acm.org/ft_gateway.cfm3fid3d104141226type3dpdf,21174,21175,42349
24903,,jnmboh2yb0aj,21175,21176,42351
24904,,ml2pqjkscpej,21176,21177,42353
24905,,2y5pwybxru8j,21177,21178,42355
24906,,mgre0dszq0ij,21178,21179,42357
24907,,ohdfevls-lwj,21179,21180,42359
24908,,oiv1iqdisjgj,21180,21181,42361
24909,,3mjnrunrprqj,21181,21182,42363
24910,,8rtsgacpbyoj,21182,21183,42365
24911,,tay5gukdg_aj,21183,21184,42367
24912,,ldxksescfzej,21184,21185,42369
24913,,3l2rt2k3wxsj,21185,21186,42371
24914,,u3z3xhubisuj,21186,21187,42373
24915,,2k1vzrwj0xij,21187,21188,42375
24916,,vokaepfndtmj,21188,21189,42377
24917,,vmwdreeeinsj,21189,21190,42379
24918,,i4mbv9koelqj,21190,21191,42381
24919,,euefaz50_gij,21191,21192,42383
24920,,yfaujmoqp1wj,21192,21193,42385
24921,,p19j8mrjbq8j,21193,21194,42387
24922,,rvtq1l40oryj,21194,21195,42389
24923,,00c1qmrdm5ij,21195,21196,42391
24924,,yncf9gezv_uj,21196,21197,42393
24925,,vvzbeqz33tcj,21197,21198,42395
24926,,yp5lgrzruuaj,21198,21199,42397
24927,,pqm0is6dae0j,21199,21200,42399
24928,,6gz1phej_ckj,21200,21201,42401
24929,,igxfxik3h7ej,21201,21202,42403
24930,,6juhbx7usryj,21202,21203,42405
24931,,xo1pc8kazg8j,21203,21204,42407
24932,,url:http://doi.wiley.com/10.1002/ace.7503,21204,21205,42409
24933,,rmmuq4dovisj,21205,21206,42411
24934,,jjk_q4u0jiqj,21206,21207,42413
24935,,0o3jgoosdiuj,21207,21208,42415
24936,,,21208,21209,42417
24937,,qlslluclyswj,21209,21210,42419
24938,,lmhe65upbkoj,21210,21211,42421
24939,,lhs20twyyzaj,21211,21212,42423
24940,,_chaufmfhrej,21212,21213,42425
24941,,url:http://ieeexplore.ieee.org/iel1/2206/4259/00165477.pdf3farnumber3d165477,21213,21214,42427
24942,,esge0rjqq40j,21214,21215,42429
24943,,3iaxit7tq_kj,21215,21216,42431
24944,,o342hsmbwe4j,21216,21217,42433
24945,,rcajyb0xieuj,21217,21218,42435
24946,,dyshn8rdrvej,21218,21219,42437
24947,,jimnuiynsdij,21219,21220,42439
24948,,a0_xgbcmxaqj,21221,21222,42443
24949,,2zi0ijdczpgj,21222,21223,42445
24950,,mynj4h5es2yj,21223,21224,42447
24951,,y43bominze0j,21224,21225,42449
24952,,gbkwenzeg40j,21225,21226,42451
24953,,qp2zupf9phej,21226,21227,42453
24954,,9otg26cnauyj,21227,21228,42455
24955,,6b4kfu28m-qj,21228,21229,42457
24956,,tijdvctux3uj,21229,21230,42459
24957,,2fjpn-p00jmj,21230,21231,42461
24958,,setqtl7ov2gj,21231,21232,42463
24959,,f6urrzr5ffcj,21232,21233,42465
24960,,w6grmgjxvtuj,21233,21234,42467
24961,,2ombvvoxspyj,21234,21235,42469
24962,,vhb-zjtepssj,21235,21236,42471
24963,,sldmbirngpmj,21236,21237,42473
24964,,afhwycmaoywj,21237,21238,42475
24965,,hw39t9dhioaj,21238,21239,42477
24966,,pr_kjsqlnu0j,21239,21240,42479
24967,,yj0r1uymkjaj,21240,21241,42481
24968,,qyqy9jidlnej,21241,21242,42483
24969,,pb2jk4jjgdqj,21242,21243,42485
24970,,gj24g-g2htwj,21243,21244,42487
24971,,llhmkhyr-mqj,21244,21245,42489
24972,,rj20qqtnbaej,21245,21246,42491
24973,,etizbudbcuij,21246,21247,42493
24974,,cydlpf-k8n8j,21247,21248,42495
24975,,url:http://doi.wiley.com/10.1002/he.11108,21248,21249,42497
24976,,8t4a0lxqdcoj,21249,21250,42499
24977,,qg7inbrqjwej,21250,21251,42501
24978,,_njngpu8qjkj,21251,21252,42503
24979,,url:http://www.csa.com/partners/viewrecord.php3frequester3dgs26collection3dtrd26recid3d017203530100xai,21252,21253,42505
24980,,8uwzb0jlvtuj,21253,21254,42507
24981,,avsgrcrwrqyj,21254,21255,42509
24982,,sf4xdh31mdaj,21255,21256,42511
24983,,url:http://www.csa.com/partners/viewrecord.php3frequester3dgs26collection3denv26recid3d178072,21256,21257,42513
24984,,crx-lrk1200j,21257,21258,42515
24985,,37dfm_-ef_wj,21258,21259,42517
24986,,nghmpd_sqmcj,21259,21260,42519
24987,,,21260,21261,42521
24988,,f-4rfhajq-0j,21261,21262,42523
24989,,swgzw0nfcdyj,21262,21263,42525
24990,,6wmnrem1g8mj,21263,21264,42527
24991,,cnjy261ol-4j,21264,21265,42529
24992,,r3hfnyb0laqj,21265,21266,42531
24993,,mr8fkpxkpqqj,21266,21267,42533
24994,,fj1h5i9s8d0j,21267,21268,42535
24995,,e4byhut5j8wj,21268,21269,42537
24996,,emoelruf2scj,21269,21270,42539
24997,,w1erucatk48j,21270,21271,42541
24998,,bpmnxvwfjrej,21271,21272,42543
24999,,woci6wdssiej,21272,21273,42545
25000,,url:http://portal.acm.org/ft_gateway.cfm3fid3d108375126type3dpdf,21273,21274,42547
25001,,snh8br61tb4j,21274,21275,42549
25002,,xbrqt_o4ewaj,21275,21276,42551
25003,,aucdcwdu6yyj,21276,21277,42553
25004,,ltttlrsz0rqj,21277,21278,42555
25005,,mib0rzjunc0j,21278,21279,42557
25006,,rqwp54yi4ymj,21279,21280,42559
25007,,jyw8xy8ea2yj,21281,21282,42563
25008,,7afmobrto3gj,21282,21283,42565
25009,,7fdavnkdbtcj,21283,21284,42567
25010,,url:http://www.geography.org.uk/journals/journals.asp3farticleid3d42,21284,21285,42569
25011,,jfxhpzssvmij,21285,21286,42571
25012,,reg2z292vmuj,21286,21287,42573
25013,,lumpk8l02woj,21287,21288,42575
25014,,ur2fkcijmqmj,21288,21289,42577
25015,,ves1xtsbhm8j,21289,21290,42579
25016,,csgorwbx-c4j,21290,21291,42581
25017,,fxb47cvrvh4j,21292,21293,42585
25018,,7kp8h4vpnu0j,21293,21294,42587
25019,,inh2jb9n4l4j,21295,21296,42591
25020,,kdhhgybfv9gj,21296,21297,42593
25021,,zfxtyxbchvcj,21297,21298,42595
25022,,cvxu2xj0j4kj,21298,21299,42597
25023,,pivc6s0cedej,21299,21300,42599
25024,,y_bnuzukn-yj,21300,21301,42601
25025,,n2cugfbtkrcj,21301,21302,42603
25026,,gztvib7mijwj,21302,21303,42605
25027,,g_ypsxctlh0j,21303,21304,42607
25028,,gdgq06-kknaj,21304,21305,42609
25029,,h6xgsfr9v6mj,21305,21306,42611
25030,,hepg2xckijuj,21306,21307,42613
25031,,gt4t4ifwixyj,21307,21308,42615
25032,,lqv1pwlnlksj,21308,21309,42617
25033,,osalhpm0xtej,21309,21310,42619
25034,,,21310,21311,42621
25035,,0omk6nwqfhuj,21311,21312,42623
25036,,elry-f4m-vsj,21312,21313,42625
25037,,kipvj69zheuj,21313,21314,42627
25038,,qy4atdab_fqj,21314,21315,42629
25039,,4h9xbwh_wmaj,21315,21316,42631
25040,,8ay_uxqtsi8j,21316,21317,42633
25041,,49f9avw4zb0j,21317,21318,42635
25042,,kcesuyax0eoj,21318,21319,42637
25043,,_mbzbhdv_xwj,21319,21320,42639
25044,,t5qifuoyzmyj,21321,21322,42643
25045,,kgbj8yb71coj,21322,21323,42645
25046,,0a8baeqiznwj,21323,21324,42647
25047,,hoexxcxgqu4j,21324,21325,42649
25048,,jeeil6em6voj,21325,21326,42651
25049,,vxmszbnbgbkj,21326,21327,42653
25050,,zktqktzvgbsj,21327,21328,42655
25051,,67gjhxipk28j,21328,21329,42657
25052,,url:http://doi.wiley.com/10.1002/tl.89,21329,21330,42659
25053,,ezndl3nmlq8j,21330,21331,42661
25054,,iagpkyc73pij,21331,21332,42663
25055,,4h7gnt6vc1mj,21332,21333,42665
25056,,ulups8x_zwgj,21333,21334,42667
25057,,_nntqqobx1ej,21334,21335,42669
25058,,6mbu5t69nfej,21335,21336,42671
25059,,url:http://www.springerlink.com/index/m328126883g3284u.pdf,21336,21337,42673
25060,,biqnxcuzyjmj,21337,21338,42675
25061,,gd2jz-quyjgj,21338,21339,42677
25062,,cpud0oh5f9aj,21339,21340,42679
25063,,4t1ifjtlmrmj,21340,21341,42681
25064,,drh5sh360ekj,21341,21342,42683
25065,,5-vya7y2qjej,21342,21343,42685
25066,,url:http://www.ingentaconnect.com/search/expand3fpub3dinfobike://els/08830355/2001/00000035/00000002/art0001126unc3d,21343,21344,42687
25067,,msiejmu3yvaj,21344,21345,42689
25068,,guexqfqbq24j,21345,21346,42691
25069,,aznrdqnlwdij,21346,21347,42693
25070,,xi8-xbgebkwj,21347,21348,42695
25071,,27uiouywnhij,21348,21349,42697
25072,,esfxndjvdsij,21350,21351,42701
25073,,385d99j4ckgj,21351,21352,42703
25074,,ec7x53qw3jsj,21352,21353,42705
25075,,2i8urtv1wt8j,21353,21354,42707
25076,,8k6oq_shc9aj,21354,21355,42709
25077,,hcjy6gpsmpyj,21355,21356,42711
25078,,yb3zd4nnedgj,21356,21357,42713
25079,,unbsmacgadoj,21357,21358,42715
25080,,ecw_qactwcwj,21358,21359,42717
25081,,barvyupemqsj,21359,21360,42719
25082,,706-axj2wrsj,21360,21361,42721
25083,,ffeajo_z4fcj,21361,21362,42723
25084,,uxrliyfsn0ij,21362,21363,42725
25085,,qvualwttq8wj,21363,21364,42727
25086,,qgyrizeupusj,21364,21365,42729
25087,,e-xqyjd-elmj,21365,21366,42731
25088,,h0d_75fie-ij,21366,21367,42733
25089,,dyrpdcqmndkj,21367,21368,42735
25090,,ov7tcv7saeyj,21368,21369,42737
25091,,ufxjgljlxrmj,21369,21370,42739
25092,,or3tbf3xvlaj,21370,21371,42741
25093,,kcnqv6rlld8j,21371,21372,42743
25094,,yrwcatvire0j,21372,21373,42745
25095,,orvklylnldej,21373,21374,42747
25096,,srzafdi1ucij,21374,21375,42749
25097,,url:http://doi.wiley.com/10.1002/he.44,21375,21376,42751
25098,,28sa2em58yij,21376,21377,42753
25099,,a22_hivuggmj,21377,21378,42755
25100,,ifwlxhtvjeqj,21378,21379,42757
25101,,url:http://www.springerlink.com/index/x1511125004h5724.pdf,21379,21380,42759
25102,,mmvec2iuummj,21380,21381,42761
25103,,dqbffvwjp3gj,21381,21382,42763
25104,,86pofinleqqj,21382,21383,42765
25105,,6epdb2t_rxsj,21383,21384,42767
25106,,yrv2vhk9xa4j,21384,21385,42769
25107,,8m2csruytryj,21385,21386,42771
25108,,zs-kfsk8pmoj,21386,21387,42773
25109,,hspnfegbmtmj,21387,21388,42775
25110,,d1bttqgunhoj,21388,21389,42777
25111,,t1xe6m-3xvgj,21389,21390,42779
25112,,fzvjg4pr2aaj,21390,21391,42781
25113,,uicz8ecz08uj,21391,21392,42783
25114,,6gqufgcahx8j,21392,21393,42785
25115,,xpsetd8smrgj,21393,21394,42787
25116,,ymb_fhjgzq8j,21394,21395,42789
25117,,4ldokwjf1tij,21395,21396,42791
25118,,gknrrybr92kj,21396,21397,42793
25119,,jkzfpgtl_5cj,21397,21398,42795
25120,,m4axycwqtkoj,21398,21399,42797
25121,,oheie8r90woj,21399,21400,42799
25122,,1ptfx1jot3qj,21400,21401,42801
25123,,khgjfwos_jej,21401,21402,42803
25124,,kssmamco9zgj,21402,21403,42805
25125,,wjz7kgphhh4j,21403,21404,42807
25126,,sorbnlj4ubmj,21404,21405,42809
25127,,6hvdy_c1qe4j,21405,21406,42811
25128,,9nlj99_cwzcj,21406,21407,42813
25129,,jzicnqpsopmj,21408,21409,42817
25130,,w2whmubeobij,21409,21410,42819
25131,,f3g9t-3j7gqj,21410,21411,42821
25132,,yypfkdvupiuj,21411,21412,42823
25133,,yo-wwtoqjukj,21412,21413,42825
25134,,8tthil3dbdoj,21413,21414,42827
25135,,xc1e6mofp80j,21414,21415,42829
25136,,s7dqodnpnzkj,21415,21416,42831
25137,,t8bnned4dqej,21416,21417,42833
25138,,cdcdirkk_vgj,21417,21418,42835
25139,,a2sylgl8tfaj,21418,21419,42837
25140,,v98unngdtqgj,21419,21420,42839
25141,,l2l0eksndpmj,21420,21421,42841
25142,,exulm3jwflaj,21421,21422,42843
25143,,po4gzbossfqj,21422,21423,42845
25144,,gch3emfkuwyj,21423,21424,42847
25145,,eqsfrybea50j,21424,21425,42849
25146,,d1jhpxnsa7wj,21425,21426,42851
25147,,8pa34aktaikj,21426,21427,42853
25148,,1f0bgv6dyrij,21427,21428,42855
25149,,x_ax5r39x1qj,21428,21429,42857
25150,,l28_n28calej,21429,21430,42859
25151,,rlfdxohk13wj,21430,21431,42861
25152,,0-zrlqpw5ykj,21431,21432,42863
25153,,p1jlkye66awj,21432,21433,42865
25154,,mtfeyepu0aoj,21433,21434,42867
25155,,mnpmxiswcqaj,21434,21435,42869
25156,,hoc-boiplkwj,21435,21436,42871
25157,,wbwoun8bww4j,21436,21437,42873
25158,,zmjsykek-dij,21438,21439,42877
25159,,zo3dfds7p3yj,21439,21440,42879
25160,,spdiwis7aioj,21440,21441,42881
25161,,xwd07ka5l6ej,21441,21442,42883
25162,,5ut4mnw0xuaj,21442,21443,42885
25163,,gnly6p1snlej,21443,21444,42887
25164,,rgis2xqy_wsj,21445,21446,42891
25165,,5oejqwmy_6ej,21446,21447,42893
25166,,cunhtoboagoj,21447,21448,42895
25167,,37qwx52fsq8j,21448,21449,42897
25168,,hiauvf7jqzgj,21449,21450,42899
25169,,ooz0wrrkujmj,21450,21451,42901
25170,,8rhl-oyxqooj,21451,21452,42903
25171,,fyce8trtisaj,21452,21453,42905
25172,,jgkthv3zrhwj,21453,21454,42907
25173,,x02bbw-6eisj,21454,21455,42909
25174,,niar1zg_az0j,21455,21456,42911
25175,,ps7oxxe6xyij,21456,21457,42913
25176,,pfa9tihr1joj,21457,21458,42915
25177,,elcfpqrgmpgj,21458,21459,42917
25178,,b00b8t3s6qej,21459,21460,42919
25179,,wwtdjnkdttej,21461,21462,42923
25180,,5fal0luzhsij,21462,21463,42925
25181,,ljoxbcaysp8j,21463,21464,42927
25182,,zopbxn4p2zsj,21464,21465,42929
25183,,b_rfykc_vi4j,21465,21466,42931
25184,,don0xyyn2egj,21466,21467,42933
25185,,8tf5lgwtxrcj,21467,21468,42935
25186,,59fjvoa7ozej,21468,21469,42937
25187,,lprk4oti2_ij,21469,21470,42939
25188,,url:http://www.springerlink.com/index/k7153131xx6r6881.pdf,21470,21471,42941
25189,,zkbtv93zp1uj,21471,21472,42943
25190,,sb2w0erbpngj,21472,21473,42945
25191,,wmwpslhhnboj,21473,21474,42947
25192,,t6d9r-rldqoj,21475,21476,42951
25193,,4mtm-urphukj,21476,21477,42953
25194,,cgclqi4kpq4j,21477,21478,42955
25195,,xeukbk-y2zwj,21478,21479,42957
25196,,rwyfxmv3gwqj,21479,21480,42959
25197,,pdz43z5dedcj,21480,21481,42961
25198,,a0j20d-vzeuj,21481,21482,42963
25199,,url:http://portal.acm.org/ft_gateway.cfm3fid3d95705526type3dpdf26dl3dguide26dl3dguide26cfid3d1111111126cftoken3d2222222,21482,21483,42965
25200,,9j9t84uxubyj,21483,21484,42967
25201,,ehffqtme-n8j,21484,21485,42969
25202,,pv7azqw3n30j,21485,21486,42971
25203,,2p6ggi63xdaj,21486,21487,42973
25204,,h3faiz5cju0j,21487,21488,42975
25205,,uyeozikubv4j,21488,21489,42977
25206,,vetb6by5kkcj,21489,21490,42979
25207,,lzzje-ahfnqj,21490,21491,42981
25208,,wtpnwbbw7foj,21491,21492,42983
25209,,jwx2duumyp4j,21492,21493,42985
25210,,tmjmbw2f5dcj,21493,21494,42987
25211,,qngeov2xggqj,21494,21495,42989
25212,,nb9wanx_70oj,21495,21496,42991
25213,,fhe3tj4s11kj,21496,21497,42993
25214,,bwftdy3anmmj,21497,21498,42995
25215,,kunmh_hh-gsj,21498,21499,42997
25216,,mkioz0xk6uwj,21499,21500,42999
25217,,hticqgrqoymj,21500,21501,43001
25218,,jjd9d-yr2tej,21501,21502,43003
25219,,ft7qqi2byxsj,21502,21503,43005
25220,,fowap4a4ltaj,21503,21504,43007
25221,,qg84vpbaapmj,21504,21505,43009
25222,,maly7ggpw28j,21505,21506,43011
25223,,kp3q-dm0nluj,21506,21507,43013
25224,,hngpxkqscomj,21507,21508,43015
25225,,c08nwyleo8ij,21508,21509,43017
25226,,rff7ydfesgwj,21509,21510,43019
25227,,_o2qefel0bij,21510,21511,43021
25228,,y1jmdbib910j,21511,21512,43023
25229,,0c5q61crx0sj,21512,21513,43025
25230,,url:http://www.publish.csiro.au/3fact3dview_file26file_id3dch9891345.pdf,21513,21514,43027
25231,,u7fferq4y70j,21514,21515,43029
25232,,nu9uxxfppqwj,21515,21516,43031
25233,,5iohziyoagaj,21516,21517,43033
25234,,ct1tuk_wivgj,21517,21518,43035
25235,,n8j1ynfhtisj,21518,21519,43037
25236,,_y87udwlmmmj,21520,21521,43041
25237,,8nmfa85-qi0j,21521,21522,43043
25238,,1hntcxxt1b4j,21522,21523,43045
25239,,ssq0efqtzboj,21523,21524,43047
25240,,1v5tmdnywdwj,21524,21525,43049
25241,,a-isj7zvgwwj,21525,21526,43051
25242,,w-cyjamxtpsj,21526,21527,43053
25243,,oui21l-yfiuj,21527,21528,43055
25244,,0gwuy9f07vmj,21528,21529,43057
25245,,o5m6uxq_xv4j,21530,21531,43061
25246,,dglw2yynmcuj,21531,21532,43063
25247,,cimjuryvcrmj,21532,21533,43065
25248,,s0v2kytovgoj,21533,21534,43067
25249,,oab-ce0mmmwj,21535,21536,43071
25250,,n3tozy_mzlwj,21536,21537,43073
25251,,s0lvdcaxat4j,21537,21538,43075
25252,,pzd7eazl5w0j,21538,21539,43077
25253,,dn0rb-x2xmmj,21539,21540,43079
25254,,omqn9nfar88j,21540,21541,43081
25255,,gvgiq_oup9qj,21541,21542,43083
25256,,2un8u3wvbm0j,21542,21543,43085
25257,,j4ksdzwwb4qj,21543,21544,43087
25258,,d20xckqhjj0j,21544,21545,43089
25259,,,21545,21546,43091
25260,,ym5cgq_uukgj,21546,21547,43093
25261,,9ue5hzp8h68j,21547,21548,43095
25262,,aghlh7zvxhyj,21548,21549,43097
25263,,i-m3ezj4xjkj,21549,21550,43099
25264,,a4iv1uv7jz0j,21550,21551,43101
25265,,url:http://doi.wiley.com/10.1002/he.104,21551,21552,43103
25266,,url:http://adsabs.harvard.edu/abs/1984rame.conf..172a,21552,21553,43105
25267,,gl1tblwo1gij,21553,21554,43107
25268,,o35sy6uqgokj,21554,21555,43109
25269,,ije9krer62sj,21555,21556,43111
25270,,jz8yxvqnjkyj,21556,21557,43113
25271,,iaath0p_r_gj,21557,21558,43115
25272,,igvkoz_63uqj,21558,21559,43117
25273,,wjacflt0b2gj,21559,21560,43119
25274,,mpexy3cmfbuj,21560,21561,43121
25275,,fhsg-jsnppuj,21561,21562,43123
25276,,phlskygev40j,21562,21563,43125
25277,,sst0uluhebqj,21563,21564,43127
25278,,00ah6tbn60uj,21564,21565,43129
25279,,wjzdwaawakej,21565,21566,43131
25280,,ra6fuyf9vrwj,21566,21567,43133
25281,,w-9zlh752vej,21567,21568,43135
25282,,url:http://portal.acm.org/ft_gateway.cfm3fid3d109959726type3dpdf,21568,21569,43137
25283,,tgcuu28treoj,21569,21570,43139
25284,,xflt2pmlrbqj,21570,21571,43141
25285,,ugzipruypdkj,21571,21572,43143
25286,,o1uomnufk_mj,21572,21573,43145
25287,,vok1szxeqg8j,21573,21574,43147
25288,,bcvzeqkcnxaj,21574,21575,43149
25289,,url:http://www.kluweronline.com/article.asp3fpips3d35765126pdf3d1,21575,21576,43151
25290,,5gdh0yehryej,21576,21577,43153
25291,,iectdp-we9wj,21577,21578,43155
25292,,dv1xyllflfaj,21578,21579,43157
25293,,bhxh56v9cxgj,21579,21580,43159
25294,,ejo_n-enlzyj,21580,21581,43161
25295,,oey8zow1buwj,21581,21582,43163
25296,,l4zjzijggyqj,21582,21583,43165
25297,,tzese3n2dkmj,21583,21584,43167
25298,,1kxt7lr1wiaj,21584,21585,43169
25299,,ob1iuahdd-0j,21585,21586,43171
25300,,kqxsv1yf_e0j,21586,21587,43173
25301,,d_6fwb0qmy0j,21587,21588,43175
25302,,yogbnpocreuj,21588,21589,43177
25303,,xpklzk36ubuj,21589,21590,43179
25304,,1g03zgczpl8j,21590,21591,43181
25305,,yeomvtzldh8j,21591,21592,43183
25306,,papmjce5qsej,21592,21593,43185
25307,,url:http://pubs.acs.org/cgi-bin/abstract.cgi/achre4/asap/abs/ar050158u.html,21593,21594,43187
25308,,ekwsso16e4ej,21594,21595,43189
25309,,canb9ivtm-0j,21595,21596,43191
25310,,wpl7yd0bw2oj,21596,21597,43193
25311,,x92yw8h9uh4j,21597,21598,43195
25312,,i2kb69gkpxuj,21598,21599,43197
25313,,8jtxrhmfwq0j,21599,21600,43199
25314,,y-rqt3f4qauj,21600,21601,43201
25315,,id3rk1jgwx0j,21601,21602,43203
25316,,cv02bgcrmo8j,21602,21603,43205
25317,,s08gilbjc48j,21603,21604,43207
25318,,lioi0dkqwbsj,21604,21605,43209
25319,,url:http://www.springerlink.com/index/rl0410355742611k.pdf,21605,21606,43211
25320,,6ygchohlyvqj,21607,21608,43215
25321,,mplgaa2rf1qj,21608,21609,43217
25322,,tprquhdaziuj,21609,21610,43219
25323,,jegasky-nsgj,21610,21611,43221
25324,,vouoy6jholsj,21611,21612,43223
25325,,es8xt3xnoh4j,21612,21613,43225
25326,,u0jxiiam7eaj,21613,21614,43227
25327,,9-kgmqmolpaj,21614,21615,43229
25328,,sbwz6v1qfqej,21615,21616,43231
25329,,jv3dailiatcj,21616,21617,43233
25330,,znabdhstyhkj,21617,21618,43235
25331,,yj6sf3voc1wj,21618,21619,43237
25332,,dpzwvbnoycqj,21619,21620,43239
25333,,xxeynecn_sij,21620,21621,43241
25334,,_jl3bn2qle4j,21621,21622,43243
25335,,fet_353fblwj,21622,21623,43245
25336,,q8kfmcoysqwj,21623,21624,43247
25337,,mfrjybg4s6cj,21624,21625,43249
25338,,hndwkfgwm7ej,21625,21626,43251
25339,,vc8bgocs7ncj,21626,21627,43253
25340,,7adbddx_jp8j,21627,21628,43255
25341,,m5kdf6xibzuj,21628,21629,43257
25342,,qex_sgmjtm8j,21629,21630,43259
25343,,xkho-pzk5xij,21630,21631,43261
25344,,ryc-j_j4yv0j,21631,21632,43263
25345,,url:http://www.csa.com/partners/viewrecord.php3frequester3dgs26collection3dtrd26recid3dn9210395ah,21632,21633,43265
25346,,ncefx5oyqamj,21633,21634,43267
25347,,fzdhdbmugm4j,21634,21635,43269
25348,,p8g5y8klb-ij,21635,21636,43271
25349,,wx8ugencuq4j,21636,21637,43273
25350,,mempvktkqogj,21637,21638,43275
25351,,fqvuskfc4yqj,21638,21639,43277
25352,,xmpmawc4j_yj,21639,21640,43279
25353,,z8_ehn-2llmj,21640,21641,43281
25354,,vlcfdl6r38wj,21641,21642,43283
25355,,y7djg2mgssgj,21642,21643,43285
25356,,gzlnfk0tk4qj,21643,21644,43287
25357,,url:http://doi.ieeecomputersociety.org/10.1109/sew.2005.40,21644,21645,43289
25358,,vgvdzim2sswj,21645,21646,43291
25359,,99l4qgh6gcgj,21646,21647,43293
25360,,url:http://ieeexplore.ieee.org/iel5/69/29527/01339269.pdf3farnumber3d1339269,21647,21648,43295
25361,,j2xfjnvoi50j,21648,21649,43297
25362,,tkrlak46u8kj,21649,21650,43299
25363,,_qe11jo1-h0j,21650,21651,43301
25364,,bgyyrxgmx7sj,21651,21652,43303
25365,,ww_qyic4mzkj,21652,21653,43305
25366,,url:http://www.csa.com/partners/viewrecord.php3frequester3dgs26collection3dtrd26recid3dn9210452ah,21653,21654,43307
25367,,i85hxtpmp0mj,21654,21655,43309
25368,,rulz6rr1nquj,21655,21656,43311
25369,,qckevmwknhej,21656,21657,43313
25370,,-4nsuihbjcuj,21657,21658,43315
25371,,qnkslfi1qacj,21658,21659,43317
25372,,3wczvbk5pbqj,21659,21660,43319
25373,,sk8pak5mccmj,21660,21661,43321
25374,,l2ktrp0gv_uj,21661,21662,43323
25375,,ug4sa6qtxpqj,21662,21663,43325
25376,,umvcerjfne4j,21663,21664,43327
25377,,nyjnq41aonuj,21664,21665,43329
25378,,vuz1ie8hoxmj,21665,21666,43331
25379,,b-zis9alpoej,21666,21667,43333
25380,,neyommp2zcgj,21667,21668,43335
25381,,5yfksknxsg0j,21668,21669,43337
25382,,k7nouai5wwij,21669,21670,43339
25383,,3khb1n8oe7aj,21670,21671,43341
25384,,dtrzny6dxk4j,21671,21672,43343
25385,,rxjrgbikonsj,21672,21673,43345
25386,,tmxe_bpkl98j,21673,21674,43347
25387,,ti2yhaasj7mj,21674,21675,43349
25388,,suohwkddx4ij,21675,21676,43351
25389,,nb51r2vr2pwj,21676,21677,43353
25390,,b96wdx4hzraj,21678,21679,43357
25391,,th3s2z3zaiqj,21679,21680,43359
25392,,7x_v7eorvusj,21680,21681,43361
25393,,av18ceg4rccj,21681,21682,43363
25394,,0zi-dcztoyuj,21682,21683,43365
25395,,pazh7d9kcuej,21683,21684,43367
25396,,zquor-tmssij,21684,21685,43369
25397,,url:http://doi.wiley.com/10.1002/tl.147,21685,21686,43371
25398,,f3yxxwpbx4aj,21686,21687,43373
25399,,m6i2b7qzfrwj,21687,21688,43375
25400,,zpjk6awnygwj,21688,21689,43377
25401,,5ry7wokqphyj,21689,21690,43379
25402,,qj_sd-omk2cj,21690,21691,43381
25403,,4fey-0jqermj,21691,21692,43383
25404,,mgyoboenen4j,21692,21693,43385
25405,,ejkby8ulqucj,21693,21694,43387
25406,,nbeeencg73qj,21694,21695,43389
25407,,pj3qii_35qaj,21695,21696,43391
25408,,ttcejf3vh08j,21696,21697,43393
25409,,uzb0cfsefoyj,21697,21698,43395
25410,,url:http://portal.acm.org/ft_gateway.cfm3fid3d108485726type3dpdf,21698,21699,43397
25411,,zdmb748m-msj,21699,21700,43399
25412,,eub0smlopoij,21700,21701,43401
25413,,1c5bjhv5wgej,21701,21702,43403
25414,,80nxrq1lyi8j,21702,21703,43405
25415,,7t5ffr6shgcj,21703,21704,43407
25416,,1gsbtn376m4j,21704,21705,43409
25417,,fqnvtqjkl0oj,21705,21706,43411
25418,,soxtcqkuytoj,21706,21707,43413
25419,,d3gxfviiiawj,21707,21708,43415
25420,,g191-dgbkwmj,21708,21709,43417
25421,,2ne0xr3hiyij,21709,21710,43419
25422,,wa8yuns77xyj,21710,21711,43421
25423,,vfoo5g8rdsaj,21712,21713,43425
25424,,y9t62n0iyh8j,21713,21714,43427
25425,,9bga6c_hqvqj,21714,21715,43429
25426,,pv5p7uhh6qyj,21715,21716,43431
25427,,xos-ji9lj3oj,21716,21717,43433
25428,,s95_gw773pwj,21717,21718,43435
25429,,ygw_mi5jco4j,21718,21719,43437
25430,,url:http://doi.wiley.com/10.1002/ev.1538,21719,21720,43439
25431,,tnrtgdunqi8j,21720,21721,43441
25432,,ylwmicwj31aj,21721,21722,43443
25433,,ze3jlgilsacj,21722,21723,43445
25434,,wdgvla7eb2gj,21723,21724,43447
25435,,bz2fv6lfjguj,21724,21725,43449
25436,,6ni_yrvysemj,21725,21726,43451
25437,,rzcrxl6ueumj,21726,21727,43453
25438,,cebwkdumkdaj,21727,21728,43455
25439,,keexaw2ixh8j,21728,21729,43457
25440,,oc0qx3xcd5wj,21729,21730,43459
25441,,uvipdgrpngej,21730,21731,43461
25442,,url:http://www.geography.org.uk/journals/journals.asp3farticleid3d71,21731,21732,43463
25443,,_cqgqcqf_bkj,21732,21733,43465
25444,,ald_rgyy_u4j,21734,21735,43469
25445,,hbp7jpwimvij,21735,21736,43471
25446,,pin0qflicx4j,21736,21737,43473
25447,,jkyklquhzj0j,21737,21738,43475
25448,,kp8j_hy7mc0j,21738,21739,43477
25449,,5n3i97kyebuj,21739,21740,43479
25450,,1yai65qialij,21740,21741,43481
25451,,5uju1glokckj,21741,21742,43483
25452,,u9w29axsin8j,21742,21743,43485
25453,,sora0xfrf9ej,21743,21744,43487
25454,,zmdtanngcrij,21744,21745,43489
25455,,08sra6s9ebij,21745,21746,43491
25456,,vozsiqm4epgj,21746,21747,43493
25457,,s3fh95qug04j,21747,21748,43495
25458,,1orhyg4bb-cj,21748,21749,43497
25459,,6eskltrdqluj,21749,21750,43499
25460,,wquhx-k0py8j,21750,21751,43501
25461,,wwv4x_r0qqyj,21751,21752,43503
25462,,gjhkk8p6ebej,21752,21753,43505
25463,,anehcwokn7uj,21753,21754,43507
25464,,url:http://doi.wiley.com/10.1002/he.10712,21754,21755,43509
25465,,n_1yar9hoouj,21755,21756,43511
25466,,bcnnecbdpwej,21756,21757,43513
25467,,p-ovcew61qij,21757,21758,43515
25468,,avhwognitaqj,21758,21759,43517
25469,,zgmnl5qpgcqj,21759,21760,43519
25470,,ro-puqf-rrwj,21760,21761,43521
25471,,czpkb1lmktsj,21761,21762,43523
25472,,lz7vtiydciej,21762,21763,43525
25473,,yexmwageasgj,21763,21764,43527
25474,,x5zok6j9t0yj,21764,21765,43529
25475,,pwsob4q-zwmj,21765,21766,43531
25476,,mr7kb6ko0nuj,21766,21767,43533
25477,,cwjcsfsn6ucj,21767,21768,43535
25478,,szukjp-cevmj,21768,21769,43537
25479,,ebjmvvo8zp0j,21769,21770,43539
25480,,url:http://doi.wiley.com/10.1002/ev.1653,21770,21771,43541
25481,,a4zzzklg6ukj,21771,21772,43543
25482,,kmhi1ipuu-sj,21772,21773,43545
25483,,sr9qrffyi3ej,21773,21774,43547
25484,,o7-efy1bahwj,21774,21775,43549
25485,,nh0sz24nkf8j,21775,21776,43551
25486,,fdiu6std8e0j,21776,21777,43553
25487,,a9sxs7tubnyj,21777,21778,43555
25488,,gda5nfnhxrmj,21778,21779,43557
25489,,vlateeadj3mj,21779,21780,43559
25490,,nbkr20lrk_8j,21780,21781,43561
25491,,pz9ydky-j8yj,21781,21782,43563
25492,,hwj64hw0j1aj,21782,21783,43565
25493,,1htlw7fpogoj,21783,21784,43567
25494,,owjdmjsyrfij,21784,21785,43569
25495,,0lrr6ntypa4j,21785,21786,43571
25496,,qmwuq9gienwj,21786,21787,43573
25497,,8xr4khggxnoj,21787,21788,43575
25498,,yijjmxjpmvmj,21788,21789,43577
25499,,bdgggly6oeuj,21789,21790,43579
25500,,0p61kakod_8j,21790,21791,43581
25501,,5uvm17ir12yj,21791,21792,43583
25502,,gafidodrtqmj,21792,21793,43585
25503,,9tpouwe0kbyj,21793,21794,43587
25504,,mkuxh9uowzoj,21794,21795,43589
25505,,url:http://www.csa.com/partners/viewrecord.php3frequester3dgs26collection3dtrd26recid3dn9210470ah,21795,21796,43591
25506,,emte57ktmo8j,21796,21797,43593
25507,,lwtck7huohoj,21797,21798,43595
25508,,u5xkdtclqz0j,21799,21800,43599
25509,,himycplf5ryj,21800,21801,43601
25510,,url:http://www.springerlink.com/index/q4g405n136278g44.pdf,21801,21802,43603
25511,,n7ia4fytrxkj,21802,21803,43605
25512,,henu_o4so6sj,21803,21804,43607
25513,,tkn9y9z6jbwj,21804,21805,43609
25514,,ris5qd1-oduj,21805,21806,43611
25515,,url:http://portal.acm.org/ft_gateway.cfm3fid3d106627626type3dpdf,21806,21807,43613
25516,,guli0f071mcj,21807,21808,43615
25517,,nm-01ozdls8j,21808,21809,43617
25518,,8lqx5d4sxywj,21809,21810,43619
25519,,xlpsy_rhrssj,21810,21811,43621
25520,,21otaerofxuj,21811,21812,43623
25521,,rqhlx1xfrpij,21813,21814,43627
25522,,dmua8fabijaj,21814,21815,43629
25523,,w6yvzw2koooj,21815,21816,43631
25524,,vmmkfzianloj,21816,21817,43633
25525,,kqfgrlpgacaj,21817,21818,43635
25526,,_eqikhlguaej,21818,21819,43637
25527,,raxzk0k3yxqj,21819,21820,43639
25528,,b1ly53x96a4j,21820,21821,43641
25529,,url:http://www.springerlink.com/index/w113644365177430.pdf,21821,21822,43643
25530,,5uasjehk-yij,21822,21823,43645
25531,,5cx1jfk0v74j,21823,21824,43647
25532,,8bnjnjvymsej,21825,21826,43651
25533,,qy3cfmzjlzkj,21826,21827,43653
25534,,qwphh6g8v3yj,21827,21828,43655
25535,,8syuxjxg4fej,21828,21829,43657
25536,,r_daxpu3fygj,21829,21830,43659
25537,,url:http://portal.acm.org/citation.cfm3fid3d144111.144160,21830,21831,43661
25538,,msymzyngn5cj,21831,21832,43663
25539,,ywhjmxggobuj,21832,21833,43665
25540,,0svvs_qk3_mj,21834,21835,43669
25541,,dfgnbob2p5sj,21835,21836,43671
25542,,url:http://portal.acm.org/ft_gateway.cfm3fid3d109965626type3dpdf,21836,21837,43673
25543,,url:http://portal.acm.org/citation.cfm3fid3d1099554.1099617,21837,21838,43675
25544,,dezhpwsxffqj,21838,21839,43677
25545,,qtspehrwogoj,21839,21840,43679
25546,,oraqday00lsj,21840,21841,43681
25547,,dazsey6rbzej,21841,21842,43683
25548,,mcvf2tvgxqqj,21842,21843,43685
25549,,idfw9rt1eowj,21843,21844,43687
25550,,od89yoqqqk4j,21845,21846,43691
25551,,9wsftvqigi0j,21846,21847,43693
25552,,ledsar8kjusj,21847,21848,43695
25553,,nqnian4vtpyj,21848,21849,43697
25554,,is85rs4offyj,21849,21850,43699
25555,,vyg3dtmwr-wj,21850,21851,43701
25556,,xvaidzbtvzmj,21851,21852,43703
25557,,deyvyujxkgej,21852,21853,43705
25558,,svpdi1xouccj,21853,21854,43707
25559,,cka7v7qfhyoj,21854,21855,43709
25560,,mfetfjhgo6wj,21855,21856,43711
25561,,d_ys_ccywt8j,21856,21857,43713
25562,,jw67w_kjwpoj,21857,21858,43715
25563,,0z4dcz1wei8j,21858,21859,43717
25564,,vnv6uvk79k0j,21859,21860,43719
25565,,ab4vj7h-qxyj,21860,21861,43721
25566,,,21861,21862,43723
25567,,skzahzedadkj,21862,21863,43725
25568,,k2_x-mq6hpmj,21863,21864,43727
25569,,ss4tj3_l3vyj,21864,21865,43729
25570,,kquzhahpgiuj,21865,21866,43731
25571,,fockljx6ysej,21866,21867,43733
25572,,m3hpmc_4p04j,21867,21868,43735
25573,,qvnzjjamvhuj,21868,21869,43737
25574,,4srcugbfrigj,21869,21870,43739
25575,,70l5tocvkr4j,21870,21871,43741
25576,,zbeiji9zcmuj,21871,21872,43743
25577,,fgjh6yevku4j,21872,21873,43745
25578,,url:http://www.csa.com/partners/viewrecord.php3frequester3dgs26collection3dtrd26recid3d20021211001542mt26recid3da8622964ah,21873,21874,43747
25579,,g8xgqk7s6i4j,21874,21875,43749
25580,,fyay6fhjvxuj,21875,21876,43751
25581,,1vl9jgg_ld0j,21876,21877,43753
25582,,url:http://www.springerlink.com/index/m131v2216478525n.pdf,21877,21878,43755
25583,,url:http://portal.acm.org/ft_gateway.cfm3fid3d110119326type3dpdf,21878,21879,43757
25584,,jxuaytwtq0sj,21879,21880,43759
25585,,odmqvizatgkj,21880,21881,43761
25586,,ezby7ltgu5gj,21881,21882,43763
25587,,qfj2am4bm14j,21882,21883,43765
25588,,kvdom-wpsycj,21883,21884,43767
25589,,3qp8jbtfeisj,21885,21886,43771
25590,,doxbpyoxb54j,21886,21887,43773
25591,,hpyyrjgrtkcj,21887,21888,43775
25592,,ofuquy0efagj,21888,21889,43777
25593,,mtrvikgrtz8j,21889,21890,43779
25594,,imuf7quh7mkj,21890,21891,43781
25595,,ok2pdtfyntaj,21891,21892,43783
25596,,2fcle4vix5mj,21892,21893,43785
25597,,nmxykswop9oj,21893,21894,43787
25598,,auzwheczzucj,21894,21895,43789
25599,,uot6qvouojmj,21895,21896,43791
25600,,obeeoxtmywsj,21896,21897,43793
25601,,,21897,21898,43795
25602,,i48rcw6gomaj,21898,21899,43797
25603,,efisoneozbyj,21899,21900,43799
25604,,e688acygftej,21900,21901,43801
25605,,zmllorv-swqj,21901,21902,43803
25606,,6yqccsyof7mj,21902,21903,43805
25607,,url:http://portal.acm.org/ft_gateway.cfm3fid3d106617926type3dpdf,21903,21904,43807
25608,,aykp-mvgsbkj,21905,21906,43811
25609,,url:http://portal.acm.org/ft_gateway.cfm3fid3d14183126type3dpdf26coll3dguide26dl3dacm26cfid3d1111111126cftoken3d2222222,21906,21907,43813
25610,,27iwqly44sgj,21907,21908,43815
25611,,vax-nwwc6fyj,21908,21909,43817
25612,,rurzgdmm-cyj,21909,21910,43819
25613,,gwvn1w9_zzoj,21911,21912,43823
25614,,qcgt1vjkfosj,21912,21913,43825
25615,,akdyvybh7o4j,21913,21914,43827
25616,,mbzwp7cdj30j,21914,21915,43829
25617,,9noq0j_vv1ij,21915,21916,43831
25618,,72qd_nn2vqmj,21916,21917,43833
25619,,m-eta-rskhgj,21917,21918,43835
25620,,nf_jwejz6_uj,21918,21919,43837
25621,,eftpn6dl-cgj,21919,21920,43839
25622,,hzwfso5rc9mj,21920,21921,43841
25623,,j34n3v8ep6oj,21921,21922,43843
25624,,url:http://pubs.acs.org/cgi-bin/abstract.cgi/achre4/2005/38/i08/abs/ar030267d.html,21922,21923,43845
25625,,wy2ygwdeosyj,21923,21924,43847
25626,,tuxkwtlgxrkj,21924,21925,43849
25627,,acsmlin3nmyj,21925,21926,43851
25628,,ppics6ap5_wj,21926,21927,43853
25629,,xv7oslaeri0j,21927,21928,43855
25630,,5rodwikjim4j,21928,21929,43857
25631,,mmamqgcfcwaj,21929,21930,43859
25632,,_2oz5poi5asj,21930,21931,43861
25633,,dompxseartmj,21931,21932,43863
25634,,fqutkv8t08ij,21932,21933,43865
25635,,ueuufjdwincj,21933,21934,43867
25636,,uygjfn9al5mj,21934,21935,43869
25637,,nw7le4xrj9ej,21935,21936,43871
25638,,7mvxkdmkpasj,21936,21937,43873
25639,,9u0lkc8qs2kj,21937,21938,43875
25640,,ib-tdng6z1uj,21938,21939,43877
25641,,rzxz2p6w8goj,21939,21940,43879
25642,,dpemwvwxs3ej,21940,21941,43881
25643,,kmifsjvmlxwj,21941,21942,43883
25644,,url:http://www.ncbi.nlm.nih.gov/entrez/query.fcgi3fcmd3dretrieve26db3dpubmed26list_uids3d1154463826dopt3dcitation,21942,21943,43885
25645,,fsilo9tj7q4j,21943,21944,43887
25646,,bt_fs1zps4oj,21944,21945,43889
25647,,jqeogqkq0bsj,21945,21946,43891
25648,,tat5ofknkq0j,21946,21947,43893
25649,,aiz7juadmhoj,21947,21948,43895
25650,,hakco8w_hkyj,21948,21949,43897
25651,,f1mzqvfh98yj,21949,21950,43899
25652,,jppy3gon9ssj,21950,21951,43901
25653,,hjhkgsgbgrmj,21951,21952,43903
25654,,82dr_egwlkmj,21952,21953,43905
25655,,url:http://www.geography.org.uk/journals/journals.asp3farticleid3d66,21953,21954,43907
25656,,srmnzot2na8j,21954,21955,43909
25657,,rmp7dzgi0oij,21955,21956,43911
25658,,h_w-gipkmvmj,21956,21957,43913
25659,,ku9gmt_ea08j,21957,21958,43915
25660,,18-qkdzw8nuj,21958,21959,43917
25661,,url:http://doi.wiley.com/10.1002/ev.1547,21959,21960,43919
25662,,n7lcx2hmnogj,21960,21961,43921
25663,,s9prikmc0p4j,21961,21962,43923
25664,,iuwzxggq-koj,21962,21963,43925
25665,,qi6f7rv_sloj,21963,21964,43927
25666,,xmfzygya198j,21964,21965,43929
25667,,kwkeuhtsbbyj,21965,21966,43931
25668,,xxkutjfgpvaj,21966,21967,43933
25669,,l0q3y936ng8j,21967,21968,43935
25670,,a40t6xb2vtkj,21968,21969,43937
25671,,9gzod7bx5e0j,21969,21970,43939
25672,,0kvc2kz3xw0j,21970,21971,43941
25673,,g0aek768_egj,21971,21972,43943
25674,,o1ykdplkbw4j,21972,21973,43945
25675,,r3chbc1e5dej,21973,21974,43947
25676,,xsygwhbgx2gj,21974,21975,43949
25677,,url:http://www.csa.com/partners/viewrecord.php3frequester3dgs26collection3dtrd26recid3da8622937ah,21975,21976,43951
25678,,btj4dsrrwukj,21976,21977,43953
25679,,qudzeiq1zo8j,21977,21978,43955
25680,,lbz5zxw6zt8j,21978,21979,43957
25681,,b1iamjgxbxsj,21979,21980,43959
25682,,wcl7xd7vew8j,21980,21981,43961
25683,,u_elysjyyqmj,21981,21982,43963
25684,,o_l36wcwty0j,21982,21983,43965
25685,,q08wobl1mw0j,21983,21984,43967
25686,,tb8cpz76xwqj,21984,21985,43969
25687,,tq_t8atahlcj,21985,21986,43971
25688,,ipjg_bpypugj,21986,21987,43973
25689,,sguc7r0gr6qj,21987,21988,43975
25690,,lwbb467lzwej,21988,21989,43977
25691,,2hifb-m8b-gj,21989,21990,43979
25692,,ua2kcxafkf0j,21990,21991,43981
25693,,6crux7gdfcoj,21991,21992,43983
25694,,zqhdseu-nsyj,21992,21993,43985
25695,,ch8srejzp7ej,21993,21994,43987
25696,,bwyvmxpjkmyj,21994,21995,43989
25697,,hdys1rktoxsj,21996,21997,43993
25698,,url:http://doi.wiley.com/10.1002/tl.5,21997,21998,43995
25699,,lz-ni5i1qckj,21998,21999,43997
25700,,tn4-krzly0aj,21999,22000,43999
25701,,earvvne74qoj,22000,22001,44001
25702,,s_jdykfxtw0j,22001,22002,44003
25703,,wdegzefcefgj,22002,22003,44005
25704,,xaxnlaye-2oj,22003,22004,44007
25705,,jsgonjqxtzaj,22004,22005,44009
25706,,aa9t5-2fnm4j,22005,22006,44011
25707,,5lamatvo-fgj,22006,22007,44013
25708,,yetqyoca1-oj,22007,22008,44015
25709,,yvdt1ekyr6kj,22008,22009,44017
25710,,iod4i1iynzsj,22009,22010,44019
25711,,kwrile_1nbwj,22010,22011,44021
25712,,zgsm4fsmncgj,22011,22012,44023
25713,,c1c3uivotvcj,22012,22013,44025
25714,,cokayvwbn4wj,22013,22014,44027
25715,,r0j4cz8qwgqj,22014,22015,44029
25716,,ha6br08pt1kj,22015,22016,44031
25717,,4xsbvsx9skuj,22016,22017,44033
25718,,url:http://doi.ieeecomputersociety.org/10.1109/icccn.1997.623310,22017,22018,44035
25719,,xadxam3s3skj,22018,22019,44037
25720,,wgn2zb18bokj,22019,22020,44039
25721,,mz4s2doz5q4j,22020,22021,44041
25722,,dm5knfnmboyj,22021,22022,44043
25723,,efe1n5eoqz0j,22022,22023,44045
25724,,qpag2poxgwoj,22023,22024,44047
25725,,v2waprex47ij,22024,22025,44049
25726,,7fixg5kub4uj,22025,22026,44051
25727,,hy_wm_wwv8yj,22026,22027,44053
25728,,0hmnfclqclyj,22027,22028,44055
25729,,bzvmk1rijkcj,22028,22029,44057
25730,,7yzkm3ictlkj,22030,22031,44061
25731,,lu3oh7iqh9ij,22031,22032,44063
25732,,tu7ypq_b0k4j,22032,22033,44065
25733,,lpelmeiok8mj,22033,22034,44067
25734,,zz51zqcomtqj,22034,22035,44069
25735,,wgl_ohp4f_qj,22035,22036,44071
25736,,o0aljpgycpuj,22036,22037,44073
25737,,a5hfxth441wj,22037,22038,44075
25738,,n5zelw5ekjuj,22038,22039,44077
25739,,toizmqh_zhwj,22039,22040,44079
25740,,_cwpevbmlaej,22040,22041,44081
25741,,v7drwssakcij,22041,22042,44083
25742,,v6x1tba4vysj,22042,22043,44085
25743,,w-3pguau5wkj,22043,22044,44087
25744,,uhbmr2pjr-cj,22044,22045,44089
25745,,zpoa4km6dggj,22045,22046,44091
25746,,5ine3rrouccj,22046,22047,44093
25747,,n1wtktnu6uej,22047,22048,44095
25748,,url:http://portal.acm.org/ft_gateway.cfm3fid3d104141926type3dpdf,22048,22049,44097
25749,,4gqwo38mlduj,22050,22051,44101
25750,,bcsh3jamh0mj,22051,22052,44103
25751,,ij8lh1u0bgqj,22052,22053,44105
25752,,cbm2zcdkttcj,22053,22054,44107
25753,,biu7no3efb0j,22054,22055,44109
25754,,em5uaehdneij,22055,22056,44111
25755,,_otvh5wqeesj,22056,22057,44113
25756,,vsfty0nhngcj,22057,22058,44115
25757,,i9q6zxym7qwj,22058,22059,44117
25758,,gq-lxeexcnuj,22059,22060,44119
25759,,url:http://doi.wiley.com/10.1002/he.92,22060,22061,44121
25760,,hr9ezaxjqwoj,22061,22062,44123
25761,,tcfvl7kvt6qj,22062,22063,44125
25762,,yhoinnnrhw0j,22063,22064,44127
25763,,47belnt5fycj,22064,22065,44129
25764,,tghcfsruf-qj,22065,22066,44131
25765,,5wg_onaknxwj,22066,22067,44133
25766,,1sc1hb4qsimj,22067,22068,44135
25767,,yakzy3hcpxqj,22068,22069,44137
25768,,eqmjuarpnbej,22069,22070,44139
25769,,p7gjcbzrqa0j,22070,22071,44141
25770,,a5eiwdh71m0j,22071,22072,44143
25771,,,22072,22073,44145
25772,,t8gemxydfuyj,22073,22074,44147
25773,,abo8t1kw7qsj,22074,22075,44149
25774,,uly0m0ocg3yj,22075,22076,44151
25775,,c9hrssqxxkoj,22076,22077,44153
25776,,url:http://www.springerlink.com/index/t8xl4524k161301l.pdf,22077,22078,44155
25777,,ab43h27n6b4j,22079,22080,44159
25778,,yaiktgwhkasj,22080,22081,44161
25779,,r6n3kw5rkt8j,22081,22082,44163
25780,,pkgaba7_uiaj,22082,22083,44165
25781,,krvrbv0hrtwj,22083,22084,44167
25782,,j8g9etdlyjyj,22084,22085,44169
25783,,zzoklsl_j-oj,22085,22086,44171
25784,,psa3kwobdbaj,22086,22087,44173
25785,,xozalnx6k84j,22087,22088,44175
25786,,s622aksldtcj,22088,22089,44177
25787,,fr_bcrgokmuj,22089,22090,44179
25788,,qsznq-r3qsmj,22090,22091,44181
25789,,4qh5icz3dj8j,22091,22092,44183
25790,,ts5kyoz9rfcj,22092,22093,44185
25791,,snm7lnljvzcj,22093,22094,44187
25792,,vpstf5exujwj,22094,22095,44189
25793,,dstk7_h6uxaj,22095,22096,44191
25794,,gvqa1g-ylr4j,22096,22097,44193
25795,,prtq2v6njdyj,22097,22098,44195
25796,,rtlilujncy0j,22098,22099,44197
25797,,3mlkqfhvh3cj,22099,22100,44199
25798,,flxxizpbpnqj,22100,22101,44201
25799,,fdb2fhvpxwuj,22101,22102,44203
25800,,url:http://links.jstor.org/sici3fsici3d0146-4949(196721)8253a2253c250253ands253e2.0.co253b2-m,22103,22104,44207
25801,,ijvpv6gojmqj,22104,22105,44209
25802,,usezf1hjjdmj,22105,22106,44211
25803,,0fhuapi4b-ej,22106,22107,44213
25804,,c-pkkldyl60j,22107,22108,44215
25805,,tsntgmlojduj,22108,22109,44217
25806,,_dlzleeoxwmj,22109,22110,44219
25807,,mbta4-d__90j,22110,22111,44221
25808,,cvzgn_zu53aj,22111,22112,44223
25809,,adyxncsqxp8j,22112,22113,44225
25810,,pyxikwzhtg8j,22113,22114,44227
25811,,pozpf_3ii-aj,22114,22115,44229
25812,,momp8rcsdhgj,22115,22116,44231
25813,,ni2go-au-i0j,22116,22117,44233
25814,,kose6uvijd8j,22117,22118,44235
25815,,iaa-xlt2sm4j,22119,22120,44239
25816,,a9t0gufm3yuj,22120,22121,44241
25817,,znlvfbwsgzcj,22121,22122,44243
25818,,ltlapa1nglaj,22122,22123,44245
25819,,2yi5qk6az8yj,22123,22124,44247
25820,,url:http://portal.acm.org/citation.cfm3fid3d235968,22124,22125,44249
25821,,xtmau7if2ooj,22125,22126,44251
25822,,url:http://www.csa.com/partners/viewrecord.php3frequester3dgs26collection3dtrd26recid3d200111000453mt26recid3da0032587ah,22126,22127,44253
25823,,url:http://pubs.acs.org/cgi-bin/abstract.cgi/achre4/2005/38/i09/abs/ar040282y.html,22127,22128,44255
25824,,p3blitlcatgj,22128,22129,44257
25825,,2eliri6apjcj,22129,22130,44259
25826,,ui0epsyakuej,22130,22131,44261
25827,,j31dfyabvvoj,22131,22132,44263
25828,,9lyyz5viiayj,22132,22133,44265
25829,,gdtx-qhwf8uj,22133,22134,44267
25830,,yvftvbnuccmj,22134,22135,44269
25831,,v1f9onpmgoqj,22135,22136,44271
25832,,ri-ur9k29fqj,22136,22137,44273
25833,,go8xlbfl7fij,22137,22138,44275
25834,,4ath2lsxj4ej,22138,22139,44277
25835,,hm6ztabm4_oj,22139,22140,44279
25836,,rsmajthdchkj,22140,22141,44281
25837,,lxk2w4mvrngj,22141,22142,44283
25838,,k5fkvzik8vij,22142,22143,44285
25839,,url:http://portal.acm.org/citation.cfm3fid3d304182.304226,22143,22144,44287
25840,,enzcqjjztmqj,22144,22145,44289
25841,,nl2xekgaaaqj,22145,22146,44291
25842,,zsrcdmhyvj0j,22146,22147,44293
25843,,bge49l3gl5sj,22147,22148,44295
25844,,o-sjln0qyqqj,22148,22149,44297
25845,,vjiw_3-pf1aj,22149,22150,44299
25846,,pew5c62jjc0j,22150,22151,44301
25847,,epjyubxrihuj,22151,22152,44303
25848,,qvppvsdbdxuj,22152,22153,44305
25849,,2py9kkdeviqj,22153,22154,44307
25850,,1had2er4esyj,22155,22156,44311
25851,,vreeuauud-0j,22156,22157,44313
25852,,djdpdtxcshoj,22157,22158,44315
25853,,anb3n40lkuaj,22159,22160,44319
25854,,2atilbczm7qj,22160,22161,44321
25855,,nmzdk1c6zquj,22161,22162,44323
25856,,mrfejje2pzoj,22162,22163,44325
25857,,lngtal1y17qj,22163,22164,44327
25858,,6hbsdfb9tikj,22164,22165,44329
25859,,sxeyln84locj,22165,22166,44331
25860,,sesks3je3auj,22166,22167,44333
25861,,kgf1fx5xehij,22167,22168,44335
25862,,kv7jy1zh9aqj,22169,22170,44339
25863,,gm-yoxzh5rij,22170,22171,44341
25864,,wi6vef7tae0j,22171,22172,44343
25865,,8tkak8aaefmj,22172,22173,44345
25866,,ehorox23mvej,22173,22174,44347
25867,,nlrge3iyl5ej,22174,22175,44349
25868,,mjdpjqy22wwj,22175,22176,44351
25869,,dmozhctid-qj,22176,22177,44353
25870,,5emncbhlv0ej,22177,22178,44355
25871,,dbevc4rma8cj,22178,22179,44357
25872,,bfnhgemmglwj,22179,22180,44359
25873,,pbcnjp-oiaej,22180,22181,44361
25874,,ixhsgunh9bgj,22181,22182,44363
25875,,yl69sxnm1rcj,22182,22183,44365
25876,,c01q9ddolocj,22183,22184,44367
25877,,dn8av8rhu4mj,22184,22185,44369
25878,,nqa0niqwfn0j,22185,22186,44371
25879,,ikdfczyu2g8j,22186,22187,44373
25880,,rng1avkvpiej,22187,22188,44375
25881,,asxp3uvf7hkj,22188,22189,44377
25882,,ftm3bgcfmvaj,22189,22190,44379
25883,,s_6vvnyb-gcj,22190,22191,44381
25884,,u2pinyijmjuj,22191,22192,44383
25885,,koe9ct5hg1ej,22192,22193,44385
25886,,brv4bj6rjywj,22193,22194,44387
25887,,url:http://www.csa.com/partners/viewrecord.php3frequester3dgs26collection3dtrd26recid3dn9210547ah,22194,22195,44389
25888,,yq8wdkwj3uyj,22195,22196,44391
25889,,url:http://www.csa.com/partners/viewrecord.php3frequester3dgs26collection3dtrd26recid3dn9210371ah,22196,22197,44393
25890,,4xbgo4kaveyj,22197,22198,44395
25891,,oiosjfjhvnij,22198,22199,44397
25892,,1kbdhzri_wij,22199,22200,44399
25893,,vvzdpeajgcqj,22200,22201,44401
25894,,i5yowolmbjij,22201,22202,44403
25895,,9fgw5t1t3lcj,22202,22203,44405
25896,,uuu6hq8nkiyj,22203,22204,44407
25897,,lpbkfx3azmmj,22204,22205,44409
25898,,nb2m5mx1tpcj,22205,22206,44411
25899,,bxfsnpcr8raj,22206,22207,44413
25900,,evifeeuzwrqj,22207,22208,44415
25901,,lkzbpuh95-gj,22208,22209,44417
25902,,t_zhivttsu8j,22209,22210,44419
25903,,y932kqrnb5qj,22210,22211,44421
25904,,1-d8kdevrhej,22211,22212,44423
25905,,qc4dd48qwb4j,22212,22213,44425
25906,,d5wmrjznywkj,22213,22214,44427
25907,,-c8i40y18ugj,22214,22215,44429
25908,,abrjm_pwx1cj,22215,22216,44431
25909,,bww-89vc9uqj,22216,22217,44433
25910,,j-qtjcib7igj,22217,22218,44435
25911,,dd0k6bwtgr4j,22218,22219,44437
25912,,c3yyudigbvuj,22219,22220,44439
25913,,1elu3ox3nzgj,22220,22221,44441
25914,,py-os0y0_fej,22221,22222,44443
25915,,cnoxm406jykj,22222,22223,44445
25916,,76wltb7xme8j,22223,22224,44447
25917,,rzvhd3hf170j,22224,22225,44449
25918,,uxyb1iwqg8ij,22225,22226,44451
25919,,rwhtqjpbmq4j,22226,22227,44453
25920,,73svgt1gbkkj,22227,22228,44455
25921,,snuze5m4mxkj,22228,22229,44457
25922,,8ub3e7l0wdsj,22229,22230,44459
25923,,gdchsv__qqij,22230,22231,44461
25924,,wgyclhjk41ij,22231,22232,44463
25925,,c2vea-wmit0j,22232,22233,44465
25926,,88xdsnfhdvaj,22233,22234,44467
25927,,pxjqplyxok8j,22234,22235,44469
25928,,gtq_o8vrps0j,22235,22236,44471
25929,,gim89axue4oj,22236,22237,44473
25930,,ztjoqeilx-cj,22237,22238,44475
25931,,wm1eh4_kul8j,22238,22239,44477
25932,,zppo-b0zj3uj,22239,22240,44479
25933,,url:http://doi.wiley.com/10.1002/ace.7607,22240,22241,44481
25934,,qhrusotn5qmj,22241,22242,44483
25935,,sqb2jzsc3pwj,22242,22243,44485
25936,,isqvnbshsqaj,22243,22244,44487
25937,,inebiz2ajqkj,22244,22245,44489
25938,,e1qxqantlvqj,22245,22246,44491
25939,,h5i3q36j7bkj,22246,22247,44493
25940,,mtfmsa-l3ewj,22247,22248,44495
25941,,udzr1j-fcduj,22248,22249,44497
25942,,kt28fccgl-ij,22249,22250,44499
25943,,t8sebod06tsj,22250,22251,44501
25944,,ye07vhpcldgj,22251,22252,44503
25945,,8szhc0to-t0j,22252,22253,44505
25946,,url:http://adsabs.harvard.edu/abs/1979aero.reptr....z,22253,22254,44507
25947,,qm0i2n8iu2qj,22254,22255,44509
25948,,1a3bd9f0-mgj,22255,22256,44511
25949,,njn8ldfyjkuj,22256,22257,44513
25950,,dbscwwbtbh8j,22257,22258,44515
25951,,0rv9zktlz9cj,22258,22259,44517
25952,,btytn8vg5hij,22259,22260,44519
25953,,7fw8csrgqnuj,22260,22261,44521
25954,,url:http://pubs.acs.org/cgi-bin/abstract.cgi/achre4/2005/38/i07/abs/ar040146t.html,22261,22262,44523
25955,,mzszkgrf3huj,22262,22263,44525
25956,,gdmbzrubyzaj,22263,22264,44527
25957,,url:http://doi.wiley.com/10.1002/he.11109,22264,22265,44529
25958,,cgrzq776gb4j,22265,22266,44531
25959,,ec9lprycklij,22266,22267,44533
25960,,i1t27i2bfmyj,22268,22269,44537
25961,,mpmtqv2v-y0j,22269,22270,44539
25962,,ijrdwduhuagj,22270,22271,44541
25963,,yaod353y_40j,22271,22272,44543
25964,,uqpiape3h2yj,22272,22273,44545
25965,,s7f9pcxdt9mj,22273,22274,44547
25966,,wnbvhxrw3iij,22274,22275,44549
25967,,fovwk2terkaj,22275,22276,44551
25968,,4_1tr_orv6kj,22276,22277,44553
25969,,sbwxy-n-9agj,22277,22278,44555
25970,,eo6vtdppvzqj,22278,22279,44557
25971,,sz_91yxvxr8j,22279,22280,44559
25972,,myd0dn2jhdcj,22280,22281,44561
25973,,url:http://pubs.acs.org/cgi-bin/abstract.cgi/achre4/2003/36/i01/abs/ar020137p.html,22281,22282,44563
25974,,t-f97fdnqsij,22282,22283,44565
25975,,a8s5-xrkjdij,22283,22284,44567
25976,,url:http://links.jstor.org/sici3fsici3d0146-4949(196723)8253a4253c517253amaa2522ml253e2.0.co253b2-t,22284,22285,44569
25977,,xk0x_fpotlgj,22285,22286,44571
25978,,kib-v4cnrpuj,22286,22287,44573
25979,,url:http://portal.acm.org/ft_gateway.cfm3fid3d77700226type3dpdf26dl3dguide26dl3dacm26cfid3d1111111126cftoken3d2222222,22287,22288,44575
25980,,-3_9luqdgduj,22288,22289,44577
25981,,vytg-beyam8j,22289,22290,44579
25982,,azmtodygknyj,22290,22291,44581
25983,,numnw9fkfnej,22291,22292,44583
25984,,1y6utu2euw8j,22292,22293,44585
25985,,nvmjhyuwx0mj,22293,22294,44587
25986,,6pftuup-nrkj,22294,22295,44589
25987,,te7xptnf7byj,22295,22296,44591
25988,,ni65gsopns4j,22296,22297,44593
25989,,wsbhsnj8tjoj,22297,22298,44595
25990,,bf5t0hcmdzyj,22298,22299,44597
25991,,oij1cmnx9icj,22299,22300,44599
25992,,uakffmsbzisj,22300,22301,44601
25993,,y9f6zrgkdyij,22301,22302,44603
25994,,uthi8a4oky4j,22302,22303,44605
25995,,jz0hxwqml5qj,22303,22304,44607
25996,,a-mewwawvd0j,22304,22305,44609
25997,,jgifzzcjd2qj,22305,22306,44611
25998,,eoknlebrlngj,22306,22307,44613
25999,,woezwdoeijwj,22307,22308,44615
26000,,url:http://www.csa.com/partners/viewrecord.php3frequester3dgs26collection3dtrd26recid3d155967ws26recid3d199301630028md,22308,22309,44617
26001,,zp_5lvboaboj,22309,22310,44619
26002,,o6es12pvaxqj,22310,22311,44621
26003,,38foa_brlwwj,22311,22312,44623
26004,,zigmqgx6k2sj,22312,22313,44625
26005,,url:http://www.springerlink.com/index/1g697mxtu3m9mpl4.pdf,22313,22314,44627
26006,,uqzjegjoawkj,22314,22315,44629
26007,,dxrpgqig8p8j,22315,22316,44631
26008,,4glv1vajn2ij,22316,22317,44633
26009,,v6pe-85uziuj,22317,22318,44635
26010,,i1dfvbqhdo4j,22318,22319,44637
26011,,yxtrfrgmbroj,22319,22320,44639
26012,,yutq8kxnntyj,22320,22321,44641
26013,,efa1kuxirowj,22321,22322,44643
26014,,,22322,22323,44645
26015,,c_iklegg4hej,22323,22324,44647
26016,,rbcikaq4kbcj,22324,22325,44649
26017,,mv03369nbuyj,22325,22326,44651
26018,,kz20knx0y5oj,22326,22327,44653
26019,,ilsfos_gq24j,22327,22328,44655
26020,,8t7yfqgtx1kj,22328,22329,44657
26021,,fepm4_3ih_4j,22329,22330,44659
26022,,thfceepskyoj,22330,22331,44661
26023,,igp0amosthej,22331,22332,44663
26024,,bxtcthzk-i8j,22332,22333,44665
26025,,s7aw05_grxmj,22333,22334,44667
26026,,url:http://ieeexplore.ieee.org/xpl/abs_free.jsp3farnumber3d1320012,22334,22335,44669
26027,,_bsvmiuer44j,22335,22336,44671
26028,,b8mu0ggw-fcj,22336,22337,44673
26029,,e5zga9mlxd0j,22337,22338,44675
26030,,url:http://doi.wiley.com/10.1002/he.11209,22338,22339,44677
26031,,aoltq1hrzn8j,22339,22340,44679
26032,,55orlawcq4kj,22340,22341,44681
26033,,o11wyiugkouj,22341,22342,44683
26034,,url:http://portal.acm.org/citation.cfm3fid3d974750.97475126dl3dguide26dl3dacm26idx3d97475026part3dperiodical26wanttype3dperiodical26title3dacm2520transactions2520on2520database2520systems2520(tods)26cfid3d1111111126cftoken3d2222222,22343,22344,44687
26035,,url:http://links.jstor.org/sici3fsici3d0146-4949(196522)6253a2253c250253ac1253e2.0.co253b2-f,22344,22345,44689
26036,,bczm2pgcktuj,22345,22346,44691
26037,,mvkydqgrgmqj,22346,22347,44693
26038,,vxm5jgzvozij,22347,22348,44695
26039,,iwpptr6am24j,22348,22349,44697
26040,,eefktvquzkyj,22349,22350,44699
26041,,url:http://www.csa.com/partners/viewrecord.php3frequester3dgs26collection3dtrd26recid3d200111010706mt26recid3da0032640ah,22350,22351,44701
26042,,tvrjhihkv3cj,22351,22352,44703
26043,,li3pa0wnuy0j,22352,22353,44705
26044,,p672q550rrej,22353,22354,44707
26045,,31m_lpvfuhsj,22354,22355,44709
26046,,xaem62dmjtgj,22355,22356,44711
26047,,byrhy3dxanuj,22356,22357,44713
26048,,bpr-blmb0tyj,22357,22358,44715
26049,,9eazoigjur0j,22358,22359,44717
26050,,vzkidzueqmqj,22359,22360,44719
26051,,ytfjpetomkgj,22360,22361,44721
26052,,fbitbuuq4hyj,22361,22362,44723
26053,,oc7r84a1k5cj,22362,22363,44725
26054,,jnpws_fjyrgj,22363,22364,44727
26055,,4-4kvrs7-y0j,22364,22365,44729
26056,,5r7xt5foh7kj,22365,22366,44731
26057,,wzmfdwgp5sij,22367,22368,44735
26058,,36_z5vhbvsgj,22368,22369,44737
26059,,4a56aug23boj,22369,22370,44739
26060,,url:http://www.csa.com/partners/viewrecord.php3frequester3dgs26collection3dtrd26recid3d0878616ci,22370,22371,44741
26061,,tnpmmhswwo8j,22371,22372,44743
26062,,l8aiptp0bsaj,22372,22373,44745
26063,,c5j4g8pnk8ij,22373,22374,44747
26064,,j97mbkkmepij,22374,22375,44749
26065,,iminvt5soyyj,22375,22376,44751
26066,,ic6j0v-7djwj,22376,22377,44753
26067,,rcuacsobwvgj,22377,22378,44755
26068,,url:http://www.csa.com/partners/viewrecord.php3frequester3dgs26collection3dtrd26recid3d871982co,22378,22379,44757
26069,,o3vt2y9-dzqj,22380,22381,44761
26070,,e0karxiwxgij,22382,22383,44765
26071,,jla8sutj5twj,22383,22384,44767
26072,,bcejf51hxssj,22384,22385,44769
26073,,mywxcncz2cej,22385,22386,44771
26074,,jdhubcepalaj,22386,22387,44773
26075,,f9e8uhbh31yj,22387,22388,44775
26076,,6pejwbxdd5qj,22388,22389,44777
26077,,url:http://portal.acm.org/citation.cfm3fid3d217279.21528126dl3dguide26dl3dacm26type3dseries26idx3dseries31626part3dproceedings26wanttype3dproceedings26title3dinternational2520multimedia2520conference26cfid3d1111111126cftoken3d2222222,22389,22390,44779
26078,,dthfvslne3wj,22390,22391,44781
26079,,8mynmxzcoduj,22391,22392,44783
26080,,tjantugjlryj,22392,22393,44785
26081,,2ooa9h8knwoj,22393,22394,44787
26082,,0gqxaktiikgj,22394,22395,44789
26083,,ckrwn7p-n_cj,22395,22396,44791
26084,,41oztd-gzccj,22396,22397,44793
26085,,3t_mc8_zsewj,22397,22398,44795
26086,,cxc1h4gvacsj,22398,22399,44797
26087,,hxs4vcjofxqj,22399,22400,44799
26088,,yt-cq_4cfe8j,22400,22401,44801
26089,,ton7rwquzp4j,22401,22402,44803
26090,,dp1tjucik2cj,22402,22403,44805
26091,,gqx8_e0imgyj,22403,22404,44807
26092,,_yprczcqk_cj,22404,22405,44809
26093,,u2jmk4vi9wmj,22405,22406,44811
26094,,30gmnatvxkgj,22406,22407,44813
26095,,zmtd3hch8pcj,22407,22408,44815
26096,,gat42giiz5aj,22408,22409,44817
26097,,rh75tsugsm8j,22409,22410,44819
26098,,dsgvzmikwzej,22410,22411,44821
26099,,042txl1qhbyj,22411,22412,44823
26100,,5skhrvbil48j,22412,22413,44825
26101,,2ttur59ijyyj,22413,22414,44827
26102,,bejrmhvyex8j,22414,22415,44829
26103,,waphvuqxwgij,22415,22416,44831
26104,,piskq2tbfisj,22416,22417,44833
26105,,1oonxr7r0ouj,22417,22418,44835
26106,,,22418,22419,44837
26107,,x94zf_oemtoj,22419,22420,44839
26108,,v1df2ttfjpsj,22420,22421,44841
26109,,kdeot8ad5boj,22421,22422,44843
26110,,gk_uwiacahej,22422,22423,44845
26111,,u3c8htshxooj,22423,22424,44847
26112,,t9rwx7-d8qcj,22424,22425,44849
26113,,sjtop-ohphkj,22425,22426,44851
26114,,pn7youlh0emj,22426,22427,44853
26115,,qf4fthcfqo8j,22427,22428,44855
26116,,wz58olxjhbuj,22428,22429,44857
26117,,in85iqk-u4sj,22429,22430,44859
26118,,zp3wegygjroj,22430,22431,44861
26119,,_suxra2iwhwj,22431,22432,44863
26120,,8xaw_4hn370j,22432,22433,44865
26121,,67amkdqtltuj,22433,22434,44867
26122,,fmnofjx1stcj,22434,22435,44869
26123,,az0st73dpzaj,22435,22436,44871
26124,,lek1siqoxcuj,22436,22437,44873
26125,,gq0raihhrlej,22438,22439,44877
26126,,gyjxlhmodfgj,22439,22440,44879
26127,,iiyy7uoxofij,22440,22441,44881
26128,,pqmmqm1am0mj,22441,22442,44883
26129,,oiujbzxnjc4j,22442,22443,44885
26130,,jcqfjkatdcqj,22443,22444,44887
26131,,a08uckpdwowj,22444,22445,44889
26132,,eoxwl-adazaj,22445,22446,44891
26133,,yaazkzcp3soj,22446,22447,44893
26134,,wne0rsdi_hwj,22447,22448,44895
26135,,dr3ep7-iqtmj,22448,22449,44897
26136,,lpjc5eqnv9ij,22449,22450,44899
26137,,lwz7ejzwrz0j,22450,22451,44901
26138,,qv7kyn9x-sqj,22451,22452,44903
26139,,rcftpicwu5oj,22452,22453,44905
26140,,pcnfzffey1wj,22453,22454,44907
26141,,uk3hduf7yaej,22454,22455,44909
26142,,6xpaemk0rwcj,22455,22456,44911
26143,,f-lchybipsuj,22456,22457,44913
26144,,otosnaxwcecj,22457,22458,44915
26145,,yin6yj-ioiwj,22458,22459,44917
26146,,2x8xgdhbimoj,22459,22460,44919
26147,,mj4splm0wxoj,22460,22461,44921
26148,,kjhqthwbxisj,22461,22462,44923
26149,,on_2zeaiog0j,22462,22463,44925
26150,,ukhy6iwce_wj,22463,22464,44927
26151,,,22464,22465,44929
26152,,mosbls4bg9ej,22465,22466,44931
26153,,adrfftdbsvqj,22466,22467,44933
26154,,lb7gkidjebwj,22467,22468,44935
26155,,x_q1hfuspiwj,22468,22469,44937
26156,,ulnqufnw_xkj,22469,22470,44939
26157,,zx4pqlydua8j,22470,22471,44941
26158,,-8mt7jarfd8j,22471,22472,44943
26159,,rtexqdvfokaj,22472,22473,44945
26160,,c_9dz-unv-ej,22473,22474,44947
26161,,4ymcu39uvosj,22474,22475,44949
26162,,i4mhmgkeowkj,22475,22476,44951
26163,,p0bhmcgcem0j,22477,22478,44955
26164,,km0qhvxih38j,22478,22479,44957
26165,,_qtvtjv9wqoj,22479,22480,44959
26166,,url:http://www.springerlink.com/index/j17404w815352lr0.pdf,22480,22481,44961
26167,,ijzaohdqnwqj,22481,22482,44963
26168,,fkuof0r97y8j,22482,22483,44965
26169,,dpkdodwpafej,22483,22484,44967
26170,,wdkrytgr3bgj,22484,22485,44969
26171,,cgk4qdhusjkj,22485,22486,44971
26172,,bduu6x2n1tgj,22486,22487,44973
26173,,qwshiztsrdgj,22487,22488,44975
26174,,qinppsvnyukj,22488,22489,44977
26175,,v-th0lo-dnej,22489,22490,44979
26176,,d1yid3vdgdoj,22490,22491,44981
26177,,url:http://portal.acm.org/ft_gateway.cfm3fid3d56513926type3dpdf26dl3dguide26dl3dacm26cfid3d1111111126cftoken3d2222222,22491,22492,44983
26178,,9qeglzdnvgsj,22492,22493,44985
26179,,cz4ukb6vixij,22494,22495,44989
26180,,-5mcki2sfksj,22495,22496,44991
26181,,o8-x1_4bwmoj,22496,22497,44993
26182,,yx2vbzrhlhwj,22497,22498,44995
26183,,ht7hpomuztgj,22498,22499,44997
26184,,url:http://links.jstor.org/sici3fsici3d0146-4949(196422)5253a2253c85253aati2522wl253e2.0.co253b2-h,22500,22501,45001
26185,,vylzoqkwivgj,22501,22502,45003
26186,,ifsr76th3iyj,22502,22503,45005
26187,,fheyqe1dl7oj,22503,22504,45007
26188,,0orc_hqrbyaj,22504,22505,45009
26189,,qkuyj0r3e7oj,22505,22506,45011
26190,,url:http://links.jstor.org/sici3fsici3d0146-4949(196323)4253a3253c327253a2522aqfaf253e2.0.co253b2-q,22506,22507,45013
26191,,fmkayioea0gj,22507,22508,45015
26192,,cbiivvdc73oj,22508,22509,45017
26193,,aw9nghteph4j,22509,22510,45019
26194,,url:http://adsabs.harvard.edu/abs/1983phdt.........4t,22510,22511,45021
26195,,8xadhevfaogj,22511,22512,45023
26196,,xrai1oaa9xgj,22512,22513,45025
26197,,vozw1swnwzkj,22513,22514,45027
26198,,bli5ewo9aasj,22514,22515,45029
26199,,lfjrzslrx3ij,22515,22516,45031
26200,,sqspnyejx-wj,22516,22517,45033
26201,,pbsfhf8a1aqj,22517,22518,45035
26202,,pu3qsoz7khij,22518,22519,45037
26203,,pctnetaftbij,22520,22521,45041
26204,,3oo0pxcakxuj,22521,22522,45043
26205,,bschrjlk9coj,22522,22523,45045
26206,,a3mbld5z7okj,22523,22524,45047
26207,,ruaax3u9q-ej,22524,22525,45049
26208,,yg8ygmsu-ayj,22525,22526,45051
26209,,fkdxsijeemyj,22526,22527,45053
26210,,rnef09x6qxuj,22527,22528,45055
26211,,4gs63ku1zsej,22528,22529,45057
26212,,uz50sw0j7oaj,22529,22530,45059
26213,,yobmmubkmooj,22530,22531,45061
26214,,mo77xjl45iej,22531,22532,45063
26215,,pk_l9gms8baj,22532,22533,45065
26216,,nh4nf65lmt0j,22533,22534,45067
26217,,t6uc2pptdiyj,22534,22535,45069
26218,,j7sletvsxvyj,22535,22536,45071
26219,,su1zd6hogj0j,22536,22537,45073
26220,,h6urh43myjij,22537,22538,45075
26221,,dk3gaq-wa6uj,22538,22539,45077
26222,,j4sla4klq30j,22539,22540,45079
26223,,url:http://portal.acm.org/citation.cfm3fid3d1068513.1069532,22540,22541,45081
26224,,rcu0cg_sgaqj,22541,22542,45083
26225,,url:http://adsabs.harvard.edu/abs/1992eaio.conf.....e,22542,22543,45085
26226,,ahu1z2sl6oej,22543,22544,45087
26227,,mqyrrgbsgd0j,22544,22545,45089
26228,,kwj0i0wgyluj,22545,22546,45091
26229,,0meackwclq0j,22546,22547,45093
26230,,bdw6ffbchgaj,22548,22549,45097
26231,,url:http://portal.acm.org/ft_gateway.cfm3fid3d32001726type3dpdf26dl3dguide26dl3dacm26cfid3d1111111126cftoken3d2222222,22549,22550,45099
26232,,dbllagbmfboj,22550,22551,45101
26233,,peofyjlvbhkj,22551,22552,45103
26234,,url:http://www.csa.com/partners/viewrecord.php3frequester3dgs26collection3dtrd26recid3d200112006503mt26recid3dn9210565ah,22552,22553,45105
26235,,hnjulgy3qdij,22553,22554,45107
26236,,url:http://portal.acm.org/citation.cfm3fid3d126482.12648826dl3dguide26dl3dacm26idx3dj68926part3dperiodical26wanttype3dperiodical26title3dacm2520sigmod2520record26cfid3d1111111126cftoken3d2222222,22554,22555,45109
26237,,zftnugixwbmj,22555,22556,45111
26238,,_6kvk8kbmqsj,22556,22557,45113
26239,,hyet-9lnreyj,22558,22559,45117
26240,,gwivtn9qgoej,22559,22560,45119
26241,,b7gter3sikmj,22560,22561,45121
26242,,url:http://portal.acm.org/ft_gateway.cfm3fid3d14140526type3dpdf26coll3dguide26dl3dacm26cfid3d1111111126cftoken3d2222222,22561,22562,45123
26243,,mstr5nziyqsj,22562,22563,45125
26244,,b_2us4l8kk8j,22563,22564,45127
26245,,6wuucv3dgpsj,22564,22565,45129
26246,,,22565,22566,45131
26247,,dpf__9suvxoj,22566,22567,45133
26248,,w7fnlnvbikgj,22567,22568,45135
26249,,fprwudm29t8j,22568,22569,45137
26250,,pzqfaauc3wej,22570,22571,45141
26251,,93gvyt-zmcqj,22571,22572,45143
26252,,jzvxjufgqnsj,22572,22573,45145
26253,,h4m3oldxlf4j,22573,22574,45147
26254,,ro5obaycifmj,22574,22575,45149
26255,,ynhmiuqfjoij,22575,22576,45151
26256,,dxllsimnjysj,22576,22577,45153
26257,,ch9ygh73v64j,22577,22578,45155
26258,,ukgymznhig8j,22578,22579,45157
26259,,lidiyzxgsj8j,22579,22580,45159
26260,,bl0vwec09doj,22580,22581,45161
26261,,jn_nzbmodisj,22581,22582,45163
26262,,t5kzhw2hohyj,22582,22583,45165
26263,,abrybhqpevyj,22583,22584,45167
26264,,f9pdsth783mj,22584,22585,45169
26265,,dbcuklogpeaj,22585,22586,45171
26266,,zvz7sozilowj,22586,22587,45173
26267,,l0n_h-uxwrkj,22587,22588,45175
26268,,1lpnnphny_kj,22588,22589,45177
26269,,nxdqpjfry0mj,22589,22590,45179
26270,,uvokao0m0vcj,22590,22591,45181
26271,,z8iglvk-xnej,22591,22592,45183
26272,,i9pjiw7bwbsj,22592,22593,45185
26273,,_t_ln2ve-yyj,22593,22594,45187
26274,,jjz4hsdgrcyj,22594,22595,45189
26275,,crhr7dm8wigj,22595,22596,45191
26276,,_x0nqgqjfvyj,22596,22597,45193
26277,,-7hyjxfd-asj,22597,22598,45195
26278,,bglqvmembqaj,22598,22599,45197
26279,,lzcoenwq108j,22599,22600,45199
26280,,ks2c9bzgk9cj,22600,22601,45201
26281,,czlrcwi_ja4j,22601,22602,45203
26282,,mhsx5qrnstoj,22602,22603,45205
26283,,ap_cbgchogyj,22603,22604,45207
26284,,nk0wk1tbabij,22604,22605,45209
26285,,url:http://www.csa.com/partners/viewrecord.php3frequester3dgs26collection3dtrd26recid3d0499168ci,22605,22606,45211
26286,,milda-sq_9ij,22606,22607,45213
26287,,z_--hjmhnmgj,22607,22608,45215
26288,,k0aofybwg3aj,22608,22609,45217
26289,,url:http://portal.acm.org/ft_gateway.cfm3fid3d102758126type3dpdf,22609,22610,45219
26290,,ceid_zembw4j,22610,22611,45221
26291,,i8uegdlyeruj,22611,22612,45223
26292,,iwz4wld_ewgj,22612,22613,45225
26293,,fhevcjgjin0j,22613,22614,45227
26294,,6604sofiwqoj,22614,22615,45229
26295,,0bmupzzouacj,22615,22616,45231
26296,,duk87onbonmj,22616,22617,45233
26297,,tkdkxqcmdymj,22617,22618,45235
26298,,rjzssr2b45oj,22618,22619,45237
26299,,f6ezhfulseyj,22619,22620,45239
26300,,z0y11cp-zmuj,22620,22621,45241
26301,,ntu4gusv7gej,22621,22622,45243
26302,,3hdrirocykkj,22622,22623,45245
26303,,url:http://portal.acm.org/citation.cfm3fid3d882082.88208426dl3dportal26dl3dacm26cfid3d1111111126cftoken3d2222222,22623,22624,45247
26304,,ba5eyxbo88ej,22624,22625,45249
26305,,gqpuodubjomj,22625,22626,45251
26306,,url:http://www.csa.com/partners/viewrecord.php3frequester3dgs26collection3dtrd26recid3dn9210407ah,22626,22627,45253
26307,,lbnqbagfsegj,22627,22628,45255
26308,,hfu5m1iyblej,22628,22629,45257
26309,,url:http://www.emeraldinsight.com/insight/viewcontentservlet3ffilename3d/published/emeraldfulltextarticle/pdf/0010430911.pdf,22629,22630,45259
26310,,url:http://www.ingentaconnect.com/content/els/09505849/1997/00000039/00000004/art01140,22630,22631,45261
26311,,fgooo6uz3t0j,22631,22632,45263
26312,,ffru-en6kaej,22632,22633,45265
26313,,url:http://links.jstor.org/sici3fsici3d0146-4949(196024)1253a1253c35253ajwtwtw253e2.0.co253b2-6,22633,22634,45267
26314,,kqeqqk6rlgij,22634,22635,45269
26315,,mucwlnkeuwoj,22635,22636,45271
26316,,w5ug1msrohsj,22636,22637,45273
26317,,swjggz5mrdoj,22637,22638,45275
26318,,uvhzuukqwfcj,22638,22639,45277
26319,,dhbxvifcp_4j,22639,22640,45279
26320,,q31x_ppojr0j,22640,22641,45281
26321,,ylmvawxvn0aj,22641,22642,45283
26322,,l_bxkzuh6rgj,22642,22643,45285
26323,,qpv-6vrbebqj,22643,22644,45287
26324,,o5pr3qesmekj,22644,22645,45289
26325,,url:http://www.csa.com/partners/viewrecord.php3frequester3dgs26collection3dtrd26recid3d200111010701mt26recid3da0032631ah,22645,22646,45291
26326,,1kkap3jyndkj,22646,22647,45293
26327,,sivshn1d7paj,22647,22648,45295
26328,,gqiwh_uxwnij,22648,22649,45297
26329,,c7nlh8uy8swj,22649,22650,45299
26330,,fwy3ck5jkuuj,22650,22651,45301
26331,,gbphsnklah4j,22651,22652,45303
26332,,hrnvbvidn0sj,22652,22653,45305
26333,,en4pt0i9r_ej,22653,22654,45307
26334,,jwhfrp6an04j,22654,22655,45309
26335,,url:http://www.ingentaconnect.com/search/expand3fpub3dinfobike://els/09505849/1996/00000038/00000005/art0106326unc3d,22655,22656,45311
26336,,fhvshke-gxyj,22656,22657,45313
26337,,gzwdhab2eb8j,22657,22658,45315
26338,,1ehdiewahy4j,22658,22659,45317
26339,,g9rvluqzbvsj,22659,22660,45319
26340,,hu8vvma9c7ej,22660,22661,45321
26341,,ot6bnzdh1syj,22661,22662,45323
26342,,qywc8aselxej,22662,22663,45325
26343,,hipz9-yy39aj,22663,22664,45327
26344,,017r5wu4kamj,22664,22665,45329
26345,,fn_m7o1k16yj,22665,22666,45331
26346,,mwkt-jymmaqj,22666,22667,45333
26347,,ckkufccnbcej,22667,22668,45335
26348,,url:http://www.ncbi.nlm.nih.gov/entrez/query.fcgi3fcmd3dretrieve26db3dpubmed26list_uids3d1565473326dopt3dcitation,22668,22669,45337
26349,,r7hhcd8yd40j,22669,22670,45339
26350,,iyowahp1i34j,22670,22671,45341
26351,,a2rqqjlqyoij,22671,22672,45343
26352,,jqhhl3ba6kej,22672,22673,45345
26353,,y_rp4i8l604j,22673,22674,45347
26354,,ya6oqhhwu-ej,22674,22675,45349
26355,,yfg07hdol7qj,22675,22676,45351
26356,,gazehvr-igij,22676,22677,45353
26357,,ajmqku_7gncj,22677,22678,45355
26358,,rtipusliowij,22678,22679,45357
26359,,nlpiywu_rfuj,22679,22680,45359
26360,,gabimh2yxzaj,22680,22681,45361
26361,,url:http://portal.acm.org/ft_gateway.cfm3fid3d33360826type3dpdf26dl3dguide26dl3dacm26cfid3d1111111126cftoken3d2222222,22681,22682,45363
26362,,pullnqh0xj0j,22682,22683,45365
26363,,hfif_lrtd3aj,22683,22684,45367
26364,,qcx9havncukj,22684,22685,45369
26365,,qcncrp2lzzuj,22685,22686,45371
26366,,jmeqttan7caj,22686,22687,45373
26367,,bihszvwuthaj,22687,22688,45375
26368,,url:http://portal.acm.org/ft_gateway.cfm3fid3d109959326type3dpdf,22688,22689,45377
26369,,zttptkgyni4j,22689,22690,45379
26370,,z5bpvgnahfwj,22690,22691,45381
26371,,url:http://adsabs.harvard.edu/abs/1987umas.rept.....c,22691,22692,45383
26372,,klcx26mo-ykj,22692,22693,45385
26373,,wnhifvsx9e0j,22693,22694,45387
26374,,uheifywlqs8j,22694,22695,45389
26375,,url:http://ieeexplore.ieee.org/iel5/2/21439/00993766.pdf3farnumber3d993766,22695,22696,45391
26376,,url:http://portal.acm.org/ft_gateway.cfm3fid3d30678426type3dpdf26dl3dguide26dl3dacm26cfid3d1111111126cftoken3d2222222,22696,22697,45393
26377,,2cif0s0sqcyj,22697,22698,45395
26378,,h6ceuinbqsuj,22698,22699,45397
26379,,7vyncpa11ngj,22699,22700,45399
26380,,oormidbwkyoj,22700,22701,45401
26381,,sqknt0ylk1oj,22701,22702,45403
26382,,k5pqpf8q-rcj,22702,22703,45405
26383,,htsft55tl3qj,22703,22704,45407
26384,,lchj0u9znmmj,22704,22705,45409
26385,,okplsji1kjej,22705,22706,45411
26386,,pzr9vngft-qj,22706,22707,45413
26387,,jugeplz8ykcj,22707,22708,45415
26388,,kajsjmz8y5yj,22708,22709,45417
26389,,vk-yt1meup4j,22709,22710,45419
26390,,ogrqlljshngj,22710,22711,45421
26391,,baidcgcjv1ij,22712,22713,45425
26392,,_now6fmectej,22714,22715,45429
26393,,rtf-dfsgnm8j,22715,22716,45431
26394,,url:http://portal.acm.org/citation.cfm3fid3d964750.80837626dl3dguide26dl3dacm26idx3d96475026part3dperiodical26wanttype3dperiodical26title3dacm2520sigarch2520computer2520architecture2520news26cfid3d1111111126cftoken3d2222222,22716,22717,45433
26395,,u2hlpo9-tj0j,22717,22718,45435
26396,,d62nuoa4-xsj,22718,22719,45437
26397,,lz40sgmxwssj,22719,22720,45439
26398,,joemq-l08uuj,22720,22721,45441
26399,,nftrqlnzvo0j,22721,22722,45443
26400,,y1paum4fdhej,22722,22723,45445
26401,,ibckdpfbapij,22723,22724,45447
26402,,oeeiuez2xmcj,22724,22725,45449
26403,,nro7mxtgexej,22725,22726,45451
26404,,p95kndnxzyqj,22726,22727,45453
26405,,i_t4cprd-kqj,22727,22728,45455
26406,,i3ydsnr9dhqj,22728,22729,45457
26407,,npots7fbjaqj,22729,22730,45459
26408,,e8obxui02lyj,22730,22731,45461
26409,,_isa8jqv1ecj,22731,22732,45463
26410,,url:http://doi.wiley.com/10.1002/he.12.abs,22732,22733,45465
26411,,pamibd-rqmuj,22733,22734,45467
26412,,xoebknsl_fsj,22734,22735,45469
26413,,8nmcyvh1g_gj,22735,22736,45471
26414,,url:http://www.csa.com/partners/viewrecord.php3frequester3dgs26collection3dtrd26recid3d0219026ci,22736,22737,45473
26415,,zihtjbpjkwoj,22737,22738,45475
26416,,jwmimj9axyoj,22738,22739,45477
26417,,url:http://portal.acm.org/ft_gateway.cfm3fid3d106624026type3dpdf,22739,22740,45479
26418,,6lkh08d0a_aj,22741,22742,45483
26419,,anrforj5ed4j,22742,22743,45485
26420,,cm98n__f_moj,22743,22744,45487
26421,,eaieb9mipyoj,22744,22745,45489
26422,,bejwq5uaqmyj,22745,22746,45491
26423,,7axcy9ml0m4j,22746,22747,45493
26424,,tnsmms0q7ogj,22747,22748,45495
26425,,ed0oe7embzqj,22748,22749,45497
26426,,url:http://portal.acm.org/ft_gateway.cfm3fid3d109957226type3dpdf,22749,22750,45499
26427,,kigne0tperij,22750,22751,45501
26428,,c3-k9iypw4yj,22751,22752,45503
26429,,756vfng9iq8j,22752,22753,45505
26430,,nva8nmqt7toj,22753,22754,45507
26431,,ypsayjo8q90j,22754,22755,45509
26432,,_zwapxqb9oej,22755,22756,45511
26433,,ygrtl5cmwcuj,22756,22757,45513
26434,,oviz8gqt0xwj,22757,22758,45515
26435,,t1xso7pwkoij,22758,22759,45517
26436,,6fmxj3jxvskj,22759,22760,45519
26437,,71_-scdzuhuj,22760,22761,45521
26438,,1y7cz-q5jo0j,22761,22762,45523
26439,,m4vkqwpebuaj,22762,22763,45525
26440,,o7ktd_3gus4j,22763,22764,45527
26441,,zkx87rt_cbuj,22764,22765,45529
26442,,mkon41euqmwj,22765,22766,45531
26443,,f9mop8dg1fsj,22766,22767,45533
26444,,9nd1f4_avgqj,22768,22769,45537
26445,,ldrq5rtifiej,22769,22770,45539
26446,,h2w6bnbjtqyj,22770,22771,45541
26447,,isvvsnmm8wuj,22771,22772,45543
26448,,ky2lifumjpej,22772,22773,45545
26449,,3vqolzskn-8j,22773,22774,45547
26450,,nelkxih6uiej,22774,22775,45549
26451,,cthyvo9ht1gj,22775,22776,45551
26452,,url:http://www.ingentaconnect.com/content/els/09505849/2001/00000043/00000014/art00205,22776,22777,45553
26453,,vbaazcgngkej,22777,22778,45555
26454,,pwkuqi5ckoyj,22778,22779,45557
26455,,geoxpyiic8ij,22779,22780,45559
26456,,vm1lno9kjuoj,22780,22781,45561
26457,,e_9f0kunngkj,22781,22782,45563
26458,,d5pctgrbj8wj,22782,22783,45565
26459,,haxbihgm-gaj,22783,22784,45567
26460,,o5ih2zjubimj,22784,22785,45569
26461,,6nooebzxdlkj,22785,22786,45571
26462,,orxvly4vveqj,22786,22787,45573
26463,,ujgpcskzkuuj,22787,22788,45575
26464,,ww8up6tsvhwj,22789,22790,45579
26465,,tda4czvxpaqj,22790,22791,45581
26466,,xoo67ccmfskj,22791,22792,45583
26467,,ysmdeh2jlhqj,22792,22793,45585
26468,,fgjbmgye5fmj,22793,22794,45587
26469,,qoaqcz3yui0j,22794,22795,45589
26470,,7zvbbuc9apyj,22795,22796,45591
26471,,_sf-hlczhywj,22796,22797,45593
26472,,6gpvs_5xchsj,22797,22798,45595
26473,,sda25tyjdsaj,22798,22799,45597
26474,,esd1q-jj5mqj,22799,22800,45599
26475,,ldx3ldnzwdyj,22800,22801,45601
26476,,7fdqvaajvxej,22801,22802,45603
26477,,8dadp0ui0emj,22802,22803,45605
26478,,nbdf9ubutsej,22803,22804,45607
26479,,1yzcebn7wnaj,22804,22805,45609
26480,,url:http://portal.acm.org/citation.cfm3fid3d171926.171932,22805,22806,45611
26481,,raadrqh5lk0j,22806,22807,45613
26482,,qgi1fi0n8vej,22807,22808,45615
26483,,mkscj8zbcowj,22808,22809,45617
26484,,mlzczgn06rgj,22809,22810,45619
26485,,v06scvdantgj,22810,22811,45621
26486,,giznzrkosw0j,22811,22812,45623
26487,,l-hs6oickhyj,22812,22813,45625
26488,,mb-x0plhtcej,22813,22814,45627
26489,,l_ev_1ghujqj,22815,22816,45631
26490,,url:http://doi.wiley.com/10.1002/tl.7007,22816,22817,45633
26491,,1-ejfjerf9uj,22817,22818,45635
26492,,lpt0vsmm50kj,22818,22819,45637
26493,,apixiij84l8j,22819,22820,45639
26494,,7fhudybekf0j,22820,22821,45641
26495,,p5xstazagcij,22822,22823,45645
26496,,ywsppskcjhuj,22823,22824,45647
26497,,djbduc6wqj4j,22824,22825,45649
26498,,ama_lfrmvaoj,22825,22826,45651
26499,,dtljn9yqlokj,22826,22827,45653
26500,,jmgnem3rjnuj,22827,22828,45655
26501,,gwp5gxkzp4mj,22828,22829,45657
26502,,ybnwggptuy8j,22829,22830,45659
26503,,f7gqdxm0gzij,22830,22831,45661
26504,,mi0hz1vhiosj,22831,22832,45663
26505,,6pzvkeueskyj,22832,22833,45665
26506,,ed5em3kq4lgj,22833,22834,45667
26507,,iheccmbzkpgj,22835,22836,45671
26508,,xq2ejs3nimyj,22836,22837,45673
26509,,ryik1gnal9gj,22837,22838,45675
26510,,kbvqspuz8fwj,22838,22839,45677
26511,,ukz8ikav_kej,22839,22840,45679
26512,,yp7qrouftzij,22840,22841,45681
26513,,nhdvagirvhij,22841,22842,45683
26514,,url:http://www.springerlink.com/index/xh6560381t402652.pdf,22842,22843,45685
26515,,mpbe4zv2zs8j,22843,22844,45687
26516,,e8icgs9be2qj,22844,22845,45689
26517,,hamxdn4dakoj,22845,22846,45691
26518,,zoqzzj78gz0j,22846,22847,45693
26519,,url:http://pubs.acs.org/cgi-bin/abstract.cgi/achre4/2005/38/i09/abs/ar040223k.html,22847,22848,45695
26520,,0whivg_ik1wj,22848,22849,45697
26521,,2ms6vzhnfjcj,22849,22850,45699
26522,,jo6-8ttloocj,22850,22851,45701
26523,,4qlei_pvlbyj,22851,22852,45703
26524,,3s3w9cuw46wj,22852,22853,45705
26525,,unlit6a2ewaj,22853,22854,45707
26526,,lvzj2mnjuz8j,22854,22855,45709
26527,,dubfdfsvvtgj,22855,22856,45711
26528,,aiz0b5pc8jcj,22856,22857,45713
26529,,xst3iyrmlauj,22857,22858,45715
26530,,bvt8whcqcmsj,22858,22859,45717
26531,,t4zvupat2h0j,22859,22860,45719
26532,,2yy0kqzvt0ej,22860,22861,45721
26533,,ocvnwjuhubkj,22861,22862,45723
26534,,hcs6nblzjkuj,22862,22863,45725
26535,,1of5tbbeocyj,22863,22864,45727
26536,,pefjtkuqvhgj,22864,22865,45729
26537,,ppc_ddbx4vsj,22865,22866,45731
26538,,v3cwylci5hsj,22866,22867,45733
26539,,ayprhrtnt_yj,22868,22869,45737
26540,,orp455a_ypsj,22869,22870,45739
26541,,1u2tc-dj_t4j,22870,22871,45741
26542,,pb3oqty3symj,22871,22872,45743
26543,,pyx0z0d1pkqj,22873,22874,45747
26544,,w7lk2xakts8j,22874,22875,45749
26545,,i-xkdgrlurwj,22875,22876,45751
26546,,yudgx2_nmsmj,22876,22877,45753
26547,,_tfvcolp3nkj,22877,22878,45755
26548,,xyl1fmq1e5yj,22878,22879,45757
26549,,mx52olf4aikj,22879,22880,45759
26550,,wbsnelajawgj,22880,22881,45761
26551,,yvjahv2aiusj,22881,22882,45763
26552,,2m4bwsnk2tmj,22882,22883,45765
26553,,ckzpq_tgwmkj,22883,22884,45767
26554,,vumdciimf4ij,22884,22885,45769
26555,,crvz7kyjefij,22885,22886,45771
26556,,mvpwlky8hcgj,22886,22887,45773
26557,,qk0pjzcqyi8j,22887,22888,45775
26558,,kktjqerndv8j,22888,22889,45777
26559,,fhukj3nv8zuj,22889,22890,45779
26560,,tnox1wg23qwj,22890,22891,45781
26561,,daoh2l0vedej,22891,22892,45783
26562,,cmwaf0bcxlgj,22892,22893,45785
26563,,yc9kjegbdl0j,22893,22894,45787
26564,,o6zgx8f5wtsj,22896,22897,45793
26565,,u3surdcacksj,22897,22898,45795
26566,,cnpwkbgctryj,22898,22899,45797
26567,,i7porjb2uxij,22899,22900,45799
26568,,s79sxhbqngaj,22900,22901,45801
26569,,url:http://doi.ieeecomputersociety.org/10.1109/tkde.2004.30,22901,22902,45803
26570,,hboanxsub0yj,22902,22903,45805
26571,,gnaujecbu-0j,22903,22904,45807
26572,,r7z-nluo_yuj,22904,22905,45809
26573,,ttvwqviwzyqj,22905,22906,45811
26574,,,22906,22907,45813
26575,,fdslil71hoej,22907,22908,45815
26576,,kmbznynzp04j,22908,22909,45817
26577,,lct81aeyq5wj,22909,22910,45819
26578,,v12khr-0puwj,22910,22911,45821
26579,,,22911,22912,45823
26580,,m5jloxpufacj,22912,22913,45825
26581,,url:http://pubs.acs.org/cgi-bin/abstract.cgi/achre4/2005/38/i08/abs/ar040278m.html,22913,22914,45827
26582,,0mshxkyhub4j,22914,22915,45829
26583,,vjz89wzs27uj,22915,22916,45831
26584,,qqxnkff-xjsj,22916,22917,45833
26585,,mdncus9kv1wj,22917,22918,45835
26586,,m1c09memmsyj,22918,22919,45837
26587,,94lsaiv2fnaj,22919,22920,45839
26588,,f7tgix_insgj,22920,22921,45841
26589,,bgnbn_homfsj,22921,22922,45843
26590,,,22922,22923,45845
26591,,r2gph-imopcj,22924,22925,45849
26592,,v3pw3scvxzij,22925,22926,45851
26593,,n4tad3bpwgqj,22926,22927,45853
26594,,ywfc_t24lq4j,22927,22928,45855
26595,,jjzfwirjrsmj,22928,22929,45857
26596,,url:http://portal.acm.org/ft_gateway.cfm3fid3d12205226type3dpdf26coll3dguide26dl3dacm26cfid3d1111111126cftoken3d2222222,22929,22930,45859
26597,,yoornkoqrdaj,22930,22931,45861
26598,,iarlqyqmz7ij,22931,22932,45863
26599,,u67-o2s0ek8j,22932,22933,45865
26600,,1cmiudqoo-mj,22933,22934,45867
26601,,pw71aoo4pxgj,22934,22935,45869
26602,,_qcdijbzb6ej,22936,22937,45873
26603,,djvnlynlwkij,22937,22938,45875
26604,,url:http://links.jstor.org/sici3fsici3d0146-4949(196623)7253a3253c258253atpma253e2.0.co253b2-a,22938,22939,45877
26605,,igmr-omhiu0j,22939,22940,45879
26606,,xy4yyeglossj,22940,22941,45881
26607,,ojg8odn2fc4j,22941,22942,45883
26608,,qhzqel9dhdcj,22942,22943,45885
26609,,1w99kwiogdij,22943,22944,45887
26610,,h07d_2wjdakj,22944,22945,45889
26611,,divw6s9ktqoj,22945,22946,45891
26612,,yly-n-ne79kj,22946,22947,45893
26613,,url:http://portal.acm.org/ft_gateway.cfm3fid3d110118726type3dpdf,22947,22948,45895
26614,,lu4gaadc1oqj,22948,22949,45897
26615,,3m8ie5f5ib0j,22949,22950,45899
26616,,txjiq3qlpuyj,22950,22951,45901
26617,,3ei-hper3toj,22951,22952,45903
26618,,en5vvdfic2uj,22952,22953,45905
26619,,9iy_gyj2lymj,22953,22954,45907
26620,,wen6pwyx0-yj,22954,22955,45909
26621,,c80xvaay068j,22955,22956,45911
26622,,et_i3qwzryqj,22956,22957,45913
26623,,bxo8olnqifuj,22957,22958,45915
26624,,qndoz9olwpkj,22958,22959,45917
26625,,7zfwje5x_baj,22959,22960,45919
26626,,6btvdtdbqrqj,22960,22961,45921
26627,,hqsdr_7ern8j,22961,22962,45923
26628,,0nsrklf_op0j,22962,22963,45925
26629,,ivozuxxy1i4j,22963,22964,45927
26630,,wdsfbfnbxgmj,22964,22965,45929
26631,,2izjja0zczaj,22965,22966,45931
26632,,lumxpmqkq30j,22966,22967,45933
26633,,url:http://portal.acm.org/ft_gateway.cfm3fid3d109957126type3dpdf,22968,22969,45937
26634,,l-rhaqtnc6qj,22969,22970,45939
26635,,w8b7msvxemsj,22970,22971,45941
26636,,59hhw61vtmwj,22971,22972,45943
26637,,prkraulpg8wj,22972,22973,45945
26638,,vgeq1ja7eesj,22973,22974,45947
26639,,qxvfpfor_2sj,22975,22976,45951
26640,,a3ltcclcd4wj,22976,22977,45953
26641,,xih_tm9usquj,22977,22978,45955
26642,,a1rimihegt0j,22978,22979,45957
26643,,xpkmifwsx9ij,22979,22980,45959
26644,,ksubzkbmtg8j,22980,22981,45961
26645,,url:http://portal.acm.org/ft_gateway.cfm3fid3d110119826type3dpdf,22981,22982,45963
26646,,q-kg8a3_bmij,22982,22983,45965
26647,,j-m_d01ji6kj,22983,22984,45967
26648,,0ymo3iyywcqj,22984,22985,45969
26649,,i_p2g58cht4j,22985,22986,45971
26650,,zt31kgyfejgj,22986,22987,45973
26651,,ibywoa1di1yj,22987,22988,45975
26652,,zizcmrjpfwwj,22988,22989,45977
26653,,fobs7av0yi4j,22989,22990,45979
26654,,bfr57va2pl8j,22990,22991,45981
26655,,_ekdqiit4nyj,22991,22992,45983
26656,,vvu6fljyd74j,22992,22993,45985
26657,,pd8den_6uicj,22993,22994,45987
26658,,amhuyl21gnkj,22994,22995,45989
26659,,nghy20um-5oj,22995,22996,45991
26660,,nf6-1gr81gsj,22996,22997,45993
26661,,famjbmzkhuuj,22998,22999,45997
26662,,oh-nrbsnaugj,22999,23000,45999
26663,,ntccdwbkqgyj,23000,23001,46001
26664,,yzzycuowmsej,23001,23002,46003
26665,,8mjiwnho8nsj,23002,23003,46005
26666,,siljz66t34cj,23003,23004,46007
26667,,jfmd5mazzn8j,23004,23005,46009
26668,,xdxje0icj0qj,23005,23006,46011
26669,,mb_yo_ttbioj,23006,23007,46013
26670,,dmlwihbkprmj,23007,23008,46015
26671,,fae_eeodrcij,23008,23009,46017
26672,,i2zgku9oilqj,23009,23010,46019
26673,,nttpxtszficj,23010,23011,46021
26674,,tbqe3xcc7m0j,23011,23012,46023
26675,,boazl7ygcx4j,23012,23013,46025
26676,,url:http://links.jstor.org/sici3fsici3d0146-4949(196724)8253a1253c1253atfbtbd253e2.0.co253b2-4,23013,23014,46027
26677,,txaqkkxksqej,23014,23015,46029
26678,,hk1hyf-geuij,23015,23016,46031
26679,,nqukdkd3am4j,23016,23017,46033
26680,,5f5mxsjviwwj,23017,23018,46035
26681,,pjejw4b6izwj,23018,23019,46037
26682,,kqrznjstujaj,23019,23020,46039
26683,,kgjvvtqzetaj,23020,23021,46041
26684,,kmk8j8klq1cj,23021,23022,46043
26685,,url:http://links.jstor.org/sici3fsici3d0146-4949(196524252f21)6253a1253c114253apatpp253e2.0.co253b2-u,23022,23023,46045
26686,,wl2s3reqstaj,23023,23024,46047
26687,,20bufojmklcj,23025,23026,46051
26688,,wgh7mpq--5wj,23026,23027,46053
26689,,_jssohepb2cj,23027,23028,46055
26690,,2cqasmip52wj,23028,23029,46057
26691,,k_ymxs_mtigj,23029,23030,46059
26692,,_kzivkfc5qcj,23030,23031,46061
26693,,6pyhmcs16iej,23031,23032,46063
26694,,7tgk4339tu0j,23032,23033,46065
26695,,wjkelsld3lqj,23033,23034,46067
26696,,fy7oexyhnkoj,23034,23035,46069
26697,,l4yrrsqwk8mj,23035,23036,46071
26698,,f445nmrq-tkj,23036,23037,46073
26699,,na1ggz7_wg4j,23037,23038,46075
26700,,xmsbilzyh4kj,23038,23039,46077
26701,,iiapavbwqcej,23039,23040,46079
26702,,jl2eu9oi7hsj,23040,23041,46081
26703,,oacjctp_lmij,23041,23042,46083
26704,,7ovo0y3iu8gj,23042,23043,46085
26705,,wfc_gxjrukaj,23043,23044,46087
26706,,pwbdwgfemhyj,23044,23045,46089
26707,,jpdsvtomn0oj,23045,23046,46091
26708,,o55wclto164j,23046,23047,46093
26709,,p83iorgsnfij,23047,23048,46095
26710,,sp8il_1obgcj,23048,23049,46097
26711,,zq7jys2fvuqj,23049,23050,46099
26712,,we4spjaphlkj,23050,23051,46101
26713,,m5zp85owthsj,23051,23052,46103
26714,,32p8tb5ipraj,23052,23053,46105
26715,,qh12hjb-gsij,23053,23054,46107
26716,,hh9fqmb-eeej,23054,23055,46109
26717,,_tbzrikhkxkj,23055,23056,46111
26718,,khacqohjiusj,23056,23057,46113
26719,,nmdhuktxwxwj,23057,23058,46115
26720,,atustunnluyj,23058,23059,46117
26721,,iqtnknoc4agj,23059,23060,46119
26722,,gwxn89gvgsyj,23060,23061,46121
26723,,pxdxhbn5gbwj,23061,23062,46123
26724,,g6dxde_v4fmj,23062,23063,46125
26725,,wo7in8piwj4j,23063,23064,46127
26726,,ibrct1do49gj,23064,23065,46129
26727,,a-mggpvduemj,23066,23067,46133
26728,,opujo0vht88j,23067,23068,46135
26729,,klgwcp9xfcsj,23068,23069,46137
26730,,nlsrw2peitwj,23069,23070,46139
26731,,ory2k__hifmj,23070,23071,46141
26732,,f6g4ems1wpij,23071,23072,46143
26733,,drbtl9wbnvcj,23072,23073,46145
26734,,w4oadxhdjvej,23073,23074,46147
26735,,jqnkzwcqhogj,23074,23075,46149
26736,,p15oeautiq4j,23075,23076,46151
26737,,xexs5gmq7xsj,23076,23077,46153
26738,,exvvkicqs8wj,23077,23078,46155
26739,,1chuyuokjpaj,23078,23079,46157
26740,,,23079,23080,46159
26741,,1ktuwckyqi4j,23080,23081,46161
26742,,url:http://portal.acm.org/ft_gateway.cfm3fid3d109962426type3dpdf,23081,23082,46163
26743,,,23082,23083,46165
26744,,yuy-wknlg5kj,23083,23084,46167
26745,,jegi6ihlrrsj,23084,23085,46169
26746,,t44udnliue0j,23085,23086,46171
26747,,_irl3zo25qqj,23086,23087,46173
26748,,fjlfuhxwabej,23087,23088,46175
26749,,o0kdjyr7ttaj,23088,23089,46177
26750,,jg9bquhapvqj,23089,23090,46179
26751,,,23090,23091,46181
26752,,8qmf127fz9sj,23091,23092,46183
26753,,i3qmpxgwr-aj,23092,23093,46185
26754,,v1db6g6uy1ij,23093,23094,46187
26755,,qftotalxiaej,23094,23095,46189
26756,,z2i4df7ql1sj,23095,23096,46191
26757,,bkfyno4olbej,23096,23097,46193
26758,,egwqzinnlisj,23097,23098,46195
26759,,lcewlaylyt0j,23098,23099,46197
26760,,ddfre3yxiumj,23099,23100,46199
26761,,0lwpe_uahcej,23100,23101,46201
26762,,chzx2hm5aqsj,23101,23102,46203
26763,,44vy6pgxr0gj,23102,23103,46205
26764,,_bquo1xm-fwj,23103,23104,46207
26765,,ezn9cobjmfyj,23104,23105,46209
26766,,ys-ouqn7u1qj,23105,23106,46211
26767,,url:http://doi.wiley.com/10.1002/he.41,23106,23107,46213
26768,,c7glmssr9jej,23107,23108,46215
26769,,ztczzwpyhuej,23108,23109,46217
26770,,tgbetlkbdwcj,23109,23110,46219
26771,,pjxmk0arbpij,23110,23111,46221
26772,,dcpkjx00jhmj,23111,23112,46223
26773,,hbbcdmw28y4j,23112,23113,46225
26774,,,23113,23114,46227
26775,,2_wpb_8eczoj,23114,23115,46229
26776,,jxc0d9ne4o0j,23115,23116,46231
26777,,sknb9n9aetcj,23116,23117,46233
26778,,wyqyxah1zp8j,23117,23118,46235
26779,,d-1jnvnmwnqj,23118,23119,46237
26780,,xbcgs61jhlyj,23119,23120,46239
26781,,u2y1fpwc6cgj,23120,23121,46241
26782,,fhh1ml_d3d4j,23122,23123,46245
26783,,i531ban72hqj,23123,23124,46247
26784,,hja28tttmjaj,23124,23125,46249
26785,,a92kqrvdzaoj,23125,23126,46251
26786,,uf93yojqbcej,23126,23127,46253
26787,,yaz_53cpl6yj,23127,23128,46255
26788,,4fpc3vteqpij,23128,23129,46257
26789,,2l9ae7jmwu8j,23129,23130,46259
26790,,b-efnqb4bwcj,23130,23131,46261
26791,,ax5hhtgdd0qj,23131,23132,46263
26792,,pava9olhvrkj,23132,23133,46265
26793,,xdxtp8rlheej,23133,23134,46267
26794,,toey-aji6faj,23134,23135,46269
26795,,evheamp52pgj,23135,23136,46271
26796,,wul6mnyagv4j,23136,23137,46273
26797,,gekc1ml1_nuj,23137,23138,46275
26798,,ov07qpvdhykj,23138,23139,46277
26799,,naouejlqjs0j,23139,23140,46279
26800,,ilrdh52s7oej,23140,23141,46281
26801,,mxkmb_4uf_8j,23141,23142,46283
26802,,tolq2s4p8hoj,23142,23143,46285
26803,,di6doauecwmj,23143,23144,46287
26804,,s-tdnj59ijkj,23144,23145,46289
26805,,8b2qfglwbeuj,23145,23146,46291
26806,,url:http://portal.acm.org/ft_gateway.cfm3fid3d110127826type3dpdf,23146,23147,46293
26807,,lwlv71fm8kqj,23147,23148,46295
26808,,03kdfn5vdoaj,23148,23149,46297
26809,,xvagxjswk9gj,23149,23150,46299
26810,,oxihvjmli_ej,23150,23151,46301
26811,,jdhs5lewooqj,23151,23152,46303
26812,,p-vhrwbl8kcj,23152,23153,46305
26813,,bqra-q948jsj,23153,23154,46307
26814,,7l5xyxoafy0j,23154,23155,46309
26815,,vzwv1ejr1xwj,23155,23156,46311
26816,,d9kwlpav3mgj,23156,23157,46313
26817,,dtk6owxwr_ej,23157,23158,46315
26818,,wgrxezdgi10j,23158,23159,46317
26819,,_dfxf1rhtgaj,23159,23160,46319
26820,,ftyvibi40saj,23160,23161,46321
26821,,dtkhqnp2arqj,23161,23162,46323
26822,,f1qlq1xcyfkj,23162,23163,46325
26823,,nl0x4upivzej,23163,23164,46327
26824,,czcfiir3ikej,23165,23166,46331
26825,,nyeghuz_ok8j,23166,23167,46333
26826,,tbya8monm_8j,23167,23168,46335
26827,,pr2gaqy6uaaj,23168,23169,46337
26828,,md3pl_aoazgj,23169,23170,46339
26829,,1t9fup7i4hsj,23170,23171,46341
26830,,yiuzdvhd4oaj,23171,23172,46343
26831,,eg9irtahvjoj,23172,23173,46345
26832,,dm3xutmyi_0j,23173,23174,46347
26833,,zup92zojg1uj,23174,23175,46349
26834,,8vjjdc5iv6cj,23175,23176,46351
26835,,tc70bwbeirwj,23176,23177,46353
26836,,9qocotixz9kj,23177,23178,46355
26837,,p1r8jwduaooj,23178,23179,46357
26838,,_9sulwki1kqj,23180,23181,46361
26839,,zr1ophmxca4j,23181,23182,46363
26840,,3pg5wzfithej,23182,23183,46365
26841,,aiy5aaloc-qj,23183,23184,46367
26842,,url:http://www.ingentaconnect.com/content/bpl/area/2001/00000033/00000004/art00038,23184,23185,46369
26843,,url:http://doi.wiley.com/10.1002/he.113,23185,23186,46371
26844,,npyao_2k8pij,23186,23187,46373
26845,,a1h2oucc5y8j,23187,23188,46375
26846,,6czawapxkzyj,23188,23189,46377
26847,,dra3xpwliuej,23189,23190,46379
26848,,ijvxumg1iuij,23190,23191,46381
26849,,jost_oniqikj,23192,23193,46385
26850,,nt0vf2s2-wuj,23193,23194,46387
26851,,amqu9ojprzqj,23194,23195,46389
26852,,9kntnfoz0gcj,23195,23196,46391
26853,,o8w-cq-obmmj,23196,23197,46393
26854,,afn9syxtfuuj,23197,23198,46395
26855,,r63nez_snlaj,23198,23199,46397
26856,,zeixzinsnnej,23199,23200,46399
26857,,dalrkrinhjej,23200,23201,46401
26858,,,23201,23202,46403
26859,,url:http://www.springerlink.com/index/p5x765043x4t2227.pdf,23202,23203,46405
26860,,rxep8wg_qluj,23203,23204,46407
26861,,qvopkyjafc8j,23204,23205,46409
26862,,nqg1fkoqjfmj,23205,23206,46411
26863,,mykhippwlc8j,23206,23207,46413
26864,,ulduau6vlr4j,23207,23208,46415
26865,,ime-scx_digj,23208,23209,46417
26866,,ljw2e2i1pycj,23209,23210,46419
26867,,url:http://portal.acm.org/citation.cfm3fid3d645921.756661,23210,23211,46421
26868,,j38eh4l0b8uj,23211,23212,46423
26869,,jkgsoo_3gjuj,23212,23213,46425
26870,,qwbd5lyqe8yj,23213,23214,46427
26871,,gaxlkph_t3ij,23214,23215,46429
26872,,d3i3fml00woj,23215,23216,46431
26873,,pfbwwt3bv8cj,23216,23217,46433
26874,,klnfas5rccej,23217,23218,46435
26875,,url:http://portal.acm.org/citation.cfm3fid3d171926.172006,23218,23219,46437
26876,,u1jwulroz-4j,23219,23220,46439
26877,,x8xztszsd9wj,23220,23221,46441
26878,,ltx0u-xko4ij,23221,23222,46443
26879,,b_m0yp4aycuj,23222,23223,46445
26880,,w0ttelmqjl4j,23223,23224,46447
26881,,s-7kopyobkcj,23224,23225,46449
26882,,n9j4xm1wursj,23225,23226,46451
26883,,hjivvq2dafmj,23226,23227,46453
26884,,ewzsbh-jv3ij,23227,23228,46455
26885,,7emrruncgaij,23228,23229,46457
26886,,hvo6vhevvoij,23229,23230,46459
26887,,h5yb2t4xeqmj,23230,23231,46461
26888,,y_xvzywbvyej,23231,23232,46463
26889,,v6h7t6k4msqj,23232,23233,46465
26890,,5_dgzoa3cuuj,23234,23235,46469
26891,,qd35frv-v4uj,23235,23236,46471
26892,,p1x_irzextyj,23236,23237,46473
26893,,gcbfhdhiefij,23237,23238,46475
26894,,cxqgt8l9w58j,23238,23239,46477
26895,,wjgaji2ts2cj,23239,23240,46479
26896,,mvd-z59xdyoj,23240,23241,46481
26897,,pehf2svwm1qj,23241,23242,46483
26898,,g8alm0csaggj,23242,23243,46485
26899,,e_jwuy2smw8j,23243,23244,46487
26900,,zsd9xhtbqlkj,23244,23245,46489
26901,,tcgcn2gfjncj,23246,23247,46493
26902,,url:http://portal.acm.org/ft_gateway.cfm3fid3d108625726type3dpdf,23247,23248,46495
26903,,5es7g0efxrej,23248,23249,46497
26904,,,23249,23250,46499
26905,,w-49jipgo-aj,23250,23251,46501
26906,,3oxplqqhs3wj,23251,23252,46503
26907,,abfnzz-3208j,23252,23253,46505
26908,,dvfm972-mygj,23253,23254,46507
26909,,fiyhrw7eljgj,23254,23255,46509
26910,,gfoelidpl-wj,23255,23256,46511
26911,,yahmssg3_-0j,23256,23257,46513
26912,,ase51s-n_cij,23257,23258,46515
26913,,muh5e5drvmgj,23258,23259,46517
26914,,eihn3mrfwjej,23259,23260,46519
26915,,pwnsfhu4xxwj,23260,23261,46521
26916,,6ydaovq6spmj,23261,23262,46523
26917,,bwatvqga2c8j,23262,23263,46525
26918,,8ipzcukwi7kj,23263,23264,46527
26919,,po59qj0g9tsj,23264,23265,46529
26920,,4wofijjajpgj,23265,23266,46531
26921,,6dg1reno9skj,23266,23267,46533
26922,,lwvm-hdlct4j,23267,23268,46535
26923,,kovsssnotb8j,23268,23269,46537
26924,,nwvl5wphshwj,23269,23270,46539
26925,,z8wz_zg5-9sj,23270,23271,46541
26926,,ftgjiw_nlb0j,23271,23272,46543
26927,,kijt5xwr-h0j,23272,23273,46545
26928,,kmnemqiyrm0j,23273,23274,46547
26929,,hptjixrmx68j,23274,23275,46549
26930,,q6nc7zuz8a0j,23275,23276,46551
26931,,glhmit1yw6aj,23276,23277,46553
26932,,of7silwobgwj,23277,23278,46555
26933,,7fxpa8avxwkj,23278,23279,46557
26934,,8yy2zrycqzaj,23279,23280,46559
26935,,yqf5zmlnqp4j,23280,23281,46561
26936,,nizyspqdt0qj,23281,23282,46563
26937,,fyaf0x_fcpgj,23282,23283,46565
26938,,bwhrj6_n-fyj,23283,23284,46567
26939,,i-taestropmj,23284,23285,46569
26940,,sevb30jyja4j,23285,23286,46571
26941,,otnqmowpxckj,23286,23287,46573
26942,,url:http://www.csa.com/partners/viewrecord.php3frequester3dgs26collection3dtrd26recid3d155943ws26recid3d199301530040md,23287,23288,46575
26943,,etg053pq9soj,23288,23289,46577
26944,,alwuu6inpw8j,23289,23290,46579
26945,,qrqaeftyqhoj,23290,23291,46581
26946,,jusuxcu8f0uj,23291,23292,46583
26947,,mq8adewcr6ij,23292,23293,46585
26948,,24k4abfyy9sj,23293,23294,46587
26949,,bzhlctpg75aj,23294,23295,46589
26950,,8fu2bhk_i9ej,23295,23296,46591
26951,,url:http://adsabs.harvard.edu/abs/1984mit..repts....g,23296,23297,46593
26952,,rekchmtrlsej,23297,23298,46595
26953,,b9zahfnex5yj,23298,23299,46597
26954,,poy3oeqi7vkj,23299,23300,46599
26955,,aza9vq7shikj,23300,23301,46601
26956,,c-yzbvoag00j,23301,23302,46603
26957,,gfnv_sv6ogsj,23302,23303,46605
26958,,w-jrgadoafcj,23303,23304,46607
26959,,kapvpjqzgjwj,23304,23305,46609
26960,,cipdzbr1jboj,23305,23306,46611
26961,,besa670lfdqj,23306,23307,46613
26962,,ddxtji7tvx8j,23307,23308,46615
26963,,sztymozefsej,23308,23309,46617
26964,,lxtntrzldm8j,23309,23310,46619
26965,,ygceuke1mgsj,23310,23311,46621
26966,,z98epujbil0j,23311,23312,46623
26967,,iidwa6fgskuj,23312,23313,46625
26968,,ogdu9f2izgyj,23314,23315,46629
26969,,hzg0tghjg3wj,23315,23316,46631
26970,,fkkgjcc2rbgj,23316,23317,46633
26971,,vyirihffbxuj,23317,23318,46635
26972,,xz0zpmlowcgj,23318,23319,46637
26973,,acz1agtx_pkj,23319,23320,46639
26974,,ck3hokwba_oj,23320,23321,46641
26975,,ciatitb_mn4j,23321,23322,46643
26976,,etb_nhph23wj,23322,23323,46645
26977,,jbqdoatwia0j,23323,23324,46647
26978,,hafyczjjkm0j,23324,23325,46649
26979,,n4bpaqe-r3kj,23325,23326,46651
26980,,,23326,23327,46653
26981,,kfygd7uz4yij,23327,23328,46655
26982,,gna86dyarzmj,23328,23329,46657
26983,,pfxdmay1d-kj,23329,23330,46659
26984,,kmfjjp_4o44j,23330,23331,46661
26985,,4ke-mym3nlgj,23331,23332,46663
26986,,2k9njmwwwecj,23332,23333,46665
26987,,79me1t0h7wcj,23333,23334,46667
26988,,eo8ybmeqopkj,23334,23335,46669
26989,,wag0usdvdgwj,23335,23336,46671
26990,,qwnme9bmr8mj,23336,23337,46673
26991,,wao1mgu-1buj,23337,23338,46675
26992,,t-yrw3shusmj,23338,23339,46677
26993,,sglf64vgknkj,23339,23340,46679
26994,,uk9xovplnfqj,23340,23341,46681
26995,,url:http://doi.wiley.com/10.1002/he.172,23341,23342,46683
26996,,6welyy2phqcj,23342,23343,46685
26997,,odp0f4valzyj,23343,23344,46687
26998,,h12iuinszmwj,23344,23345,46689
26999,,ito_dzr1laqj,23345,23346,46691
27000,,vs8fd4blpq4j,23346,23347,46693
27001,,0gg-c7ylrvgj,23347,23348,46695
27002,,x4lnvmllagej,23348,23349,46697
27003,,yqp2wsmrbxej,23349,23350,46699
27004,,zxgfaffmvn8j,23350,23351,46701
27005,,mjy6ag4c7zyj,23351,23352,46703
27006,,tb1tokffysgj,23353,23354,46707
27007,,4itu5uweqmuj,23354,23355,46709
27008,,maa3z0nzy1aj,23355,23356,46711
27009,,ocviesboabuj,23356,23357,46713
27010,,aydxew2echaj,23357,23358,46715
27011,,v8hgnwokqaaj,23358,23359,46717
27012,,,23359,23360,46719
27013,,r9z7n2uuuf4j,23360,23361,46721
27014,,vzr_lgrnauej,23361,23362,46723
27015,,nvt81hhfst8j,23362,23363,46725
27016,,vmezjefwxvej,23363,23364,46727
27017,,6m0huqcmdlgj,23364,23365,46729
27018,,z6uafeeygdaj,23365,23366,46731
27019,,9bejm6gxmp4j,23366,23367,46733
27020,,tk5ap9cbmisj,23367,23368,46735
27021,,njzzs2og42wj,23368,23369,46737
27022,,vnmv1tuo2baj,23369,23370,46739
27023,,kyx3sphoreuj,23370,23371,46741
27024,,uxwx9fiuru4j,23371,23372,46743
27025,,dpj8kcpifskj,23372,23373,46745
27026,,nvsefwu3qeuj,23373,23374,46747
27027,,yxb_lgng7h0j,23374,23375,46749
27028,,tqadg1iurwkj,23376,23377,46753
27029,,,23377,23378,46755
27030,,wb9nbmrpz30j,23378,23379,46757
27031,,mds_hwhgggaj,23379,23380,46759
27032,,n6zjmckux2mj,23380,23381,46761
27033,,7ymqkrgbw8ej,23381,23382,46763
27034,,hrfw1uz57yqj,23382,23383,46765
27035,,ttwpaynogdgj,23383,23384,46767
27036,,olrkxr0-cx4j,23384,23385,46769
27037,,6kfqlzf4nwej,23385,23386,46771
27038,,y7pjn8bvoe0j,23386,23387,46773
27039,,url:http://adsabs.harvard.edu/abs/1994ttw..conf.....l,23387,23388,46775
27040,,6s2q9jhncxyj,23388,23389,46777
27041,,iscqruy4r6cj,23389,23390,46779
27042,,tzzmrtgeqcqj,23390,23391,46781
27043,,0kgykrrnlsaj,23391,23392,46783
27044,,5zrle7ggxmgj,23392,23393,46785
27045,,ur59v65iyigj,23393,23394,46787
27046,,u_ft0ez9y2ij,23394,23395,46789
27047,,az4avvoluh4j,23395,23396,46791
27048,,boeh5h262vij,23396,23397,46793
27049,,z5q-jqu06xwj,23397,23398,46795
27050,,0w-mnyiyyxwj,23398,23399,46797
27051,,v37c334qjhoj,23399,23400,46799
27052,,zxmjppaled4j,23400,23401,46801
27053,,qhy6schilroj,23401,23402,46803
27054,,4aaaklfra7gj,23402,23403,46805
27055,,cscpfnw-umaj,23403,23404,46807
27056,,s-xbd_ec0oaj,23404,23405,46809
27057,,un1zz9o-kq4j,23405,23406,46811
27058,,vxpwb6icxv0j,23406,23407,46813
27059,,gdgou-tldj4j,23407,23408,46815
27060,,qqjl7fkb_pmj,23408,23409,46817
27061,,rj7vqfmayzij,23409,23410,46819
27062,,wex4bkynkpsj,23410,23411,46821
27063,,8daphcisemkj,23411,23412,46823
27064,,9dd2oxkb3baj,23412,23413,46825
27065,,b2pmad9ic8oj,23413,23414,46827
27066,,,23414,23415,46829
27067,,5i1xppwjxioj,23415,23416,46831
27068,,w_squstx5iaj,23416,23417,46833
27069,,hymmv6rj9pcj,23417,23418,46835
27070,,hpc2ivhotwmj,23418,23419,46837
27071,,7vo5mzzk1ucj,23419,23420,46839
27072,,0b5uiycyxd0j,23420,23421,46841
27073,,b0nt0gfg7jaj,23421,23422,46843
27074,,dzlo7azi3ruj,23422,23423,46845
27075,,y5h2qhogusgj,23423,23424,46847
27076,,xzdbygcij4qj,23424,23425,46849
27077,,jirhvf5eqp4j,23425,23426,46851
27078,,v_syk0wt1pwj,23426,23427,46853
27079,,x0bauxxpb7ej,23427,23428,46855
27080,,js-l8fmscfaj,23428,23429,46857
27081,,url:http://portal.acm.org/citation.cfm3fid3d244130.24424026dl3dguide26dl3dacm26type3dseries26idx3dseries31626part3dproceedings26wanttype3dproceedings26title3dinternational2520multimedia2520conference26cfid3d1111111126cftoken3d2222222,23429,23430,46859
27082,,e_jxodxxopkj,23430,23431,46861
27083,,ad1shs3ttzoj,23431,23432,46863
27084,,jamaus2hre0j,23432,23433,46865
27085,,ouy_0xnv1bcj,23433,23434,46867
27086,,4k9b8pgzp6aj,23434,23435,46869
27087,,oknyuamy28mj,23435,23436,46871
27088,,rm5rc9psekoj,23436,23437,46873
27089,,1p4mzxl6kywj,23437,23438,46875
27090,,j35g1dmjh60j,23438,23439,46877
27091,,quzh8rl7pbsj,23439,23440,46879
27092,,ocymxk2g77oj,23440,23441,46881
27093,,seatta6bbs0j,23441,23442,46883
27094,,jodg2guurpwj,23442,23443,46885
27095,,pax4ut--leij,23443,23444,46887
27096,,zs1ue7kwa00j,23444,23445,46889
27097,,rzktt0lqqs0j,23445,23446,46891
27098,,mhm6jadjezsj,23446,23447,46893
27099,,uw9tnq-oyvoj,23447,23448,46895
27100,,1_mk0emirwsj,23448,23449,46897
27101,,ftugeclqkmwj,23449,23450,46899
27102,,nyiig5q_nx0j,23450,23451,46901
27103,,2ab6ixopml8j,23451,23452,46903
27104,,43ptiwbnpdoj,23452,23453,46905
27105,,sgksgaxki6kj,23453,23454,46907
27106,,fv8xjkv0xg8j,23455,23456,46911
27107,,uhc0l55ie2wj,23456,23457,46913
27108,,w28deb8yb4cj,23457,23458,46915
27109,,hvvwtke9rccj,23458,23459,46917
27110,,slcac6sardcj,23460,23461,46921
27111,,rgdl5fudmuqj,23461,23462,46923
27112,,6xeywt9sxluj,23462,23463,46925
27113,,i5mkqkycsduj,23463,23464,46927
27114,,7-cmej-dupmj,23464,23465,46929
27115,,dxr_sx2bq3kj,23465,23466,46931
27116,,rgpy48ao4d4j,23466,23467,46933
27117,,emydpvoj8cmj,23467,23468,46935
27118,,5ukpiwc28esj,23468,23469,46937
27119,,q1mxcqpfbc8j,23469,23470,46939
27120,,stlzsf_dsgmj,23470,23471,46941
27121,,y1z4i3_4l00j,23471,23472,46943
27122,,dbvae5bq73kj,23472,23473,46945
27123,,ohdeww00evcj,23474,23475,46949
27124,,url:http://links.jstor.org/sici3fsici3d0146-4949(196021252f22)1253a2253c37253acah253e2.0.co253b2-e,23475,23476,46951
27125,,5yrpu-xm-gkj,23476,23477,46953
27126,,5da8m3ubci8j,23477,23478,46955
27127,,najnhh70_0kj,23478,23479,46957
27128,,fp9xqmm63bcj,23479,23480,46959
27129,,xksoemopqa4j,23480,23481,46961
27130,,tbssvmwe8fqj,23481,23482,46963
27131,,czsiuzavltuj,23482,23483,46965
27132,,url:http://doi.wiley.com/10.1002/he.173,23484,23485,46969
27133,,qpczssvhgdqj,23485,23486,46971
27134,,lzltkxb6rmuj,23486,23487,46973
27135,,mshh4mfg5xwj,23487,23488,46975
27136,,l0quuyl6ntgj,23488,23489,46977
27137,,fh16m_sffh4j,23489,23490,46979
27138,,urhyz3m7v30j,23490,23491,46981
27139,,gwsqt2garw4j,23491,23492,46983
27140,,s4wqqp2mhx0j,23492,23493,46985
27141,,pw6nodivvluj,23493,23494,46987
27142,,wxo5waxsemsj,23494,23495,46989
27143,,lnynweouptkj,23495,23496,46991
27144,,lvsrebzkllmj,23496,23497,46993
27145,,flegjc67ojyj,23497,23498,46995
27146,,hwjbgntodzqj,23498,23499,46997
27147,,i1tfs8cfzrwj,23499,23500,46999
27148,,d21selgvhy8j,23500,23501,47001
27149,,url:http://portal.acm.org/ft_gateway.cfm3fid3d101775826type3dpdf,23501,23502,47003
27150,,fhprpyncz1cj,23502,23503,47005
27151,,9tntm-lednsj,23503,23504,47007
27152,,qlmiox_wlf4j,23504,23505,47009
27153,,flrq7gqojn8j,23505,23506,47011
27154,,98qxjb9bul0j,23506,23507,47013
27155,,wwp-y_2_qhgj,23507,23508,47015
27156,,rryeth4xrfkj,23508,23509,47017
27157,,bsnpc-xkxtsj,23509,23510,47019
27158,,dfgs6tclz8qj,23510,23511,47021
27159,,z3tqt0xdpioj,23511,23512,47023
27160,,cqbx1z9znpsj,23512,23513,47025
27161,,yevdto10iucj,23513,23514,47027
27162,,xyuzr5oujyuj,23514,23515,47029
27163,,oqxymhfup14j,23515,23516,47031
27164,,aflt1k4hkzcj,23516,23517,47033
27165,,fvevzcccxmej,23517,23518,47035
27166,,nvo6zt48qzej,23518,23519,47037
27167,,url:http://portal.acm.org/ft_gateway.cfm3fid3d110136726type3dpdf,23519,23520,47039
27168,,ltpoomuguiwj,23520,23521,47041
27169,,o_qthnnwzzqj,23522,23523,47045
27170,,ubnkbf7vdxmj,23523,23524,47047
27171,,fphv7fhyyg0j,23524,23525,47049
27172,,bto5t95oaf8j,23525,23526,47051
27173,,l1tbsg6uxamj,23526,23527,47053
27174,,wughvh3wqyoj,23527,23528,47055
27175,,1cgebapdvqmj,23528,23529,47057
27176,,9moxyi03z_ij,23529,23530,47059
27177,,hrkhokn-buyj,23530,23531,47061
27178,,jwfzg8qngkoj,23531,23532,47063
27179,,umwedpzlxc0j,23532,23533,47065
27180,,3tkzl8fvwrmj,23533,23534,47067
27181,,xcrdgifvko0j,23534,23535,47069
27182,,oueii_zjhgaj,23535,23536,47071
27183,,9jdrodgwe6sj,23536,23537,47073
27184,,url:http://www.csa.com/partners/viewrecord.php3frequester3dgs26collection3dtrd26recid3d0293460ci,23537,23538,47075
27185,,cl2l-mhtbqyj,23538,23539,47077
27186,,vvw3cdjaqzuj,23539,23540,47079
27187,,ff8yi0wdg9mj,23540,23541,47081
27188,,gwywgh0a_sij,23541,23542,47083
27189,,dmu8t5s07uij,23542,23543,47085
27190,,wgguiotseqoj,23543,23544,47087
27191,,fqvody6vpfwj,23544,23545,47089
27192,,url:http://www.csa.com/partners/viewrecord.php3frequester3dgs26collection3dtrd26recid3dn9210478ah,23545,23546,47091
27193,,r9tt5zsnncqj,23546,23547,47093
27194,,6mz3iwhqwr4j,23547,23548,47095
27195,,e1vdtdlm44oj,23548,23549,47097
27196,,l20df_qyljej,23549,23550,47099
27197,,btylobs-kbej,23550,23551,47101
27198,,e28tchvzfgsj,23551,23552,47103
27199,,0jo9i0fvfdej,23552,23553,47105
27200,,url:http://portal.acm.org/ft_gateway.cfm3fid3d106629126type3dpdf,23554,23555,47109
27201,,url:http://portal.acm.org/citation.cfm3fid3d1007568.1007719,23555,23556,47111
27202,,4qr7sjsm8xgj,23556,23557,47113
27203,,kfyp08zmbagj,23557,23558,47115
27204,,i3reh2krllwj,23558,23559,47117
27205,,bihvq8ad3_qj,23559,23560,47119
27206,,8_zvlwzd8cej,23560,23561,47121
27207,,vm0pxegfxfqj,23561,23562,47123
27208,,oxhez_w67tej,23562,23563,47125
27209,,avcql2lurnej,23563,23564,47127
27210,,vqatg3lsuauj,23564,23565,47129
27211,,url:http://portal.acm.org/ft_gateway.cfm3fid3d108626626type3dpdf,23565,23566,47131
27212,,em19rs4tqmij,23566,23567,47133
27213,,6a1g1mbvuwcj,23567,23568,47135
27214,,mjivtmb5o20j,23568,23569,47137
27215,,k-tfbgyiascj,23569,23570,47139
27216,,r1ord4nnp8aj,23570,23571,47141
27217,,mkivovqbcxoj,23571,23572,47143
27218,,qbyx0johp38j,23572,23573,47145
27219,,m2j6meqw4l8j,23573,23574,47147
27220,,lu7onqfpy_kj,23574,23575,47149
27221,,4fz6vh-5q6aj,23575,23576,47151
27222,,n_xzcqemndsj,23576,23577,47153
27223,,h9aqb-sygjsj,23577,23578,47155
27224,,lxqdousjddij,23578,23579,47157
27225,,utvfyhdskm0j,23579,23580,47159
27226,,fgjtgzai60uj,23580,23581,47161
27227,,nfyxqybc_c4j,23581,23582,47163
27228,,cs3ym9ymq5qj,23582,23583,47165
27229,,mm7wwgaaqawj,23583,23584,47167
27230,,25-myrw4mvgj,23584,23585,47169
27231,,fx0nxsnqdzqj,23585,23586,47171
27232,,uad2xl2vke0j,23586,23587,47173
27233,,af9gsqn7dmej,23587,23588,47175
27234,,sewpr2jgk1sj,23588,23589,47177
27235,,pimqv7pk7gqj,23589,23590,47179
27236,,x3vmjf-pge4j,23590,23591,47181
27237,,vefrirnp95ej,23591,23592,47183
27238,,a4e5gpjav4ej,23592,23593,47185
27239,,z2gik1t8_k0j,23593,23594,47187
27240,,qqa1jt1bw_0j,23595,23596,47191
27241,,vuonduunncqj,23597,23598,47195
27242,,v9fio_9d7uej,23598,23599,47197
27243,,tz24fn3gmdej,23599,23600,47199
27244,,azywdt_6d80j,23600,23601,47201
27245,,nr7w61ucdiyj,23601,23602,47203
27246,,yuk5phcny4yj,23602,23603,47205
27247,,84yakrep3nej,23603,23604,47207
27248,,zyc8jguctnwj,23604,23605,47209
27249,,ivwboynmmryj,23606,23607,47213
27250,,gxkopc7-kpsj,23607,23608,47215
27251,,3s_0llezriyj,23608,23609,47217
27252,,fjx4hpvquhuj,23609,23610,47219
27253,,kffcxkdq_b0j,23610,23611,47221
27254,,no5m5wzhnc8j,23611,23612,47223
27255,,mglk-6kvlkyj,23613,23614,47227
27256,,m9zl9doh17yj,23614,23615,47229
27257,,anixzjztgpmj,23615,23616,47231
27258,,fn_sfg4chlkj,23616,23617,47233
27259,,wnwxpmfvwwaj,23617,23618,47235
27260,,yprw7auxvayj,23618,23619,47237
27261,,nisg3-hhw_qj,23619,23620,47239
27262,,h_jdxgklv3aj,23620,23621,47241
27263,,1d-hcdo1pfkj,23621,23622,47243
27264,,p481tnbmikkj,23622,23623,47245
27265,,51jdhtpl3huj,23623,23624,47247
27266,,voewqr69ndyj,23624,23625,47249
27267,,a5xyn_tc6_wj,23625,23626,47251
27268,,9dllfm2tr5oj,23626,23627,47253
27269,,bs7ihfblvgyj,23627,23628,47255
27270,,s7jj_scir_cj,23628,23629,47257
27271,,cylujhnwttij,23629,23630,47259
27272,,5az0leu2-fij,23630,23631,47261
27273,,8npg_4n6l_mj,23631,23632,47263
27274,,hokwwvgavdmj,23632,23633,47265
27275,,tuvtfb6jyjmj,23633,23634,47267
27276,,nqewk_dmrawj,23634,23635,47269
27277,,28bvoa9byjaj,23635,23636,47271
27278,,nagu9nwd4caj,23636,23637,47273
27279,,krfr8djb3c8j,23637,23638,47275
27280,,tbuqw4m8rrkj,23638,23639,47277
27281,,expqfqskhigj,23639,23640,47279
27282,,url:http://www.ingentaconnect.com/content/els/13891286/2004/00000044/00000003/art00376,23640,23641,47281
27283,,dqrhnxtjb7qj,23642,23643,47285
27284,,kp9zjcgffaij,23643,23644,47287
27285,,qzxvnlq1ejoj,23644,23645,47289
27286,,rokuon2yahmj,23645,23646,47291
27287,,cca189cbqtyj,23646,23647,47293
27288,,oyapm1c1dw8j,23647,23648,47295
27289,,url:http://www.csa.com/partners/viewrecord.php3frequester3dgs26collection3dtrd26recid3d199303720138md26recid3d199303g2d0068ed,23648,23649,47297
27290,,rwpgbo02pxij,23649,23650,47299
27291,,xrkjd2a2gekj,23650,23651,47301
27292,,8eldslm5dzmj,23651,23652,47303
27293,,jgb8c7wu8ayj,23652,23653,47305
27294,,nhmxzcgenxoj,23653,23654,47307
27295,,tusddchddnij,23654,23655,47309
27296,,i4omcebfn0cj,23655,23656,47311
27297,,5vnth4boqdgj,23656,23657,47313
27298,,mot4q_5p5-cj,23657,23658,47315
27299,,6ldueaxxk4uj,23658,23659,47317
27300,,fld7hfxa2wuj,23659,23660,47319
27301,,s7_58ebhat0j,23660,23661,47321
27302,,kszh_fdsi38j,23661,23662,47323
27303,,7purgfkkdu0j,23662,23663,47325
27304,,e4fepcu0gogj,23663,23664,47327
27305,,w-ioijbzr-ej,23665,23666,47331
27306,,hbvoshjzlysj,23666,23667,47333
27307,,,23667,23668,47335
27308,,qyjqb_482cej,23668,23669,47337
27309,,stxcb_tigt0j,23669,23670,47339
27310,,pdhkhpg_tw4j,23670,23671,47341
27311,,0uv_sblagvcj,23671,23672,47343
27312,,bpdirt9ebuej,23672,23673,47345
27313,,noxoek0adq8j,23673,23674,47347
27314,,hc7mkp3hraqj,23674,23675,47349
27315,,url:http://portal.acm.org/citation.cfm3fid3d984505.984511,23675,23676,47351
27316,,gdka7th6ypaj,23676,23677,47353
27317,,c-p7pgwbwp0j,23677,23678,47355
27318,,izuufbagglej,23678,23679,47357
27319,,tzbwamr5av0j,23679,23680,47359
27320,,fneqynaozlsj,23680,23681,47361
27321,,a52791ufyqkj,23681,23682,47363
27322,,ftmoh58d330j,23682,23683,47365
27323,,_okjwcqgttwj,23683,23684,47367
27324,,twx-qeekrpgj,23684,23685,47369
27325,,0uki6lqvghkj,23685,23686,47371
27326,,url:http://ieeexplore.ieee.org/iel1/2206/324/00006467.pdf3farnumber3d6467,23686,23687,47373
27327,,2sji4-iilrij,23687,23688,47375
27328,,7tptwxigrc0j,23688,23689,47377
27329,,_pyzzxn2sjyj,23689,23690,47379
27330,,c0vlucg1hbmj,23690,23691,47381
27331,,ky8iu7urd9ij,23691,23692,47383
27332,,ct0da854pryj,23692,23693,47385
27333,,l5mp3jbz2bcj,23693,23694,47387
27334,,b7_cudaoxd4j,23694,23695,47389
27335,,2vstksldhjaj,23695,23696,47391
27336,,wnxp0p_egbwj,23696,23697,47393
27337,,2gzaioadnt0j,23697,23698,47395
27338,,aajgersm9j0j,23698,23699,47397
27339,,l1hfie5p-quj,23699,23700,47399
27340,,jorlovi9gkcj,23700,23701,47401
27341,,lbvf30mtj9sj,23701,23702,47403
27342,,fjyenk1hvfkj,23702,23703,47405
27343,,wjbg8ej4638j,23703,23704,47407
27344,,gm-rqkhqbhwj,23704,23705,47409
27345,,kzz0clsr0yaj,23705,23706,47411
27346,,3tvyzeq1-i4j,23706,23707,47413
27347,,eh6mgjzbj1oj,23707,23708,47415
27348,,5gizorggjiaj,23708,23709,47417
27349,,_comrs5zygaj,23709,23710,47419
27350,,oxji1zsmmzej,23710,23711,47421
27351,,fuo8r2dpcwoj,23711,23712,47423
27352,,hfhmymzgsogj,23712,23713,47425
27353,,url:http://doi.wiley.com/10.1002/tl.134,23713,23714,47427
27354,,v6k-ebkizigj,23714,23715,47429
27355,,hrlzlqmc-caj,23715,23716,47431
27356,,mmavc6_uzcqj,23716,23717,47433
27357,,dkioul6_fu4j,23717,23718,47435
27358,,url:http://portal.acm.org/ft_gateway.cfm3fid3d60187326type3dpdf26coll3dguide26dl3dacm26cfid3d1111111126cftoken3d2222222,23718,23719,47437
27359,,myajtpko9yyj,23719,23720,47439
27360,,0nh5ecwssg4j,23720,23721,47441
27361,,url:http://portal.acm.org/citation.cfm3fid3d244447,23721,23722,47443
27362,,i8ynlbamwhgj,23722,23723,47445
27363,,gzkdhbseag4j,23723,23724,47447
27364,,3fe2tkdbelqj,23724,23725,47449
27365,,cgqkjvm6wt0j,23725,23726,47451
27366,,j4dshdj3atuj,23726,23727,47453
27367,,u0dtujckjzaj,23727,23728,47455
27368,,afprqopors0j,23728,23729,47457
27369,,uz4aocwrrpaj,23729,23730,47459
27370,,er0r8doaguqj,23730,23731,47461
27371,,qqb2-tuialoj,23731,23732,47463
27372,,jnqfk81mzlyj,23732,23733,47465
27373,,1vdh3jgx4-uj,23733,23734,47467
27374,,dvkn55y9uvmj,23734,23735,47469
27375,,2tmkwxywvo4j,23735,23736,47471
27376,,gdmqg9hhudsj,23736,23737,47473
27377,,c0b5ozgeldcj,23737,23738,47475
27378,,aotoym0k1ssj,23738,23739,47477
27379,,fwaxdfa9sakj,23739,23740,47479
27380,,kk4xkbma1smj,23740,23741,47481
27381,,xpckpd1aw2wj,23741,23742,47483
27382,,shbzjmfxhkuj,23742,23743,47485
27383,,phx2ddaieoaj,23743,23744,47487
27384,,jpk-dfpmflaj,23744,23745,47489
27385,,az35lr4apq0j,23745,23746,47491
27386,,0q3jtxwemmuj,23746,23747,47493
27387,,irzxu3-vqzkj,23747,23748,47495
27388,,7zwnodaqhlaj,23748,23749,47497
27389,,kfyxseyufgyj,23749,23750,47499
27390,,db_x3hgrbysj,23750,23751,47501
27391,,tqcvb6sweraj,23751,23752,47503
27392,,sgh91bbedeij,23752,23753,47505
27393,,rwry5zbvxo8j,23753,23754,47507
27394,,uypnycm0abwj,23754,23755,47509
27395,,eyj4lzqjetyj,23755,23756,47511
27396,,url:http://pubs.acs.org/cgi-bin/abstract.cgi/achre4/2005/38/i02/abs/ar040021o.html,23756,23757,47513
27397,,9kjp_94dawmj,23757,23758,47515
27398,,xzpeyvn5n5mj,23758,23759,47517
27399,,4y_qctflgukj,23759,23760,47519
27400,,zdh1etlpbgsj,23760,23761,47521
27401,,qmka__m9kqcj,23761,23762,47523
27402,,zwoqp9cbeq4j,23762,23763,47525
27403,,oev-imrd3d8j,23763,23764,47527
27404,,x76dyofkjx0j,23764,23765,47529
27405,,url:http://portal.acm.org/ft_gateway.cfm3fid3d110124026type3dpdf,23765,23766,47531
27406,,chke72h4d8aj,23766,23767,47533
27407,,wkvsi4oz8uej,23767,23768,47535
27408,,xpkeoi3mkwij,23768,23769,47537
27409,,knofiumls4oj,23770,23771,47541
27410,,ryhqnf6qpvqj,23771,23772,47543
27411,,zc9i-p-ofu4j,23772,23773,47545
27412,,cjnswbvyt4kj,23773,23774,47547
27413,,sbp52jgtjoqj,23774,23775,47549
27414,,vvwwfhhwmbaj,23775,23776,47551
27415,,hsgcao0bizqj,23776,23777,47553
27416,,wtg3so5-vmcj,23777,23778,47555
27417,,dtf5k8-u6kij,23778,23779,47557
27418,,zzlmelr_1jej,23779,23780,47559
27419,,url:http://portal.acm.org/citation.cfm3fid3d983070.98307426coll3dguide26dl3dacm26idx3dj68926part3dperiodical26wanttype3dperiodical26title3dacm2520sigmod2520record26cfid3d1111111126cftoken3d2222222,23780,23781,47561
27420,,mvpsidgcltoj,23781,23782,47563
27421,,mxtibvqcatsj,23782,23783,47565
27422,,j-gtxxifqgyj,23783,23784,47567
27423,,iif6sbkpp30j,23784,23785,47569
27424,,dkkynengpnyj,23785,23786,47571
27425,,gd8ltxv0nxaj,23786,23787,47573
27426,,7sf6d2dvxosj,23787,23788,47575
27427,,x5pxs-wlrtwj,23788,23789,47577
27428,,hjxxo5ulg1ij,23789,23790,47579
27429,,e06um2pi6v4j,23790,23791,47581
27430,,url:http://www.csa.com/partners/viewrecord.php3frequester3dgs26collection3dtrd26recid3dn9210461ah,23791,23792,47583
27431,,sh0jmmqskdoj,23792,23793,47585
27432,,zpxhmqiu8yaj,23793,23794,47587
27433,,9r2vbam4lbwj,23794,23795,47589
27434,,smicgkzkjzsj,23795,23796,47591
27435,,45ryeuuzni0j,23797,23798,47595
27436,,smqap_eyrh4j,23798,23799,47597
27437,,hmlgmcxtxmsj,23799,23800,47599
27438,,lcbi4imu-jij,23800,23801,47601
27439,,ia79iqzmleaj,23801,23802,47603
27440,,l6tweyfnqxsj,23802,23803,47605
27441,,e2a8-zhmlisj,23803,23804,47607
27442,,5s4xqqhua70j,23804,23805,47609
27443,,hezlzqo5xk8j,23805,23806,47611
27444,,url:http://links.jstor.org/sici3fsici3d0146-4949(196721)8253a2253c193253a2522snpd253e2.0.co253b2-k,23806,23807,47613
27445,,ntqvlgarpzcj,23807,23808,47615
27446,,omyc0we1j4kj,23808,23809,47617
27447,,qwuicr4fgnyj,23809,23810,47619
27448,,44_fram8unwj,23810,23811,47621
27449,,emn7ay_nmyej,23811,23812,47623
27450,,okj8jomwcnkj,23812,23813,47625
27451,,uc0xkvfhczwj,23813,23814,47627
27452,,sdyk5kpowhaj,23814,23815,47629
27453,,3ibp-qibnkaj,23815,23816,47631
27454,,60drofs7te0j,23816,23817,47633
27455,,,23817,23818,47635
27456,,1xxrxrdyifqj,23819,23820,47639
27457,,fz0pm8xvhwyj,23820,23821,47641
27458,,kwdcch53gm4j,23821,23822,47643
27459,,bvxftlo-ukkj,23822,23823,47645
27460,,vqti3-joia4j,23823,23824,47647
27461,,klo8lobgw1cj,23824,23825,47649
27462,,wlftcupcm3aj,23825,23826,47651
27463,,v_n-ydpcliuj,23826,23827,47653
27464,,arfrrnm42kej,23829,23830,47659
27465,,s6yqpsivrm4j,23830,23831,47661
27466,,o-sczndpzxej,23831,23832,47663
27467,,6qxqhxtpzq4j,23832,23833,47665
27468,,efvkz5vvljsj,23833,23834,47667
27469,,hh88gtx4osqj,23834,23835,47669
27470,,1k2z20zp8ayj,23835,23836,47671
27471,,rjllcu8qceuj,23836,23837,47673
27472,,url:http://portal.acm.org/citation.cfm3fid3d245882.24588526coll3dguide26dl3dacm26idx3dj68926part3dperiodical26wanttype3dperiodical26title3dacm2520sigmod2520record26cfid3d1111111126cftoken3d2222222,23837,23838,47675
27473,,eqshly54ciij,23838,23839,47677
27474,,txjcsxexp30j,23839,23840,47679
27475,,pfzekwee1w4j,23840,23841,47681
27476,,xphqpatkhouj,23841,23842,47683
27477,,9xvlo84moxkj,23842,23843,47685
27478,,7qkkkc6vpquj,23843,23844,47687
27479,,9vcvup6sfm8j,23844,23845,47689
27480,,qzucrt3ivw8j,23845,23846,47691
27481,,f0oqrbm3xigj,23846,23847,47693
27482,,sgjnei0jnwoj,23847,23848,47695
27483,,url:http://portal.acm.org/ft_gateway.cfm3fid3d102761726type3dpdf,23848,23849,47697
27484,,zpovvmklel8j,23849,23850,47699
27485,,jwd2kgtgma0j,23850,23851,47701
27486,,gg1qj0oev4uj,23851,23852,47703
27487,,vnnhip1xao4j,23852,23853,47705
27488,,mmdmhyzjgtyj,23853,23854,47707
27489,,url:http://www.csa.com/partners/viewrecord.php3frequester3dgs26collection3dtrd26recid3d0014647ci,23854,23855,47709
27490,,h4cfaezftv0j,23855,23856,47711
27491,,a-k9qwgedrgj,23856,23857,47713
27492,,y26ukrxmnfgj,23857,23858,47715
27493,,p7m3y7oqhjyj,23858,23859,47717
27494,,1dx6j3pojdmj,23859,23860,47719
27495,,-50mvmwbkt8j,23860,23861,47721
27496,,n0ybbmrpeuwj,23861,23862,47723
27497,,jnp2yhq77s8j,23862,23863,47725
27498,,abqdk34lhbaj,23863,23864,47727
27499,,kaflmigfepsj,23864,23865,47729
27500,,18owr7wp8w0j,23865,23866,47731
27501,,24h-tn25wbmj,23866,23867,47733
27502,,oogakrk-ir4j,23867,23868,47735
27503,,gwfafhah-q4j,23868,23869,47737
27504,,v73gpr_gusqj,23869,23870,47739
27505,,dzqd3kkxbiqj,23870,23871,47741
27506,,mmbuvwo21d8j,23871,23872,47743
27507,,hszebo7jidoj,23872,23873,47745
27508,,wsg_q2jbgcaj,23873,23874,47747
27509,,qns5jjukgxqj,23874,23875,47749
27510,,zy7n_eoz5nuj,23875,23876,47751
27511,,url:http://www.springerlink.com/index/l56223707j66v1g6.pdf,23876,23877,47753
27512,,h-j5-akqswuj,23877,23878,47755
27513,,lxzkyinnmdqj,23878,23879,47757
27514,,g4d-eigbypwj,23879,23880,47759
27515,,x_n6qiqndvsj,23880,23881,47761
27516,,url:http://portal.acm.org/ft_gateway.cfm3fid3d33547626type3dpdf26dl3dguide26dl3dacm26cfid3d1111111126cftoken3d2222222,23881,23882,47763
27517,,hslpdedwctyj,23882,23883,47765
27518,,dvwiwat9kvaj,23883,23884,47767
27519,,x2whqlf02hsj,23884,23885,47769
27520,,odtmnq9wea4j,23885,23886,47771
27521,,u9rjn6ai5qsj,23886,23887,47773
27522,,vkxz-5ihzp8j,23887,23888,47775
27523,,vtjjagle6hyj,23888,23889,47777
27524,,uol0lgis7gyj,23889,23890,47779
27525,,url:http://portal.acm.org/ft_gateway.cfm3fid3d95711326type3dpdf26dl3dportal26dl3dacm26cfid3d1111111126cftoken3d2222222,23890,23891,47781
27526,,url:http://portal.acm.org/ft_gateway.cfm3fid3d35321426type3dpdf26dl3dguide26dl3dacm26cfid3d1111111126cftoken3d2222222,23891,23892,47783
27527,,ghdvtqddmn0j,23892,23893,47785
27528,,wxt8bjcjyg0j,23893,23894,47787
27529,,fpaycgs-uuyj,23894,23895,47789
27530,,cot_ienqvyej,23895,23896,47791
27531,,qkunzrb4lq8j,23897,23898,47795
27532,,krfojeo2fowj,23898,23899,47797
27533,,owlsoi6xz_gj,23899,23900,47799
27534,,5x3igdvdd9gj,23900,23901,47801
27535,,vcvdez-tbs4j,23901,23902,47803
27536,,pbdpdudkqfyj,23902,23903,47805
27537,,,23903,23904,47807
27538,,4fhpoouj6hsj,23904,23905,47809
27539,,dfevvaxehcoj,23905,23906,47811
27540,,jcqfsva8a7oj,23906,23907,47813
27541,,hzvtwa06txuj,23907,23908,47815
27542,,9i3g7vatkzsj,23908,23909,47817
27543,,iocmxb0y2ukj,23909,23910,47819
27544,,ckkhed869toj,23910,23911,47821
27545,,z1jzetx9lu4j,23911,23912,47823
27546,,wkcx-pcxsp4j,23912,23913,47825
27547,,url:http://portal.acm.org/citation.cfm3fid3d163090.16310426dl3dguide26dl3dacm26idx3dj68926part3dperiodical26wanttype3dperiodical26title3dacm2520sigmod2520record26cfid3d1111111126cftoken3d2222222,23914,23915,47829
27548,,fiyglf-qhl4j,23915,23916,47831
27549,,fxkopu3cbnwj,23916,23917,47833
27550,,5djfjxkr-qoj,23917,23918,47835
27551,,kskbvilgyt0j,23918,23919,47837
27552,,iscpdsqrjjqj,23919,23920,47839
27553,,cu6yasq6vr8j,23920,23921,47841
27554,,url:http://doi.wiley.com/10.1002/ace.172,23921,23922,47843
27555,,msr0ba8piowj,23922,23923,47845
27556,,3lndm1hd6kej,23923,23924,47847
27557,,sl_wczuatvoj,23924,23925,47849
27558,,wmatndn-uxuj,23925,23926,47851
27559,,uiou35ghxtij,23926,23927,47853
27560,,75bd5jhalbsj,23927,23928,47855
27561,,pyghlsczgigj,23928,23929,47857
27562,,es0a4bbtmm4j,23929,23930,47859
27563,,jhy1cxsznkkj,23930,23931,47861
27564,,jxl7i2xxm2ej,23931,23932,47863
27565,,niopoag8ss4j,23932,23933,47865
27566,,ibbjqpz0n0ej,23933,23934,47867
27567,,qd1zyhl2ba8j,23934,23935,47869
27568,,bwppcrkgdhkj,23935,23936,47871
27569,,aosczzy6ozij,23936,23937,47873
27570,,hc6-m9wbolkj,23937,23938,47875
27571,,p8sqpinqrhqj,23938,23939,47877
27572,,mmm_jbkmgb4j,23939,23940,47879
27573,,a5aa5q5e4osj,23940,23941,47881
27574,,t-j2hr2jrlwj,23942,23943,47885
27575,,nzbgw3irbmmj,23943,23944,47887
27576,,75ohfxjpjoij,23944,23945,47889
27577,,yg-lxa-8pqwj,23945,23946,47891
27578,,xdhgxbe3n14j,23946,23947,47893
27579,,url:http://www.csa.com/partners/viewrecord.php3frequester3dgs26collection3denv26recid3d7903461,23947,23948,47895
27580,,hmfyryqqe38j,23948,23949,47897
27581,,uour6i5qqo8j,23949,23950,47899
27582,,dkxeoskjlemj,23950,23951,47901
27583,,y2aru67kd2oj,23951,23952,47903
27584,,9hqvxrubfh8j,23952,23953,47905
27585,,url:http://www.ingentaconnect.com/search/expand3fpub3dinfobike://pep/jae/2000/00000214/00000001/art0000926unc3d,23953,23954,47907
27586,,bet5swackcoj,23954,23955,47909
27587,,q0pjanapvmoj,23955,23956,47911
27588,,url:http://portal.acm.org/citation.cfm3fid3d339389,23956,23957,47913
27589,,g9dnayhe7kwj,23957,23958,47915
27590,,evoho4geyawj,23958,23959,47917
27591,,wcelnsoheecj,23959,23960,47919
27592,,7e_v55exm9wj,23960,23961,47921
27593,,9sydmlcrr4cj,23961,23962,47923
27594,,rqexrdwflsmj,23962,23963,47925
27595,,56q9rlny9omj,23963,23964,47927
27596,,pbw6z73mqmqj,23964,23965,47929
27597,,wnndnm2dr8wj,23965,23966,47931
27598,,dayidklvfyij,23966,23967,47933
27599,,-r-f3pd-k7cj,23967,23968,47935
27600,,n3aowswqdbyj,23968,23969,47937
27601,,amlnho4cvm4j,23969,23970,47939
27602,,czcp9ay8vt8j,23970,23971,47941
27603,,em-bhyob9d8j,23971,23972,47943
27604,,l8pnjs6qezqj,23972,23973,47945
27605,,rxvqv3qhtqoj,23973,23974,47947
27606,,3tjndydnvxgj,23974,23975,47949
27607,,eqazytkbumcj,23975,23976,47951
27608,,rv6eqh7uvuwj,23976,23977,47953
27609,,kmnusdaq-z8j,23977,23978,47955
27610,,qhqfseixmgij,23978,23979,47957
27611,,qwn5u9v44gyj,23979,23980,47959
27612,,ubhglfwolywj,23980,23981,47961
27613,,url:http://www.csa.com/partners/viewrecord.php3frequester3dgs26collection3dtrd26recid3dn8128802ah,23981,23982,47963
27614,,url:http://portal.acm.org/ft_gateway.cfm3fid3d108624626type3dpdf,23982,23983,47965
27615,,url:http://portal.acm.org/ft_gateway.cfm3fid3d21975426type3dpdf26dl3dguide26dl3dacm26cfid3d1111111126cftoken3d2222222,23983,23984,47967
27616,,j08ky9dvp1uj,23984,23985,47969
27617,,wehgoqw85jcj,23985,23986,47971
27618,,cht_r09dabmj,23986,23987,47973
27619,,hzo7t0zfvfsj,23987,23988,47975
27620,,tuzhq1pjpsgj,23988,23989,47977
27621,,od60iabo06ij,23989,23990,47979
27622,,gbxti3pexmej,23990,23991,47981
27623,,url:http://adsabs.harvard.edu/abs/1976phdt.......119s,23991,23992,47983
27624,,avi2hmrt450j,23992,23993,47985
27625,,,23993,23994,47987
27626,,ugugelm3ctoj,23994,23995,47989
27627,,07sfcbyzhtyj,23995,23996,47991
27628,,url:http://www.csa.com/partners/viewrecord.php3frequester3dgs26collection3dtrd26recid3dn9210403ah,23996,23997,47993
27629,,yzdrgqqjczoj,23997,23998,47995
27630,,boiq4kqpwjyj,23998,23999,47997
27631,,6cwmp0uxphkj,23999,24000,47999
27632,,elyzdm-wwa4j,24000,24001,48001
27633,,kzhonmse5uuj,24001,24002,48003
27634,,ljvd_ktbjjij,24002,24003,48005
27635,,ohbarnxxgpcj,24003,24004,48007
27636,,honvqsa_pu0j,24004,24005,48009
27637,,kfqwiah_sqsj,24006,24007,48013
27638,,b9f3yb4bhxqj,24007,24008,48015
27639,,qvyxhywmy50j,24008,24009,48017
27640,,na0gcju0unyj,24009,24010,48019
27641,,jqd85kyvuoyj,24010,24011,48021
27642,,jkg7mvhfhquj,24011,24012,48023
27643,,fbd8ic-azdyj,24012,24013,48025
27644,,juldfzgh3l0j,24013,24014,48027
27645,,ov7_wuo_rq8j,24014,24015,48029
27646,,tr0fc3bgbuaj,24015,24016,48031
27647,,nixi5xm5umsj,24016,24017,48033
27648,,k0wrdqad0wsj,24017,24018,48035
27649,,owvdojs4pdqj,24018,24019,48037
27650,,wxrmc_eumxoj,24020,24021,48041
27651,,u0ndc4dawiuj,24021,24022,48043
27652,,q2yzq3udkdaj,24022,24023,48045
27653,,hsxfrakzpqmj,24024,24025,48049
27654,,rh5q6z3aqhij,24025,24026,48051
27655,,l8hm_wk-y7uj,24026,24027,48053
27656,,kshobmhrqvaj,24027,24028,48055
27657,,j8loewq34euj,24028,24029,48057
27658,,heb4szl6srej,24029,24030,48059
27659,,sdhzqtijod0j,24030,24031,48061
27660,,jke2ywqocwmj,24031,24032,48063
27661,,1j22qcsibrij,24032,24033,48065
27662,,s4xy_7vlcvkj,24033,24034,48067
27663,,qd3rmouukbmj,24035,24036,48071
27664,,ym8sw7fg4roj,24036,24037,48073
27665,,wsmdlcwzgakj,24037,24038,48075
27666,,i4ze67ka-boj,24038,24039,48077
27667,,bwhpwmbnovwj,24039,24040,48079
27668,,bjt_h3kyaiuj,24040,24041,48081
27669,,19xkq06lmrij,24041,24042,48083
27670,,3skyod9nfekj,24042,24043,48085
27671,,sdsodd-otqcj,24043,24044,48087
27672,,74zz6y4z7hwj,24044,24045,48089
27673,,xv6a0z6pc8mj,24045,24046,48091
27674,,jyifkee66voj,24046,24047,48093
27675,,yannivjw7poj,24047,24048,48095
27676,,nxjncv5p8ewj,24048,24049,48097
27677,,swatszb8qfyj,24049,24050,48099
27678,,7awvn7rq0iyj,24050,24051,48101
27679,,yktd5zjwhnmj,24051,24052,48103
27680,,nivfezjgxjkj,24052,24053,48105
27681,,84xsjtywr0wj,24053,24054,48107
27682,,jv5b2v5riomj,24054,24055,48109
27683,,fehkfsgws6yj,24055,24056,48111
27684,,wp4pq1pymkkj,24056,24057,48113
27685,,omjmhxass6gj,24057,24058,48115
27686,,umrfl3p3jasj,24058,24059,48117
27687,,l13gbjlsw88j,24059,24060,48119
27688,,kxswhlpd6zej,24060,24061,48121
27689,,zp1vwkdj3-wj,24061,24062,48123
27690,,url:http://www.csa.com/partners/viewrecord.php3frequester3dgs26collection3dtrd26recid3dn7531009ah,24062,24063,48125
27691,,cp7zi-8p7wkj,24063,24064,48127
27692,,url:http://portal.acm.org/ft_gateway.cfm3fid3d2866326type3dpdf26dl3dguide26dl3dacm26cfid3d1111111126cftoken3d2222222,24064,24065,48129
27693,,nmikjopzcsoj,24065,24066,48131
27694,,qlw9lrpb3asj,24066,24067,48133
27695,,lurugklk9kaj,24067,24068,48135
27696,,ou9cdvnakbaj,24069,24070,48139
27697,,9n9hlzzetwaj,24070,24071,48141
27698,,xqj5keruspcj,24071,24072,48143
27699,,ymuuyo4fb00j,24072,24073,48145
27700,,pa1a_ie-rxij,24073,24074,48147
27701,,ujrpvnrgpskj,24074,24075,48149
27702,,lbqujnr9ux8j,24075,24076,48151
27703,,dauhada6rjqj,24076,24077,48153
27704,,74hkl9o64yaj,24077,24078,48155
27705,,kxguzvdplv8j,24078,24079,48157
27706,,07ec8ch2uhaj,24079,24080,48159
27707,,badxxj9mlnaj,24080,24081,48161
27708,,hxn5gtigedcj,24081,24082,48163
27709,,zmgs90g7_tmj,24082,24083,48165
27710,,br_thneq1qej,24083,24084,48167
27711,,hwtdtnwciy8j,24084,24085,48169
27712,,c-sh5jdvnmcj,24085,24086,48171
27713,,tuxzqkh6fk4j,24086,24087,48173
27714,,fnfen9wkhj4j,24087,24088,48175
27715,,jsneuh-kopgj,24088,24089,48177
27716,,jcytchmbiemj,24089,24090,48179
27717,,k9yyw7qyw1oj,24090,24091,48181
27718,,ushsb0vzhdkj,24091,24092,48183
27719,,ls-imotljq4j,24092,24093,48185
27720,,fgm3dan1psyj,24093,24094,48187
27721,,e6ygi7bfldaj,24094,24095,48189
27722,,url:http://links.jstor.org/sici3fsici3d0146-4949(196323)4253a3253c284253ateogha253e2.0.co253b2-e,24095,24096,48191
27723,,c_cvah6jyy0j,24096,24097,48193
27724,,url:http://portal.acm.org/ft_gateway.cfm3fid3d50926626type3dpdf26dl3dportal26dl3dacm26cfid3d1111111126cftoken3d2222222,24097,24098,48195
27725,,uyt-6haclhoj,24098,24099,48197
27726,,5mmxvmr7bauj,24099,24100,48199
27727,,sb4h81mu_ecj,24100,24101,48201
27728,,_we1f3tipuuj,24101,24102,48203
27729,,_ecevrjyfx8j,24102,24103,48205
27730,,swb1wdzqqtij,24103,24104,48207
27731,,zzcdiw123qgj,24104,24105,48209
27732,,vbeubh6aykaj,24105,24106,48211
27733,,bzt2q8tpxskj,24106,24107,48213
27734,,44eataivcnyj,24107,24108,48215
27735,,tadjboy5cvoj,24108,24109,48217
27736,,xcs7gpqoliaj,24109,24110,48219
27737,,lvuky6x9bysj,24110,24111,48221
27738,,r4czsb07my0j,24111,24112,48223
27739,,sdplw0jcko0j,24112,24113,48225
27740,,ft6-pmwjb5gj,24113,24114,48227
27741,,sr1mpxkl0wuj,24114,24115,48229
27742,,hwng6uakit0j,24115,24116,48231
27743,,ojjwkozbhl0j,24116,24117,48233
27744,,url:http://www.csa.com/partners/viewrecord.php3frequester3dgs26collection3dtrd26recid3da8622986ah,24117,24118,48235
27745,,3bbxma20zdyj,24118,24119,48237
27746,,q_u0huafha4j,24119,24120,48239
27747,,xxpc5oo6rs0j,24120,24121,48241
27748,,zbk1hpcpzg4j,24121,24122,48243
27749,,ob3gimkzgomj,24122,24123,48245
27750,,sk_bzums1twj,24123,24124,48247
27751,,3nl70mps-lkj,24124,24125,48249
27752,,f1wpvh_ziz8j,24125,24126,48251
27753,,ts6pw4dbhssj,24126,24127,48253
27754,,nyilvpc86_ij,24127,24128,48255
27755,,ii6kgoroh7yj,24129,24130,48259
27756,,knug0h9q7hij,24130,24131,48261
27757,,46l_ogvdfjoj,24131,24132,48263
27758,,qvhrsvczcssj,24132,24133,48265
27759,,o-vvslbfs7ej,24133,24134,48267
27760,,banwqubzv6oj,24134,24135,48269
27761,,lnoaeic7o1sj,24135,24136,48271
27762,,8bursw2uvfaj,24136,24137,48273
27763,,cxbvqmshsvyj,24137,24138,48275
27764,,wndvkt5n9uwj,24138,24139,48277
27765,,iyy9jqbhiscj,24139,24140,48279
27766,,z1kjt6kxg9yj,24140,24141,48281
27767,,cthc978bifmj,24141,24142,48283
27768,,url:http://www.ingentaconnect.com/search/expand3fpub3dinfobike://els/13891286/2001/00000035/00000004/art0018726unc3d,24142,24143,48285
27769,,al770kwrcouj,24143,24144,48287
27770,,cqfpc4jv-hcj,24144,24145,48289
27771,,ke26fffgbyaj,24145,24146,48291
27772,,wts3dnfv4tgj,24146,24147,48293
27773,,p53oeairygmj,24147,24148,48295
27774,,czcyad79sz0j,24148,24149,48297
27775,,0fex1xsp6jcj,24150,24151,48301
27776,,reqx_sq3c74j,24151,24152,48303
27777,,url:http://doi.wiley.com/10.1002/ace.179,24152,24153,48305
27778,,b3mlzmeebxcj,24153,24154,48307
27779,,j89ld2vpyeuj,24154,24155,48309
27780,,g0jd1_m5ukej,24156,24157,48313
27781,,gg6nitfqttsj,24157,24158,48315
27782,,iatxy-9dtsaj,24158,24159,48317
27783,,z7xgjon_bzuj,24159,24160,48319
27784,,46m3r-d2pvqj,24160,24161,48321
27785,,yo8uxdaszwyj,24161,24162,48323
27786,,rpe9lbxkq3qj,24162,24163,48325
27787,,url:http://www.csa.com/partners/viewrecord.php3frequester3dgs26collection3dtrd26recid3dn9210516ah,24163,24164,48327
27788,,o7pzjxz5jd4j,24164,24165,48329
27789,,yakszd3p7cij,24165,24166,48331
27790,,1wardj4nheoj,24167,24168,48335
27791,,jgffs5laylqj,24169,24170,48339
27792,,tabnizl130qj,24170,24171,48341
27793,,tqgzvloa3buj,24171,24172,48343
27794,,hydibrnov24j,24172,24173,48345
27795,,qzjoahqrwd4j,24173,24174,48347
27796,,p4f5a17fw4cj,24174,24175,48349
27797,,nzdxh7urnfqj,24175,24176,48351
27798,,4t9wn7ro4u0j,24176,24177,48353
27799,,tjbg5puidxij,24177,24178,48355
27800,,prmh6pgr-xuj,24178,24179,48357
27801,,2fiz_0cq7roj,24179,24180,48359
27802,,mifi-jxk8kkj,24180,24181,48361
27803,,bwpecoeudmsj,24181,24182,48363
27804,,c5iiurobp04j,24182,24183,48365
27805,,url:http://adsabs.harvard.edu/abs/1984phdt........37s,24183,24184,48367
27806,,xkbynssbu1ej,24184,24185,48369
27807,,mp0pcnduth0j,24185,24186,48371
27808,,mi3xmgrcchmj,24186,24187,48373
27809,,url:http://ieeexplore.ieee.org/iel1/2206/1630/00042791.pdf3farnumber3d42791,24187,24188,48375
27810,,rcxzggfogfcj,24188,24189,48377
27811,,mzas8jwvyauj,24189,24190,48379
27812,,2lhybl13jcoj,24190,24191,48381
27813,,m6c5aroka9gj,24191,24192,48383
27814,,hvhjh3rbphsj,24192,24193,48385
27815,,83wqw4cinwoj,24193,24194,48387
27816,,blqocryaitgj,24194,24195,48389
27817,,myaigcr-oykj,24195,24196,48391
27818,,rqirjz4tbx4j,24196,24197,48393
27819,,owthc-ie6t0j,24197,24198,48395
27820,,iizo2pumubaj,24198,24199,48397
27821,,esem-hltgegj,24199,24200,48399
27822,,0w_i5xccfvyj,24200,24201,48401
27823,,sw5td9xwqb4j,24201,24202,48403
27824,,1ypb90tzpsuj,24202,24203,48405
27825,,26tvuqo5rkyj,24203,24204,48407
27826,,k1fseaectjij,24204,24205,48409
27827,,dc4dvulix5wj,24205,24206,48411
27828,,,24206,24207,48413
27829,,i1ezkht5ixcj,24207,24208,48415
27830,,gta4xqpcqusj,24208,24209,48417
27831,,ss7deybmotij,24209,24210,48419
27832,,_bkx17d-y7gj,24210,24211,48421
27833,,1svagl9plwij,24211,24212,48423
27834,,kmvsonvhazij,24212,24213,48425
27835,,tvb6lhkmny8j,24213,24214,48427
27836,,rihks333piyj,24214,24215,48429
27837,,yoc_diseolwj,24215,24216,48431
27838,,v0noftudnioj,24216,24217,48433
27839,,url:http://www.csa.com/partners/viewrecord.php3frequester3dgs26collection3dtrd26recid3dn9210513ah,24217,24218,48435
27840,,txhpjxu15s0j,24218,24219,48437
27841,,d3zlb2oia7ij,24219,24220,48439
27842,,yujga5gacvwj,24220,24221,48441
27843,,lyzg9ozj8p8j,24221,24222,48443
27844,,url:http://portal.acm.org/citation.cfm3fid3d171926.171967,24222,24223,48445
27845,,vuk6w3thdjsj,24223,24224,48447
27846,,,24224,24225,48449
27847,,lo6rinub0vyj,24225,24226,48451
27848,,kk7d8xv9w5oj,24226,24227,48453
27849,,wrvexn3yxd0j,24227,24228,48455
27850,,vc8x8xz9y00j,24228,24229,48457
27851,,6bnyssj9fkkj,24229,24230,48459
27852,,jat8wvws4ckj,24230,24231,48461
27853,,uyvcfl4ixd8j,24231,24232,48463
27854,,9xzz9ta2f5kj,24232,24233,48465
27855,,0emtqxtj74yj,24233,24234,48467
27856,,lwvewhy_xh8j,24234,24235,48469
27857,,abh4vg1qtckj,24235,24236,48471
27858,,898rlyxireoj,24236,24237,48473
27859,,qnterob_uw8j,24237,24238,48475
27860,,uq6tyvdjbsyj,24238,24239,48477
27861,,pdpcus1wtk4j,24239,24240,48479
27862,,s1f-rfciuy0j,24240,24241,48481
27863,,vri9v9dkdaoj,24241,24242,48483
27864,,gnx9kwa1yeoj,24242,24243,48485
27865,,bjzii2cccosj,24243,24244,48487
27866,,uugjah8uglsj,24244,24245,48489
27867,,easrefe4zdaj,24245,24246,48491
27868,,bykcvtdcxzcj,24246,24247,48493
27869,,8a8rkzhr3wgj,24247,24248,48495
27870,,chwazkustmkj,24248,24249,48497
27871,,w_vral6eqpwj,24249,24250,48499
27872,,qpneqvrormwj,24250,24251,48501
27873,,emvcwlbwid4j,24251,24252,48503
27874,,ycfkpk2zldsj,24252,24253,48505
27875,,hwgtjyvlc9uj,24254,24255,48509
27876,,mlrzuqyd_bcj,24255,24256,48511
27877,,doblmv6puy4j,24257,24258,48515
27878,,r1si5mmbloij,24258,24259,48517
27879,,2p3gsaonhnqj,24259,24260,48519
27880,,ncgbjts3uo0j,24260,24261,48521
27881,,qvzukahcwdoj,24261,24262,48523
27882,,jbowiaik0vej,24262,24263,48525
27883,,wpzpg3qgdc8j,24263,24264,48527
27884,,rfnzuhzbp_oj,24264,24265,48529
27885,,bp6i81kobbaj,24265,24266,48531
27886,,tvvf-qfefemj,24266,24267,48533
27887,,,24267,24268,48535
27888,,vunofmkc3_4j,24268,24269,48537
27889,,g7bthdqbb7uj,24269,24270,48539
27890,,80thrza6kamj,24271,24272,48543
27891,,p1oqsemrdn0j,24272,24273,48545
27892,,crw5w2eadtuj,24273,24274,48547
27893,,nyqrxexs8v4j,24274,24275,48549
27894,,5xma1r2rab8j,24275,24276,48551
27895,,tipujpjmxosj,24277,24278,48555
27896,,ezbiehxgnyqj,24278,24279,48557
27897,,8sp4c29ghgoj,24279,24280,48559
27898,,nby-ujljvwmj,24280,24281,48561
27899,,ov5gshdaynmj,24281,24282,48563
27900,,fr8ifgpnmkej,24282,24283,48565
27901,,6xssnxt0f8sj,24283,24284,48567
27902,,bydv_qdfnccj,24284,24285,48569
27903,,url:http://adsabs.harvard.edu/abs/1974ippd.rept.....s,24285,24286,48571
27904,,dganbgxasbej,24286,24287,48573
27905,,uaxaxyysl-uj,24287,24288,48575
27906,,url:http://www.csa.com/partners/viewrecord.php3frequester3dgs26collection3dtrd26recid3da7423818ah,24288,24289,48577
27907,,4dn7myb6om4j,24289,24290,48579
27908,,swo6pxjsb0kj,24291,24292,48583
27909,,zr0viiah9hej,24292,24293,48585
27910,,xuoomnwxaacj,24293,24294,48587
27911,,gxok-mz4b1cj,24294,24295,48589
27912,,k2q5ybtgnlij,24295,24296,48591
27913,,skwfloup6uoj,24296,24297,48593
27914,,7tbammfxpdyj,24297,24298,48595
27915,,hofvuq8lndoj,24298,24299,48597
27916,,y1nub0brmzej,24299,24300,48599
27917,,h-tyltytlh4j,24300,24301,48601
27918,,8oailwaxdsej,24301,24302,48603
27919,,pgksbbrnew0j,24302,24303,48605
27920,,zqw-mo_l_rij,24303,24304,48607
27921,,sxaszqybeucj,24304,24305,48609
27922,,gcyw7m-anp4j,24305,24306,48611
27923,,ngf6zodbxh0j,24306,24307,48613
27924,,m0lnb84z1usj,24307,24308,48615
27925,,1y0jrk86eemj,24308,24309,48617
27926,,nfnrktronzwj,24309,24310,48619
27927,,uewrmfdcl-8j,24310,24311,48621
27928,,s0ycc4h8ewcj,24311,24312,48623
27929,,vd0h2wg55cij,24312,24313,48625
27930,,jxdbwoqcilij,24313,24314,48627
27931,,kohd3perntij,24314,24315,48629
27932,,i87uimm5ebaj,24315,24316,48631
27933,,lenbieekm5oj,24316,24317,48633
27934,,cuplii6ccpqj,24317,24318,48635
27935,,4e70y1ijuccj,24319,24320,48639
27936,,url:http://www.springerlink.com/index/3ryc8ca8yh6r89ev.pdf,24320,24321,48641
27937,,3ufxu0xtgqaj,24321,24322,48643
27938,,w0ziavcspryj,24322,24323,48645
27939,,piqhmvfobiaj,24323,24324,48647
27940,,sfodp0h_u_4j,24324,24325,48649
27941,,r2zwfmzwiqej,24325,24326,48651
27942,,ixverlo3kkqj,24326,24327,48653
27943,,oms-eiwqgrej,24327,24328,48655
27944,,sedkil_dlrwj,24329,24330,48659
27945,,mkxs3uropy0j,24330,24331,48661
27946,,dcuxnb5zoiij,24331,24332,48663
27947,,wcopym-vv7sj,24332,24333,48665
27948,,bvcqt7zfoaoj,24333,24334,48667
27949,,url:http://portal.acm.org/ft_gateway.cfm3fid3d21526026type3dhtm26dl3dguide26dl3dacm26cfid3d1111111126cftoken3d2222222,24334,24335,48669
27950,,url:http://www.csa.com/partners/viewrecord.php3frequester3dgs26collection3dtrd26recid3d200111010705mt26recid3da0032638ah,24335,24336,48671
27951,,9cze45kfvduj,24336,24337,48673
27952,,x9psaiaodj4j,24337,24338,48675
27953,,oxwzlbxtmtyj,24338,24339,48677
27954,,jh2mxhxhduij,24339,24340,48679
27955,,kf0b7uutiv0j,24340,24341,48681
27956,,sehrxmkawcwj,24341,24342,48683
27957,,kyaf0euuhoaj,24342,24343,48685
27958,,wu9udwgpukej,24343,24344,48687
27959,,7r9bzbhsu_0j,24344,24345,48689
27960,,y65ispqmaeyj,24345,24346,48691
27961,,adsj2uwtkbuj,24346,24347,48693
27962,,um5nbyjhemsj,24347,24348,48695
27963,,sxedmfsvei0j,24348,24349,48697
27964,,lv38qfth5coj,24349,24350,48699
27965,,cuw2u0h7mmej,24350,24351,48701
27966,,j3xhynp1yzmj,24351,24352,48703
27967,,zsbsj8ecfg8j,24352,24353,48705
27968,,96pk1idag90j,24353,24354,48707
27969,,6uympvjqrqoj,24355,24356,48711
27970,,7ia2olaxk5wj,24356,24357,48713
27971,,gd_dvjp2yqwj,24357,24358,48715
27972,,url:http://www.ingentaconnect.com/search/expand3fpub3dinfobike://els/09505849/2001/00000043/00000015/art0020026unc3d,24358,24359,48717
27973,,url:http://www.csa.com/partners/viewrecord.php3frequester3dgs26collection3dtrd26recid3d20021212023583mt26recid3da7642823ah,24359,24360,48719
27974,,2ixvkuryxpsj,24360,24361,48721
27975,,asdy6febwukj,24361,24362,48723
27976,,3ihvjmskuscj,24362,24363,48725
27977,,kt6qwzdpqtej,24363,24364,48727
27978,,zsrc6dj2wfmj,24364,24365,48729
27979,,khga_imrgrej,24365,24366,48731
27980,,zazipof6smsj,24366,24367,48733
27981,,j_rfnb8nnowj,24367,24368,48735
27982,,ab3gucde2j8j,24368,24369,48737
27983,,rzhd-oqjw2gj,24370,24371,48741
27984,,7ovbf4fndxsj,24371,24372,48743
27985,,cijq0qxrkmij,24372,24373,48745
27986,,h6zrbgumesmj,24373,24374,48747
27987,,vj1muj30tbyj,24374,24375,48749
27988,,8cmt_igf3dqj,24375,24376,48751
27989,,tgqltny4ckij,24376,24377,48753
27990,,1im8yos6tjkj,24377,24378,48755
27991,,amjodyyqrbgj,24378,24379,48757
27992,,bz-co548tiaj,24379,24380,48759
27993,,f-ax-ney2cmj,24381,24382,48763
27994,,zvepnkvdhhij,24382,24383,48765
27995,,ht8naoyn4e4j,24383,24384,48767
27996,,mtd-hfjz7hyj,24384,24385,48769
27997,,cjgclnshdgij,24385,24386,48771
27998,,2sfgnlsiihej,24386,24387,48773
27999,,4ha7bs5vq3mj,24387,24388,48775
28000,,kib_o2vzpqwj,24388,24389,48777
28001,,urdsebza7joj,24389,24390,48779
28002,,dmwxgobg6jaj,24390,24391,48781
28003,,xomhia0a1imj,24391,24392,48783
28004,,co197zb9wzoj,24392,24393,48785
28005,,url:http://www.csa.com/partners/viewrecord.php3frequester3dgs26collection3dtrd26recid3da8622991ah,24393,24394,48787
28006,,url:http://links.jstor.org/sici3fsici3d0146-4949(196622)7253a2253c131253anaaijp253e2.0.co253b2-8,24394,24395,48789
28007,,qeyefdpxydgj,24395,24396,48791
28008,,k8ovc1sqwbwj,24396,24397,48793
28009,,4rlgayqxjbyj,24397,24398,48795
28010,,yqhlo3jwi68j,24398,24399,48797
28011,,zu2asf6-j08j,24399,24400,48799
28012,,fzsgcyh7isij,24401,24402,48803
28013,,vunuh4cdl5aj,24402,24403,48805
28014,,mmbabuvatqoj,24403,24404,48807
28015,,7mcti3mtracj,24404,24405,48809
28016,,b6wj1dwixvej,24405,24406,48811
28017,,,24406,24407,48813
28018,,ktz9-c48nvsj,24407,24408,48815
28019,,url:http://portal.acm.org/ft_gateway.cfm3fid3d36209626type3dpdf26dl3dguide26dl3dacm26cfid3d1111111126cftoken3d2222222,24408,24409,48817
28020,,wyo6xpsqeykj,24409,24410,48819
28021,,zu_2vnzp9bwj,24410,24411,48821
28022,,w3-h6njlj54j,24411,24412,48823
28023,,nkqtoymufe4j,24412,24413,48825
28024,,kivharybqe0j,24413,24414,48827
28025,,zlugwbg5ppaj,24414,24415,48829
28026,,7kumgkaaeqwj,24416,24417,48833
28027,,ijct3i_kjbej,24417,24418,48835
28028,,9dt6jrzqi8gj,24418,24419,48837
28029,,8l5iafykjqaj,24419,24420,48839
28030,,ninvkcmyyw8j,24420,24421,48841
28031,,c92zccegmv0j,24421,24422,48843
28032,,4ukvtvasyisj,24422,24423,48845
28033,,hl7achc1mgyj,24423,24424,48847
28034,,ofcub1ivwgaj,24424,24425,48849
28035,,abwgx4oluh4j,24425,24426,48851
28036,,pegfdzfmjbwj,24426,24427,48853
28037,,uozqkhdbklej,24427,24428,48855
28038,,mg-b7vrs_3yj,24428,24429,48857
28039,,qmk_ie61veaj,24429,24430,48859
28040,,pjxbnx3xyboj,24430,24431,48861
28041,,,24431,24432,48863
28042,,eawkno7h3y4j,24432,24433,48865
28043,,ba5jwjtor8oj,24433,24434,48867
28044,,vgugpjkqjccj,24434,24435,48869
28045,,dmazagv16r8j,24435,24436,48871
28046,,qmccf_wrp-yj,24436,24437,48873
28047,,dpyucfthrwoj,24437,24438,48875
28048,,abztdba56a4j,24438,24439,48877
28049,,3fpogeoiawuj,24439,24440,48879
28050,,wkcdtg_5kfgj,24440,24441,48881
28051,,cqxf_s7hptqj,24441,24442,48883
28052,,5zqduj8ypg8j,24442,24443,48885
28053,,doqypdimyaqj,24443,24444,48887
28054,,3aktk5pic5ij,24444,24445,48889
28055,,qgxbtmcjdykj,24445,24446,48891
28056,,hwfnrgxj6iij,24446,24447,48893
28057,,4q1lwuvvtsij,24447,24448,48895
28058,,dbyj6vjxdwoj,24448,24449,48897
28059,,f82ssxyctq0j,24449,24450,48899
28060,,uwpejacy6sqj,24450,24451,48901
28061,,f1isx6h-rxmj,24451,24452,48903
28062,,bwsqfbs1arsj,24452,24453,48905
28063,,ize2ubqd9m4j,24453,24454,48907
28064,,vrd2aak6g-wj,24454,24455,48909
28065,,mnveozon_9mj,24455,24456,48911
28066,,aeyj1ef5upcj,24456,24457,48913
28067,,url:http://portal.acm.org/ft_gateway.cfm3fid3d108360326type3dpdf,24457,24458,48915
28068,,h_oxq6ntheuj,24458,24459,48917
28069,,yx2edm9slpcj,24459,24460,48919
28070,,qjl6letjrroj,24460,24461,48921
28071,,1yow-qfykvej,24461,24462,48923
28072,,xrmvpn_0kfoj,24462,24463,48925
28073,,1inocgwfamkj,24463,24464,48927
28074,,we0qyycwtbmj,24464,24465,48929
28075,,myutsgdxuw4j,24465,24466,48931
28076,,r2rbh2hl3jgj,24466,24467,48933
28077,,zqfpwdkln7oj,24467,24468,48935
28078,,8zmr3fizilwj,24468,24469,48937
28079,,95uowrlcmbkj,24470,24471,48941
28080,,do0jd2q3nayj,24471,24472,48943
28081,,l1921ku5l-mj,24472,24473,48945
28082,,rlipe7_qsrmj,24473,24474,48947
28083,,eopbawzmpk4j,24474,24475,48949
28084,,wsoitlfr1n4j,24475,24476,48951
28085,,5goldgvfqrsj,24476,24477,48953
28086,,pzqcmigkermj,24477,24478,48955
28087,,o90zyuop9q0j,24478,24479,48957
28088,,sduywrplkbij,24480,24481,48961
28089,,zeut6hlzi-gj,24481,24482,48963
28090,,x1isr0f6haaj,24482,24483,48965
28091,,ilxx7e1nxc4j,24483,24484,48967
28092,,ett0rp85agaj,24484,24485,48969
28093,,bx6ggz9sjvcj,24485,24486,48971
28094,,yomwpppc29kj,24486,24487,48973
28095,,url:http://portal.acm.org/ft_gateway.cfm3fid3d102772026type3dpdf,24487,24488,48975
28096,,tdqjmczwoqcj,24488,24489,48977
28097,,lh_8bjgunpkj,24489,24490,48979
28098,,b9sqcmyi3f4j,24490,24491,48981
28099,,d8j1em5tueoj,24491,24492,48983
28100,,yo2abn30gimj,24492,24493,48985
28101,,3chzhv64iscj,24493,24494,48987
28102,,kkvl443qwe4j,24494,24495,48989
28103,,l-jm9hyrkggj,24495,24496,48991
28104,,nciydwyvoa8j,24496,24497,48993
28105,,atdpnpiwhzyj,24497,24498,48995
28106,,_xnrjw3fbwoj,24498,24499,48997
28107,,86u6fgcbjvmj,24499,24500,48999
28108,,2zbrcjgag_kj,24500,24501,49001
28109,,url:http://www.csa.com/partners/viewrecord.php3frequester3dgs26collection3dtrd26recid3dn8621946ah,24501,24502,49003
28110,,url:http://www.csa.com/partners/viewrecord.php3frequester3dgs26collection3dtrd26recid3da8622961ah,24502,24503,49005
28111,,ibqn4rxg9o4j,24503,24504,49007
28112,,ybqtilndqb4j,24504,24505,49009
28113,,zftampkkrbqj,24505,24506,49011
28114,,k6ib2lmpjcsj,24506,24507,49013
28115,,w0oe6jeet4gj,24507,24508,49015
28116,,y-vepodlfwsj,24508,24509,49017
28117,,4cljd2cffgkj,24509,24510,49019
28118,,zzymvtajsnqj,24510,24511,49021
28119,,jt61imqez-qj,24511,24512,49023
28120,,mqezu5h7bgaj,24512,24513,49025
28121,,gv1vxtk6csej,24513,24514,49027
28122,,url:http://doi.wiley.com/10.1002/anie.199111881,24514,24515,49029
28123,,r0d16nnkgn8j,24515,24516,49031
28124,,msk0xhsckuij,24516,24517,49033
28125,,h8hdyuoatz4j,24517,24518,49035
28126,,tkvzfognhiuj,24518,24519,49037
28127,,19dlijancugj,24519,24520,49039
28128,,sbvyopunx1mj,24520,24521,49041
28129,,url:http://www.ncbi.nlm.nih.gov/entrez/query.fcgi3fcmd3dretrieve26db3dpubmed26list_uids3d74841926dopt3dcitation,24521,24522,49043
28130,,1euzk7xdnfij,24522,24523,49045
28131,,yzkuhf1-en0j,24523,24524,49047
28132,,url:http://www.springerlink.com/index/t564770251648nh7.pdf,24524,24525,49049
28133,,92dm0_euf2kj,24525,24526,49051
28134,,nn-7aqujvpwj,24526,24527,49053
28135,,fiagl8qmizqj,24527,24528,49055
28136,,v35lihxpf1cj,24528,24529,49057
28137,,bh6w9uolt2ej,24529,24530,49059
28138,,ohme9-ogyeyj,24530,24531,49061
28139,,bi5qhbyihguj,24531,24532,49063
28140,,url:http://www.blackwell-synergy.com/links/doi/10.1111/j.0033-0124.1975.00002.x/abs/,24532,24533,49065
28141,,pvm4f6ptfskj,24533,24534,49067
28142,,dv7p-cftjuqj,24534,24535,49069
28143,,qfx4hqqv9rwj,24535,24536,49071
28144,,url:http://ieeexplore.ieee.org/iel1/2206/2685/00081889.pdf3farnumber3d81889,24536,24537,49073
28145,,uakuwilocp4j,24537,24538,49075
28146,,g1uk0jdd3nqj,24538,24539,49077
28147,,vdclppnvvqgj,24539,24540,49079
28148,,fzwmr6lozkwj,24540,24541,49081
28149,,imyhel-utwcj,24541,24542,49083
28150,,fizgu-xmdxkj,24542,24543,49085
28151,,y_27u3y5g94j,24543,24544,49087
28152,,2wtkxxs6p0oj,24545,24546,49091
28153,,j_ji52ov_kyj,24547,24548,49095
28154,,xoitt_hgks0j,24548,24549,49097
28155,,dzjg2g-3lxuj,24549,24550,49099
28156,,czzwgc8dm8sj,24550,24551,49101
28157,,euowqxmxb6gj,24551,24552,49103
28158,,tsqpzhsgowgj,24552,24553,49105
28159,,ddhd_jv1auwj,24553,24554,49107
28160,,edo5qw7vkwmj,24554,24555,49109
28161,,mnkx1offyryj,24555,24556,49111
28162,,lpdbpqegisoj,24556,24557,49113
28163,,7nivj4yoikyj,24557,24558,49115
28164,,lazwaritryaj,24558,24559,49117
28165,,fpme9knrg08j,24559,24560,49119
28166,,url:http://ieeexplore.ieee.org/iel2/407/6051/00234934.pdf3farnumber3d234934,24560,24561,49121
28167,,r4llrsgdrvej,24561,24562,49123
28168,,drc1zl4obraj,24562,24563,49125
28169,,lrnvpvdektej,24563,24564,49127
28170,,atqetdrwpnwj,24564,24565,49129
28171,,9emkt6mrrogj,24565,24566,49131
28172,,22lkbjo2epsj,24566,24567,49133
28173,,bglj6qkmjjkj,24567,24568,49135
28174,,t53gssepf2wj,24568,24569,49137
28175,,anxsj1bqzr4j,24569,24570,49139
28176,,mf0o7bwgw8kj,24570,24571,49141
28177,,yk6luzkiyb0j,24571,24572,49143
28178,,vvw-yipq6zcj,24572,24573,49145
28179,,050gamiuxuej,24573,24574,49147
28180,,ph6zrbg6czuj,24574,24575,49149
28181,,zajvmibt26uj,24575,24576,49151
28182,,nztxrlsytuij,24576,24577,49153
28183,,y3os8dzentsj,24577,24578,49155
28184,,kpxjknstu5sj,24578,24579,49157
28185,,cdm573sudy8j,24579,24580,49159
28186,,ojel6v0u9csj,24580,24581,49161
28187,,w4_lzfs09omj,24581,24582,49163
28188,,ye6a6hw7viej,24582,24583,49165
28189,,wpunno3fqeyj,24583,24584,49167
28190,,miftqkfuh88j,24584,24585,49169
28191,,dsffdan1wbej,24586,24587,49173
28192,,cyvxxvi8cccj,24587,24588,49175
28193,,vnnke8fwh_gj,24588,24589,49177
28194,,u5h99yfvjtej,24589,24590,49179
28195,,0jfyern68sej,24590,24591,49181
28196,,xqgwz-yccaij,24591,24592,49183
28197,,9dlou2khtwsj,24592,24593,49185
28198,,h7gikx2m054j,24593,24594,49187
28199,,j-f7b78ovn8j,24594,24595,49189
28200,,2evq9omen5mj,24595,24596,49191
28201,,_eultfqd0q0j,24596,24597,49193
28202,,hjc33iu49yuj,24597,24598,49195
28203,,mpgmcjwewbcj,24598,24599,49197
28204,,t3rb7pifnsmj,24599,24600,49199
28205,,tnarg4qfdi0j,24600,24601,49201
28206,,zbjuvftwobgj,24601,24602,49203
28207,,jwj2ief5eiej,24602,24603,49205
28208,,url:http://www.springerlink.com/index/m240k6g7hptt0377.pdf,24603,24604,49207
28209,,d7hd9vvzjnwj,24604,24605,49209
28210,,c-biowztzvoj,24605,24606,49211
28211,,url:http://portal.acm.org/citation.cfm3fid3d1027527.1027770,24606,24607,49213
28212,,en2fqetahg4j,24607,24608,49215
28213,,rx4whlps3vwj,24608,24609,49217
28214,,0tc6ebpaaisj,24609,24610,49219
28215,,gtfoqhquzy0j,24610,24611,49221
28216,,iecf5buh5nmj,24611,24612,49223
28217,,xgppzklmqquj,24612,24613,49225
28218,,pgatujz-ngcj,24613,24614,49227
28219,,url:http://portal.acm.org/citation.cfm3fid3d984341.98434226coll3dguide26dl3dacm26idx3dj68926part3dperiodical26wanttype3dperiodical26title3dacm2520sigmod2520record26cfid3d1111111126cftoken3d2222222,24614,24615,49229
28220,,1x66kqseftaj,24615,24616,49231
28221,,wm1n_0l28xwj,24616,24617,49233
28222,,hzfdtcx1b4aj,24617,24618,49235
28223,,deu9yhnz15mj,24618,24619,49237
28224,,buju6twrdd8j,24619,24620,49239
28225,,url:http://doi.wiley.com/10.1002/ev.1505,24620,24621,49241
28226,,qjovh3f84qij,24621,24622,49243
28227,,vhmhfv2ebeij,24622,24623,49245
28228,,dlne3_wl2j4j,24623,24624,49247
28229,,fwswy1vsaq4j,24624,24625,49249
28230,,gfjeoxhwenkj,24625,24626,49251
28231,,,24626,24627,49253
28232,,tr3kanunofij,24627,24628,49255
28233,,xdropdgkrakj,24628,24629,49257
28234,,8mzawtblwyaj,24629,24630,49259
28235,,m3gcs-ezfxcj,24630,24631,49261
28236,,yo0fkec5yvyj,24631,24632,49263
28237,,lxz5cibib3wj,24632,24633,49265
28238,,hzoa0mqzdaij,24633,24634,49267
28239,,6z1xf0grkx4j,24634,24635,49269
28240,,ykpxl63tlokj,24635,24636,49271
28241,,url:http://www.ncbi.nlm.nih.gov/entrez/query.fcgi3fcmd3dretrieve26db3dpubmed26list_uids3d73912026dopt3dcitation,24636,24637,49273
28242,,1t1-3w57dtcj,24637,24638,49275
28243,,noqbx4-owkqj,24638,24639,49277
28244,,bp_puq_qch0j,24639,24640,49279
28245,,o-hljxfc22oj,24640,24641,49281
28246,,mo-snywayawj,24641,24642,49283
28247,,bb0aog0xvjaj,24642,24643,49285
28248,,ggd0h4kmwgmj,24643,24644,49287
28249,,dowxfm8fbdij,24644,24645,49289
28250,,3ws8bn56dhgj,24645,24646,49291
28251,,oh-7rp5i04ej,24646,24647,49293
28252,,4z4ofntkucgj,24647,24648,49295
28253,,7uhazzl1yxij,24648,24649,49297
28254,,bm9yt0-e3ayj,24649,24650,49299
28255,,ivm7iy47ejoj,24650,24651,49301
28256,,_7prtbdcb0ej,24651,24652,49303
28257,,k9oal7oav6kj,24652,24653,49305
28258,,g7u7nclt5aoj,24653,24654,49307
28259,,51vwkx3_zhsj,24654,24655,49309
28260,,z0gtenb-3cmj,24655,24656,49311
28261,,url:http://www.csa.com/partners/viewrecord.php3frequester3dgs26collection3dtrd26recid3da8622923ah,24656,24657,49313
28262,,3pvikeykihaj,24657,24658,49315
28263,,6tbboaiilq4j,24658,24659,49317
28264,,ufvgy53kptuj,24660,24661,49321
28265,,url:http://www.csa.com/partners/viewrecord.php3frequester3dgs26collection3dtrd26recid3d20021212029377mt26recid3da7340046ah,24661,24662,49323
28266,,by0ams-equij,24662,24663,49325
28267,,bjgdcimamykj,24663,24664,49327
28268,,1dlqvppuzfqj,24664,24665,49329
28269,,ljflykguqp0j,24665,24666,49331
28270,,k6wgskghlysj,24666,24667,49333
28271,,snfn7jybozmj,24667,24668,49335
28272,,rdkhjtrosi8j,24668,24669,49337
28273,,qzxwqdwu5waj,24669,24670,49339
28274,,ddoigndkp6kj,24671,24672,49343
28275,,uzzeayr0ljaj,24672,24673,49345
28276,,8qn9sdwsjyyj,24673,24674,49347
28277,,iv8zo1i17tsj,24674,24675,49349
28278,,i21vu2sodeoj,24675,24676,49351
28279,,x8joscm8lhsj,24676,24677,49353
28280,,zuqy8ml38iij,24677,24678,49355
28281,,4ld2y596ngwj,24678,24679,49357
28282,,n2yqwfbgnr4j,24679,24680,49359
28283,,ynxp3gjnxtyj,24680,24681,49361
28284,,52f3k8x3z8gj,24681,24682,49363
28285,,zlb79e1t8k8j,24682,24683,49365
28286,,euhrt2kx5vaj,24683,24684,49367
28287,,axxp8bnzkmmj,24684,24685,49369
28288,,n7_cnfj2jxkj,24685,24686,49371
28289,,duwbku4bc1mj,24686,24687,49373
28290,,ardczljqizaj,24687,24688,49375
28291,,url:http://portal.acm.org/citation.cfm3fid3d115586.115592,24688,24689,49377
28292,,omo4z94ringj,24689,24690,49379
28293,,ln80ltmd4mej,24690,24691,49381
28294,,url:http://pubs.acs.org/cgi-bin/abstract.cgi/achre4/2005/38/i09/abs/ar0402356.html,24691,24692,49383
28295,,6m8nrigpcoaj,24692,24693,49385
28296,,b9ikqvr7bb4j,24693,24694,49387
28297,,ou3cl_x1paej,24694,24695,49389
28298,,5a9npxkm5p8j,24695,24696,49391
28299,,x8rv7rg4ensj,24696,24697,49393
28300,,rg2osrkmaisj,24697,24698,49395
28301,,7mma3u5thh8j,24698,24699,49397
28302,,iaxnd-l5znkj,24699,24700,49399
28303,,dxpmwljqqyqj,24700,24701,49401
28304,,zu-og8yjxwej,24701,24702,49403
28305,,mve_gv7ddykj,24702,24703,49405
28306,,escyzyrsiquj,24703,24704,49407
28307,,qdfbamqymwuj,24704,24705,49409
28308,,3l-8bjykf1qj,24705,24706,49411
28309,,vxlk65oxjzaj,24706,24707,49413
28310,,gsjxb7ulwpmj,24707,24708,49415
28311,,qoktgl1xthij,24708,24709,49417
28312,,r2xabr22a0qj,24709,24710,49419
28313,,kma3th41ovqj,24710,24711,49421
28314,,whbzkxcbrr8j,24711,24712,49423
28315,,q633in0ane8j,24712,24713,49425
28316,,l9m1kcapy-kj,24715,24716,49431
28317,,di4wm5ygvgyj,24716,24717,49433
28318,,ty8tlrklil4j,24717,24718,49435
28319,,koqy0ftb7baj,24718,24719,49437
28320,,,24719,24720,49439
28321,,joipt9urz1mj,24720,24721,49441
28322,,w6_ekzvfg3gj,24721,24722,49443
28323,,7ljgy3wmcbsj,24722,24723,49445
28324,,2pv5bch8v9kj,24723,24724,49447
28325,,n54kbzfircij,24724,24725,49449
28326,,gn62io2us4gj,24725,24726,49451
28327,,wktysto07fuj,24726,24727,49453
28328,,trp1tlsr5ioj,24727,24728,49455
28329,,srxcs00ywv0j,24728,24729,49457
28330,,yhhyfwr5hy4j,24729,24730,49459
28331,,jwvawg-qdqaj,24730,24731,49461
28332,,m-u5lyyr6sij,24731,24732,49463
28333,,6d_ww1fkgboj,24732,24733,49465
28334,,h_yetj96-vcj,24733,24734,49467
28335,,wjbh9xyntlwj,24734,24735,49469
28336,,url:http://www.csa.com/partners/viewrecord.php3frequester3dgs26collection3dtrd26recid3d200111010664mt26recid3da0032565ah,24735,24736,49471
28337,,jn8j9pomjuuj,24736,24737,49473
28338,,33djtikg2jmj,24737,24738,49475
28339,,50bftvcpfwej,24738,24739,49477
28340,,jsoadovvmouj,24739,24740,49479
28341,,sa4p684ztf4j,24740,24741,49481
28342,,puzm8rwjejcj,24741,24742,49483
28343,,xcumlr-9mwsj,24742,24743,49485
28344,,lxbinqfw3iej,24743,24744,49487
28345,,jmizmjgji-oj,24744,24745,49489
28346,,yylquipvnakj,24745,24746,49491
28347,,url:http://portal.acm.org/ft_gateway.cfm3fid3d102764026type3dpdf,24746,24747,49493
28348,,vcjjzqqswk0j,24747,24748,49495
28349,,g_aipzwnod0j,24748,24749,49497
28350,,url:http://portal.acm.org/ft_gateway.cfm3fid3d108376626type3dpdf,24749,24750,49499
28351,,pzea0mpq_ekj,24750,24751,49501
28352,,hslsokeyag0j,24751,24752,49503
28353,,minnbwcnh_wj,24752,24753,49505
28354,,bzcoyrszhkij,24753,24754,49507
28355,,1xj9cynsr_mj,24754,24755,49509
28356,,url:http://adsabs.harvard.edu/abs/1973phdt........10h,24755,24756,49511
28357,,7pbh4dxtet0j,24756,24757,49513
28358,,cu0nkddyowyj,24757,24758,49515
28359,,7lk_1ncwumej,24758,24759,49517
28360,,btmkizkheosj,24759,24760,49519
28361,,aday32g50jyj,24760,24761,49521
28362,,xhmtpgropcsj,24761,24762,49523
28363,,yijjdoqezdcj,24763,24764,49527
28364,,url:http://doi.wiley.com/10.1002/(sici)1521-3773(19991004)38:19253c2894::aid-anie2894253e3.0.co3b2-f,24764,24765,49529
28365,,kkh3xajkfvuj,24765,24766,49531
28366,,da4tq5br2amj,24766,24767,49533
28367,,sjvbubemingj,24767,24768,49535
28368,,fotkjqbxakkj,24768,24769,49537
28369,,ygeoaf-b-bwj,24769,24770,49539
28370,,nbu35wxnphij,24770,24771,49541
28371,,i3ckbljtfycj,24771,24772,49543
28372,,sm10xarqcg8j,24773,24774,49547
28373,,8f79vb7uezqj,24774,24775,49549
28374,,zk-btinzsruj,24776,24777,49553
28375,,6jyxzga85gij,24777,24778,49555
28376,,qjmx9v1djowj,24778,24779,49557
28377,,yyb79peynjmj,24779,24780,49559
28378,,t_sohhc7efoj,24780,24781,49561
28379,,itcl7r4gc_ej,24781,24782,49563
28380,,tzir7efkiqwj,24782,24783,49565
28381,,gzuan3dke5gj,24783,24784,49567
28382,,1jnye88jyfuj,24784,24785,49569
28383,,okgy-dm_l9uj,24785,24786,49571
28384,,a_pi30caqxaj,24786,24787,49573
28385,,7voqtxvhc_8j,24787,24788,49575
28386,,bj8rtthbvgyj,24788,24789,49577
28387,,u2ybfw2m77yj,24789,24790,49579
28388,,njj_h0mvr5qj,24790,24791,49581
28389,,6nggsqz2fiij,24791,24792,49583
28390,,jwr06b1wgnmj,24792,24793,49585
28391,,hydeilfo6omj,24793,24794,49587
28392,,ngbda6havl0j,24794,24795,49589
28393,,aqdjjjj-ceej,24795,24796,49591
28394,,bc8w5hru47aj,24796,24797,49593
28395,,v0ty6g0dhmcj,24797,24798,49595
28396,,eo-absvawbyj,24798,24799,49597
28397,,url:http://doi.wiley.com/10.1002/tl.126,24799,24800,49599
28398,,qvnjl-suu9mj,24800,24801,49601
28399,,makk97xbj88j,24801,24802,49603
28400,,_vn0zilazwsj,24802,24803,49605
28401,,7nv6-s-slekj,24803,24804,49607
28402,,dyp_ou6znpkj,24804,24805,49609
28403,,9s1p158ryk0j,24805,24806,49611
28404,,he_nvzprxi4j,24806,24807,49613
28405,,l_bgvh5fkx4j,24807,24808,49615
28406,,f-rmja5_xpqj,24808,24809,49617
28407,,ume9yhzqhqaj,24809,24810,49619
28408,,aocppqrqt64j,24810,24811,49621
28409,,s5xc5te5kxqj,24811,24812,49623
28410,,6zk8zoo8husj,24812,24813,49625
28411,,avauvrhvvw0j,24813,24814,49627
28412,,8a_z47nyhtcj,24814,24815,49629
28413,,3n-chnxjrp8j,24815,24816,49631
28414,,uanb6hq0rusj,24816,24817,49633
28415,,waoda90g7ogj,24817,24818,49635
28416,,heg3dh4mpk4j,24818,24819,49637
28417,,url:http://portal.acm.org/ft_gateway.cfm3fid3d12205726type3dpdf,24819,24820,49639
28418,,wfevcu1btugj,24820,24821,49641
28419,,,24821,24822,49643
28420,,qlem_azteduj,24822,24823,49645
28421,,usgvwokm0zqj,24823,24824,49647
28422,,url:http://portal.acm.org/ft_gateway.cfm3fid3d102759326type3dpdf,24824,24825,49649
28423,,zvaz2ew1xmsj,24825,24826,49651
28424,,iywdyq3u_qkj,24826,24827,49653
28425,,n-hh1w36jvyj,24827,24828,49655
28426,,4hl0dejrdzij,24828,24829,49657
28427,,1ljvzbj4psuj,24829,24830,49659
28428,,url:http://www.csa.com/partners/viewrecord.php3frequester3dgs26collection3dtrd26recid3d0052398ci26recid3d0052398ea,24830,24831,49661
28429,,om20yxsru1qj,24831,24832,49663
28430,,kvprjy-k4iqj,24832,24833,49665
28431,,8ir1nrq4zm8j,24833,24834,49667
28432,,ukokub0xro0j,24834,24835,49669
28433,,sntwdnb_578j,24835,24836,49671
28434,,ltygctzt7mij,24836,24837,49673
28435,,n1a-yxidvjcj,24837,24838,49675
28436,,n1vswbxv1qej,24838,24839,49677
28437,,7rwxrxtmhzcj,24839,24840,49679
28438,,fixcq_ozfmsj,24840,24841,49681
28439,,zmmhkani9o0j,24841,24842,49683
28440,,url:http://doi.wiley.com/10.1002/ev.1272,24842,24843,49685
28441,,i1fp72nml1kj,24843,24844,49687
28442,,vken7fakrm8j,24844,24845,49689
28443,,ublxbohh8kuj,24845,24846,49691
28444,,thb6sqecx-qj,24846,24847,49693
28445,,gl3sbyuxecaj,24847,24848,49695
28446,,mgjpsmu57igj,24848,24849,49697
28447,,px9njcapraaj,24849,24850,49699
28448,,rtfrlap5h6mj,24850,24851,49701
28449,,dfjt-3kl_c8j,24851,24852,49703
28450,,vcbja2qkejwj,24852,24853,49705
28451,,kdcjvttjjp0j,24853,24854,49707
28452,,gcpfhtuqpbyj,24854,24855,49709
28453,,8zb9bxt85eij,24855,24856,49711
28454,,tk19rgo0dn8j,24856,24857,49713
28455,,ss97pplbaosj,24857,24858,49715
28456,,4z9h6fhszsaj,24858,24859,49717
28457,,url:http://portal.acm.org/ft_gateway.cfm3fid3d106625626type3dpdf,24859,24860,49719
28458,,uquezrgvdpkj,24860,24861,49721
28459,,shvvadaksquj,24861,24862,49723
28460,,mtjjvwpto1oj,24862,24863,49725
28461,,qehg2lprstkj,24863,24864,49727
28462,,1nbixms06kwj,24864,24865,49729
28463,,0jvvv2oz3bsj,24865,24866,49731
28464,,anj0f7kgqcgj,24866,24867,49733
28465,,bdxdbhpvcumj,24867,24868,49735
28466,,c9fcjms88omj,24868,24869,49737
28467,,uw8esiwf1pij,24869,24870,49739
28468,,3jijvbah6eaj,24871,24872,49743
28469,,lju1yrtmlxej,24872,24873,49745
28470,,jafpu0r5cpgj,24873,24874,49747
28471,,qoljkvc2moyj,24874,24875,49749
28472,,x9gwguikszqj,24875,24876,49751
28473,,aqc379dsllij,24876,24877,49753
28474,,mv_cktvtamsj,24877,24878,49755
28475,,blhjetxffssj,24878,24879,49757
28476,,yd3wuwag2i4j,24879,24880,49759
28477,,uanvpf-3upij,24880,24881,49761
28478,,s01os2ascrqj,24881,24882,49763
28479,,khd977gitekj,24883,24884,49767
28480,,ocis_llbgr0j,24884,24885,49769
28481,,6nifrobccacj,24885,24886,49771
28482,,bpt2mwv3zo4j,24886,24887,49773
28483,,dn6aeubtfiyj,24887,24888,49775
28484,,xajgipwfz7yj,24888,24889,49777
28485,,ywt8efy9wqoj,24889,24890,49779
28486,,70ttvhcebrkj,24890,24891,49781
28487,,y5gli9ezj3yj,24891,24892,49783
28488,,bra6ip7y8dwj,24892,24893,49785
28489,,5iwuowfxmvuj,24893,24894,49787
28490,,iljie8-f_7qj,24894,24895,49789
28491,,0us3724scxcj,24895,24896,49791
28492,,ux2eb7kj0_8j,24896,24897,49793
28493,,fanhdyovphuj,24897,24898,49795
28494,,b4donikibf8j,24898,24899,49797
28495,,uyj1cjxz4iuj,24899,24900,49799
28496,,qxj5by0cqcaj,24900,24901,49801
28497,,pbq-nyw3db0j,24901,24902,49803
28498,,7hbfnndle8ij,24902,24903,49805
28499,,8mxnpmjzequj,24903,24904,49807
28500,,nyp5fedlf-cj,24904,24905,49809
28501,,urdj4hghlaqj,24905,24906,49811
28502,,iq6itu491sij,24906,24907,49813
28503,,fnx4dbcgjkwj,24907,24908,49815
28504,,ertpfow2ubyj,24908,24909,49817
28505,,g_uazl9b8asj,24909,24910,49819
28506,,cftlv2rvms4j,24910,24911,49821
28507,,ukh9q8d0i90j,24911,24912,49823
28508,,mhwgd04tvfoj,24912,24913,49825
28509,,idqn11yozf8j,24913,24914,49827
28510,,i0ryir1auhyj,24914,24915,49829
28511,,9jcmeqwmriaj,24915,24916,49831
28512,,sk5jseswhuoj,24916,24917,49833
28513,,qp6bwvbjbpmj,24917,24918,49835
28514,,doq1u_c0ohwj,24918,24919,49837
28515,,ffy-8lmdwzcj,24919,24920,49839
28516,,_0ugbazedz0j,24920,24921,49841
28517,,zqfrulr5x2sj,24921,24922,49843
28518,,rjkfjmhjkfuj,24922,24923,49845
28519,,0gxnawfxwruj,24923,24924,49847
28520,,v-i8sxwuo5oj,24924,24925,49849
28521,,blnae2pgesuj,24925,24926,49851
28522,,umzhodurpdej,24926,24927,49853
28523,,q8qt-3uiykcj,24927,24928,49855
28524,,5e9ggcfuy14j,24928,24929,49857
28525,,url:http://www.springerlink.com/index/h618761246483650.pdf,24929,24930,49859
28526,,jbom9ljs9lwj,24930,24931,49861
28527,,p9sdu6nogayj,24931,24932,49863
28528,,rrmvlfjdin8j,24932,24933,49865
28529,,cnfeevxbjdyj,24933,24934,49867
28530,,p0cdypsnq-uj,24934,24935,49869
28531,,_yn_xubvq7qj,24935,24936,49871
28532,,bizufl3ruzwj,24936,24937,49873
28533,,yhzlfmhybvoj,24937,24938,49875
28534,,ig1qkk5uoxaj,24938,24939,49877
28535,,url:http://adsabs.harvard.edu/abs/1976infph..16...55k,24939,24940,49879
28536,,s7ynehmdb-yj,24940,24941,49881
28537,,jxdmy2wmrhqj,24941,24942,49883
28538,,pkzv9yclygej,24942,24943,49885
28539,,fzno-6vstjuj,24943,24944,49887
28540,,abmgp1kfvxij,24944,24945,49889
28541,,ml-ofmpry6aj,24945,24946,49891
28542,,url:http://portal.acm.org/ft_gateway.cfm3fid3d109959626type3dpdf,24946,24947,49893
28543,,sm3bm76o6jej,24948,24949,49897
28544,,5asvaxwggumj,24949,24950,49899
28545,,newln1skensj,24950,24951,49901
28546,,9zsalrp3haqj,24951,24952,49903
28547,,wfkk1v3vamgj,24952,24953,49905
28548,,gws46uq_t38j,24953,24954,49907
28549,,gf-dm2f0wqgj,24954,24955,49909
28550,,url:http://portal.acm.org/ft_gateway.cfm3fid3d102752826type3dpdf,24955,24956,49911
28551,,ap7og96tyusj,24956,24957,49913
28552,,omxk3iknz24j,24957,24958,49915
28553,,ncwodjkvqpoj,24958,24959,49917
28554,,qgycmdvw1lqj,24959,24960,49919
28555,,864ms9yag0ij,24960,24961,49921
28556,,ba28dtp-ekwj,24961,24962,49923
28557,,b9ud25ukumij,24962,24963,49925
28558,,ujjvb-xsgnej,24963,24964,49927
28559,,url:http://portal.acm.org/citation.cfm3fid3d29682.29683,24964,24965,49929
28560,,qoriz2ieahej,24966,24967,49933
28561,,j0l0mhj7nx8j,24967,24968,49935
28562,,hmejey1bfn8j,24968,24969,49937
28563,,rz8wgom-ip8j,24970,24971,49941
28564,,uik0uoyzhgaj,24971,24972,49943
28565,,xueggjbol6cj,24972,24973,49945
28566,,dkep8xg0nyoj,24973,24974,49947
28567,,agdpiouhaxmj,24974,24975,49949
28568,,qvpx2oseswmj,24975,24976,49951
28569,,ehtserpzfvuj,24976,24977,49953
28570,,rnmifu9mpdmj,24977,24978,49955
28571,,wqcakzr4ts8j,24978,24979,49957
28572,,lmmjh-qpklej,24979,24980,49959
28573,,_depedv0yawj,24980,24981,49961
28574,,yxyd6qbt_wej,24981,24982,49963
28575,,ujh0k7nhrc4j,24982,24983,49965
28576,,qc_wxuzh6soj,24983,24984,49967
28577,,xtypp3r3voej,24984,24985,49969
28578,,z21tw8rbm8kj,24985,24986,49971
28579,,vhbh2te0ll0j,24986,24987,49973
28580,,hk9e0zxu3umj,24987,24988,49975
28581,,slnrsrzkq-sj,24988,24989,49977
28582,,n8y_hzfwt2cj,24989,24990,49979
28583,,c5dw3mijdjqj,24990,24991,49981
28584,,zqgumx-fjkoj,24991,24992,49983
28585,,_-vk9n_wmvwj,24992,24993,49985
28586,,4ljzss4hz4cj,24994,24995,49989
28587,,c8g65frw9u8j,24995,24996,49991
28588,,vzwjtlhcuywj,24996,24997,49993
28589,,bnktys4ptayj,24997,24998,49995
28590,,6ytxnpzmca0j,24998,24999,49997
28591,,ntsntg6svygj,24999,25000,49999
28592,,eutld3r6dwgj,25000,25001,50001
28593,,olgt5cxjnvcj,25001,25002,50003
28594,,x-ukmt_9euej,25003,25004,50007
28595,,1yuucyp7wiej,25004,25005,50009
28596,,6mwaij0zqtij,25005,25006,50011
28597,,q3odajmflt4j,25006,25007,50013
28598,,nbl9zdys1akj,25007,25008,50015
28599,,xhedldvwdgmj,25008,25009,50017
28600,,_mrrwbubrwaj,25009,25010,50019
28601,,d1w-r2pbfkej,25010,25011,50021
28602,,s5qw9czjahij,25011,25012,50023
28603,,irbbistnyqqj,25012,25013,50025
28604,,f0y2wvpj4iyj,25013,25014,50027
28605,,paoklvu3b48j,25014,25015,50029
28606,,vgmpijvxivmj,25015,25016,50031
28607,,url:http://www.csa.com/partners/viewrecord.php3frequester3dgs26collection3denv26recid3d8913264,25016,25017,50033
28608,,k3x5pxeqcmqj,25017,25018,50035
28609,,5syum1lil2cj,25018,25019,50037
28610,,url:http://adsabs.harvard.edu/abs/1976scom.nasa..740m,25019,25020,50039
28611,,h4r-wakjwswj,25020,25021,50041
28612,,cvu_ax3e5x4j,25021,25022,50043
28613,,d-3voaqs9zyj,25022,25023,50045
28614,,_tenlfr6c2ij,25023,25024,50047
28615,,i90ugbyquv8j,25024,25025,50049
28616,,ceo0s35yen8j,25025,25026,50051
28617,,mdpjghwdpccj,25026,25027,50053
28618,,tiovuzhl4mwj,25027,25028,50055
28619,,vkl01w7jm14j,25029,25030,50059
28620,,myvtdaxj4wyj,25030,25031,50061
28621,,url:http://www.ingentaconnect.com/search/expand3fpub3dinfobike://els/08830355/2001/00000035/00000006/art0001426unc3d,25031,25032,50063
28622,,fcvbmgsiac4j,25032,25033,50065
28623,,diwgffcg1aij,25033,25034,50067
28624,,jibw1ok02dgj,25034,25035,50069
28625,,6oaijadupucj,25035,25036,50071
28626,,xejumetwdsoj,25036,25037,50073
28627,,ndniopmzexwj,25037,25038,50075
28628,,url:http://portal.acm.org/citation.cfm3fid3d984514.98452126coll3dguide26dl3dacm26idx3dj68926part3dperiodical26wanttype3dperiodical26title3dacm2520sigmod2520record26cfid3d1111111126cftoken3d2222222,25038,25039,50077
28629,,url:http://www.csa.com/partners/viewrecord.php3frequester3dgs26collection3dtrd26recid3dn9210459ah,25039,25040,50079
28630,,fkhmni2jlrgj,25040,25041,50081
28631,,50okpicdx1yj,25041,25042,50083
28632,,nszydj1e8g4j,25042,25043,50085
28633,,ebk6yqpreauj,25043,25044,50087
28634,,omaelxln0usj,25044,25045,50089
28635,,ogqykcjac7sj,25045,25046,50091
28636,,url:http://www.springerlink.com/index/v36953v81722j623.pdf,25046,25047,50093
28637,,9tzxoxmqgsmj,25047,25048,50095
28638,,5g9jkqixkf0j,25048,25049,50097
28639,,n5q8xdqfr5wj,25049,25050,50099
28640,,ntk1vijdyocj,25050,25051,50101
28641,,klszvqykrxyj,25051,25052,50103
28642,,jjc4twwyakmj,25052,25053,50105
28643,,wm_5hfvj294j,25053,25054,50107
28644,,tlu1tos6hmyj,25054,25055,50109
28645,,url:http://doi.wiley.com/10.1002/ace.7403,25055,25056,50111
28646,,url:http://ieeexplore.ieee.org/xpl/abs_free.jsp3farnumber3d9069,25056,25057,50113
28647,,pbdnleci7noj,25057,25058,50115
28648,,jfcwqwlvjtkj,25058,25059,50117
28649,,rxe3_keqcyoj,25059,25060,50119
28650,,i3dgqixcb5uj,25060,25061,50121
28651,,_f0_hofd3wwj,25061,25062,50123
28652,,5f8bn6hqocij,25062,25063,50125
28653,,px9neqcq_8ej,25063,25064,50127
28654,,vexpcke8nd8j,25064,25065,50129
28655,,sizmcozuhcyj,25065,25066,50131
28656,,qu8bcmhn3ymj,25066,25067,50133
28657,,hg6zjawii44j,25067,25068,50135
28658,,ghy7i8y8ljmj,25068,25069,50137
28659,,6ujxkoy-gtmj,25069,25070,50139
28660,,kvy-s1xpmgej,25071,25072,50143
28661,,sbbjah_0218j,25072,25073,50145
28662,,nw3_bfgkik0j,25073,25074,50147
28663,,dwpocfcbz78j,25074,25075,50149
28664,,zxeernu1l24j,25075,25076,50151
28665,,gwv7jq-v-eqj,25076,25077,50153
28666,,gmud1o-upvyj,25077,25078,50155
28667,,8usm-pnwuj4j,25078,25079,50157
28668,,qbfwuft5g3ej,25079,25080,50159
28669,,jdz-ngxaxvyj,25081,25082,50163
28670,,oi1vimnzsqmj,25082,25083,50165
28671,,l1tbwzuuqugj,25083,25084,50167
28672,,di8sjd2hgnwj,25084,25085,50169
28673,,zcwa3xrpaqkj,25085,25086,50171
28674,,w_fy1waqyfqj,25086,25087,50173
28675,,jqujfhuxuscj,25087,25088,50175
28676,,ftqkvh86s3aj,25088,25089,50177
28677,,gx5pfcykxwej,25089,25090,50179
28678,,otbacqhg2z0j,25090,25091,50181
28679,,_6exs50tibcj,25091,25092,50183
28680,,3coqh5oovxkj,25092,25093,50185
28681,,url:http://portal.acm.org/ft_gateway.cfm3fid3d110116426type3dpdf,25093,25094,50187
28682,,wdeojzchsyij,25094,25095,50189
28683,,yf2plrsl848j,25095,25096,50191
28684,,dmq7fwfvexmj,25096,25097,50193
28685,,sdvwuxomozcj,25097,25098,50195
28686,,5jyrccsmeuwj,25098,25099,50197
28687,,gfagzmlvfiqj,25099,25100,50199
28688,,xwfwoqdcrpoj,25100,25101,50201
28689,,kcuyjzm9aksj,25101,25102,50203
28690,,y6vyjd2nlwgj,25102,25103,50205
28691,,6_mveu4caksj,25103,25104,50207
28692,,mypvzubuir8j,25104,25105,50209
28693,,gnfbsp4dawqj,25105,25106,50211
28694,,ozadzbsj7kkj,25106,25107,50213
28695,,gs-k7kvynzsj,25107,25108,50215
28696,,kbmc6w_hn6gj,25108,25109,50217
28697,,sa0guvdmo4ij,25109,25110,50219
28698,,z848cqjgv1ij,25110,25111,50221
28699,,cocdiiipkj4j,25111,25112,50223
28700,,qfsbywoybcsj,25112,25113,50225
28701,,rgndajm-asaj,25113,25114,50227
28702,,vsdnk-lyjdoj,25114,25115,50229
28703,,mkbmo7g5jecj,25115,25116,50231
28704,,mdpk2jhpnnyj,25116,25117,50233
28705,,_gdybz61absj,25117,25118,50235
28706,,dw1tpray2ymj,25118,25119,50237
28707,,ajy_kggaspoj,25119,25120,50239
28708,,kftc_tsqip8j,25120,25121,50241
28709,,omvdggt_o4aj,25121,25122,50243
28710,,7lngisqzng0j,25122,25123,50245
28711,,3wvt29eyxrcj,25123,25124,50247
28712,,url:http://doi.wiley.com/10.1002/he.18,25124,25125,50249
28713,,ullt46gvik0j,25125,25126,50251
28714,,4rfv1u9cs4wj,25126,25127,50253
28715,,url:http://www.springerlink.com/index/k56667728633340h.pdf,25127,25128,50255
28716,,aiio1qupjucj,25128,25129,50257
28717,,t1fdmi5byhyj,25129,25130,50259
28718,,vgoorscycagj,25130,25131,50261
28719,,toflotnu3bgj,25131,25132,50263
28720,,n7ydfjuvfeuj,25132,25133,50265
28721,,j1i7ah4cizsj,25133,25134,50267
28722,,dkoloon9_vaj,25134,25135,50269
28723,,kbstmbjcs88j,25135,25136,50271
28724,,vsc6pqvtwpkj,25136,25137,50273
28725,,ypfvp9tc7r0j,25137,25138,50275
28726,,rypiihbkupij,25138,25139,50277
28727,,w9c52jqzikyj,25139,25140,50279
28728,,2k6gk_-pd8aj,25140,25141,50281
28729,,aiy1cudybnqj,25141,25142,50283
28730,,dyutujjk1jaj,25142,25143,50285
28731,,o9ywzndvnb8j,25143,25144,50287
28732,,6jg2vrthw4uj,25144,25145,50289
28733,,h6mvootr1mgj,25145,25146,50291
28734,,342rftt1ulwj,25146,25147,50293
28735,,hphagx5vlumj,25147,25148,50295
28736,,url:http://portal.acm.org/ft_gateway.cfm3fid3d95703826type3dpdf26dl3dguide26dl3dacm26cfid3d1111111126cftoken3d2222222,25148,25149,50297
28737,,u-atuiufqkwj,25149,25150,50299
28738,,lo87gb0bdtkj,25150,25151,50301
28739,,yflaz1alkpoj,25151,25152,50303
28740,,7kw9xw7qhesj,25152,25153,50305
28741,,ggmfi7ywi4gj,25153,25154,50307
28742,,ftbam_jaf4wj,25154,25155,50309
28743,,m09uxxi4cmkj,25155,25156,50311
28744,,osbp-ebh6xgj,25156,25157,50313
28745,,aryzs5-qtgqj,25157,25158,50315
28746,,erbocmi3q-4j,25158,25159,50317
28747,,f91oxg60excj,25160,25161,50321
28748,,evgyhw03z8ej,25161,25162,50323
28749,,nedc1svr6zij,25162,25163,50325
28750,,g55qmrtkltoj,25163,25164,50327
28751,,kpofakkp5amj,25164,25165,50329
28752,,vfsa35iip8kj,25165,25166,50331
28753,,url:http://doi.wiley.com/10.1002/ace.78,25166,25167,50333
28754,,69zyy-dob-wj,25167,25168,50335
28755,,w7xbgh4jpqgj,25168,25169,50337
28756,,ysg5zp-clo4j,25169,25170,50339
28757,,lsh5zdqsnrmj,25170,25171,50341
28758,,5bqqte8d2acj,25171,25172,50343
28759,,xqviqeje3ygj,25172,25173,50345
28760,,usujb2k7b2wj,25173,25174,50347
28761,,47ia4_p4ypgj,25174,25175,50349
28762,,clmnjmp6ttmj,25175,25176,50351
28763,,xy8vealzmucj,25176,25177,50353
28764,,l1mx1dcubbej,25177,25178,50355
28765,,5mspn_ldxhuj,25178,25179,50357
28766,,url:http://www.springerlink.com/index/j051030734uv2784.pdf,25179,25180,50359
28767,,7e3wnewowdij,25180,25181,50361
28768,,url:http://portal.acm.org/ft_gateway.cfm3fid3d109970526type3dpdf,25181,25182,50363
28769,,tc9vnmz2lpwj,25182,25183,50365
28770,,lu6gavp0bwkj,25183,25184,50367
28771,,dyu7x1hxmycj,25184,25185,50369
28772,,vax1txh7z9gj,25185,25186,50371
28773,,2viz2vl1juoj,25186,25187,50373
28774,,nq7csmvfjq8j,25187,25188,50375
28775,,sou9anw0xkqj,25188,25189,50377
28776,,3xvysqsaun8j,25189,25190,50379
28777,,hxcytejiyrcj,25190,25191,50381
28778,,kyfyqylnm2gj,25191,25192,50383
28779,,tnyqsouj0dkj,25192,25193,50385
28780,,kfqykpldhmcj,25193,25194,50387
28781,,v8zdy5fmbaqj,25194,25195,50389
28782,,4bbwsfhvz5aj,25195,25196,50391
28783,,url:http://portal.acm.org/ft_gateway.cfm3fid3d19567526type3dpdf26dl3dguide26dl3dacm26cfid3d1111111126cftoken3d2222222,25196,25197,50393
28784,,x3ndfaimjrgj,25197,25198,50395
28785,,wmao3pdq85gj,25198,25199,50397
28786,,cvtec4a-auij,25199,25200,50399
28787,,akr9mfkun58j,25200,25201,50401
28788,,9axsxoedvd0j,25201,25202,50403
28789,,izrv1iybfgkj,25202,25203,50405
28790,,mfyt0zgj9loj,25203,25204,50407
28791,,x6c1mqckhbij,25204,25205,50409
28792,,s_bzr0_cp88j,25205,25206,50411
28793,,k9bxkpoyiksj,25206,25207,50413
28794,,url:http://www.blackwell-synergy.com/links/doi/10.1111/j.0033-0124.1987.00317.x/abs/,25207,25208,50415
28795,,jif7fgiub-ij,25208,25209,50417
28796,,bs5pbkzy8qij,25209,25210,50419
28797,,url:http://portal.acm.org/citation.cfm3fid3d171926.172011,25210,25211,50421
28798,,tf7mcnrlup0j,25211,25212,50423
28799,,sakeqth7ntej,25212,25213,50425
28800,,rlhlrg3-vg8j,25213,25214,50427
28801,,ikqqh6rgreoj,25214,25215,50429
28802,,oz6ebbby-cmj,25215,25216,50431
28803,,inoyr0i0gscj,25216,25217,50433
28804,,votvtvnvflqj,25217,25218,50435
28805,,pn_jdkzx4x8j,25218,25219,50437
28806,,4dgvnlaxcryj,25219,25220,50439
28807,,bdmqkj5k-wgj,25220,25221,50441
28808,,-8zgeidh6c4j,25221,25222,50443
28809,,bovn9x5r5vsj,25222,25223,50445
28810,,uahd-wdxwmsj,25223,25224,50447
28811,,bviqy6t_lwgj,25224,25225,50449
28812,,dvhucesyjp8j,25225,25226,50451
28813,,bkogg_3jl2wj,25226,25227,50453
28814,,vwn9ztd8jxsj,25227,25228,50455
28815,,toeuskndqhuj,25228,25229,50457
28816,,vmyjs3n_yx8j,25229,25230,50459
28817,,o1k3wblsbqoj,25230,25231,50461
28818,,8labgpmy8vij,25231,25232,50463
28819,,url:http://www.springerlink.com/index/q211058260jj0627.pdf,25232,25233,50465
28820,,ofevgzy7hwoj,25233,25234,50467
28821,,y-6kw9rnu7gj,25234,25235,50469
28822,,nflivgw4q48j,25235,25236,50471
28823,,lh8etgtr-q4j,25236,25237,50473
28824,,dfddy8hspuwj,25237,25238,50475
28825,,ma_p5r0p5ksj,25238,25239,50477
28826,,url:http://adsabs.harvard.edu/abs/1978phdt........55h,25239,25240,50479
28827,,zjliwcxymtwj,25240,25241,50481
28828,,zebxpgjcmvqj,25241,25242,50483
28829,,phr6fdu3qk0j,25242,25243,50485
28830,,ke0foj1uaokj,25243,25244,50487
28831,,uxznjtni_eyj,25244,25245,50489
28832,,e3nbqel4gv8j,25245,25246,50491
28833,,bhyltyu1-nuj,25246,25247,50493
28834,,yqphodejwgkj,25247,25248,50495
28835,,xr_mqdab8o8j,25248,25249,50497
28836,,jvfftu-lpycj,25249,25250,50499
28837,,mjqlivtiy0ij,25250,25251,50501
28838,,2i2v-0cd3kkj,25251,25252,50503
28839,,m8iz_liswoij,25252,25253,50505
28840,,e0jfsdonhayj,25253,25254,50507
28841,,jt-4thrkqryj,25254,25255,50509
28842,,url:http://www.csa.com/partners/viewrecord.php3frequester3dgs26collection3dtrd26recid3dn9210520ah,25255,25256,50511
28843,,st8j-gfx0h8j,25256,25257,50513
28844,,4psbeysra_ej,25257,25258,50515
28845,,hufjqsyd5ssj,25258,25259,50517
28846,,url:http://portal.acm.org/ft_gateway.cfm3fid3d32011226type3dpdf26dl3dguide26dl3dacm26cfid3d1111111126cftoken3d2222222,25259,25260,50519
28847,,3ilbawi4e6aj,25260,25261,50521
28848,,hcswh21oujyj,25261,25262,50523
28849,,url:http://portal.acm.org/ft_gateway.cfm3fid3d35323826type3dpdf26dl3dguide26dl3dacm26cfid3d1111111126cftoken3d2222222,25262,25263,50525
28850,,vh1yzruzhiwj,25263,25264,50527
28851,,c5mppqjca2sj,25264,25265,50529
28852,,rriszqxyvcyj,25265,25266,50531
28853,,6pplxr_qhxcj,25266,25267,50533
28854,,njlhiamq6noj,25268,25269,50537
28855,,umgun2rcvtej,25269,25270,50539
28856,,dnlhkxolsmoj,25270,25271,50541
28857,,sopgvfewgdaj,25271,25272,50543
28858,,pg1fdvhhk0uj,25272,25273,50545
28859,,vb4ni6fvtbaj,25273,25274,50547
28860,,q0ulddivmwcj,25274,25275,50549
28861,,r6n2hegtuj8j,25275,25276,50551
28862,,p1_5qffde0aj,25276,25277,50553
28863,,8anvhu9wrluj,25277,25278,50555
28864,,ril7hzdg6rqj,25278,25279,50557
28865,,hzuy1vyz7iaj,25279,25280,50559
28866,,fakwjnkxvkij,25280,25281,50561
28867,,hmay9ppfrs0j,25281,25282,50563
28868,,lxawvce92bkj,25283,25284,50567
28869,,tcpy5vdrwwyj,25284,25285,50569
28870,,ckcnybq2bp0j,25285,25286,50571
28871,,_55ewv5ntbgj,25286,25287,50573
28872,,op_igvr0ugqj,25287,25288,50575
28873,,url:http://portal.acm.org/ft_gateway.cfm3fid3d109970226type3dpdf,25288,25289,50577
28874,,jakfg0mkuqyj,25289,25290,50579
28875,,myy0nyolcr0j,25290,25291,50581
28876,,a6eygn0_dtij,25291,25292,50583
28877,,sr26dvp70paj,25292,25293,50585
28878,,t_c7-zro-rej,25293,25294,50587
28879,,url:http://www.csa.com/partners/viewrecord.php3frequester3dgs26collection3dtrd26recid3d0456638ci,25294,25295,50589
28880,,url:http://www.springerlink.com/index/w85488467824n218.pdf,25295,25296,50591
28881,,nx-cpfwir1kj,25296,25297,50593
28882,,nyfmj3hmreuj,25297,25298,50595
28883,,rar1vkbcwzqj,25298,25299,50597
28884,,5k5cyklfw-sj,25299,25300,50599
28885,,atq_k4dfbsaj,25300,25301,50601
28886,,iiljzwnd4r4j,25301,25302,50603
28887,,giv0yfz_o0oj,25302,25303,50605
28888,,9twa8qzn6vkj,25304,25305,50609
28889,,qgtxtpqxtdsj,25305,25306,50611
28890,,h2oqxgjbo_mj,25306,25307,50613
28891,,,25307,25308,50615
28892,,va7vh495dxkj,25308,25309,50617
28893,,qm-r5p341asj,25309,25310,50619
28894,,09akiq_tdcij,25310,25311,50621
28895,,ufs528fyyh8j,25311,25312,50623
28896,,azu2wabxzysj,25312,25313,50625
28897,,bet0wcmuadaj,25313,25314,50627
28898,,3gurjelnrdcj,25314,25315,50629
28899,,s73pzkyrvcyj,25315,25316,50631
28900,,url:http://ieeexplore.ieee.org/iel5/7344/19927/00921278.pdf3farnumber3d921278,25316,25317,50633
28901,,2uogxlzuhyoj,25317,25318,50635
28902,,a1pkyvsaimcj,25318,25319,50637
28903,,ym86mreb-psj,25319,25320,50639
28904,,url:http://www.csa.com/partners/viewrecord.php3frequester3dgs26collection3dtrd26recid3dn9118026ah,25321,25322,50643
28905,,lvzu3hss61aj,25322,25323,50645
28906,,afp0wb1wpwij,25323,25324,50647
28907,,dcicz0o7yt0j,25324,25325,50649
28908,,dwszt430ttyj,25325,25326,50651
28909,,pa889hzdlcaj,25326,25327,50653
28910,,2wqz7tdjeygj,25327,25328,50655
28911,,t5rdhbyqhwmj,25328,25329,50657
28912,,nizxffdsofkj,25329,25330,50659
28913,,zvo5rjepfeyj,25330,25331,50661
28914,,lcxuuwfdv8oj,25331,25332,50663
28915,,qjae_qhdolqj,25332,25333,50665
28916,,n_ba0ot78qyj,25333,25334,50667
28917,,dwemq61yedkj,25334,25335,50669
28918,,hxs9cwa5r8aj,25335,25336,50671
28919,,ocdmecvhfeqj,25336,25337,50673
28920,,1t0qemsuitoj,25337,25338,50675
28921,,,25339,25340,50679
28922,,zvclkm3-ry4j,25340,25341,50681
28923,,oj1zgo4osluj,25341,25342,50683
28924,,gzdopgec5owj,25342,25343,50685
28925,,z7kssgqwdr0j,25343,25344,50687
28926,,its9radnsl8j,25344,25345,50689
28927,,jqlovbj74aoj,25345,25346,50691
28928,,npjldiuwhggj,25346,25347,50693
28929,,yhovd5twsdqj,25347,25348,50695
28930,,t3lqllvguskj,25348,25349,50697
28931,,4qgarkd6la4j,25349,25350,50699
28932,,kbxewevcvyoj,25350,25351,50701
28933,,efouhhblgaqj,25351,25352,50703
28934,,,25352,25353,50705
28935,,qdvcnsinp_0j,25353,25354,50707
28936,,hbkiyhjmyt8j,25354,25355,50709
28937,,4u-dkcrry6sj,25355,25356,50711
28938,,rpufvpdfddmj,25356,25357,50713
28939,,drdmw1hbb9wj,25357,25358,50715
28940,,url:http://portal.acm.org/ft_gateway.cfm3fid3d102770526type3dpdf,25358,25359,50717
28941,,,25359,25360,50719
28942,,4ycuiajymlwj,25360,25361,50721
28943,,33ayjhnpwwkj,25361,25362,50723
28944,,jvjufperjhmj,25362,25363,50725
28945,,gntyuromdf8j,25363,25364,50727
28946,,ay2_rm2tlo4j,25364,25365,50729
28947,,_4eciqlyzrmj,25365,25366,50731
28948,,url:http://portal.acm.org/ft_gateway.cfm3fid3d108359626type3dpdf,25366,25367,50733
28949,,s3ljixz251mj,25367,25368,50735
28950,,url:http://www.springerlink.com/index/wr74427174454867.pdf,25368,25369,50737
28951,,gpayaw1dp30j,25369,25370,50739
28952,,id5ucza0mcqj,25370,25371,50741
28953,,qq2kfneli_8j,25371,25372,50743
28954,,nhwniqyaqr0j,25372,25373,50745
28955,,pse2y5rdldyj,25373,25374,50747
28956,,yye0-zopqlqj,25374,25375,50749
28957,,vwnov44xoewj,25375,25376,50751
28958,,kgd4rjdgj3sj,25376,25377,50753
28959,,ouz7tjfxuxqj,25377,25378,50755
28960,,al84hmzlb4mj,25378,25379,50757
28961,,xkhgeqewo48j,25380,25381,50761
28962,,du5gsqt0_vqj,25381,25382,50763
28963,,crvm3tj13z8j,25382,25383,50765
28964,,zhs0_s2ux9uj,25383,25384,50767
28965,,phcdsbvfa2uj,25384,25385,50769
28966,,url:http://www.csa.com/partners/viewrecord.php3frequester3dgs26collection3dtrd26recid3d0214853ci,25385,25386,50771
28967,,pyggc7yirh0j,25386,25387,50773
28968,,ixy8mksphiuj,25387,25388,50775
28969,,oudhtbfqphej,25388,25389,50777
28970,,kzbubhyo6xmj,25389,25390,50779
28971,,yviwwbqbgt0j,25390,25391,50781
28972,,z_zptoaqowej,25391,25392,50783
28973,,b3ana9ijm28j,25392,25393,50785
28974,,jmnwozqmhokj,25393,25394,50787
28975,,rpfqex_rocgj,25394,25395,50789
28976,,ycql0xlglmoj,25395,25396,50791
28977,,2r6nigbmig0j,25396,25397,50793
28978,,pciojmqvw2qj,25397,25398,50795
28979,,sdiavef1esij,25398,25399,50797
28980,,ck2sde-3yyij,25399,25400,50799
28981,,8ahatrvwsjoj,25400,25401,50801
28982,,_6b9r61ofygj,25401,25402,50803
28983,,tsycepgmcpkj,25403,25404,50807
28984,,xxzflblh_ooj,25404,25405,50809
28985,,wrttpeyheauj,25405,25406,50811
28986,,b7fyvimzdbyj,25406,25407,50813
28987,,z9yquqpdxlaj,25407,25408,50815
28988,,oi-5oe6h6bsj,25408,25409,50817
28989,,url:http://www.csa.com/partners/viewrecord.php3frequester3dgs26collection3dtrd26recid3d074157ws26recid3d7910351444md,25409,25410,50819
28990,,url:http://portal.acm.org/citation.cfm3fid3d984393,25410,25411,50821
28991,,url:http://portal.acm.org/ft_gateway.cfm3fid3d108367426type3dpdf,25411,25412,50823
28992,,url:http://adsabs.harvard.edu/abs/1976scom.nasa..357b,25412,25413,50825
28993,,iqszgynrgb4j,25413,25414,50827
28994,,fsoe2pqm6g8j,25414,25415,50829
28995,,32vw_hgprv4j,25415,25416,50831
28996,,kqyahooep6gj,25416,25417,50833
28997,,oaihsezxigaj,25417,25418,50835
28998,,url:http://www.springerlink.com/index/j6425476814q6x0k.pdf,25418,25419,50837
28999,,4wri8q1aul8j,25419,25420,50839
29000,,orkstyncgnej,25420,25421,50841
29001,,_pd4wldrn14j,25422,25423,50845
29002,,tagsoekox00j,25423,25424,50847
29003,,,25424,25425,50849
29004,,sctkptcl79cj,25425,25426,50851
29005,,vkdhni5dc5oj,25426,25427,50853
29006,,8hdrql3x014j,25427,25428,50855
29007,,9i9v4fn-iv4j,25428,25429,50857
29008,,8hzro6obiwej,25429,25430,50859
29009,,xjoax7kppeyj,25430,25431,50861
29010,,6uajblluogsj,25431,25432,50863
29011,,ynf6ldvnzo0j,25432,25433,50865
29012,,0suhykbgf_oj,25433,25434,50867
29013,,2ox6eufnjfoj,25434,25435,50869
29014,,79nu366etymj,25435,25436,50871
29015,,nw7bryl5xr8j,25436,25437,50873
29016,,hoxbdjahub0j,25437,25438,50875
29017,,ok6pxyrt29aj,25438,25439,50877
29018,,3v6tp3kuemuj,25439,25440,50879
29019,,ghlq4dcw5bqj,25440,25441,50881
29020,,n_wq4cynmvoj,25441,25442,50883
29021,,_mybwbnqplij,25442,25443,50885
29022,,90dnz3remi8j,25443,25444,50887
29023,,url:http://portal.acm.org/ft_gateway.cfm3fid3d110200026type3dpdf,25444,25445,50889
29024,,exhhnrbsv9mj,25445,25446,50891
29025,,bfscveqgtnuj,25446,25447,50893
29026,,fuwvsnyxaacj,25447,25448,50895
29027,,a29gqd973ogj,25448,25449,50897
29028,,5yfgcaeax1mj,25449,25450,50899
29029,,e81b1zuux6cj,25450,25451,50901
29030,,9htqypbhshuj,25451,25452,50903
29031,,d8pgsxg_s9oj,25452,25453,50905
29032,,gnsfgxnhgzaj,25453,25454,50907
29033,,fxn393otli0j,25455,25456,50911
29034,,6b-d7zpravoj,25456,25457,50913
29035,,e0kdnwfgyuij,25457,25458,50915
29036,,zf0qnljctxwj,25458,25459,50917
29037,,url:http://portal.acm.org/ft_gateway.cfm3fid3d110116926type3dpdf,25459,25460,50919
29038,,swpgois7dacj,25460,25461,50921
29039,,ntyz92qa9fej,25461,25462,50923
29040,,idp7ohztwtgj,25462,25463,50925
29041,,3sxniagrhjuj,25463,25464,50927
29042,,57wqo1z44u8j,25464,25465,50929
29043,,0zwkhitclt8j,25465,25466,50931
29044,,0ppp2pnomk8j,25466,25467,50933
29045,,jq4rricyekej,25467,25468,50935
29046,,avn7zvho3mcj,25468,25469,50937
29047,,hmwkfkcapt0j,25470,25471,50941
29048,,7msk1wduu50j,25471,25472,50943
29049,,bx9jefqd_kgj,25472,25473,50945
29050,,2mkiyb7spvij,25473,25474,50947
29051,,6rze022kk3ij,25474,25475,50949
29052,,qljfqtze27qj,25475,25476,50951
29053,,9mdxp7h6x9kj,25476,25477,50953
29054,,ex-rtx61qhgj,25477,25478,50955
29055,,0yrz4kwqz0gj,25478,25479,50957
29056,,i8gefwnlup0j,25479,25480,50959
29057,,pbgqfnkmbp4j,25480,25481,50961
29058,,k7fwiuvd3wuj,25481,25482,50963
29059,,czqcvmlcbpij,25482,25483,50965
29060,,ytm4aq-pojmj,25483,25484,50967
29061,,isyglchzkguj,25484,25485,50969
29062,,i-l5jk0yndyj,25485,25486,50971
29063,,mvcqc79t2cgj,25486,25487,50973
29064,,0dhi4up0wpsj,25487,25488,50975
29065,,-85stbniv4gj,25488,25489,50977
29066,,5ebjutrktwoj,25489,25490,50979
29067,,gps4rwks0osj,25490,25491,50981
29068,,09dyb6yauocj,25491,25492,50983
29069,,6twtfqrudgcj,25492,25493,50985
29070,,uk0atrkfhbej,25493,25494,50987
29071,,kfrnsdxeslej,25494,25495,50989
29072,,necp1r8ljjej,25495,25496,50991
29073,,zhads8x80lmj,25496,25497,50993
29074,,_neccgqfzkaj,25497,25498,50995
29075,,2pm8ijeomo4j,25498,25499,50997
29076,,7rehevzuktyj,25499,25500,50999
29077,,h2_nwzj35lmj,25500,25501,51001
29078,,znozllbosbmj,25501,25502,51003
29079,,rk8pdgzpllij,25502,25503,51005
29080,,or_5ii5prx0j,25503,25504,51007
29081,,rbg6qx7dxl8j,25504,25505,51009
29082,,7kq7iy-nk2aj,25505,25506,51011
29083,,cwve6heb6xmj,25506,25507,51013
29084,,url:http://www.springerlink.com/index/jq8707671371081u.pdf,25507,25508,51015
29085,,qajogw-ffqij,25508,25509,51017
29086,,b0ggtppx7uuj,25509,25510,51019
29087,,pizbkp1-shmj,25510,25511,51021
29088,,3vnbvyimrbyj,25511,25512,51023
29089,,url:http://www.csa.com/partners/viewrecord.php3frequester3dgs26collection3dtrd26recid3dn9210576ah,25512,25513,51025
29090,,pgt6uj8lbvqj,25513,25514,51027
29091,,in6nl_3dn-mj,25514,25515,51029
29092,,5bjtbk4zdzij,25515,25516,51031
29093,,crgrddnt2ckj,25516,25517,51033
29094,,4l2vi588pqaj,25517,25518,51035
29095,,url:http://adsabs.harvard.edu/abs/1976scom.nasa..840b,25518,25519,51037
29096,,axrfsloy1hcj,25519,25520,51039
29097,,-0lu8virytej,25520,25521,51041
29098,,url:http://www.springerlink.com/index/j7t88vp55g073024.pdf,25521,25522,51043
29099,,mscvzgof4iyj,25522,25523,51045
29100,,url:http://links.jstor.org/sici3fsici3d0146-4949(196721)8253a2253c153253anonaar253e2.0.co253b2-8,25523,25524,51047
29101,,3ajrbvupo6yj,25525,25526,51051
29102,,nt0nxg1zjq8j,25526,25527,51053
29103,,t2krxxbbigcj,25527,25528,51055
29104,,h_r325w8gxoj,25528,25529,51057
29105,,lll_zsv1alyj,25529,25530,51059
29106,,9axyahpj5j8j,25530,25531,51061
29107,,yzpfn3dsyeuj,25531,25532,51063
29108,,9rmqdylrgpuj,25532,25533,51065
29109,,dps1qaokgpej,25533,25534,51067
29110,,url:http://portal.acm.org/citation.cfm3fid3d1077961.1077962,25534,25535,51069
29111,,xrgch4cw3ryj,25535,25536,51071
29112,,t0ae_iti5r0j,25536,25537,51073
29113,,9ssm5smkuy4j,25537,25538,51075
29114,,mz2snz5avpcj,25538,25539,51077
29115,,-1yxuf8wtvaj,25539,25540,51079
29116,,4dkdjfaghi0j,25540,25541,51081
29117,,hfcs1yrryzsj,25541,25542,51083
29118,,lgejivwaspqj,25542,25543,51085
29119,,q3gsyhyz-euj,25543,25544,51087
29120,,9fnbffapybij,25544,25545,51089
29121,,rlgcb68ttmgj,25545,25546,51091
29122,,2vdxgfqwzmkj,25546,25547,51093
29123,,7n9trz7ggjkj,25547,25548,51095
29124,,m_nqh_h0dekj,25548,25549,51097
29125,,url:http://www.csa.com/partners/viewrecord.php3frequester3dgs26collection3dtrd26recid3dn9210474ah,25549,25550,51099
29126,,url:http://www.csa.com/partners/viewrecord.php3frequester3dgs26collection3dtrd26recid3d0585188ci,25550,25551,51101
29127,,meh6g0ovzbqj,25551,25552,51103
29128,,tgp_iygwvgqj,25552,25553,51105
29129,,vltxfuajpgqj,25553,25554,51107
29130,,sds3euytd38j,25554,25555,51109
29131,,wvohnvcnbfcj,25555,25556,51111
29132,,sqvrj2t7ez8j,25556,25557,51113
29133,,cw6r80ly4myj,25557,25558,51115
29134,,ugnogvjk7sgj,25558,25559,51117
29135,,duv3nb-tez8j,25559,25560,51119
29136,,upsdmbxn_aaj,25560,25561,51121
29137,,dvdzcb6fuj0j,25561,25562,51123
29138,,ohqmp-y_semj,25562,25563,51125
29139,,xlvpphhaps0j,25563,25564,51127
29140,,r1j8aiv-gr8j,25564,25565,51129
29141,,b7sdhyjreasj,25565,25566,51131
29142,,url:http://portal.acm.org/ft_gateway.cfm3fid3d64100626type3dpdf26dl3dguide26dl3dacm26cfid3d1111111126cftoken3d2222222,25566,25567,51133
29143,,8v2dt2hq5paj,25567,25568,51135
29144,,t_xrllqtrckj,25568,25569,51137
29145,,oyo38apomg4j,25569,25570,51139
29146,,umcca3ec4jwj,25570,25571,51141
29147,,bmzu3zi62wyj,25571,25572,51143
29148,,vgblwu2nbxsj,25572,25573,51145
29149,,pdvnant49jsj,25573,25574,51147
29150,,o7fj_nld2uoj,25574,25575,51149
29151,,vge5ngmnnhuj,25575,25576,51151
29152,,zhc4_soero4j,25576,25577,51153
29153,,uxbg6ixeiraj,25577,25578,51155
29154,,xh4z_inai4aj,25578,25579,51157
29155,,hevvudbwk8mj,25579,25580,51159
29156,,14xprdqmrasj,25580,25581,51161
29157,,xpu6pufxlvej,25581,25582,51163
29158,,9qgp1z8uheij,25582,25583,51165
29159,,rsuvvmqgjsoj,25583,25584,51167
29160,,fokoqhpftncj,25584,25585,51169
29161,,pg7wqemwdawj,25585,25586,51171
29162,,veizngn8_9sj,25586,25587,51173
29163,,owjiisrtnugj,25587,25588,51175
29164,,omw6mamq1_aj,25588,25589,51177
29165,,stjgpdy2swgj,25589,25590,51179
29166,,dboiwsk44s0j,25591,25592,51183
29167,,wjcywpc1l7ej,25592,25593,51185
29168,,url:http://doi.wiley.com/10.1002/tl.112,25593,25594,51187
29169,,wrhh-4upnqaj,25595,25596,51191
29170,,zwp5-xbec7aj,25596,25597,51193
29171,,ia19bpfetoej,25597,25598,51195
29172,,hgzlar_vs9uj,25598,25599,51197
29173,,r6tfduu4ojoj,25599,25600,51199
29174,,mtnspicw6rij,25600,25601,51201
29175,,gqgyn17jhmej,25601,25602,51203
29176,,sfhlfw4eej4j,25602,25603,51205
29177,,a6is-i8f9xuj,25603,25604,51207
29178,,o1oofb0eepkj,25604,25605,51209
29179,,dfvyqmxpnzkj,25605,25606,51211
29180,,ygtk3_xiaxqj,25606,25607,51213
29181,,n5ytxrajpjuj,25607,25608,51215
29182,,u5khxt5pmtuj,25609,25610,51219
29183,,irftnktftjyj,25610,25611,51221
29184,,nsq9spsfgesj,25611,25612,51223
29185,,wkmdh3v7bbaj,25612,25613,51225
29186,,d1stvlkf_iqj,25613,25614,51227
29187,,x7_1losgieyj,25614,25615,51229
29188,,url:http://portal.acm.org/ft_gateway.cfm3fid3d110136526type3dpdf,25615,25616,51231
29189,,0wpcxosvwryj,25616,25617,51233
29190,,hajx9chg0-ej,25617,25618,51235
29191,,lv8bgma6gwmj,25618,25619,51237
29192,,w8pvbe_71lej,25619,25620,51239
29193,,hteg0lakfckj,25620,25621,51241
29194,,htwrzz969xwj,25621,25622,51243
29195,,vtihl7mszhcj,25622,25623,51245
29196,,0bmq7hirtauj,25623,25624,51247
29197,,e-jme5y9dvmj,25624,25625,51249
29198,,5qfwzgxapcoj,25625,25626,51251
29199,,lpxeu6-k_9ej,25626,25627,51253
29200,,pz0maudpmxsj,25627,25628,51255
29201,,2zzkotlvdbij,25628,25629,51257
29202,,pvw-k3oxehgj,25629,25630,51259
29203,,tsx2lw3hjrij,25630,25631,51261
29204,,ozlpmdg7vjwj,25631,25632,51263
29205,,9nxyw0px5nmj,25632,25633,51265
29206,,url:http://doi.wiley.com/10.1002/tl.140,25633,25634,51267
29207,,6tkjcbgyqicj,25634,25635,51269
29208,,url:http://adsabs.harvard.edu/abs/1977phdt........26e,25635,25636,51271
29209,,url:http://portal.acm.org/ft_gateway.cfm3fid3d109974226type3dpdf,25636,25637,51273
29210,,url:http://www.csa.com/partners/viewrecord.php3frequester3dgs26collection3dtrd26recid3dn9210486ah,25637,25638,51275
29211,,cgbao1czkyoj,25638,25639,51277
29212,,9fz2tj2rhnkj,25639,25640,51279
29213,,xekfpgopqlij,25640,25641,51281
29214,,bgaglieyacqj,25641,25642,51283
29215,,dfg-0fg1zryj,25642,25643,51285
29216,,diozmithgl4j,25643,25644,51287
29217,,zth-25wd1b8j,25644,25645,51289
29218,,kwiyvteno2ej,25645,25646,51291
29219,,w5kqizomdmmj,25646,25647,51293
29220,,tu4prk0ozrej,25647,25648,51295
29221,,agthjdynqbsj,25648,25649,51297
29222,,ghjaa3_lyygj,25649,25650,51299
29223,,url:http://portal.acm.org/citation.cfm3fid3d234286.234290,25650,25651,51301
29224,,qvvmkwqlinej,25651,25652,51303
29225,,qiwtbx2ap6ej,25652,25653,51305
29226,,s7x8zqsf4jkj,25654,25655,51309
29227,,id8_jpqemxij,25655,25656,51311
29228,,kka0y1urwdqj,25656,25657,51313
29229,,dbl9sfofmn4j,25657,25658,51315
29230,,ezejx8bmchmj,25658,25659,51317
29231,,aeirjb7j_ccj,25659,25660,51319
29232,,mecbiy4oapuj,25660,25661,51321
29233,,cplsjpgmm20j,25661,25662,51323
29234,,h2a2g_kymlgj,25662,25663,51325
29235,,_bah-2crxtej,25663,25664,51327
29236,,364gjmsvjkkj,25664,25665,51329
29237,,htu_sj_o_nqj,25665,25666,51331
29238,,lc5uev9mnhej,25666,25667,51333
29239,,emph1xhixuaj,25667,25668,51335
29240,,hhjtkgk-2c8j,25668,25669,51337
29241,,jsjhflf_fhsj,25669,25670,51339
29242,,m9dbn5phwdaj,25670,25671,51341
29243,,o7rkyertqloj,25671,25672,51343
29244,,clmlnhf7hnij,25672,25673,51345
29245,,0ge8zpx-azcj,25673,25674,51347
29246,,xsigznwiepyj,25674,25675,51349
29247,,_t8mqzrqviuj,25675,25676,51351
29248,,pq3emvcgpvyj,25676,25677,51353
29249,,0hpmgeqvblyj,25677,25678,51355
29250,,u6dpraxbjocj,25679,25680,51359
29251,,mezit5mohq4j,25680,25681,51361
29252,,gzr961alud0j,25681,25682,51363
29253,,vrlsohknzvoj,25682,25683,51365
29254,,iyx-un9lz3kj,25683,25684,51367
29255,,vhoulardl6gj,25684,25685,51369
29256,,byrutmxiqhyj,25685,25686,51371
29257,,lk5dyk78nbkj,25686,25687,51373
29258,,le8u4wptztkj,25687,25688,51375
29259,,5q_6hlwz2yij,25688,25689,51377
29260,,6scmbffw0ngj,25690,25691,51381
29261,,nakc1o5xixwj,25691,25692,51383
29262,,38k5jllhdicj,25692,25693,51385
29263,,h1gee5bch3oj,25693,25694,51387
29264,,jfdh2bda_oqj,25694,25695,51389
29265,,yoyxxnphhmej,25695,25696,51391
29266,,flgamu6fiimj,25696,25697,51393
29267,,3rquu-4o3ycj,25697,25698,51395
29268,,fegqnj-d1zsj,25698,25699,51397
29269,,j3um8liazpmj,25699,25700,51399
29270,,pq5nidpz0o4j,25700,25701,51401
29271,,cxj6-pclckyj,25701,25702,51403
29272,,uicouf4v2acj,25702,25703,51405
29273,,rjnmxujubm4j,25703,25704,51407
29274,,wp15gimutykj,25704,25705,51409
29275,,imtot8owld8j,25705,25706,51411
29276,,url:http://www.csa.com/partners/viewrecord.php3frequester3dgs26collection3dtrd26recid3dn9210404ah,25706,25707,51413
29277,,hfcqdqmzcxoj,25707,25708,51415
29278,,x7k9kjjeczqj,25708,25709,51417
29279,,ifoohstwqkij,25709,25710,51419
29280,,f73kigvgoxij,25710,25711,51421
29281,,mo-taqrm0g4j,25711,25712,51423
29282,,7zvyjw1s-zgj,25712,25713,51425
29283,,81vn76l4smyj,25713,25714,51427
29284,,9h-untxeg6uj,25714,25715,51429
29285,,his1ptxg3b0j,25715,25716,51431
29286,,re6zggeyqbsj,25716,25717,51433
29287,,piom8quicmuj,25717,25718,51435
29288,,f5rjxgvotb4j,25718,25719,51437
29289,,hinsxxxuoi0j,25719,25720,51439
29290,,oyvjfc-wr94j,25720,25721,51441
29291,,6im9rag3qoaj,25721,25722,51443
29292,,eahuc2dwllyj,25722,25723,51445
29293,,ykkmxzntsuqj,25723,25724,51447
29294,,ck9ryhwvrcuj,25724,25725,51449
29295,,7odu_c2qs-uj,25725,25726,51451
29296,,w2hfvqqoviij,25726,25727,51453
29297,,ocppsbhhl3ij,25727,25728,51455
29298,,ltn7py1dcwgj,25728,25729,51457
29299,,dqxl6aezbpwj,25729,25730,51459
29300,,wgpxut7lcckj,25730,25731,51461
29301,,0ofs4hgl4qej,25731,25732,51463
29302,,url:http://www.csa.com/partners/viewrecord.php3frequester3dgs26collection3dtrd26recid3dn9210519ah,25732,25733,51465
29303,,2sovdk_9qtcj,25733,25734,51467
29304,,5qit3x90zk8j,25734,25735,51469
29305,,cqn0lbzsmeoj,25735,25736,51471
29306,,bdedubp8h-yj,25736,25737,51473
29307,,6aacd9q1sdij,25737,25738,51475
29308,,v_vihhmmirmj,25738,25739,51477
29309,,4he7xza0xf0j,25739,25740,51479
29310,,pw6dk4qrpy4j,25740,25741,51481
29311,,aidvdxw2c_yj,25741,25742,51483
29312,,hbp5wxuvqgmj,25742,25743,51485
29313,,w1owfqmxkdoj,25743,25744,51487
29314,,fi3yzjqwgy8j,25744,25745,51489
29315,,93-zkuvsv20j,25745,25746,51491
29316,,kbn1d94lwy0j,25746,25747,51493
29317,,url:http://portal.acm.org/citation.cfm3fid3d166635.16666426dl3dguide26dl3dacm26idx3dj68926part3dperiodical26wanttype3dperiodical26title3dacm2520sigmod2520record26cfid3d1111111126cftoken3d2222222,25747,25748,51495
29318,,026-f7bzmd8j,25748,25749,51497
29319,,efrr68nk8mwj,25749,25750,51499
29320,,5cxh1nuz-qaj,25750,25751,51501
29321,,sv9wd7c1qkwj,25751,25752,51503
29322,,manoxccgel8j,25752,25753,51505
29323,,yomojxfarhaj,25753,25754,51507
29324,,v9b5tv5vgbcj,25754,25755,51509
29325,,url:http://pubs.acs.org/cgi-bin/abstract.cgi/achre4/2004/37/i12/abs/ar0302843.html,25755,25756,51511
29326,,xdxzepqi6c8j,25756,25757,51513
29327,,ey3pdukiwnoj,25758,25759,51517
29328,,ckxz3lpryswj,25759,25760,51519
29329,,svgxtutvd60j,25760,25761,51521
29330,,ge5htrcf4acj,25761,25762,51523
29331,,g3fnf7gama4j,25762,25763,51525
29332,,ywub1ude1ikj,25763,25764,51527
29333,,_dv8bybbmxkj,25764,25765,51529
29334,,p2sdsa7rasoj,25765,25766,51531
29335,,cvvvs6mjci0j,25766,25767,51533
29336,,_ick4vgjlgsj,25767,25768,51535
29337,,outxsgwfsk8j,25768,25769,51537
29338,,mylpvq0f2hqj,25769,25770,51539
29339,,mtrcoanbmmaj,25770,25771,51541
29340,,lgaj_hv0plcj,25771,25772,51543
29341,,p87anlwlcwuj,25772,25773,51545
29342,,dsk8prn17muj,25773,25774,51547
29343,,zlv_rz9ayq0j,25774,25775,51549
29344,,nzpsepzyo7sj,25775,25776,51551
29345,,cgwx9ueld14j,25776,25777,51553
29346,,nnbbeyvsrmsj,25777,25778,51555
29347,,4cmphvksimaj,25778,25779,51557
29348,,jwusfkcgvvij,25779,25780,51559
29349,,rwlbb7s9k4oj,25780,25781,51561
29350,,wyrrb4clmb0j,25781,25782,51563
29351,,owthaqmfpy0j,25782,25783,51565
29352,,8s4uasfq_hwj,25783,25784,51567
29353,,4rkk1kgo-paj,25784,25785,51569
29354,,en-x3ufau68j,25785,25786,51571
29355,,38imodljgvcj,25786,25787,51573
29356,,nhnkimcbhjcj,25787,25788,51575
29357,,ndidtfqjf1qj,25788,25789,51577
29358,,7rgju4bichmj,25789,25790,51579
29359,,ilzmdav1kcuj,25790,25791,51581
29360,,vfgikjdqu6ij,25791,25792,51583
29361,,bdlz_mqm-uej,25792,25793,51585
29362,,url:http://www.springerlink.com/index/x88x353864153376.pdf,25793,25794,51587
29363,,kqw7a0ssp7ej,25794,25795,51589
29364,,url:http://portal.acm.org/citation.cfm3fid3d234286.1057840,25795,25796,51591
29365,,hfsnabvugzkj,25796,25797,51593
29366,,j5pb_jgxybmj,25797,25798,51595
29367,,lev1wqycnkkj,25798,25799,51597
29368,,url:http://ieeexplore.ieee.org/iel4/5812/15497/00718146.pdf3farnumber3d718146,25799,25800,51599
29369,,url:http://www.csa.com/partners/viewrecord.php3frequester3dgs26collection3dtrd26recid3dn9210527ah,25800,25801,51601
29370,,omzq1ah1ivqj,25801,25802,51603
29371,,g3w0sye0jrmj,25802,25803,51605
29372,,wocr0spvaemj,25803,25804,51607
29373,,_k6iolkiyw8j,25804,25805,51609
29374,,url:http://pubs.acs.org/cgi-bin/abstract.cgi/achre4/2005/38/i06/abs/ar040212r.html,25805,25806,51611
29375,,dargfsgnoxej,25806,25807,51613
29376,,lcq0hzyyyncj,25807,25808,51615
29377,,2yeqc8qg4rsj,25808,25809,51617
29378,,yjwd5b0u_puj,25809,25810,51619
29379,,rvifg0xy0-8j,25810,25811,51621
29380,,5xvcbb1t-twj,25812,25813,51625
29381,,spmjyvawob0j,25813,25814,51627
29382,,d98og8eclvuj,25814,25815,51629
29383,,d1tzj9lvv7sj,25815,25816,51631
29384,,d4pcmb-2oogj,25816,25817,51633
29385,,mqtcmfeezcwj,25817,25818,51635
29386,,rgtkmui8zzqj,25818,25819,51637
29387,,vdevllr-_3gj,25819,25820,51639
29388,,tggamfciumuj,25820,25821,51641
29389,,url:http://portal.acm.org/citation.cfm3fid3d984519,25821,25822,51643
29390,,bxgpblq1locj,25822,25823,51645
29391,,srwztrgktuwj,25823,25824,51647
29392,,_hyy5-nv8rkj,25824,25825,51649
29393,,p-5zpeknbpoj,25825,25826,51651
29394,,8tgwqzjeqtaj,25826,25827,51653
29395,,3zt_pgo66c0j,25827,25828,51655
29396,,ds62hpy8nhmj,25828,25829,51657
29397,,m8k-t_bxnfsj,25829,25830,51659
29398,,duuiqgjcjcsj,25830,25831,51661
29399,,wqzgjbe8czej,25831,25832,51663
29400,,dffjcishmuwj,25832,25833,51665
29401,,qsxq2ln6i3sj,25833,25834,51667
29402,,svvh9qqcgdwj,25834,25835,51669
29403,,jxxrqbatdhej,25835,25836,51671
29404,,k4q9otcr5lqj,25836,25837,51673
29405,,x2sk3f5h6jej,25837,25838,51675
29406,,6bdhyo5uwhmj,25838,25839,51677
29407,,ns-yczv9roij,25839,25840,51679
29408,,_aelxgnnseij,25840,25841,51681
29409,,lzcmc6dsto0j,25841,25842,51683
29410,,7qcuy36llx4j,25842,25843,51685
29411,,iudxjby59hej,25843,25844,51687
29412,,dqvcwakflxgj,25844,25845,51689
29413,,gqfbqqk6erkj,25845,25846,51691
29414,,v85hrc0fnqwj,25846,25847,51693
29415,,fweantobzzqj,25847,25848,51695
29416,,avkqinq6qaqj,25848,25849,51697
29417,,4ke9bog0ickj,25849,25850,51699
29418,,s5bogcjun1yj,25850,25851,51701
29419,,2a_adeaiv28j,25851,25852,51703
29420,,kgxqrshwga8j,25852,25853,51705
29421,,url:http://www.csa.com/partners/viewrecord.php3frequester3dgs26collection3dtrd26recid3d0804630ci,25853,25854,51707
29422,,ba4-wfvzwcwj,25854,25855,51709
29423,,url:http://portal.acm.org/ft_gateway.cfm3fid3d13028826type3dpdf26dl3dguide26dl3dacm26cfid3d1111111126cftoken3d2222222,25855,25856,51711
29424,,6ak0gf7jatsj,25856,25857,51713
29425,,cmnegqsxmacj,25857,25858,51715
29426,,wvvbbejo2lej,25858,25859,51717
29427,,jyqdyro4c0yj,25859,25860,51719
29428,,frgzzdu7pwyj,25860,25861,51721
29429,,_gectxqgfzoj,25861,25862,51723
29430,,gwmqonzhkaaj,25862,25863,51725
29431,,vb34h3obs0qj,25863,25864,51727
29432,,a0vhodbw-swj,25864,25865,51729
29433,,gxs9wkl68eoj,25865,25866,51731
29434,,orq2yuknseij,25866,25867,51733
29435,,b3n3g3pgqdmj,25867,25868,51735
29436,,atv02q1qo-oj,25868,25869,51737
29437,,owbipjmbnysj,25869,25870,51739
29438,,wpjs4f-ktzsj,25870,25871,51741
29439,,nzt1xsjbpkoj,25871,25872,51743
29440,,url:http://www.springerlink.com/index/v567337310361767.pdf,25872,25873,51745
29441,,nbifjyt708yj,25873,25874,51747
29442,,jaf5a8dqkrsj,25875,25876,51751
29443,,byiupge4940j,25876,25877,51753
29444,,puaxdlhbqygj,25877,25878,51755
29445,,i7qmaajwmasj,25878,25879,51757
29446,,9hcl2sgvfuuj,25879,25880,51759
29447,,bxr-whnk3wgj,25880,25881,51761
29448,,jfdve7g1qvkj,25881,25882,51763
29449,,url:http://portal.acm.org/ft_gateway.cfm3fid3d106623426type3dpdf,25882,25883,51765
29450,,mngn9ocmyfoj,25883,25884,51767
29451,,jtho83yar5aj,25884,25885,51769
29452,,4uerapiwuvqj,25885,25886,51771
29453,,0fbuizakeqaj,25886,25887,51773
29454,,3ixvbncrsdij,25887,25888,51775
29455,,r53po6b3lhcj,25888,25889,51777
29456,,6mefhqqa6bwj,25889,25890,51779
29457,,dp-ztr-a-swj,25890,25891,51781
29458,,s6nv3s5aplyj,25891,25892,51783
29459,,09mifkmegdsj,25892,25893,51785
29460,,url:http://www.springerlink.com/index/ww6w2642787l326x.pdf,25893,25894,51787
29461,,rq0thaf1znaj,25894,25895,51789
29462,,dkrubgavgh8j,25895,25896,51791
29463,,url:http://www.geography.org.uk/journals/download.asp3farticleid3d155,25896,25897,51793
29464,,ngiqwp3f6mej,25898,25899,51797
29465,,9xdvqb43xkoj,25899,25900,51799
29466,,gebndhm0xsgj,25900,25901,51801
29467,,awdkpchsxaaj,25901,25902,51803
29468,,6rr7p23pbsmj,25902,25903,51805
29469,,uem5sbi3gwmj,25903,25904,51807
29470,,frqhv36wttaj,25904,25905,51809
29471,,6uaab7bg6c8j,25905,25906,51811
29472,,n2ildkt_vi4j,25906,25907,51813
29473,,c4d1g00odewj,25907,25908,51815
29474,,cvuof_c23nmj,25908,25909,51817
29475,,gkvch6zymsgj,25909,25910,51819
29476,,o5vlibzvlc8j,25910,25911,51821
29477,,tmprfw4vcfaj,25911,25912,51823
29478,,0mpgsnujclqj,25912,25913,51825
29479,,h2jh8cjcivuj,25913,25914,51827
29480,,cg736hmzzbqj,25914,25915,51829
29481,,26pbgtykylqj,25915,25916,51831
29482,,bairigji3w4j,25916,25917,51833
29483,,cyesqsduc9qj,25917,25918,51835
29484,,vfnvuh5yavsj,25918,25919,51837
29485,,7cxt4eucqusj,25919,25920,51839
29486,,vx4pfcylagkj,25920,25921,51841
29487,,83itvxj81rsj,25921,25922,51843
29488,,_ceicabvdsoj,25922,25923,51845
29489,,5waqtltkommj,25923,25924,51847
29490,,mg6zhgm-mbqj,25924,25925,51849
29491,,boucdltetx4j,25925,25926,51851
29492,,d0da9bbhi0kj,25926,25927,51853
29493,,qmxmch8bhgkj,25927,25928,51855
29494,,zqm8dg8dstaj,25928,25929,51857
29495,,dl05eafrod4j,25929,25930,51859
29496,,hwmsm3orwvej,25930,25931,51861
29497,,wuglponzynyj,25931,25932,51863
29498,,url:http://www.springerlink.com/index/t804533832400402.pdf,25932,25933,51865
29499,,qd6bh1nrlxcj,25933,25934,51867
29500,,di5vsv_ocrsj,25934,25935,51869
29501,,ztwq5fjz2oyj,25935,25936,51871
29502,,6a1uyoxiqcwj,25936,25937,51873
29503,,vjh8qoeqfukj,25937,25938,51875
29504,,2w1exg_hptmj,25938,25939,51877
29505,,yyymdbyv2ymj,25939,25940,51879
29506,,fbt3tkos5kqj,25940,25941,51881
29507,,bvxpx8ctdkcj,25941,25942,51883
29508,,h2lqhglt6wuj,25942,25943,51885
29509,,8vtofcy3hryj,25943,25944,51887
29510,,2-s9ispq0zmj,25944,25945,51889
29511,,wi2omrsii8ej,25945,25946,51891
29512,,a6h_wi-jwasj,25946,25947,51893
29513,,6s7pedoryasj,25947,25948,51895
29514,,cjodvqlz6pqj,25948,25949,51897
29515,,url:http://doi.wiley.com/10.1002/tl.57,25949,25950,51899
29516,,_eqwqqiukhgj,25950,25951,51901
29517,,cy8kgf_ufscj,25951,25952,51903
29518,,19sl1jm1qgqj,25952,25953,51905
29519,,mlaclo3gps4j,25953,25954,51907
29520,,6z1ugg6m9_cj,25954,25955,51909
29521,,osap6k-lpwyj,25955,25956,51911
29522,,dldtkpli9ruj,25956,25957,51913
29523,,tt_omitnhskj,25957,25958,51915
29524,,jo9-zeisif8j,25958,25959,51917
29525,,efn9p-fkawsj,25959,25960,51919
29526,,bx9ffyllj_sj,25960,25961,51921
29527,,ahacu8azwsuj,25961,25962,51923
29528,,ha8mmwzekeqj,25962,25963,51925
29529,,xxx_mr9rc_gj,25963,25964,51927
29530,,bv5_8ozfi7uj,25964,25965,51929
29531,,cpcvrekxbzaj,25965,25966,51931
29532,,kai6hssdysgj,25966,25967,51933
29533,,xq2wdmnwixaj,25967,25968,51935
29534,,jdzzkemjpwsj,25968,25969,51937
29535,,p2_d8jfgqxoj,25969,25970,51939
29536,,dem1nx3njrej,25970,25971,51941
29537,,d9irnnp3q1yj,25971,25972,51943
29538,,nmjlsj5tqdcj,25972,25973,51945
29539,,dbinkjsuqrcj,25973,25974,51947
29540,,q8xbdugmuuwj,25974,25975,51949
29541,,61e2d-k5me4j,25975,25976,51951
29542,,48amp1fbrmaj,25976,25977,51953
29543,,,25977,25978,51955
29544,,pdzptjstfgoj,25978,25979,51957
29545,,rpyw7dboddcj,25979,25980,51959
29546,,,25980,25981,51961
29547,,qn1_mxse0bij,25981,25982,51963
29548,,8cqjz166scej,25982,25983,51965
29549,,6z0pudpiy8gj,25983,25984,51967
29550,,twgf7seazvwj,25984,25985,51969
29551,,rml9zhk6fdwj,25985,25986,51971
29552,,dds8tpfwj8uj,25986,25987,51973
29553,,f7fj_uaoz8ej,25987,25988,51975
29554,,0tivlo2z2faj,25988,25989,51977
29555,,cjsdixu9lsoj,25989,25990,51979
29556,,5lpe5mho__0j,25990,25991,51981
29557,,kdjaewvivvsj,25991,25992,51983
29558,,a2hqjjmuajkj,25992,25993,51985
29559,,nfaiulafjsuj,25993,25994,51987
29560,,tl67lybcro4j,25995,25996,51991
29561,,url:http://portal.acm.org/citation.cfm3fid3d1008192.1008207,25996,25997,51993
29562,,url:http://portal.acm.org/citation.cfm3fid3d565117.56513826dl3dguide26dl3dacm26type3dissue26idx3dj68926part3dperiodical26wanttype3dperiodical26title3dacm2520sigmod2520record26cfid3d1111111126cftoken3d2222222,25997,25998,51995
29563,,kcm90hzyom4j,25998,25999,51997
29564,,ou8axzlxwpqj,25999,26000,51999
29565,,,26000,26001,52001
29566,,_tqna8lr2uaj,26001,26002,52003
29567,,itirghahkzwj,26002,26003,52005
29568,,zcpi9zjn_raj,26003,26004,52007
29569,,sh25u6ysun8j,26004,26005,52009
29570,,url:http://www.csa.com/partners/viewrecord.php3frequester3dgs26collection3denv26recid3d9201931,26005,26006,52011
29571,,aeyb7jkqwxsj,26006,26007,52013
29572,,okxmbgqnefwj,26007,26008,52015
29573,,qkl5fi39znkj,26008,26009,52017
29574,,tr8bqjgke2yj,26009,26010,52019
29575,,mdmtu4znan0j,26010,26011,52021
29576,,1xxrtup64bwj,26011,26012,52023
29577,,0vh_ufugpa0j,26012,26013,52025
29578,,yweqxv9db9cj,26013,26014,52027
29579,,iziw0sfngjej,26014,26015,52029
29580,,ptylrrxk300j,26015,26016,52031
29581,,udri67aecf4j,26016,26017,52033
29582,,wdspemgqxksj,26017,26018,52035
29583,,vwhsr5wzhjsj,26018,26019,52037
29584,,url:http://portal.acm.org/ft_gateway.cfm3fid3d100768326type3dpdf,26019,26020,52039
29585,,sg3m6agod1gj,26020,26021,52041
29586,,ta8hwhdomvij,26021,26022,52043
29587,,fbyt7don7hej,26022,26023,52045
29588,,ddx2a5jvicij,26023,26024,52047
29589,,jhqlqpou8oyj,26024,26025,52049
29590,,99lnmuqso0gj,26025,26026,52051
29591,,csiptqn6vzqj,26026,26027,52053
29592,,url:http://www.csa.com/partners/viewrecord.php3frequester3dgs26collection3dtrd26recid3d0250274ci,26027,26028,52055
29593,,url:http://www.csa.com/partners/viewrecord.php3frequester3dgs26collection3dtrd26recid3d200111010676mt26recid3da0032580ah,26028,26029,52057
29594,,6u5qssnkjjej,26029,26030,52059
29595,,q4c6losfu7yj,26030,26031,52061
29596,,nkmpdqsaerwj,26031,26032,52063
29597,,fley09zw6ngj,26032,26033,52065
29598,,oy4eswvulvcj,26033,26034,52067
29599,,opj7b2jeg3wj,26034,26035,52069
29600,,4orm17osz64j,26035,26036,52071
29601,,ziyse9p8xwij,26036,26037,52073
29602,,0ta25vsgl7kj,26037,26038,52075
29603,,668n_hcxg70j,26039,26040,52079
29604,,url:http://www.ingentaconnect.com/search/expand3fpub3dinfobike://els/13891286/2001/00000035/00000005/art0019426unc3d,26040,26041,52081
29605,,3zc3dbphfhkj,26041,26042,52083
29606,,epvhfxcxmuej,26042,26043,52085
29607,,whnmpfscj4oj,26043,26044,52087
29608,,uifz0silmemj,26044,26045,52089
29609,,t0jvhs3unfej,26045,26046,52091
29610,,j7n2tsdbm1yj,26046,26047,52093
29611,,uacem8n0n2wj,26047,26048,52095
29612,,eaysh7b_shuj,26048,26049,52097
29613,,wau8ii_g1v4j,26049,26050,52099
29614,,bpuiizml4qwj,26050,26051,52101
29615,,qkg2ybzccewj,26051,26052,52103
29616,,url:http://www.springerlink.com/index/h383879241rm2t22.pdf,26052,26053,52105
29617,,mfgnti92h3sj,26053,26054,52107
29618,,m4nddqjphmmj,26054,26055,52109
29619,,g8jnrvyqukaj,26055,26056,52111
29620,,ylylsnybx6aj,26056,26057,52113
29621,,hdwre4ibxaqj,26057,26058,52115
29622,,k5nghi6kzxgj,26058,26059,52117
29623,,cso1po6ie1cj,26059,26060,52119
29624,,9cur4apd-7qj,26060,26061,52121
29625,,plwbnrzle1gj,26061,26062,52123
29626,,bhnkqv9idamj,26062,26063,52125
29627,,ygejun30musj,26063,26064,52127
29628,,f0oqeng7upyj,26064,26065,52129
29629,,n5vkg7c4oiaj,26065,26066,52131
29630,,vwn3sq_dckoj,26066,26067,52133
29631,,faqivfizuacj,26067,26068,52135
29632,,url:http://www.csa.com/partners/viewrecord.php3frequester3dgs26collection3dtrd26recid3dn9210577ah,26068,26069,52137
29633,,nlnjn2lh7xqj,26070,26071,52141
29634,,4zbs-u7sok0j,26071,26072,52143
29635,,g31kfmflscgj,26072,26073,52145
29636,,ebf7pimhu6aj,26073,26074,52147
29637,,umxzkfkqvvaj,26074,26075,52149
29638,,g2xe3sbf45kj,26076,26077,52153
29639,,ao8awbujwj4j,26077,26078,52155
29640,,6o92yoqka0wj,26078,26079,52157
29641,,cqi-yysdwv4j,26079,26080,52159
29642,,jmq7tj6boigj,26080,26081,52161
29643,,b5g42zehb1ej,26081,26082,52163
29644,,sslwirg8i9qj,26082,26083,52165
29645,,oonccbfdkpsj,26083,26084,52167
29646,,xd6hrpazo8uj,26084,26085,52169
29647,,tcqr6dkyjdaj,26085,26086,52171
29648,,d-asgsjnrxqj,26086,26087,52173
29649,,srsvowsyceqj,26087,26088,52175
29650,,oslmabqyaeej,26088,26089,52177
29651,,nmr6autmhkwj,26089,26090,52179
29652,,hg5v8befdhij,26090,26091,52181
29653,,3uwn-wkakpoj,26091,26092,52183
29654,,mwgwxgfqawqj,26092,26093,52185
29655,,toecpgt-2oej,26093,26094,52187
29656,,qvrn6uuomp4j,26094,26095,52189
29657,,r-bkiptpff4j,26095,26096,52191
29658,,zfeq9ghvz9oj,26096,26097,52193
29659,,url:http://portal.acm.org/citation.cfm3fid3d582353.582373,26097,26098,52195
29660,,,26098,26099,52197
29661,,1ql04ykt5mgj,26099,26100,52199
29662,,sngdprl5yr4j,26100,26101,52201
29663,,zimzqjovzk8j,26101,26102,52203
29664,,azrtbfmefs8j,26102,26103,52205
29665,,aduztc5d4d8j,26104,26105,52209
29666,,iam2lcreqc4j,26105,26106,52211
29667,,no3wfcwv0rej,26106,26107,52213
29668,,url:http://www.ncbi.nlm.nih.gov/entrez/query.fcgi3fcmd3dretrieve26db3dpubmed26list_uids3d528472426dopt3dcitation,26107,26108,52215
29669,,kuven1wfjtuj,26108,26109,52217
29670,,rm73gjx2vpsj,26109,26110,52219
29671,,gxolge_zxqej,26110,26111,52221
29672,,r770jeqiayyj,26111,26112,52223
29673,,krgwdsqntzkj,26112,26113,52225
29674,,cnxxiyifjkoj,26113,26114,52227
29675,,uvt3hodobzuj,26114,26115,52229
29676,,xieozxszcjqj,26115,26116,52231
29677,,ovfojp0ihy0j,26116,26117,52233
29678,,url:http://portal.acm.org/ft_gateway.cfm3fid3d105816426type3dpdf,26117,26118,52235
29679,,url:http://portal.acm.org/ft_gateway.cfm3fid3d109963926type3dpdf,26118,26119,52237
29680,,rozomuzjm-mj,26119,26120,52239
29681,,vopy1ojgx14j,26120,26121,52241
29682,,kc02bowbuygj,26121,26122,52243
29683,,khymdfgnjtyj,26122,26123,52245
29684,,bkpxv8fo3aij,26123,26124,52247
29685,,ey5sf-mxdfcj,26124,26125,52249
29686,,ki4ezhhj-hmj,26125,26126,52251
29687,,hzfl1joqjxej,26126,26127,52253
29688,,gkpte5y4etaj,26127,26128,52255
29689,,czu_thazticj,26128,26129,52257
29690,,htiesaiz_voj,26129,26130,52259
29691,,url:http://www.springerlink.com/index/u1230884u5j68233.pdf,26130,26131,52261
29692,,i7ax4vpjjbyj,26131,26132,52263
29693,,9wug-mg098cj,26132,26133,52265
29694,,ua036pmuqw8j,26133,26134,52267
29695,,bvaj1u6qtvgj,26134,26135,52269
29696,,v5i9irun8n8j,26135,26136,52271
29697,,ny5e4mkj6vyj,26136,26137,52273
29698,,an6nq7iletyj,26137,26138,52275
29699,,xfquxgkeyduj,26138,26139,52277
29700,,eqrno2xk5syj,26139,26140,52279
29701,,ammefe2_1vyj,26140,26141,52281
29702,,6r8lj9qnuduj,26141,26142,52283
29703,,url:http://www.csa.com/partners/viewrecord.php3frequester3dgs26collection3dtrd26recid3d200111010684mt26recid3da0032598ah,26143,26144,52287
29704,,mm6mtjmmizij,26144,26145,52289
29705,,prjc4qcnqisj,26145,26146,52291
29706,,sj7rewlizxwj,26146,26147,52293
29707,,q6hzko_nl1kj,26147,26148,52295
29708,,6agqp7bpsnsj,26148,26149,52297
29709,,lakea7tswhij,26149,26150,52299
29710,,zn8bosbqqksj,26150,26151,52301
29711,,z8mb1ichmvqj,26151,26152,52303
29712,,chwl6irp_g0j,26152,26153,52305
29713,,_odhqeblwcgj,26153,26154,52307
29714,,eyv1vwjwbkcj,26154,26155,52309
29715,,crwf45kqr20j,26155,26156,52311
29716,,qf01-e2mqdgj,26156,26157,52313
29717,,f_akbx2udlyj,26157,26158,52315
29718,,eexwq2gx3goj,26158,26159,52317
29719,,fvi5tiizfjaj,26159,26160,52319
29720,,d9ikggt_9mqj,26160,26161,52321
29721,,url:http://www.csa.com/partners/viewrecord.php3frequester3dgs26collection3dtrd26recid3d0879288ci,26161,26162,52323
29722,,hxn3dklioeij,26162,26163,52325
29723,,u5etl2i6xg0j,26163,26164,52327
29724,,bmgno9xkmeij,26164,26165,52329
29725,,vcc6iqulrj4j,26165,26166,52331
29726,,raazo_p2kr4j,26166,26167,52333
29727,,5yinfmruwg0j,26167,26168,52335
29728,,xa-sjo7cfdsj,26168,26169,52337
29729,,xx7vcrtv0zsj,26169,26170,52339
29730,,epdek48szt8j,26170,26171,52341
29731,,wmqkidzkeisj,26172,26173,52345
29732,,-88mu84v-yyj,26173,26174,52347
29733,,volw8qoyqwcj,26174,26175,52349
29734,,pzsyhbvsbyaj,26175,26176,52351
29735,,4gdg9desceqj,26176,26177,52353
29736,,twcwvlgxnxkj,26177,26178,52355
29737,,sjcd33-6pckj,26179,26180,52359
29738,,adblaj5rasoj,26180,26181,52361
29739,,oi27b82dxzaj,26181,26182,52363
29740,,url:http://www.springerlink.com/index/pv962288326hvh1u.pdf,26182,26183,52365
29741,,fgjilwndk3gj,26183,26184,52367
29742,,hn06ski5kfqj,26184,26185,52369
29743,,oshwsihlvbcj,26185,26186,52371
29744,,aj07jg8qudij,26186,26187,52373
29745,,url:http://links.jstor.org/sici3fsici3d0146-4949(196221252f22)3253a2253c21253amlame253e2.0.co253b2-f,26187,26188,52375
29746,,jqsxqmulshkj,26188,26189,52377
29747,,9a-zbrn3n-kj,26189,26190,52379
29748,,asttra96eiyj,26190,26191,52381
29749,,vm_hmbculnqj,26191,26192,52383
29750,,42heaa8qgwcj,26192,26193,52385
29751,,url_sguf_cwj,26193,26194,52387
29752,,s6efjbmbub4j,26194,26195,52389
29753,,lrmu375sdtaj,26195,26196,52391
29754,,t3crw-fwxpaj,26196,26197,52393
29755,,senrzit9dwmj,26197,26198,52395
29756,,jhrug7wjeo4j,26198,26199,52397
29757,,zyaul7lg81ij,26199,26200,52399
29758,,ksy2ldvjceuj,26200,26201,52401
29759,,e7qqp2vh66oj,26201,26202,52403
29760,,yxtsboicvtoj,26202,26203,52405
29761,,0xadlktq_fkj,26203,26204,52407
29762,,yrl2vv_e6f8j,26204,26205,52409
29763,,ycqwylnaoemj,26205,26206,52411
29764,,qcmyx5t_p6oj,26206,26207,52413
29765,,qba9junjqiaj,26207,26208,52415
29766,,ve8c76nind8j,26208,26209,52417
29767,,jlvv-r2be_ej,26209,26210,52419
29768,,bnuggawuwvoj,26211,26212,52423
29769,,52y8jz8yuiaj,26212,26213,52425
29770,,kpzcg62ksjij,26213,26214,52427
29771,,url:http://www.ingentaconnect.com/search/expand3fpub3dinfobike://els/13891286/2000/00000032/00000005/art0001726unc3d,26214,26215,52429
29772,,aat_abzvdeqj,26215,26216,52431
29773,,qvvnagvcqfsj,26216,26217,52433
29774,,url:http://adsabs.harvard.edu/abs/1976scom.nasa..206w,26217,26218,52435
29775,,p8a_uhwh958j,26218,26219,52437
29776,,ty5wlujai9ij,26219,26220,52439
29777,,demtzoc-fw8j,26220,26221,52441
29778,,hig5qs-pzc0j,26221,26222,52443
29779,,rrvffasokeij,26222,26223,52445
29780,,n8zsiaa4rpkj,26223,26224,52447
29781,,9vmjoiicjicj,26224,26225,52449
29782,,zjqjs0ol0oej,26225,26226,52451
29783,,geiqyaq51wwj,26226,26227,52453
29784,,h6bqvc0erxmj,26227,26228,52455
29785,,_urvwo5dgycj,26228,26229,52457
29786,,vts_zt3iramj,26229,26230,52459
29787,,whbpahbczxmj,26230,26231,52461
29788,,vgvv7azct1uj,26231,26232,52463
29789,,url:http://portal.acm.org/ft_gateway.cfm3fid3d110134226type3dpdf,26232,26233,52465
29790,,bvop8yd9hbwj,26234,26235,52469
29791,,y19biwb8ch4j,26235,26236,52471
29792,,fontgyzxfgsj,26236,26237,52473
29793,,m4ynfkzm7woj,26237,26238,52475
29794,,url:http://portal.acm.org/citation.cfm3fid3d1083784.1083795,26238,26239,52477
29795,,poura88etcej,26239,26240,52479
29796,,kqw5jjl-crij,26240,26241,52481
29797,,r4gc3p27n0aj,26241,26242,52483
29798,,tkghv-bjlikj,26242,26243,52485
29799,,puaojr5kdikj,26243,26244,52487
29800,,sloonjg3p-mj,26244,26245,52489
29801,,d83w1qm5d_wj,26245,26246,52491
29802,,qlahg7kf2_sj,26246,26247,52493
29803,,r4qc4htu248j,26247,26248,52495
29804,,cbdw2fhnygyj,26248,26249,52497
29805,,gjdzcb31abij,26249,26250,52499
29806,,iv1kwblqewwj,26250,26251,52501
29807,,1hr_ouwusp4j,26251,26252,52503
29808,,cdqs2adl0-oj,26252,26253,52505
29809,,qlhj1enjkzwj,26253,26254,52507
29810,,zbc_ggagfw4j,26254,26255,52509
29811,,vveipa_woiwj,26255,26256,52511
29812,,4g3nkhmqmvaj,26256,26257,52513
29813,,r3n6xpetljuj,26257,26258,52515
29814,,ctpvdogppjej,26258,26259,52517
29815,,zkduwj9xv1sj,26259,26260,52519
29816,,clfi9y2aeioj,26260,26261,52521
29817,,oozosfbtcc8j,26261,26262,52523
29818,,gbkf7apikegj,26262,26263,52525
29819,,enzj50ho9u8j,26263,26264,52527
29820,,vbomei-wowoj,26264,26265,52529
29821,,42qdssvqb2yj,26265,26266,52531
29822,,vawzscundvej,26266,26267,52533
29823,,idarm_2coz0j,26267,26268,52535
29824,,8w5kj2g2c_oj,26268,26269,52537
29825,,agas8xequ0wj,26269,26270,52539
29826,,xgs-st3oxxcj,26270,26271,52541
29827,,tijldlsdgmyj,26271,26272,52543
29828,,,26272,26273,52545
29829,,ex9ctv4-zzgj,26273,26274,52547
29830,,ece15bt6uwqj,26274,26275,52549
29831,,znag1jdnbluj,26275,26276,52551
29832,,jmfbchss8vqj,26276,26277,52553
29833,,pgkioiy8iosj,26277,26278,52555
29834,,fcoyzc4qfj0j,26278,26279,52557
29835,,siic5kpzpi8j,26279,26280,52559
29836,,ceqf-v7ip6mj,26280,26281,52561
29837,,ukmgpv_16nmj,26281,26282,52563
29838,,9goxxc56dqaj,26282,26283,52565
29839,,xvyiv89v6jkj,26283,26284,52567
29840,,l2zyobbnsfaj,26284,26285,52569
29841,,j4bjs6easpej,26285,26286,52571
29842,,lx9vfe-lz5ej,26286,26287,52573
29843,,irllmoqepa8j,26287,26288,52575
29844,,tzorzatgypej,26288,26289,52577
29845,,dzlb9ukejbej,26289,26290,52579
29846,,7ng3y2kcm8qj,26290,26291,52581
29847,,zaanoimpxgej,26291,26292,52583
29848,,mqg4cl55ujaj,26292,26293,52585
29849,,0flbdrpouaqj,26293,26294,52587
29850,,oni3ghqopckj,26294,26295,52589
29851,,au271wseeq0j,26295,26296,52591
29852,,url:http://www.csa.com/partners/viewrecord.php3frequester3dgs26collection3dtrd26recid3d2005102518080ci,26296,26297,52593
29853,,siunqqsyb6sj,26297,26298,52595
29854,,wlsdeqz9ub4j,26298,26299,52597
29855,,ngzkt7iqipuj,26299,26300,52599
29856,,v3rneey-y0ej,26300,26301,52601
29857,,wytmaocz3_4j,26301,26302,52603
29858,,irl7tqnkl0yj,26302,26303,52605
29859,,gf1shv7p3w4j,26304,26305,52609
29860,,tfpmc6tzbrij,26305,26306,52611
29861,,vfljnsdtfsej,26306,26307,52613
29862,,p9hmhntf9faj,26307,26308,52615
29863,,ywzjvtgsmewj,26308,26309,52617
29864,,_2f7zwizk0qj,26309,26310,52619
29865,,bbdjo4sk9zej,26310,26311,52621
29866,,y1eru0fzzk4j,26311,26312,52623
29867,,etdbe3x_xo4j,26312,26313,52625
29868,,vmlazej0bikj,26313,26314,52627
29869,,ci01yfxfujuj,26314,26315,52629
29870,,lkd0l8pw3xyj,26315,26316,52631
29871,,o0qlbrnbpgej,26316,26317,52633
29872,,g65vxnvtj7sj,26317,26318,52635
29873,,35nmd2ciprej,26318,26319,52637
29874,,efdqjo4kk6qj,26319,26320,52639
29875,,fcdgcuanneij,26320,26321,52641
29876,,bvyqscifijcj,26321,26322,52643
29877,,cwvc6gkbd1mj,26322,26323,52645
29878,,_jgndex9daej,26323,26324,52647
29879,,efjvkv_hp0yj,26324,26325,52649
29880,,kpef9ixlngej,26325,26326,52651
29881,,uqtfngi91ukj,26326,26327,52653
29882,,mt7aitkp-xcj,26327,26328,52655
29883,,oekajfvecvyj,26328,26329,52657
29884,,ofp0se95jmej,26329,26330,52659
29885,,bgiqefq3eg0j,26330,26331,52661
29886,,beeu27wpjo0j,26331,26332,52663
29887,,gfkplksc7asj,26332,26333,52665
29888,,yrltjqnw6yuj,26333,26334,52667
29889,,xehgyk4n7fgj,26334,26335,52669
29890,,tu9kuqtfuvmj,26335,26336,52671
29891,,b9m6n4k8ui4j,26336,26337,52673
29892,,8ojx7me_oz0j,26337,26338,52675
29893,,f_op_oqfok8j,26338,26339,52677
29894,,jcqqgbm1c-uj,26339,26340,52679
29895,,vv1ugzew1dmj,26340,26341,52681
29896,,viikf4-1xygj,26341,26342,52683
29897,,3pkvgwkcjgoj,26342,26343,52685
29898,,znxjz0jsojuj,26343,26344,52687
29899,,rx9mxmefe9kj,26344,26345,52689
29900,,url:http://doi.wiley.com/10.1002/tl.161,26345,26346,52691
29901,,dprbgckz8ggj,26346,26347,52693
29902,,zz1kucg2rm0j,26347,26348,52695
29903,,57xm5rrckouj,26348,26349,52697
29904,,edkfhw3x8xij,26349,26350,52699
29905,,ewis023gh-aj,26350,26351,52701
29906,,url:http://links.jstor.org/sici3fsici3d0146-4949(196221252f22)3253a2253c32253a2522qslio253e2.0.co253b2-n,26351,26352,52703
29907,,6jyelvnbfzoj,26352,26353,52705
29908,,r5658fmxm7cj,26353,26354,52707
29909,,bvc1obdfzymj,26354,26355,52709
29910,,c095a4q2ofaj,26355,26356,52711
29911,,z7rgwi_xqraj,26356,26357,52713
29912,,opie6ssusbkj,26357,26358,52715
29913,,lmvttsdlejsj,26358,26359,52717
29914,,hhn15bvud08j,26359,26360,52719
29915,,8lbau4xpgp4j,26360,26361,52721
29916,,ofvt8mbdzrwj,26361,26362,52723
29917,,qnbwqtehefyj,26362,26363,52725
29918,,url:http://ieeexplore.ieee.org/iel2/1097/7626/00316471.pdf3farnumber3d316471,26363,26364,52727
29919,,url:http://portal.acm.org/ft_gateway.cfm3fid3d110118026type3dpdf,26364,26365,52729
29920,,nw6khp4pz5qj,26365,26366,52731
29921,,wjoa_owduvgj,26366,26367,52733
29922,,_q3scpb8vbgj,26367,26368,52735
29923,,svcae9jlq90j,26368,26369,52737
29924,,kipb9dqda-aj,26369,26370,52739
29925,,0meg5rjy0doj,26370,26371,52741
29926,,ji9b9ukwtoij,26371,26372,52743
29927,,xfaxjosvrp4j,26372,26373,52745
29928,,tzsux1m6egwj,26373,26374,52747
29929,,,26374,26375,52749
29930,,vryweqfrqcwj,26375,26376,52751
29931,,zghrplr9vasj,26377,26378,52755
29932,,gp425n8jmnej,26378,26379,52757
29933,,srdyiauwgk0j,26379,26380,52759
29934,,8ofyaw636ewj,26380,26381,52761
29935,,pqe5iegrvhqj,26381,26382,52763
29936,,uqu6mp-baqmj,26382,26383,52765
29937,,5c6kfhveicyj,26383,26384,52767
29938,,35lwdllmoe0j,26384,26385,52769
29939,,kyqykpmxtruj,26385,26386,52771
29940,,url:http://portal.acm.org/ft_gateway.cfm3fid3d109965826type3dpdf,26386,26387,52773
29941,,l1xjhn6fpm8j,26387,26388,52775
29942,,url:http://portal.acm.org/ft_gateway.cfm3fid3d109964326type3dpdf,26388,26389,52777
29943,,w2uxiwb8on8j,26389,26390,52779
29944,,qldksdi11suj,26390,26391,52781
29945,,0jzx8e_1f0gj,26391,26392,52783
29946,,awv0ws90bloj,26392,26393,52785
29947,,zy7kyhbdwv0j,26393,26394,52787
29948,,url:http://pubs.acs.org/cgi-bin/abstract.cgi/achre4/asap/abs/ar0501267.html,26394,26395,52789
29949,,ztj1sqnbvrsj,26395,26396,52791
29950,,izhlhudmrymj,26396,26397,52793
29951,,kusnrly7wraj,26397,26398,52795
29952,,thtoocyrclgj,26398,26399,52797
29953,,ucb071tvmvej,26399,26400,52799
29954,,dvnkwvowx_cj,26400,26401,52801
29955,,vfzb-tlbshqj,26401,26402,52803
29956,,qxxhlvv8aqoj,26402,26403,52805
29957,,url:http://www.springerlink.com/index/ld48kcxjwtcracdl.pdf,26403,26404,52807
29958,,ds0z6qjgysqj,26404,26405,52809
29959,,wv2ulvnavjyj,26405,26406,52811
29960,,r69ygln9ryaj,26406,26407,52813
29961,,gq6uik4shloj,26407,26408,52815
29962,,ti_9gb7on7mj,26408,26409,52817
29963,,heyjuur38gmj,26409,26410,52819
29964,,5vi21d9qn6yj,26410,26411,52821
29965,,pstdryyeahwj,26411,26412,52823
29966,,jzct0yld1ruj,26412,26413,52825
29967,,sszfk9jfdzcj,26413,26414,52827
29968,,9ctfqzhw_naj,26414,26415,52829
29969,,ktbay12yuakj,26415,26416,52831
29970,,lw-bqijqawkj,26416,26417,52833
29971,,rsj6mrrbetwj,26417,26418,52835
29972,,url:http://portal.acm.org/ft_gateway.cfm3fid3d106618326type3dpdf,26418,26419,52837
29973,,9nsj60msacsj,26419,26420,52839
29974,,qg3jzulgt2yj,26420,26421,52841
29975,,vjggundvhy8j,26421,26422,52843
29976,,3nn5wsocp0cj,26422,26423,52845
29977,,dxc_4kgvoqaj,26423,26424,52847
29978,,dypbcgucbsij,26424,26425,52849
29979,,x5ibsuymhqkj,26425,26426,52851
29980,,hvw2ad5blfqj,26426,26427,52853
29981,,cdikvjmv4wkj,26427,26428,52855
29982,,6_rjfeqjg1yj,26428,26429,52857
29983,,eohx5grr9i8j,26429,26430,52859
29984,,fqngkj6fcbwj,26430,26431,52861
29985,,opow89yk6a8j,26431,26432,52863
29986,,hraywjwwepyj,26432,26433,52865
29987,,kevqs7obuhoj,26433,26434,52867
29988,,url:http://portal.acm.org/ft_gateway.cfm3fid3d110118826type3dpdf,26435,26436,52871
29989,,kwlfi1x6okcj,26436,26437,52873
29990,,1c9zd08rbeaj,26437,26438,52875
29991,,1jxtm_-odswj,26438,26439,52877
29992,,zo5i5lktkhej,26439,26440,52879
29993,,qryybshocawj,26440,26441,52881
29994,,d-z19m8x1fmj,26441,26442,52883
29995,,phy13zv2-hij,26442,26443,52885
29996,,mtwijedkt2ej,26443,26444,52887
29997,,url:http://www.ingentaconnect.com/search/expand3fpub3dinfobike://pep/jae/2003/00000217/00000003/art0000126unc3d,26444,26445,52889
29998,,mzkwgvfyms8j,26445,26446,52891
29999,,bpuvr91giuaj,26446,26447,52893
30000,,rzzapxm_ehmj,26447,26448,52895
30001,,yu7miz1agu0j,26448,26449,52897
30002,,szd03geheo8j,26449,26450,52899
30003,,do1ys-idfnij,26451,26452,52903
30004,,a5s_u6ixg3ej,26452,26453,52905
30005,,5by1upumstuj,26453,26454,52907
30006,,3tgulvuhwfuj,26454,26455,52909
30007,,tnwl087l91ij,26455,26456,52911
30008,,buh-owpsnuij,26456,26457,52913
30009,,qggpwfmpusij,26457,26458,52915
30010,,mckoy53a_fuj,26458,26459,52917
30011,,url:http://links.jstor.org/sici3fsici3d0146-4949(196722)8253a3253c468253asoao253e2.0.co253b2-f,26459,26460,52919
30012,,redexpbydyyj,26460,26461,52921
30013,,rwjh20ni7zqj,26461,26462,52923
30014,,mk06-locecsj,26462,26463,52925
30015,,xqdasaspeegj,26463,26464,52927
30016,,rxal89vfykyj,26464,26465,52929
30017,,url:http://www.csa.com/partners/viewrecord.php3frequester3dgs26collection3dtrd26recid3da8622925ah,26465,26466,52931
30018,,302mklxkt5oj,26466,26467,52933
30019,,e-gx3vojmrwj,26467,26468,52935
30020,,h7rbovmqhhej,26468,26469,52937
30021,,px_fw-ezouyj,26469,26470,52939
30022,,5k-gwvznwruj,26470,26471,52941
30023,,tr0hjuldvgej,26471,26472,52943
30024,,nfddgc0iha4j,26472,26473,52945
30025,,ejqxlv_b8qkj,26473,26474,52947
30026,,3xxii5-rhzcj,26474,26475,52949
30027,,oityiqv3-8mj,26475,26476,52951
30028,,pbjbz5bypyuj,26476,26477,52953
30029,,qek2bskixbcj,26477,26478,52955
30030,,qv8cxh_xouqj,26478,26479,52957
30031,,swyjl5zz2v0j,26479,26480,52959
30032,,t51bodmiu5sj,26480,26481,52961
30033,,recwcmrxpawj,26481,26482,52963
30034,,ej1q3v4vzigj,26482,26483,52965
30035,,xekfxku9onuj,26483,26484,52967
30036,,gg8hh8bubi0j,26484,26485,52969
30037,,o_dr3bhirnaj,26485,26486,52971
30038,,url:http://portal.acm.org/ft_gateway.cfm3fid3d102775226type3dpdf,26486,26487,52973
30039,,tpfpg8kphwaj,26487,26488,52975
30040,,crvuotzixryj,26488,26489,52977
30041,,sygdpkirmsmj,26489,26490,52979
30042,,fusio0mjzouj,26490,26491,52981
30043,,hzmiypdje_0j,26491,26492,52983
30044,,nt3fqkv2_q0j,26492,26493,52985
30045,,wnis0ojcjmaj,26493,26494,52987
30046,,8hmbq7h151aj,26494,26495,52989
30047,,bc99wupm4scj,26495,26496,52991
30048,,,26496,26497,52993
30049,,9ywzrmyin4sj,26497,26498,52995
30050,,g8nyeyzcdggj,26498,26499,52997
30051,,t0htk2u0fykj,26499,26500,52999
30052,,etqexc5y-qmj,26500,26501,53001
30053,,8sqwf2ii254j,26501,26502,53003
30054,,o7msuhr3cp0j,26502,26503,53005
30055,,k9xczeeerzij,26503,26504,53007
30056,,jlahxcfgzukj,26504,26505,53009
30057,,yygyiaa6c00j,26505,26506,53011
30058,,5qc9ulrojfwj,26506,26507,53013
30059,,t4t6mjnyqr0j,26507,26508,53015
30060,,eioomt_t7wqj,26508,26509,53017
30061,,1kpbfzohjjgj,26509,26510,53019
30062,,yaqw0bzxy3sj,26510,26511,53021
30063,,ngrac0nvvh8j,26511,26512,53023
30064,,fnh8rbomtf8j,26512,26513,53025
30065,,url:http://portal.acm.org/citation.cfm3fid3d217279.21532326dl3dguide26dl3dacm26type3dseries26idx3d21727926part3dproceedings26wanttype3dproceedings26title3dinternational2520multimedia2520conference26cfid3d1111111126cftoken3d2222222,26513,26514,53027
30066,,6osrmpr9km8j,26514,26515,53029
30067,,h1zsj-a3hygj,26515,26516,53031
30068,,url:http://portal.acm.org/ft_gateway.cfm3fid3d102469626type3dpdf,26516,26517,53033
30069,,aurn2m0ljsyj,26517,26518,53035
30070,,dwijh1hfx14j,26518,26519,53037
30071,,aooqquvnxw4j,26519,26520,53039
30072,,icvzuofulwsj,26520,26521,53041
30073,,nnmwtkcmdz0j,26521,26522,53043
30074,,plzwcvjtbagj,26522,26523,53045
30075,,kvhuihttj_yj,26523,26524,53047
30076,,mdze22wevugj,26524,26525,53049
30077,,lp_ozokfi30j,26525,26526,53051
30078,,1b0jvmshklgj,26526,26527,53053
30079,,x92uvimbxpkj,26527,26528,53055
30080,,klxkb1ujxtwj,26528,26529,53057
30081,,ba0bn0njo5ij,26529,26530,53059
30082,,hrvfjqvhbagj,26530,26531,53061
30083,,gjjkj3ji2xcj,26531,26532,53063
30084,,hddsjafwjiwj,26532,26533,53065
30085,,f36was34gacj,26533,26534,53067
30086,,bft9uiyxsvmj,26534,26535,53069
30087,,o3fg1v919p8j,26535,26536,53071
30088,,kdydj2sdynij,26536,26537,53073
30089,,c7lczd6r1osj,26537,26538,53075
30090,,x74byboe2twj,26538,26539,53077
30091,,xdn85ecg2iej,26539,26540,53079
30092,,yldukqwy5eyj,26540,26541,53081
30093,,qwn2_50arouj,26541,26542,53083
30094,,zkk28-niakkj,26542,26543,53085
30095,,2qn1lvd0itkj,26543,26544,53087
30096,,h7qcmocgo3oj,26544,26545,53089
30097,,vb6fgbh_zb4j,26545,26546,53091
30098,,8l9rmymwcrqj,26546,26547,53093
30099,,mfuwn3l_l0ej,26547,26548,53095
30100,,yyvdh_ktemoj,26548,26549,53097
30101,,sydjsy8hzwuj,26549,26550,53099
30102,,rpvvzjynnxij,26550,26551,53101
30103,,yb3a1zjd0hmj,26551,26552,53103
30104,,yzg6yz2qfkgj,26552,26553,53105
30105,,ie9hhrd7fvqj,26553,26554,53107
30106,,abgovswv6-cj,26554,26555,53109
30107,,61cw9dcc6qsj,26555,26556,53111
30108,,zizk75thxeej,26556,26557,53113
30109,,tipamg6l36sj,26557,26558,53115
30110,,urceuybpvzqj,26558,26559,53117
30111,,rsgniszsgs0j,26559,26560,53119
30112,,blxykydwaz0j,26560,26561,53121
30113,,b28ddrqzhdoj,26561,26562,53123
30114,,kua45oh0rkyj,26562,26563,53125
30115,,kxq5zlme3vej,26563,26564,53127
30116,,7zrb9cfayiij,26564,26565,53129
30117,,d0x5xifnby0j,26566,26567,53133
30118,,c4ka833dhj4j,26567,26568,53135
30119,,p589yvj8s3kj,26568,26569,53137
30120,,g-4rsnd2d3oj,26569,26570,53139
30121,,a_25lmi64wmj,26570,26571,53141
30122,,7zzwz0yiivoj,26571,26572,53143
30123,,hjugwezcib4j,26572,26573,53145
30124,,w5gqzk1klpij,26573,26574,53147
30125,,dl06l6lhaukj,26574,26575,53149
30126,,2kxphu8o2mmj,26575,26576,53151
30127,,url:http://www.ingentaconnect.com/search/expand3fpub3dinfobike://els/13891286/2001/00000037/00000003/art0019226unc3d,26576,26577,53153
30128,,hct8r-o9-oaj,26577,26578,53155
30129,,lphpnqeeyrcj,26578,26579,53157
30130,,ddgspz6hnscj,26579,26580,53159
30131,,4w88x5sbwooj,26580,26581,53161
30132,,nv1zfnc_zycj,26581,26582,53163
30133,,v8eviygtuw0j,26582,26583,53165
30134,,vjv9ws0e31oj,26583,26584,53167
30135,,tzncf2zmz5oj,26584,26585,53169
30136,,39toh1x1jzgj,26585,26586,53171
30137,,3aheg3bihqij,26586,26587,53173
30138,,jelnvkwox3gj,26587,26588,53175
30139,,fqb25gr8tekj,26588,26589,53177
30140,,ysyk6orzi64j,26589,26590,53179
30141,,xm-0vudrzf0j,26590,26591,53181
30142,,zm-nowanirwj,26591,26592,53183
30143,,a-c2jkh4ck4j,26592,26593,53185
30144,,nbtzn1mhlnij,26593,26594,53187
30145,,8jgvv0pxiroj,26594,26595,53189
30146,,tqlyg1wbo5uj,26596,26597,53193
30147,,o9qfk7c0vhkj,26597,26598,53195
30148,,rcikjq67z6uj,26598,26599,53197
30149,,r3ehm32wsd8j,26599,26600,53199
30150,,8tqj0nzkctaj,26600,26601,53201
30151,,hoswqkwm8rkj,26601,26602,53203
30152,,en4hlhfwfpaj,26602,26603,53205
30153,,iwmajudxxxaj,26603,26604,53207
30154,,0pm4nip1150j,26604,26605,53209
30155,,g6_g-0ocu3ej,26605,26606,53211
30156,,uiuvmfndcgwj,26606,26607,53213
30157,,gi6bq9tey5ej,26607,26608,53215
30158,,092apdgycusj,26608,26609,53217
30159,,sv_m1okzsrcj,26609,26610,53219
30160,,yu348hmuhfej,26610,26611,53221
30161,,url:http://ieeexplore.ieee.org/iel2/1097/7626/00316513.pdf3farnumber3d316513,26611,26612,53223
30162,,ixwtpukyxjaj,26612,26613,53225
30163,,tr3ozamtejuj,26614,26615,53229
30164,,nrz9v864sduj,26615,26616,53231
30165,,php6jqmf_t4j,26616,26617,53233
30166,,url:http://portal.acm.org/ft_gateway.cfm3fid3d109969326type3dpdf,26617,26618,53235
30167,,gjbnwdkezm0j,26618,26619,53237
30168,,gvdtn6czy8yj,26619,26620,53239
30169,,lbp-utmfcscj,26620,26621,53241
30170,,f5g180y4k1cj,26621,26622,53243
30171,,p7uk7kuj6buj,26622,26623,53245
30172,,nexsilvl4jsj,26623,26624,53247
30173,,w6vqsdg5qz0j,26624,26625,53249
30174,,3efglcor7aaj,26625,26626,53251
30175,,lhlkrphyjf8j,26626,26627,53253
30176,,dgwspurhxr8j,26627,26628,53255
30177,,3dsaz5yq1xwj,26628,26629,53257
30178,,e4fb9g_-upyj,26629,26630,53259
30179,,asnpxfcr9ccj,26630,26631,53261
30180,,xtmlit4ei20j,26631,26632,53263
30181,,lysiqgp0vbsj,26632,26633,53265
30182,,x9w0sobnwwoj,26633,26634,53267
30183,,fnigcqemu5oj,26634,26635,53269
30184,,bgtcwllkftcj,26635,26636,53271
30185,,sjfryqzmcoyj,26636,26637,53273
30186,,rk5fdcoe_ygj,26637,26638,53275
30187,,oymalof_-dgj,26638,26639,53277
30188,,url:http://portal.acm.org/ft_gateway.cfm3fid3d95715426type3dpdf26dl3dportal26dl3dacm26cfid3d1111111126cftoken3d2222222,26639,26640,53279
30189,,kknm1ms49mgj,26640,26641,53281
30190,,xrtrtxnxvdyj,26641,26642,53283
30191,,rfjjnsglcj4j,26642,26643,53285
30192,,bqbqz2lolzuj,26643,26644,53287
30193,,mgz6btdmrhoj,26644,26645,53289
30194,,zxmpxvhg7e0j,26645,26646,53291
30195,,g-xq4zunolyj,26646,26647,53293
30196,,rwrhmpd907kj,26647,26648,53295
30197,,tlgwzunfjaaj,26648,26649,53297
30198,,cemnm6ihtaej,26649,26650,53299
30199,,ys_ikboj4vej,26650,26651,53301
30200,,url:http://doi.wiley.com/10.1002/ev.1616,26651,26652,53303
30201,,url:http://portal.acm.org/citation.cfm3fid3d171926.171971,26653,26654,53307
30202,,unjge90i4mqj,26654,26655,53309
30203,,9fad4dyeermj,26655,26656,53311
30204,,htzi99jqppwj,26656,26657,53313
30205,,owgv8uhxuf4j,26657,26658,53315
30206,,qopgr9ass38j,26658,26659,53317
30207,,2bo9wfxodqqj,26659,26660,53319
30208,,5dnylemqtb0j,26660,26661,53321
30209,,fatpff9gpwwj,26661,26662,53323
30210,,3j79q8z_o4mj,26662,26663,53325
30211,,dacuzflyammj,26663,26664,53327
30212,,6pepchyjoruj,26664,26665,53329
30213,,ewndm9tgocwj,26665,26666,53331
30214,,kvx8qictvcwj,26666,26667,53333
30215,,url:http://doi.wiley.com/10.1002/anie.199726831,26667,26668,53335
30216,,0_vkgcpab6gj,26668,26669,53337
30217,,ouwjochbj6aj,26669,26670,53339
30218,,30ahvnm4oc4j,26670,26671,53341
30219,,rojkd4hlwfej,26671,26672,53343
30220,,h7fxgdhpooyj,26672,26673,53345
30221,,evsgojddzawj,26673,26674,53347
30222,,a9szwoc8tssj,26674,26675,53349
30223,,nyzgl2ws3dmj,26675,26676,53351
30224,,la0mvnq90pgj,26676,26677,53353
30225,,vqj6pnli8aoj,26677,26678,53355
30226,,cstjuim6gz0j,26678,26679,53357
30227,,avcspr2z-n4j,26679,26680,53359
30228,,qlyptmq4lyuj,26680,26681,53361
30229,,fjcynldsy88j,26681,26682,53363
30230,,zlctdwq0hcij,26682,26683,53365
30231,,1lhpvbgk-bcj,26683,26684,53367
30232,,yi4fbvz-jykj,26684,26685,53369
30233,,f5aovapqgkqj,26685,26686,53371
30234,,hlpmvbtyze4j,26686,26687,53373
30235,,_sd-rzrbeucj,26687,26688,53375
30236,,rqieylbbbyej,26688,26689,53377
30237,,jdfqpetl_y8j,26689,26690,53379
30238,,nbajdj5izqej,26690,26691,53381
30239,,cq8mdsdzqgmj,26691,26692,53383
30240,,qroxw2cygr4j,26692,26693,53385
30241,,mxuqsq4raeej,26693,26694,53387
30242,,2cptgqtqsmmj,26694,26695,53389
30243,,wpzwut8ica4j,26695,26696,53391
30244,,zm2l2hk1iz0j,26697,26698,53395
30245,,wkk8wdcalu0j,26698,26699,53397
30246,,vdj4svnqxfyj,26699,26700,53399
30247,,yejkpc-on2wj,26700,26701,53401
30248,,elto03foooqj,26701,26702,53403
30249,,vffvucgkbwwj,26702,26703,53405
30250,,h6vvp5n7iaej,26703,26704,53407
30251,,bivc5h8mfswj,26704,26705,53409
30252,,ftwhg08h9poj,26705,26706,53411
30253,,her5b6yz_hyj,26706,26707,53413
30254,,hrkhoky2mpkj,26707,26708,53415
30255,,agmmhp3i75cj,26708,26709,53417
30256,,1inkcl06zykj,26709,26710,53419
30257,,ai4p27gtpxej,26710,26711,53421
30258,,url:http://portal.acm.org/ft_gateway.cfm3fid3d110750026type3dpdf,26711,26712,53423
30259,,url:http://www.csa.com/partners/viewrecord.php3frequester3dgs26collection3dtrd26recid3dn9210571ah,26712,26713,53425
30260,,p6vvkzuo4pgj,26713,26714,53427
30261,,fjd6b2bzaksj,26714,26715,53429
30262,,xdhh90jriw8j,26715,26716,53431
30263,,cjtn3ttcjiej,26716,26717,53433
30264,,v7pgfdceqkgj,26717,26718,53435
30265,,fslndm-xbrej,26718,26719,53437
30266,,lodr9a8nyj8j,26719,26720,53439
30267,,nsoa6gcc_jsj,26720,26721,53441
30268,,tcgdtrsbet0j,26721,26722,53443
30269,,url:http://portal.acm.org/ft_gateway.cfm3fid3d106628726type3dpdf,26722,26723,53445
30270,,bowi5aonomqj,26723,26724,53447
30271,,3ugjbixidjij,26724,26725,53449
30272,,j0kaqqmg_skj,26725,26726,53451
30273,,8cj3dnwk48mj,26726,26727,53453
30274,,4le3zowgzewj,26727,26728,53455
30275,,fc6tamekxv8j,26728,26729,53457
30276,,kcgrzrqrbwij,26729,26730,53459
30277,,afeipnb9154j,26730,26731,53461
30278,,url:http://portal.acm.org/citation.cfm3fid3d584647.584648,26731,26732,53463
30279,,c1i5hndpoycj,26732,26733,53465
30280,,hn2vydrajnwj,26733,26734,53467
30281,,vrmg0lwppo4j,26734,26735,53469
30282,,wxnclch14s0j,26735,26736,53471
30283,,zwpb8ekadruj,26736,26737,53473
30284,,uvzbgjittn4j,26737,26738,53475
30285,,taigyhrg-5cj,26738,26739,53477
30286,,c3jlul-psioj,26739,26740,53479
30287,,kfz6or_rvc8j,26740,26741,53481
30288,,zymwcr4kwcuj,26741,26742,53483
30289,,km-cheksmsej,26742,26743,53485
30290,,url:http://doi.wiley.com/10.1002/ace.52,26743,26744,53487
30291,,n4f_yyvsu7gj,26744,26745,53489
30292,,hgmpqc6v6s4j,26745,26746,53491
30293,,g57eruxc2tij,26746,26747,53493
30294,,0hpvftaysu8j,26748,26749,53497
30295,,qzmc_kwg5xej,26749,26750,53499
30296,,url:http://www.ingentaconnect.com/content/bpl/area/2001/00000033/00000004/art00044,26750,26751,53501
30297,,nqkirtckivsj,26751,26752,53503
30298,,6c1iiqdd5m8j,26752,26753,53505
30299,,k7phu5byhaqj,26753,26754,53507
30300,,m96ilur55oyj,26754,26755,53509
30301,,rllxra_mxrej,26755,26756,53511
30302,,url:http://links.jstor.org/sici3fsici3d0146-4949(196224)3253a1253c20253aevbpaw253e2.0.co253b2-v,26756,26757,53513
30303,,4leq14w7gzij,26757,26758,53515
30304,,lavkeuw0b1qj,26758,26759,53517
30305,,bynxegb5wswj,26759,26760,53519
30306,,bp2bruxp5jwj,26760,26761,53521
30307,,4ayjdqfxrkcj,26761,26762,53523
30308,,jcbmiqduilsj,26762,26763,53525
30309,,sikcc5o8rxqj,26763,26764,53527
30310,,4t3buclq1jij,26764,26765,53529
30311,,c4sewcjl7o4j,26765,26766,53531
30312,,tgouofhtvoej,26766,26767,53533
30313,,eqyqkodzqpqj,26767,26768,53535
30314,,0dbos1audo0j,26768,26769,53537
30315,,hanly3mzfyyj,26769,26770,53539
30316,,k08fiy-lb2ej,26770,26771,53541
30317,,url:http://adsabs.harvard.edu/abs/1992mit..rept.1990f,26771,26772,53543
30318,,hb7psn185ykj,26772,26773,53545
30319,,chasvdcrqeej,26774,26775,53549
30320,,3wolchgajbcj,26775,26776,53551
30321,,h20gikyc-mwj,26776,26777,53553
30322,,adxxrqrmy9ij,26777,26778,53555
30323,,isbwqin-ey0j,26778,26779,53557
30324,,1z6huxdac9ij,26779,26780,53559
30325,,aydgo028zy8j,26780,26781,53561
30326,,bmv_iwdclioj,26781,26782,53563
30327,,ccixe9sbti8j,26782,26783,53565
30328,,url:http://portal.acm.org/citation.cfm3fid3d192593.19737126dl3dguide26dl3dacm26type3dseries26idx3d19259326part3dproceedings26wanttype3dproceedings26title3dinternational2520multimedia2520conference26cfid3d1111111126cftoken3d2222222,26783,26784,53567
30329,,462clq3tqnej,26785,26786,53571
30330,,ydjnxd54-rcj,26786,26787,53573
30331,,ljvqwao2qnwj,26787,26788,53575
30332,,pvgsyql1uzsj,26788,26789,53577
30333,,s-ct8qqhdxmj,26789,26790,53579
30334,,kbarjf_iwwwj,26790,26791,53581
30335,,c4u4wa4t_30j,26791,26792,53583
30336,,5eqmkb2wso0j,26792,26793,53585
30337,,y0vkx7cyz10j,26793,26794,53587
30338,,-3r2sw0bzboj,26795,26796,53591
30339,,wthx8xfoargj,26796,26797,53593
30340,,ne-hqy9ccjcj,26797,26798,53595
30341,,d0jpo8mdhoaj,26798,26799,53597
30342,,umdbvnsm7kij,26799,26800,53599
30343,,pqgv3imdl6kj,26800,26801,53601
30344,,sn-m3iba6y4j,26801,26802,53603
30345,,9zj0pz5fxzkj,26802,26803,53605
30346,,ytfbywqpapcj,26803,26804,53607
30347,,qc-pv0argi8j,26804,26805,53609
30348,,kqpdcay4ofuj,26805,26806,53611
30349,,7ivl47egsluj,26806,26807,53613
30350,,nwplm2gawr4j,26807,26808,53615
30351,,0tfij-9a890j,26808,26809,53617
30352,,9km1mkzwawoj,26809,26810,53619
30353,,lmlleeqns4ej,26810,26811,53621
30354,,ah2tiz7kukgj,26811,26812,53623
30355,,ph_vupu_kxaj,26812,26813,53625
30356,,o1qn6bdjwl8j,26813,26814,53627
30357,,dr1mdvxzfqwj,26814,26815,53629
30358,,url:http://www.csa.com/partners/viewrecord.php3frequester3dgs26collection3dtrd26recid3d200308250549ci26recid3d200308500246ea,26815,26816,53631
30359,,y7nywwmu1sej,26816,26817,53633
30360,,url:http://ieeexplore.ieee.org/iel3/3990/11481/00547836.pdf3farnumber3d547836,26817,26818,53635
30361,,iweljle5t-wj,26818,26819,53637
30362,,mkfvh7osxomj,26819,26820,53639
30363,,ylftsc6hijyj,26820,26821,53641
30364,,0kjsyo1jrtej,26821,26822,53643
30365,,gy1gf_x9yryj,26822,26823,53645
30366,,kpyfpqgcegyj,26823,26824,53647
30367,,s6gouutn2lej,26824,26825,53649
30368,,,26825,26826,53651
30369,,rhi_kz7is9uj,26826,26827,53653
30370,,mdidi2db97oj,26827,26828,53655
30371,,jntlvx4tpi0j,26828,26829,53657
30372,,f2rfjktsg4cj,26829,26830,53659
30373,,9lbhbyaub_ej,26830,26831,53661
30374,,8rctgpyl-1ij,26831,26832,53663
30375,,9kepfmn9tgmj,26833,26834,53667
30376,,a_bps5qdvamj,26834,26835,53669
30377,,fdf_uivyfisj,26835,26836,53671
30378,,v3sw9h6gsfkj,26836,26837,53673
30379,,eegzjs33xm8j,26837,26838,53675
30380,,cczangbudquj,26838,26839,53677
30381,,url:http://www.csa.com/partners/viewrecord.php3frequester3dgs26collection3dtrd26recid3dn9210487ah,26839,26840,53679
30382,,ces4gq3tn-cj,26840,26841,53681
30383,,spk2etaddwmj,26841,26842,53683
30384,,cucpumrf8ooj,26842,26843,53685
30385,,okojtwb3qqkj,26843,26844,53687
30386,,oks5gxw-1_uj,26844,26845,53689
30387,,url:http://portal.acm.org/citation.cfm3fid3d335222,26845,26846,53691
30388,,5cgjhkwlwd0j,26846,26847,53693
30389,,s-y1wdzyoe4j,26847,26848,53695
30390,,xs8a5v9n3okj,26848,26849,53697
30391,,uadfu0w_t-uj,26849,26850,53699
30392,,,26850,26851,53701
30393,,0hadagr-v3oj,26851,26852,53703
30394,,g0kggf8usy0j,26852,26853,53705
30395,,wpklwkip_d8j,26853,26854,53707
30396,,bmqcizs8suwj,26854,26855,53709
30397,,lsv9emnq5iwj,26855,26856,53711
30398,,xwqpnyczyrej,26856,26857,53713
30399,,url:http://portal.acm.org/citation.cfm3fid3d908276,26857,26858,53715
30400,,8ecltvgjtu0j,26858,26859,53717
30401,,ixo8f3i-f3qj,26859,26860,53719
30402,,u_q7ullam48j,26860,26861,53721
30403,,z4dxyqu0jdqj,26861,26862,53723
30404,,fjoxml30mmkj,26862,26863,53725
30405,,imjiyd8k5goj,26863,26864,53727
30406,,l9hfmk1dtdaj,26864,26865,53729
30407,,gb2bwswp_ckj,26865,26866,53731
30408,,i6b3ilzndb4j,26866,26867,53733
30409,,jfoef9zddgyj,26868,26869,53737
30410,,p7zdb6ss5aej,26870,26871,53741
30411,,6z0tdl4cvzuj,26871,26872,53743
30412,,7clhi_lotouj,26872,26873,53745
30413,,lyrxfbqzycej,26873,26874,53747
30414,,37llirw_coqj,26874,26875,53749
30415,,caucm7tftdyj,26875,26876,53751
30416,,tgcx4ll24y0j,26876,26877,53753
30417,,rx4hgui0nw4j,26877,26878,53755
30418,,2fkv9juelngj,26878,26879,53757
30419,,qgjui57fyy4j,26879,26880,53759
30420,,5ioekkoonzej,26880,26881,53761
30421,,rs5zexzihuqj,26881,26882,53763
30422,,9n1o_rkrm8sj,26882,26883,53765
30423,,g7g3bg11grwj,26883,26884,53767
30424,,i7iyq9jwdc0j,26884,26885,53769
30425,,8vjyrnjcuh0j,26885,26886,53771
30426,,fwq7al0qgw4j,26886,26887,53773
30427,,t57nbjrihrmj,26887,26888,53775
30428,,qws7clr5bqij,26888,26889,53777
30429,,8up-2trki5wj,26889,26890,53779
30430,,9aurlqhb6aij,26890,26891,53781
30431,,gj_1dewubpgj,26891,26892,53783
30432,,tmprwkpghdkj,26892,26893,53785
30433,,ytm2ycmuk-ej,26893,26894,53787
30434,,sltwenhc9m4j,26894,26895,53789
30435,,-1v17ejfaiaj,26895,26896,53791
30436,,6d0qt6sjp8cj,26896,26897,53793
30437,,hq60b_yfyaqj,26897,26898,53795
30438,,ibzwm87walsj,26898,26899,53797
30439,,kobzrlerimyj,26899,26900,53799
30440,,up2-7g05wjsj,26900,26901,53801
30441,,url:http://portal.acm.org/citation.cfm3fid3d30424526coll3dportal26dl3dacm,26901,26902,53803
30442,,ncg7o1vgdtoj,26902,26903,53805
30443,,url:http://www.springerlink.com/index/j407187956033035.pdf,26903,26904,53807
30444,,q68-rsfeioyj,26905,26906,53811
30445,,i1a-yyhhpuwj,26906,26907,53813
30446,,7tduy2ia9aoj,26907,26908,53815
30447,,h0q5dohuut0j,26908,26909,53817
30448,,moiycyfvnhmj,26909,26910,53819
30449,,pjcgbz5_vrgj,26910,26911,53821
30450,,32wdj4l_m90j,26911,26912,53823
30451,,kgcywsrx3tuj,26912,26913,53825
30452,,ebzk4qp389yj,26913,26914,53827
30453,,qobgyk5r30kj,26914,26915,53829
30454,,3cx_aylo5s0j,26915,26916,53831
30455,,ez7s_yiooxkj,26916,26917,53833
30456,,je7ubrkxm6oj,26917,26918,53835
30457,,oqnmxpvd7iej,26918,26919,53837
30458,,0htzwhwauh8j,26919,26920,53839
30459,,url:http://www.csa.com/partners/viewrecord.php3frequester3dgs26collection3dtrd26recid3dn9210420ah,26920,26921,53841
30460,,sxvpe1pfwagj,26921,26922,53843
30461,,sst_bznev0cj,26922,26923,53845
30462,,_kvcwfvfmzcj,26923,26924,53847
30463,,s_ljujxxcygj,26924,26925,53849
30464,,ukw3evrek8cj,26925,26926,53851
30465,,9_zkjxabrioj,26926,26927,53853
30466,,ewytiooml7oj,26927,26928,53855
30467,,uyim2oirgoij,26928,26929,53857
30468,,7voexa4-akqj,26929,26930,53859
30469,,le5hvsfbcxuj,26930,26931,53861
30470,,bbywdi_hhyoj,26931,26932,53863
30471,,swjzb39l1syj,26932,26933,53865
30472,,s9wjsus9zbmj,26933,26934,53867
30473,,epel3vqsktgj,26934,26935,53869
30474,,qrns_s1-kyyj,26935,26936,53871
30475,,3vw0ubriecej,26936,26937,53873
30476,,itzj1lbpn0wj,26937,26938,53875
30477,,zff85yulssqj,26938,26939,53877
30478,,4dwt0hfdcwcj,26939,26940,53879
30479,,see7z50nk8uj,26940,26941,53881
30480,,y541r5ij5xgj,26941,26942,53883
30481,,x8uppp9dyksj,26942,26943,53885
30482,,kklurv5nzlcj,26943,26944,53887
30483,,w_3kgygx5toj,26944,26945,53889
30484,,68u4ede1su8j,26945,26946,53891
30485,,xoz4iylviukj,26946,26947,53893
30486,,atv-v2ulnauj,26947,26948,53895
30487,,lbtpspttr6mj,26948,26949,53897
30488,,zszxtv5iqx4j,26949,26950,53899
30489,,46ymwgdfzcej,26950,26951,53901
30490,,-13trgvdaz4j,26951,26952,53903
30491,,ebglhz0wy8yj,26952,26953,53905
30492,,url:http://portal.acm.org/ft_gateway.cfm3fid3d110196426type3dpdf,26953,26954,53907
30493,,xmc0w6cqjjij,26954,26955,53909
30494,,zx61uaccdigj,26955,26956,53911
30495,,,26956,26957,53913
30496,,ncmcdodzal4j,26957,26958,53915
30497,,lasxhcbipgyj,26958,26959,53917
30498,,clleptal2jaj,26959,26960,53919
30499,,zc2gvc89wbgj,26960,26961,53921
30500,,japrgzkj_z8j,26961,26962,53923
30501,,djidljubkikj,26962,26963,53925
30502,,zsn87kuq_ymj,26963,26964,53927
30503,,0i8ezrq6tjij,26964,26965,53929
30504,,6b0tfodm_r8j,26965,26966,53931
30505,,lbyy5cjthsuj,26966,26967,53933
30506,,awfge4lrt14j,26967,26968,53935
30507,,_zwxszuabcoj,26968,26969,53937
30508,,wybn-aw9szqj,26969,26970,53939
30509,,kkpjbiiek9aj,26970,26971,53941
30510,,2p_-xfhjgkqj,26971,26972,53943
30511,,c88mqxuwxryj,26972,26973,53945
30512,,4ydomterbggj,26973,26974,53947
30513,,mripyn0np8aj,26974,26975,53949
30514,,crppwru9hw0j,26975,26976,53951
30515,,onz9ende1aej,26976,26977,53953
30516,,ruqggyki6d0j,26977,26978,53955
30517,,zqjme1bgqgmj,26978,26979,53957
30518,,nir1h2xxtaaj,26979,26980,53959
30519,,url:http://pubs.acs.org/cgi-bin/abstract.cgi/achre4/asap/abs/ar050163y.html,26980,26981,53961
30520,,vyigypyqqw4j,26981,26982,53963
30521,,bho8kticu-8j,26982,26983,53965
30522,,zl89qjzrufcj,26983,26984,53967
30523,,dsqtb__7q9cj,26984,26985,53969
30524,,zolmt7f6irwj,26985,26986,53971
30525,,ojofzfhr-zij,26986,26987,53973
30526,,oc1-bgeszeij,26987,26988,53975
30527,,a-mc2cdusjoj,26988,26989,53977
30528,,riyojxw6jemj,26989,26990,53979
30529,,wtdlocdee8wj,26990,26991,53981
30530,,url:http://doi.wiley.com/10.1002/ev.1625,26991,26992,53983
30531,,004z3ctw0dej,26992,26993,53985
30532,,8rwcydk9vbmj,26993,26994,53987
30533,,odiq721mj5wj,26994,26995,53989
30534,,_kjsf-mtecaj,26995,26996,53991
30535,,cwzopjjb50cj,26996,26997,53993
30536,,ynsc6-93cosj,26997,26998,53995
30537,,eys6nsxqgxoj,26998,26999,53997
30538,,n-ramkbvwxmj,26999,27000,53999
30539,,ijzjranmlmij,27000,27001,54001
30540,,url:http://portal.acm.org/ft_gateway.cfm3fid3d12649426type3dpdf26coll3dguide26dl3dacm26cfid3d1111111126cftoken3d2222222,27002,27003,54005
30541,,48o7uqtgdg4j,27003,27004,54007
30542,,jefmtq0agigj,27004,27005,54009
30543,,_gsvswdye24j,27005,27006,54011
30544,,fzewmmevfhij,27007,27008,54015
30545,,opyngibzpvgj,27008,27009,54017
30546,,zpt7qbaf9ewj,27009,27010,54019
30547,,e1eqscehqvcj,27010,27011,54021
30548,,ekxm26v5d_aj,27011,27012,54023
30549,,fiwtq2psmycj,27012,27013,54025
30550,,5b13gnnt7jij,27013,27014,54027
30551,,hsjs3hhzdb0j,27014,27015,54029
30552,,7tvkzxap8taj,27015,27016,54031
30553,,h7rqzpwfgu4j,27016,27017,54033
30554,,tblfsb7p1ioj,27017,27018,54035
30555,,h6pehoc_bkyj,27018,27019,54037
30556,,q42rdnopmg0j,27019,27020,54039
30557,,agezqgi7kbqj,27020,27021,54041
30558,,krvzgg0uij0j,27021,27022,54043
30559,,hfx0xc3btkkj,27022,27023,54045
30560,,08hpwyqmtqaj,27023,27024,54047
30561,,rsmjycw6gvgj,27024,27025,54049
30562,,9ph-z-ojz7wj,27025,27026,54051
30563,,ulxz9e5upemj,27026,27027,54053
30564,,ibzpicicru8j,27027,27028,54055
30565,,rj7szun0eecj,27028,27029,54057
30566,,jilyrdsvwtaj,27029,27030,54059
30567,,yxbj7lntjjwj,27030,27031,54061
30568,,smlozhkzmhij,27031,27032,54063
30569,,u3co7szymyij,27032,27033,54065
30570,,4jezkq6fqncj,27033,27034,54067
30571,,yjxn7qfir8aj,27034,27035,54069
30572,,1b_xbu139n0j,27035,27036,54071
30573,,vlxs3tzynmoj,27037,27038,54075
30574,,94ihiq9tp9mj,27039,27040,54079
30575,,nqutrait2wsj,27040,27041,54081
30576,,,27041,27042,54083
30577,,wc5xltrxrcuj,27043,27044,54087
30578,,uhxz6d8a9qsj,27044,27045,54089
30579,,pu-lzwz0rtej,27045,27046,54091
30580,,jrrijgz7wyyj,27046,27047,54093
30581,,4apl1osj80yj,27047,27048,54095
30582,,jeonpejzy5cj,27049,27050,54099
30583,,aidshph4ss0j,27050,27051,54101
30584,,tj-g7hl_blcj,27051,27052,54103
30585,,ep1hbesohcsj,27052,27053,54105
30586,,0t68utxz09gj,27053,27054,54107
30587,,evsgkxyp5okj,27054,27055,54109
30588,,rc7hyj4yfyyj,27055,27056,54111
30589,,1yu6dn_xessj,27056,27057,54113
30590,,dx5py-50rfcj,27057,27058,54115
30591,,9rtccw7tehyj,27058,27059,54117
30592,,u4-e8b06f-ij,27059,27060,54119
30593,,nc2pqlss_cij,27060,27061,54121
30594,,onw0sz7e4vyj,27061,27062,54123
30595,,rycmhotopqyj,27062,27063,54125
30596,,pfe7wb9xpgaj,27063,27064,54127
30597,,hd-7tkqerjuj,27064,27065,54129
30598,,pcwbiiqrneaj,27065,27066,54131
30599,,93ar_airsvmj,27066,27067,54133
30600,,lbxffel6zmej,27067,27068,54135
30601,,crennuandbgj,27068,27069,54137
30602,,_m6qwgmxriej,27070,27071,54141
30603,,eokmhy-ocsgj,27071,27072,54143
30604,,xn99r0tecauj,27072,27073,54145
30605,,j3ybnuct7zcj,27073,27074,54147
30606,,fulbota3jyuj,27074,27075,54149
30607,,c76cr6hzkdij,27075,27076,54151
30608,,largwrums5kj,27076,27077,54153
30609,,vsn9edoxmqmj,27077,27078,54155
30610,,v33mg2ef8jqj,27078,27079,54157
30611,,2rb_0zbvruej,27079,27080,54159
30612,,lkjd8kc2sycj,27080,27081,54161
30613,,zq5dkeg2v3uj,27081,27082,54163
30614,,ogq7crdad-uj,27082,27083,54165
30615,,6qnyx1owrmoj,27083,27084,54167
30616,,jx0lttuvuzaj,27084,27085,54169
30617,,o8s42s2ddjij,27085,27086,54171
30618,,nr4jhgr8hq4j,27086,27087,54173
30619,,30uib9v8mqyj,27087,27088,54175
30620,,2wcetovtuumj,27088,27089,54177
30621,,iiof-pjlxjgj,27089,27090,54179
30622,,_jnhba4lzkkj,27090,27091,54181
30623,,obcch6icpfoj,27091,27092,54183
30624,,m4m0tv8m3ayj,27092,27093,54185
30625,,lk1sq-jkpguj,27093,27094,54187
30626,,gs7w9_geraej,27094,27095,54189
30627,,7vq2dxjcjl4j,27095,27096,54191
30628,,uzxt_vhapxqj,27096,27097,54193
30629,,7pe58wel9bwj,27097,27098,54195
30630,,ljkpmu1tilcj,27098,27099,54197
30631,,4kx6wvoedn0j,27099,27100,54199
30632,,av-lee46irmj,27100,27101,54201
30633,,lrocsfnfprmj,27101,27102,54203
30634,,ijduq51dm8mj,27102,27103,54205
30635,,jsgiokb4bb0j,27103,27104,54207
30636,,zgqho0dt578j,27105,27106,54211
30637,,pw78fnri6mgj,27106,27107,54213
30638,,ws4imtudaboj,27107,27108,54215
30639,,ncxidg82zwaj,27108,27109,54217
30640,,k_e5ilffggsj,27109,27110,54219
30641,,gxth8ua2ppoj,27110,27111,54221
30642,,ifawikx2ytij,27111,27112,54223
30643,,dribvd1yrhij,27112,27113,54225
30644,,ea-28bmohtgj,27113,27114,54227
30645,,p7h24kmryiuj,27114,27115,54229
30646,,0gp02zskcmmj,27115,27116,54231
30647,,,27116,27117,54233
30648,,z1p9qnsfduaj,27117,27118,54235
30649,,dsx0lukgzbaj,27118,27119,54237
30650,,0x1ilqddhswj,27119,27120,54239
30651,,qspc18okpm0j,27120,27121,54241
30652,,gptavb55tnyj,27121,27122,54243
30653,,edhtin0ovl8j,27122,27123,54245
30654,,ihpe8vg5ufcj,27123,27124,54247
30655,,zwdz2kxjxaaj,27124,27125,54249
30656,,,27125,27126,54251
30657,,qkjimepbj5yj,27126,27127,54253
30658,,indwm41yvlgj,27127,27128,54255
30659,,ek4yrywlno8j,27128,27129,54257
30660,,url:http://adsabs.harvard.edu/abs/1976infph..16...65s,27129,27130,54259
30661,,ctvtjrnebikj,27130,27131,54261
30662,,xpazo5ultzij,27131,27132,54263
30663,,vo-l5mslhrmj,27132,27133,54265
30664,,url:http://links.jstor.org/sici3fsici3d0146-4949(196223)3253a3253c5253ahrahn2522253e2.0.co253b2-f,27133,27134,54267
30665,,5ja4qr8rxq0j,27134,27135,54269
30666,,o7tbiygaclaj,27135,27136,54271
30667,,_jwlupawba8j,27136,27137,54273
30668,,_izi7_hdxuwj,27137,27138,54275
30669,,nuwk0jtpscyj,27138,27139,54277
30670,,url:http://www.jbc.org/cgi/reprint/280/11/10395.pdf,27139,27140,54279
30671,,rql42s-9uwaj,27140,27141,54281
30672,,azxvvg0hvukj,27141,27142,54283
30673,,url:http://doi.wiley.com/10.1002/he.10.abs,27142,27143,54285
30674,,nzw9ibrf6msj,27143,27144,54287
30675,,xz8hhix-nmoj,27144,27145,54289
30676,,ytlvsehrersj,27145,27146,54291
30677,,u7ve3o3eyd4j,27146,27147,54293
30678,,cnfxvlgcrdoj,27147,27148,54295
30679,,vmrrxf1ux7kj,27148,27149,54297
30680,,url:http://www.springerlink.com/index/p074t33638t88v55.pdf,27149,27150,54299
30681,,cfrxxpwfqhgj,27150,27151,54301
30682,,hwyzjyi2xc0j,27151,27152,54303
30683,,v5kerqrexuej,27152,27153,54305
30684,,zqesxg9docqj,27153,27154,54307
30685,,5iomi78uwraj,27154,27155,54309
30686,,dysn2m2kxquj,27155,27156,54311
30687,,egp2juw_00gj,27156,27157,54313
30688,,qzjsryg2cacj,27157,27158,54315
30689,,gtqzavfi9smj,27158,27159,54317
30690,,lrudm_d7uaej,27159,27160,54319
30691,,p_0e_c3-btkj,27160,27161,54321
30692,,km61v7qm0gaj,27161,27162,54323
30693,,r8awmkmppacj,27162,27163,54325
30694,,url:http://www.csa.com/partners/viewrecord.php3frequester3dgs26collection3dtrd26recid3d200161001713ce26recid3d200114008871mt,27163,27164,54327
30695,,wbipfrn-_a0j,27164,27165,54329
30696,,u8x4phxi5paj,27165,27166,54331
30697,,yrpasz1prooj,27166,27167,54333
30698,,sstgzelio2sj,27167,27168,54335
30699,,v6a49isfbg4j,27168,27169,54337
30700,,o9eeu3o60fmj,27169,27170,54339
30701,,0hymtqusvayj,27170,27171,54341
30702,,fih576mbsw0j,27171,27172,54343
30703,,mosvdvkwhjwj,27172,27173,54345
30704,,mer69rjcx3sj,27173,27174,54347
30705,,4wpra9-p5w0j,27174,27175,54349
30706,,z5qfu_mkfm4j,27175,27176,54351
30707,,phba0g9j7ekj,27176,27177,54353
30708,,gekonaki01yj,27177,27178,54355
30709,,9m_mmhbxcumj,27178,27179,54357
30710,,z9q75ydpc08j,27179,27180,54359
30711,,rb5u3eeupjwj,27180,27181,54361
30712,,6kiqiqluutkj,27181,27182,54363
30713,,mjohn9engjgj,27182,27183,54365
30714,,url:http://doi.ieeecomputersociety.org/10.1109/tkde.2004.1277824,27183,27184,54367
30715,,cjnktzibr3sj,27184,27185,54369
30716,,24edemzone4j,27185,27186,54371
30717,,xzsqn32oqgmj,27186,27187,54373
30718,,llnp1l5tf1oj,27187,27188,54375
30719,,eit9akgvbrwj,27188,27189,54377
30720,,mvuz-dio-moj,27189,27190,54379
30721,,podi_6lstuij,27191,27192,54383
30722,,xvnfr8fhewwj,27192,27193,54385
30723,,dwhmoyo9ul4j,27193,27194,54387
30724,,1wwalnhadzmj,27194,27195,54389
30725,,7zhoubbxw3qj,27195,27196,54391
30726,,nowcw1qlldyj,27196,27197,54393
30727,,kc77itc9l3oj,27197,27198,54395
30728,,huuccrt5fgaj,27198,27199,54397
30729,,henlcr2tdd0j,27199,27200,54399
30730,,lwzoqgxmn2gj,27200,27201,54401
30731,,6aml9nrx6acj,27201,27202,54403
30732,,ofucfsfxssqj,27202,27203,54405
30733,,uoxmauuy0bij,27203,27204,54407
30734,,l_w7lnsd4wuj,27204,27205,54409
30735,,833k8cip8gyj,27205,27206,54411
30736,,url:http://ieeexplore.ieee.org/iel2/997/7843/00331718.pdf3farnumber3d331718,27206,27207,54413
30737,,p9oyznxqojwj,27207,27208,54415
30738,,gxjdlh9qaugj,27208,27209,54417
30739,,eqvs_-iejukj,27209,27210,54419
30740,,rjigkcziwkoj,27210,27211,54421
30741,,sf1e6zefq-yj,27211,27212,54423
30742,,kyzfaketq2oj,27212,27213,54425
30743,,ovpxtbejwzoj,27213,27214,54427
30744,,ypzpy5gkqfqj,27214,27215,54429
30745,,_qfaw5bqvyyj,27215,27216,54431
30746,,ayj_iyd4_csj,27216,27217,54433
30747,,vdifkmfqxmej,27217,27218,54435
30748,,,27218,27219,54437
30749,,lk1un_uk5hej,27219,27220,54439
30750,,dchzmbqegewj,27221,27222,54443
30751,,tbos0cbe1vqj,27222,27223,54445
30752,,qmfekxmbhiuj,27223,27224,54447
30753,,nir1ftdnqpuj,27224,27225,54449
30754,,32yrdnqsgomj,27225,27226,54451
30755,,yviehad9lpqj,27226,27227,54453
30756,,navg71q60baj,27227,27228,54455
30757,,9ee83fn6hvsj,27228,27229,54457
30758,,4p4prbdz-imj,27229,27230,54459
30759,,l7p1wlmxufwj,27230,27231,54461
30760,,7a6g7zjmc5cj,27231,27232,54463
30761,,nkiehdojblyj,27232,27233,54465
30762,,dqoey0yx60ej,27233,27234,54467
30763,,pulxexqskhoj,27234,27235,54469
30764,,tmcqpyhpn90j,27235,27236,54471
30765,,url:http://www.csa.com/partners/viewrecord.php3frequester3dgs26collection3dtrd26recid3d0718331ci,27236,27237,54473
30766,,kqizp2w7-r0j,27237,27238,54475
30767,,rds3fd50encj,27238,27239,54477
30768,,yntnf1n0lncj,27239,27240,54479
30769,,rijfceavht4j,27240,27241,54481
30770,,9jmbm9ihxaij,27241,27242,54483
30771,,nb9fndkyzyoj,27242,27243,54485
30772,,r5bjk_49sxmj,27243,27244,54487
30773,,dpqmoyqwnrsj,27244,27245,54489
30774,,x70-wpdy51yj,27245,27246,54491
30775,,ndsfco8znuqj,27246,27247,54493
30776,,falktaso27aj,27247,27248,54495
30777,,ylfxjnihsvgj,27248,27249,54497
30778,,r7rkhgnf-bej,27249,27250,54499
30779,,q7jr_8hny4ej,27250,27251,54501
30780,,piggxstmb2cj,27251,27252,54503
30781,,ody9srspetij,27252,27253,54505
30782,,cpkomh3ipkmj,27253,27254,54507
30783,,fsjnb-h5iuej,27254,27255,54509
30784,,xfzqqjdwnfcj,27255,27256,54511
30785,,9mf4yllia_ej,27256,27257,54513
30786,,m1bqrhdjtauj,27257,27258,54515
30787,,tzkk9c09f2cj,27259,27260,54519
30788,,kaped_p-7iwj,27260,27261,54521
30789,,ilw8p2shru8j,27262,27263,54525
30790,,4oyxetf6a3ej,27263,27264,54527
30791,,qpdp56ngu6cj,27264,27265,54529
30792,,8ljr7kdh5nyj,27265,27266,54531
30793,,pjawpbnrfjcj,27266,27267,54533
30794,,_bpijjbtokgj,27267,27268,54535
30795,,9mekqf-zqcij,27268,27269,54537
30796,,acg1pkugyyej,27269,27270,54539
30797,,5f8zdlscik0j,27270,27271,54541
30798,,hitpqmoce8gj,27271,27272,54543
30799,,ckubbkzgspmj,27272,27273,54545
30800,,gsijt9kbss4j,27273,27274,54547
30801,,url:http://www.springerlink.com/index/u224623541225714.pdf,27274,27275,54549
30802,,a1-nxxwanu4j,27275,27276,54551
30803,,anofuwtuafcj,27276,27277,54553
30804,,zp7a8dveez0j,27278,27279,54557
30805,,l3cpzshg7tej,27279,27280,54559
30806,,er3ybymr9wkj,27280,27281,54561
30807,,tlkfz8d_7vuj,27281,27282,54563
30808,,eolxamrafqkj,27282,27283,54565
30809,,gpxtem-kotgj,27283,27284,54567
30810,,mecfhyuh3fyj,27284,27285,54569
30811,,ntcjtu3hqiuj,27285,27286,54571
30812,,jyrksm3cluij,27286,27287,54573
30813,,_bjol8yhko4j,27287,27288,54575
30814,,uyygtyppl-sj,27288,27289,54577
30815,,jhzrqmp8tswj,27289,27290,54579
30816,,s1tv4huzczoj,27290,27291,54581
30817,,e6y61rorvsoj,27291,27292,54583
30818,,kjuzh5snuhij,27292,27293,54585
30819,,xgeinwpeqc8j,27293,27294,54587
30820,,,27294,27295,54589
30821,,bioxpzhuzr4j,27295,27296,54591
30822,,w4x-3ktwwgcj,27296,27297,54593
30823,,fv8j1jpglcaj,27297,27298,54595
30824,,uydhxpcpvc8j,27298,27299,54597
30825,,eqlapcasdeej,27299,27300,54599
30826,,spfupe42khmj,27300,27301,54601
30827,,ftl1yrwjbmwj,27301,27302,54603
30828,,hsxgjc50x2kj,27302,27303,54605
30829,,gmkfseddgy4j,27304,27305,54609
30830,,af8sxza0cxij,27305,27306,54611
30831,,ad1h2axlarkj,27306,27307,54613
30832,,bfzpttw0c5sj,27307,27308,54615
30833,,a_ju7iimxcuj,27308,27309,54617
30834,,hp82u5zhthij,27309,27310,54619
30835,,ythpos-mbzwj,27310,27311,54621
30836,,qgvgnldahhkj,27311,27312,54623
30837,,rvykakh43taj,27312,27313,54625
30838,,url:http://portal.acm.org/ft_gateway.cfm3fid3d108372426type3dpdf,27313,27314,54627
30839,,uez3n3ilaj0j,27314,27315,54629
30840,,dbrvyt7sja0j,27315,27316,54631
30841,,uyiumeolkpqj,27316,27317,54633
30842,,kdchsrtwwvgj,27317,27318,54635
30843,,7to2inn_xywj,27318,27319,54637
30844,,tfgb-yagbgkj,27319,27320,54639
30845,,8krjaevjjagj,27320,27321,54641
30846,,9ymhwooy39gj,27321,27322,54643
30847,,0kco-t1sbf4j,27322,27323,54645
30848,,jpgw6or0y2mj,27323,27324,54647
30849,,dxfzg-qdbfqj,27324,27325,54649
30850,,gzjl7iyell8j,27325,27326,54651
30851,,0kcdji1oyxuj,27326,27327,54653
30852,,2kjytfcsi0aj,27327,27328,54655
30853,,pr0tth94o44j,27328,27329,54657
30854,,pkfdopel-2gj,27329,27330,54659
30855,,swtg2viteesj,27330,27331,54661
30856,,1_70kamjsvaj,27331,27332,54663
30857,,ouxxv0wbu60j,27332,27333,54665
30858,,mrvngnactq8j,27333,27334,54667
30859,,7fd8efsetr0j,27334,27335,54669
30860,,47jtnosswnwj,27335,27336,54671
30861,,4dfafq6ckygj,27336,27337,54673
30862,,bts7tglzxgoj,27337,27338,54675
30863,,g8es-ebon7uj,27338,27339,54677
30864,,bv_x7ghrkdgj,27339,27340,54679
30865,,izhhfpqbnmcj,27340,27341,54681
30866,,nuffi3k6mh8j,27341,27342,54683
30867,,yc7t-gpyjsij,27342,27343,54685
30868,,wekvedkoudij,27343,27344,54687
30869,,cvc1em767lej,27344,27345,54689
30870,,9vl7mra7up4j,27345,27346,54691
30871,,7nt-6gnwkdyj,27346,27347,54693
30872,,3cvhryslp0uj,27347,27348,54695
30873,,zwhcna2llzkj,27348,27349,54697
30874,,uwh93hhsm2cj,27350,27351,54701
30875,,o4wu2ofnyu0j,27351,27352,54703
30876,,url:http://portal.acm.org/citation.cfm3fcoll3dguide26dl3dguide26id3d983042,27352,27353,54705
30877,,ysxvpjhxsm4j,27353,27354,54707
30878,,rtc4fy1rleuj,27354,27355,54709
30879,,krgsnzq9kbaj,27356,27357,54713
30880,,fejyegvg9puj,27357,27358,54715
30881,,tuhgqv8pwhmj,27358,27359,54717
30882,,ju-i7g9tc6yj,27359,27360,54719
30883,,q3ry7uefaqcj,27360,27361,54721
30884,,otami9lcbaaj,27361,27362,54723
30885,,vmvrhsj8onkj,27362,27363,54725
30886,,yhmxabk9bxaj,27363,27364,54727
30887,,kr6g4s2y6c0j,27364,27365,54729
30888,,3mxczkogensj,27365,27366,54731
30889,,8jxchu-mgtmj,27366,27367,54733
30890,,2rdyz6di0ugj,27367,27368,54735
30891,,u38purlhssgj,27368,27369,54737
30892,,nyj6zcz65lwj,27369,27370,54739
30893,,rlkdm42tc4oj,27370,27371,54741
30894,,dkbsiycx6loj,27371,27372,54743
30895,,0yd47skorgej,27372,27373,54745
30896,,yalxzvuvcuoj,27373,27374,54747
30897,,tbtihsuldd0j,27374,27375,54749
30898,,byaefuwtxguj,27375,27376,54751
30899,,apxksu2nt98j,27376,27377,54753
30900,,sw6ujwig6x4j,27377,27378,54755
30901,,fj7rkp9fkw4j,27378,27379,54757
30902,,u0pfjzacl78j,27379,27380,54759
30903,,ddm5kbxcfb8j,27380,27381,54761
30904,,n195rg0jd2aj,27381,27382,54763
30905,,ykxtsemeeasj,27382,27383,54765
30906,,nomsxmhaq9yj,27383,27384,54767
30907,,6jzhhhgetmyj,27384,27385,54769
30908,,7orykewirv4j,27385,27386,54771
30909,,icj2ntaeveuj,27386,27387,54773
30910,,7vjeexda304j,27387,27388,54775
30911,,4yaal7d2epcj,27388,27389,54777
30912,,q0lbtnngsisj,27389,27390,54779
30913,,0gec62ygfsgj,27390,27391,54781
30914,,awt9oagmfnmj,27391,27392,54783
30915,,_gptxl8tqrkj,27392,27393,54785
30916,,vua0k7mc8iej,27394,27395,54789
30917,,noyysmydyq8j,27395,27396,54791
30918,,url:http://portal.acm.org/citation.cfm3fid3d171926.172008,27396,27397,54793
30919,,ie9zteef684j,27397,27398,54795
30920,,url:http://www.csa.com/partners/viewrecord.php3frequester3dgs26collection3dtrd26recid3dn9210457ah,27398,27399,54797
30921,,f5svohumwi8j,27399,27400,54799
30922,,etdbrdfpgnej,27400,27401,54801
30923,,pwbmy6m_cyqj,27401,27402,54803
30924,,cgvikee0h0kj,27402,27403,54805
30925,,htvghz8ikhsj,27403,27404,54807
30926,,yyd0zcgwbtsj,27404,27405,54809
30927,,xybdbnl5zw8j,27405,27406,54811
30928,,kxfo_2it0hoj,27406,27407,54813
30929,,url:http://www.csa.com/partners/viewrecord.php3frequester3dgs26collection3dtrd26recid3d017608480149ai,27407,27408,54815
30930,,t7wor6g7de4j,27408,27409,54817
30931,,9n7dne7ep3qj,27409,27410,54819
30932,,7kno9vxhankj,27410,27411,54821
30933,,luktsyrlqr4j,27411,27412,54823
30934,,yhty6c9bj8uj,27412,27413,54825
30935,,1axbnoihcyij,27413,27414,54827
30936,,fls5ojm2pdqj,27415,27416,54831
30937,,i-df8he9mbkj,27416,27417,54833
30938,,myedrktfjiuj,27417,27418,54835
30939,,uxuo5ahhcbqj,27418,27419,54837
30940,,w05ebskisagj,27419,27420,54839
30941,,l8rjlm2u3caj,27420,27421,54841
30942,,f7qhodmoxqmj,27421,27422,54843
30943,,mqxnupod-byj,27422,27423,54845
30944,,l7kbkrfz89sj,27423,27424,54847
30945,,wjuz662f_8uj,27424,27425,54849
30946,,fhdrvce5cjoj,27425,27426,54851
30947,,zephdodjyiuj,27426,27427,54853
30948,,ewriixqhbrej,27427,27428,54855
30949,,ywkrxdecxbwj,27429,27430,54859
30950,,p8yjuq2gl9ej,27430,27431,54861
30951,,c4s5tigu0-qj,27431,27432,54863
30952,,rzisynvh3auj,27432,27433,54865
30953,,wa6khatlvfaj,27433,27434,54867
30954,,url:http://www.springerlink.com/index/h0488q1wr73x4l80.pdf,27434,27435,54869
30955,,lbchnmyd95gj,27435,27436,54871
30956,,url:http://doi.wiley.com/10.1002/ace.167,27436,27437,54873
30957,,ghznxcsznl8j,27437,27438,54875
30958,,rjj_ulbeonij,27438,27439,54877
30959,,dcslth1rz0yj,27439,27440,54879
30960,,gi_tboqah9mj,27440,27441,54881
30961,,m1tnmycs6hmj,27442,27443,54885
30962,,url:http://ieeexplore.ieee.org/xpl/abs_free.jsp3farnumber3d1320026,27443,27444,54887
30963,,wgq_niunvduj,27445,27446,54891
30964,,pgorqrct_mej,27446,27447,54893
30965,,isapaiomosuj,27447,27448,54895
30966,,g8jswuao2lmj,27448,27449,54897
30967,,yhz664dvnaij,27449,27450,54899
30968,,3b3wbet3bnaj,27450,27451,54901
30969,,bt1xqlrz36ij,27452,27453,54905
30970,,ybrrtrp-fegj,27453,27454,54907
30971,,w5ufqohwlhqj,27454,27455,54909
30972,,iwy6_nx5zxij,27455,27456,54911
30973,,0d1evojw-zwj,27456,27457,54913
30974,,x1jvvakmdjuj,27457,27458,54915
30975,,url:http://portal.acm.org/ft_gateway.cfm3fid3d110118126type3dpdf,27459,27460,54919
30976,,kr9md9jyqdkj,27460,27461,54921
30977,,rqylpujwcuwj,27461,27462,54923
30978,,wqrnqzssccwj,27462,27463,54925
30979,,zfjmb1wgxywj,27463,27464,54927
30980,,g8ravwl_icij,27464,27465,54929
30981,,gof6gscovwyj,27465,27466,54931
30982,,we99ie_03ogj,27466,27467,54933
30983,,qy-iwgih88qj,27467,27468,54935
30984,,zivpo1l9yaej,27468,27469,54937
30985,,yweayex_frmj,27469,27470,54939
30986,,xhgz4aex99kj,27470,27471,54941
30987,,wyjyb8npw1sj,27471,27472,54943
30988,,b6cl2ncckyoj,27472,27473,54945
30989,,uijqcmqkqb8j,27473,27474,54947
30990,,0py3s7joi9aj,27474,27475,54949
30991,,__qmsfrnovmj,27475,27476,54951
30992,,e5gt7mznlzmj,27476,27477,54953
30993,,z4l7hrmegl8j,27477,27478,54955
30994,,feql-lnctxij,27478,27479,54957
30995,,7bgz4navzooj,27479,27480,54959
30996,,cmaooygnzdgj,27480,27481,54961
30997,,s1gql72c5tuj,27481,27482,54963
30998,,spfdutwwvkqj,27482,27483,54965
30999,,w6elup62bzyj,27483,27484,54967
31000,,ugqfkqbvzvcj,27486,27487,54973
31001,,xwv-l7vgwnyj,27487,27488,54975
31002,,lmis8mynki8j,27488,27489,54977
31003,,c1eswhckugij,27489,27490,54979
31004,,7f_scisisgyj,27490,27491,54981
31005,,ewttqwd-qbaj,27491,27492,54983
31006,,4uik08vi9wkj,27492,27493,54985
31007,,9xn6fig_bqoj,27493,27494,54987
31008,,qogxurc7f4qj,27494,27495,54989
31009,,ulog58u5wo0j,27495,27496,54991
31010,,7m0wi4izrxoj,27497,27498,54995
31011,,orrq2qqrujyj,27498,27499,54997
31012,,4n3d9sh99xsj,27499,27500,54999
31013,,ojqmj-2ta2ij,27500,27501,55001
31014,,tkn47kavovsj,27501,27502,55003
31015,,orepudnvv9kj,27502,27503,55005
31016,,3i7dbxtew7qj,27503,27504,55007
31017,,sg5uhqcdrs0j,27504,27505,55009
31018,,4n2gzv3wyzuj,27505,27506,55011
31019,,otty0cd5sosj,27506,27507,55013
31020,,9taalujah28j,27507,27508,55015
31021,,aizon8ijtkqj,27508,27509,55017
31022,,xypxjwituruj,27509,27510,55019
31023,,gs9jzqnxfzej,27510,27511,55021
31024,,_masczufmjsj,27511,27512,55023
31025,,dibmwxjip4oj,27512,27513,55025
31026,,xzpt8stiitmj,27513,27514,55027
31027,,wxzunmrqor4j,27514,27515,55029
31028,,az8apes2inyj,27515,27516,55031
31029,,4_uwrf6eksaj,27516,27517,55033
31030,,yduhgxptdhcj,27517,27518,55035
31031,,2nlrs3dk6dyj,27518,27519,55037
31032,,vj1kbpjzshwj,27520,27521,55041
31033,,e52vfcz81umj,27521,27522,55043
31034,,9nxwpiwvc0cj,27522,27523,55045
31035,,6xk3hayyjv8j,27523,27524,55047
31036,,ipxvnm8oggqj,27524,27525,55049
31037,,_rlpiinduayj,27525,27526,55051
31038,,lpovuhcmyuuj,27526,27527,55053
31039,,sflmevwcrrsj,27527,27528,55055
31040,,ltp3yojpd5yj,27528,27529,55057
31041,,omjybqy50uqj,27529,27530,55059
31042,,jpgzatqmjywj,27530,27531,55061
31043,,azpczp6ioygj,27531,27532,55063
31044,,v2f8ppzwrwuj,27532,27533,55065
31045,,ylsqwkurmxoj,27533,27534,55067
31046,,6zwlfsz-w_sj,27534,27535,55069
31047,,b1jzi543nzyj,27535,27536,55071
31048,,uxcg199zp9oj,27536,27537,55073
31049,,znwqwhufpp8j,27537,27538,55075
31050,,iv_lgy0dxbgj,27538,27539,55077
31051,,vltuqpo52hgj,27539,27540,55079
31052,,y41xkvgm_xwj,27540,27541,55081
31053,,,27541,27542,55083
31054,,jaw6tkhy6tej,27543,27544,55087
31055,,oc1qhmkjxdsj,27544,27545,55089
31056,,tucqizcp9agj,27545,27546,55091
31057,,zjsfnmwec74j,27546,27547,55093
31058,,fs4mw04pql8j,27547,27548,55095
31059,,4foodpnnugij,27548,27549,55097
31060,,aqecvv8vbu4j,27549,27550,55099
31061,,yrcbdjhs55yj,27550,27551,55101
31062,,gvoicaffydej,27551,27552,55103
31063,,oliaoefjlpcj,27552,27553,55105
31064,,fhadnxfxh_yj,27553,27554,55107
31065,,bard5nosgf4j,27554,27555,55109
31066,,h30omyjzh-8j,27555,27556,55111
31067,,url:http://portal.acm.org/citation.cfm3fid3d373423,27556,27557,55113
31068,,_9olezjlw3aj,27557,27558,55115
31069,,am96xngv-70j,27558,27559,55117
31070,,lxvap1oj2byj,27559,27560,55119
31071,,gcbsblw5biyj,27560,27561,55121
31072,,_qp2iojhog0j,27561,27562,55123
31073,,usbxg-_e4fgj,27562,27563,55125
31074,,mic_y6tsgzuj,27563,27564,55127
31075,,pjen-wr5prsj,27564,27565,55129
31076,,kpnbw52uuoqj,27565,27566,55131
31077,,u0bqaprly4yj,27566,27567,55133
31078,,hr4-pdopy50j,27567,27568,55135
31079,,6anvivpkamej,27568,27569,55137
31080,,tv0hyw-4xmoj,27570,27571,55141
31081,,3zhpyfeeshcj,27571,27572,55143
31082,,rhjjrlvhi78j,27572,27573,55145
31083,,t69vn1a3jh4j,27573,27574,55147
31084,,eqzfnhe0hz0j,27574,27575,55149
31085,,teplzqntbdyj,27575,27576,55151
31086,,ds_6dbk2x50j,27576,27577,55153
31087,,mumfvpcv1ukj,27577,27578,55155
31088,,tcnownjthqoj,27578,27579,55157
31089,,9vx-sva6kyuj,27579,27580,55159
31090,,yed6vittjsmj,27580,27581,55161
31091,,sh2u_ufog74j,27581,27582,55163
31092,,8yvngjq6xmij,27582,27583,55165
31093,,ftxjawdjgs8j,27583,27584,55167
31094,,d0p0riygeroj,27584,27585,55169
31095,,pqcnd1q1z9ej,27585,27586,55171
31096,,cr2ovl18j-gj,27586,27587,55173
31097,,bmccsjbxyecj,27587,27588,55175
31098,,0b_lxk9turkj,27588,27589,55177
31099,,l6ou4cnybiyj,27589,27590,55179
31100,,osnfrpnugvij,27590,27591,55181
31101,,eacao8owcaoj,27591,27592,55183
31102,,9bgum5yalbgj,27592,27593,55185
31103,,url:http://doi.wiley.com/10.1002/he.122,27593,27594,55187
31104,,xclf19pb2hej,27594,27595,55189
31105,,4ievf-gb2-wj,27595,27596,55191
31106,,url:http://adsabs.harvard.edu/abs/1986mit..reptq....l,27596,27597,55193
31107,,zjbvmgs3rioj,27597,27598,55195
31108,,8ezr0if-tlaj,27598,27599,55197
31109,,ml-emtotcgej,27599,27600,55199
31110,,wveib7u-mzuj,27600,27601,55201
31111,,2ecx6umup8mj,27601,27602,55203
31112,,e2ty_gziev8j,27602,27603,55205
31113,,jv8yjirlycuj,27603,27604,55207
31114,,bdsmgw6nliaj,27604,27605,55209
31115,,1f1iaoqxd2uj,27605,27606,55211
31116,,6gg-i-gkhewj,27606,27607,55213
31117,,r6gz3vflv-mj,27607,27608,55215
31118,,un3aazspnk8j,27608,27609,55217
31119,,,27609,27610,55219
31120,,ohhnkz25swgj,27610,27611,55221
31121,,rubg8j79usoj,27612,27613,55225
31122,,fr6pxjmreqcj,27613,27614,55227
31123,,h3tzs2cwawmj,27614,27615,55229
31124,,0m94nv_r7uaj,27615,27616,55231
31125,,bcuc-5z0s2uj,27616,27617,55233
31126,,8bctg9ysbskj,27617,27618,55235
31127,,t9qepn2savwj,27618,27619,55237
31128,,url:http://portal.acm.org/ft_gateway.cfm3fid3d108372726type3dpdf,27619,27620,55239
31129,,zy0wklhykxwj,27620,27621,55241
31130,,tdov_pkgnp8j,27621,27622,55243
31131,,tejvbkuc6pgj,27622,27623,55245
31132,,7otyomupuhwj,27623,27624,55247
31133,,jv_xkmsuaiij,27624,27625,55249
31134,,ksmzma0v-hkj,27625,27626,55251
31135,,0h4v35ida9ej,27627,27628,55255
31136,,gjmo6feyddmj,27628,27629,55257
31137,,url:http://pubs.acs.org/cgi-bin/abstract.cgi/achre4/asap/abs/ar050113t.html,27629,27630,55259
31138,,sphwcp4oai4j,27630,27631,55261
31139,,mkm9t_4rmqcj,27631,27632,55263
31140,,t_g8poalupyj,27632,27633,55265
31141,,xgkiaq8jfo8j,27633,27634,55267
31142,,jzvbg3bx_pij,27634,27635,55269
31143,,cmztseq41xoj,27635,27636,55271
31144,,fe2orugqkbij,27636,27637,55273
31145,,mgrv_fjbspsj,27637,27638,55275
31146,,agqqveq7a0aj,27638,27639,55277
31147,,wo-ir4jrq0uj,27639,27640,55279
31148,,nmr_lemlxkkj,27640,27641,55281
31149,,xdhuhexjr1sj,27641,27642,55283
31150,,pfp1jopxx9yj,27642,27643,55285
31151,,2pv1g5o-jcsj,27643,27644,55287
31152,,_helk8zex6wj,27644,27645,55289
31153,,url:http://doi.wiley.com/10.1002/tl.182,27645,27646,55291
31154,,sb5btj-a30oj,27646,27647,55293
31155,,6aayds7-kz4j,27647,27648,55295
31156,,ek1h2p7qycyj,27649,27650,55299
31157,,url:http://www.csa.com/partners/viewrecord.php3frequester3dgs26collection3dtrd26recid3d20021214044997mt26recid3da7212128ah,27650,27651,55301
31158,,url:http://www.springerlink.com/index/v67hq27824607480.pdf,27651,27652,55303
31159,,vloqfgkgzmwj,27652,27653,55305
31160,,_gkwne6u9-cj,27653,27654,55307
31161,,zn01i6mgmhaj,27655,27656,55311
31162,,bjb8i7gdeckj,27656,27657,55313
31163,,6m7fahj6ryyj,27657,27658,55315
31164,,qgk5cisjvvkj,27658,27659,55317
31165,,url:http://www.springerlink.com/index/h3n4r15013438560.pdf,27659,27660,55319
31166,,ob3u8zyivoqj,27660,27661,55321
31167,,url:http://www.csa.com/partners/viewrecord.php3frequester3dgs26collection3dtrd26recid3d0789662ci,27661,27662,55323
31168,,xzcbsppp8daj,27662,27663,55325
31169,,yuwk6kwgx2sj,27663,27664,55327
31170,,osyl9zky1hwj,27664,27665,55329
31171,,6-p91u7hwxaj,27665,27666,55331
31172,,bbavfdotwd8j,27666,27667,55333
31173,,_dnxftzilfej,27667,27668,55335
31174,,umbqcffutbaj,27668,27669,55337
31175,,ehprd3m7fwsj,27669,27670,55339
31176,,url:http://portal.acm.org/citation.cfm3fid3d1041410.1041428,27670,27671,55341
31177,,oudgxozdsxaj,27671,27672,55343
31178,,wqi_gqrberqj,27672,27673,55345
31179,,6ftksulpdyqj,27673,27674,55347
31180,,strfknqrov4j,27674,27675,55349
31181,,qa7jbqahk3wj,27675,27676,55351
31182,,iloapmead5mj,27676,27677,55353
31183,,pymfeg8rleej,27677,27678,55355
31184,,qasqlbba3paj,27678,27679,55357
31185,,6sienycpox8j,27679,27680,55359
31186,,2oswikbibyej,27680,27681,55361
31187,,a9yzhyfukikj,27681,27682,55363
31188,,vnu9tiozge8j,27682,27683,55365
31189,,e9wylnvceroj,27683,27684,55367
31190,,qvlxk0i76fij,27684,27685,55369
31191,,rpiocjiqtikj,27685,27686,55371
31192,,ubwyhxj57laj,27686,27687,55373
31193,,vjl6i78dzj8j,27687,27688,55375
31194,,gxfnwz34gyqj,27688,27689,55377
31195,,sj_7dwnvq5gj,27689,27690,55379
31196,,url:http://portal.acm.org/citation.cfm3fid3d500141.500228,27691,27692,55383
31197,,httzocqu4w0j,27692,27693,55385
31198,,gztn9byy_7uj,27693,27694,55387
31199,,ufvsacyw4eij,27694,27695,55389
31200,,pesnz9ubyf8j,27695,27696,55391
31201,,i9z6t5eyj3aj,27696,27697,55393
31202,,_2rv0yu2jnij,27697,27698,55395
31203,,tgi6o9sv7acj,27698,27699,55397
31204,,qnl7xviu2hmj,27699,27700,55399
31205,,ttlhrfovgqej,27700,27701,55401
31206,,url:http://portal.acm.org/ft_gateway.cfm3fid3d1583526type3dpdf,27701,27702,55403
31207,,d24yd6iygmoj,27702,27703,55405
31208,,b0juzgscqrij,27703,27704,55407
31209,,jfgfcjpcswaj,27704,27705,55409
31210,,r-qp7c5wef0j,27705,27706,55411
31211,,abjawbtrte0j,27706,27707,55413
31212,,cc8vflmnfn0j,27707,27708,55415
31213,,thx2yphakukj,27709,27710,55419
31214,,zoufwtesewaj,27710,27711,55421
31215,,njnbo5nhhfyj,27711,27712,55423
31216,,pop6usftissj,27712,27713,55425
31217,,javeprvysekj,27713,27714,55427
31218,,atya6rl7ongj,27714,27715,55429
31219,,cle7msnvf0ej,27715,27716,55431
31220,,sjylwx_mrbaj,27716,27717,55433
31221,,0rjmec70pfoj,27717,27718,55435
31222,,5iv4iamnhdej,27718,27719,55437
31223,,y4gkz_ubfhcj,27719,27720,55439
31224,,3mkraun1afij,27720,27721,55441
31225,,nbb2ch0qsxcj,27721,27722,55443
31226,,usbwxkfi1r0j,27722,27723,55445
31227,,hg9z7wf5zigj,27723,27724,55447
31228,,hvnqyzcpoyqj,27724,27725,55449
31229,,oztcaakireyj,27725,27726,55451
31230,,75wzm39vpjyj,27726,27727,55453
31231,,z26qjtq6xduj,27727,27728,55455
31232,,5jpbvziimwwj,27728,27729,55457
31233,,g9djlb7u-vkj,27729,27730,55459
31234,,wdj9byb4xogj,27730,27731,55461
31235,,ghh3r3y4j1cj,27731,27732,55463
31236,,x0a8dphk6igj,27733,27734,55467
31237,,u73xqqmich8j,27734,27735,55469
31238,,yi5bus3avkoj,27735,27736,55471
31239,,hcxbvgwk9lkj,27736,27737,55473
31240,,url:http://portal.acm.org/ft_gateway.cfm3fid3d108377826type3dpdf,27737,27738,55475
31241,,bjhcigmdcz4j,27738,27739,55477
31242,,xylybgsydjgj,27739,27740,55479
31243,,ebhrdge_g-sj,27740,27741,55481
31244,,wmjise1raa0j,27741,27742,55483
31245,,m_soe4zggigj,27742,27743,55485
31246,,avkdl_fhbjkj,27743,27744,55487
31247,,sweapgb68xsj,27744,27745,55489
31248,,tkec7v8oyy4j,27745,27746,55491
31249,,67uczttggfwj,27746,27747,55493
31250,,x_wp7amlw0wj,27747,27748,55495
31251,,ba_skikhk0oj,27748,27749,55497
31252,,viputentskqj,27749,27750,55499
31253,,url:http://www.kluweronline.com/article.asp3fpips3d514715626pdf3d1,27750,27751,55501
31254,,n5yj4y54wbwj,27751,27752,55503
31255,,wxiqnwgr0g0j,27752,27753,55505
31256,,v9z6_7l_qpmj,27753,27754,55507
31257,,upulpludvxuj,27754,27755,55509
31258,,xvcsfldswhqj,27755,27756,55511
31259,,-1k9em10u4yj,27756,27757,55513
31260,,_n6qax7y-lsj,27757,27758,55515
31261,,gl6-iorcmbaj,27758,27759,55517
31262,,23mzo06ktbgj,27759,27760,55519
31263,,6gxr_g9-hc4j,27760,27761,55521
31264,,g-ztgoac-oyj,27761,27762,55523
31265,,tbenhplw6lmj,27762,27763,55525
31266,,4pl5vswjxj0j,27763,27764,55527
31267,,wfplwcji5ekj,27764,27765,55529
31268,,elu8ftmdsyyj,27766,27767,55533
31269,,url:http://www.geography.org.uk/journals/journals.asp3farticleid3d56,27767,27768,55535
31270,,llb7derhogij,27768,27769,55537
31271,,pqajxcsg6j4j,27769,27770,55539
31272,,,27770,27771,55541
31273,,vvdei1rq2eej,27772,27773,55545
31274,,8gqgahalqrgj,27773,27774,55547
31275,,url:http://portal.acm.org/ft_gateway.cfm3fid3d102759826type3dpdf,27774,27775,55549
31276,,r1opsyu9yiyj,27775,27776,55551
31277,,url:http://www.springerlink.com/index/rx23776nv70n2h6n.pdf,27776,27777,55553
31278,,1egefvgzwhyj,27777,27778,55555
31279,,peozmafwftaj,27778,27779,55557
31280,,2tryifmc6xaj,27779,27780,55559
31281,,url:http://doi.wiley.com/10.1002/tl.148,27780,27781,55561
31282,,w7a_hryk67uj,27781,27782,55563
31283,,k1jchljlj1oj,27782,27783,55565
31284,,9h_oyaa2kf8j,27783,27784,55567
31285,,o2kkwkuixyqj,27784,27785,55569
31286,,affs0fbuzpmj,27785,27786,55571
31287,,uxkly8gdxx0j,27786,27787,55573
31288,,url:http://portal.acm.org/ft_gateway.cfm3fid3d109968826type3dpdf,27787,27788,55575
31289,,gkrun4bp7ouj,27788,27789,55577
31290,,0rkipvztmpyj,27789,27790,55579
31291,,xtz0mdto31aj,27790,27791,55581
31292,,ig44mmwmxzyj,27791,27792,55583
31293,,ct0xt4mxuwgj,27792,27793,55585
31294,,url:http://portal.acm.org/ft_gateway.cfm3fid3d101775726type3dpdf,27793,27794,55587
31295,,5nwajfzbqhaj,27794,27795,55589
31296,,icjqwkf5c1oj,27795,27796,55591
31297,,nb9kswlrpygj,27796,27797,55593
31298,,dpnxbfdsys4j,27797,27798,55595
31299,,na8qvycwm8sj,27798,27799,55597
31300,,8xml9nna5tyj,27799,27800,55599
31301,,hlk0vmrmtgaj,27800,27801,55601
31302,,qfl2gcqnwqoj,27801,27802,55603
31303,,bvjjuu2awg8j,27802,27803,55605
31304,,url:http://portal.acm.org/citation.cfm3fid3d645924,27803,27804,55607
31305,,ojb40qpqdsmj,27804,27805,55609
31306,,_0p36rfmatkj,27805,27806,55611
31307,,sq5lkbggzksj,27806,27807,55613
31308,,_xx_khg2syqj,27807,27808,55615
31309,,zhdixwczk3sj,27808,27809,55617
31310,,-259libjbisj,27810,27811,55621
31311,,p6rterpbeogj,27811,27812,55623
31312,,bamckifhp0gj,27812,27813,55625
31313,,url:http://portal.acm.org/ft_gateway.cfm3fid3d110127626type3dpdf,27813,27814,55627
31314,,lnnhfhlfsecj,27814,27815,55629
31315,,bvb4smqtlcmj,27815,27816,55631
31316,,vo3qywyryqsj,27816,27817,55633
31317,,uqgzak83cfuj,27818,27819,55637
31318,,zgeoq0mdnrwj,27819,27820,55639
31319,,g75wlbwzkiqj,27820,27821,55641
31320,,i181ivwexkaj,27821,27822,55643
31321,,hzqblb7lmjej,27822,27823,55645
31322,,ondp-ehv_hgj,27823,27824,55647
31323,,x2dztsgpwvcj,27824,27825,55649
31324,,8ceo0qt6daej,27825,27826,55651
31325,,5d5ajclj4i0j,27826,27827,55653
31326,,hmucppzcmloj,27827,27828,55655
31327,,gpx4taaba38j,27828,27829,55657
31328,,fbtjtqgowc4j,27829,27830,55659
31329,,ovwsnblwr84j,27831,27832,55663
31330,,yo9ql6lqjqgj,27832,27833,55665
31331,,bvacns8vz4wj,27833,27834,55667
31332,,mtiiirxyy9ej,27834,27835,55669
31333,,kgqlygz5_fcj,27835,27836,55671
31334,,ok2_81jfplqj,27836,27837,55673
31335,,mesioijkwsyj,27837,27838,55675
31336,,ywlerr7igm8j,27838,27839,55677
31337,,zgpqfcpnlnoj,27839,27840,55679
31338,,yi4racy9kymj,27840,27841,55681
31339,,fq0ech-u91cj,27841,27842,55683
31340,,tts47coypeuj,27842,27843,55685
31341,,0t5c2xqtg7yj,27843,27844,55687
31342,,bpylorc6rzkj,27845,27846,55691
31343,,_t1u338ql6gj,27846,27847,55693
31344,,2un2k9ltjyqj,27847,27848,55695
31345,,ampcobrta5gj,27848,27849,55697
31346,,g1fosnvnuguj,27849,27850,55699
31347,,uzx0re7d-gyj,27851,27852,55703
31348,,si2lncb2bquj,27852,27853,55705
31349,,dcyyycnd7dkj,27853,27854,55707
31350,,b7vgtdk-gjkj,27854,27855,55709
31351,,w42dkcj4qxoj,27855,27856,55711
31352,,bqtjot7gaiij,27856,27857,55713
31353,,n6ympleqisyj,27857,27858,55715
31354,,tf0egpkyj0gj,27858,27859,55717
31355,,gz0-oqajhysj,27859,27860,55719
31356,,haatp2s2ri4j,27860,27861,55721
31357,,jw2tebyrtfgj,27861,27862,55723
31358,,pap-huglvzij,27862,27863,55725
31359,,ri42ciuozgij,27863,27864,55727
31360,,_c2jkev4fcsj,27864,27865,55729
31361,,m_e0avodwvoj,27865,27866,55731
31362,,ygjjnub6arcj,27866,27867,55733
31363,,x80vyel6svkj,27867,27868,55735
31364,,twfdmosgkx4j,27868,27869,55737
31365,,imdkfpkm11ij,27869,27870,55739
31366,,9londv6ab14j,27870,27871,55741
31367,,ausbgcwv71yj,27871,27872,55743
31368,,3lnyijt5ddij,27872,27873,55745
31369,,ggiwjf7uvoqj,27873,27874,55747
31370,,qwcdc40grpmj,27874,27875,55749
31371,,hkmnhkt1kf4j,27875,27876,55751
31372,,hdwmtxhw4syj,27876,27877,55753
31373,,vevsd_7numkj,27877,27878,55755
31374,,y9hnvmmeigcj,27878,27879,55757
31375,,qhf_1yamqgyj,27879,27880,55759
31376,,dzjs6tlgq1mj,27880,27881,55761
31377,,oiivgwifmiej,27881,27882,55763
31378,,x4sawdz_jf8j,27882,27883,55765
31379,,ium3phwlh54j,27883,27884,55767
31380,,emrobgtexigj,27884,27885,55769
31381,,eyxxhe1yxyuj,27886,27887,55773
31382,,jklhly_dwo4j,27887,27888,55775
31383,,ctmv5jhhdtyj,27888,27889,55777
31384,,muiatmlwlemj,27889,27890,55779
31385,,,27890,27891,55781
31386,,pbal1uz6obej,27891,27892,55783
31387,,tpt7a4ljrxcj,27892,27893,55785
31388,,nnsns5qii0sj,27893,27894,55787
31389,,cajg4akiru8j,27894,27895,55789
31390,,cyjr7x2ntgmj,27895,27896,55791
31391,,pwqjdld04h8j,27896,27897,55793
31392,,1425utv4xgwj,27897,27898,55795
31393,,dsrblncfasej,27898,27899,55797
31394,,12kqmx5cnsmj,27899,27900,55799
31395,,3njqxpxqdxmj,27900,27901,55801
31396,,npvaxa5obnyj,27901,27902,55803
31397,,tmxayngxktwj,27902,27903,55805
31398,,pyh3b16ndosj,27903,27904,55807
31399,,url:http://www.csa.com/partners/viewrecord.php3frequester3dgs26collection3dtrd26recid3d0928603ci,27904,27905,55809
31400,,_ogaozypfjmj,27905,27906,55811
31401,,url:http://ieeexplore.ieee.org/iel5/69/29215/01318561.pdf3farnumber3d1318561,27906,27907,55813
31402,,xp_ozcj2mdsj,27907,27908,55815
31403,,rnojhofrs9kj,27908,27909,55817
31404,,4wqaz1fcijej,27909,27910,55819
31405,,uc1ad6xomvqj,27910,27911,55821
31406,,go35xi3s0s4j,27911,27912,55823
31407,,c9humx2-emgj,27912,27913,55825
31408,,lqtsfea63dmj,27913,27914,55827
31409,,kjttoig0xooj,27914,27915,55829
31410,,cuuafnvk6x0j,27915,27916,55831
31411,,lroaexi_0uej,27916,27917,55833
31412,,uw2_hgmotiuj,27917,27918,55835
31413,,cemeibl31aij,27918,27919,55837
31414,,k5r3aract6mj,27919,27920,55839
31415,,njew8izobgcj,27920,27921,55841
31416,,g3kcnwq5tssj,27921,27922,55843
31417,,7knxzmhkz2kj,27922,27923,55845
31418,,rsoesnrfubsj,27923,27924,55847
31419,,6h59fh8dejyj,27924,27925,55849
31420,,av-03lzwl-ej,27925,27926,55851
31421,,url:http://doi.wiley.com/10.1002/he.169,27926,27927,55853
31422,,tbxxe4l2h0sj,27927,27928,55855
31423,,eh5nlbj8ocmj,27928,27929,55857
31424,,4meorvkanv8j,27929,27930,55859
31425,,o0uzz2yl6nsj,27930,27931,55861
31426,,,27931,27932,55863
31427,,p0cojb8hexqj,27932,27933,55865
31428,,ddrwh9adtoaj,27933,27934,55867
31429,,8jdjf6whl6ej,27934,27935,55869
31430,,hdnq3vxrrm4j,27935,27936,55871
31431,,os91tiz7aamj,27936,27937,55873
31432,,hi1sfvaljaoj,27937,27938,55875
31433,,xhjtub3brjsj,27938,27939,55877
31434,,lb5ah5ge5lij,27939,27940,55879
31435,,fiyk12lg2pqj,27940,27941,55881
31436,,fv8r3vr8ilmj,27941,27942,55883
31437,,htowefiosfej,27942,27943,55885
31438,,seccqjvyu0aj,27943,27944,55887
31439,,htfy0r_kbtoj,27944,27945,55889
31440,,6j0vuuxhdikj,27945,27946,55891
31441,,1c4clqev9ioj,27946,27947,55893
31442,,pizefuwie8uj,27947,27948,55895
31443,,aqivktw7rewj,27948,27949,55897
31444,,jajjyjk0ytuj,27949,27950,55899
31445,,url:http://portal.acm.org/citation.cfm3fid3d1101149.1101374,27950,27951,55901
31446,,ry-3ufxitcwj,27951,27952,55903
31447,,nj9tlgpfcm4j,27952,27953,55905
31448,,rfywjdxi7uqj,27953,27954,55907
31449,,url:http://portal.acm.org/ft_gateway.cfm3fid3d2482326type3dpdf26coll3dguide26dl3dacm26cfid3d1111111126cftoken3d2222222,27954,27955,55909
31450,,yhpjnhpuvxej,27955,27956,55911
31451,,bsloycbucckj,27956,27957,55913
31452,,tki0eiratlej,27957,27958,55915
31453,,8e4hejhslcuj,27958,27959,55917
31454,,url:http://www.blackwell-synergy.com/links/doi/10.1111/j.0033-0124.1969.00007.x/abs/,27959,27960,55919
31455,,p1mefz6qxpmj,27960,27961,55921
31456,,jdyx854ny7sj,27961,27962,55923
31457,,jc_2d-1i114j,27962,27963,55925
31458,,mnpwurwf-qaj,27963,27964,55927
31459,,bkas8qjukm4j,27964,27965,55929
31460,,c4ockxv7qf8j,27965,27966,55931
31461,,4bt_mndyumsj,27966,27967,55933
31462,,rrltmwmobe4j,27967,27968,55935
31463,,fwcy-chczjcj,27968,27969,55937
31464,,tvaythqcxnij,27969,27970,55939
31465,,xg1qxndjdzaj,27970,27971,55941
31466,,kfwblrelpp0j,27971,27972,55943
31467,,tyxzabuzyxqj,27972,27973,55945
31468,,hr5clx15eeij,27973,27974,55947
31469,,ciikvurpxikj,27974,27975,55949
31470,,fg12tskstmcj,27975,27976,55951
31471,,rkmdn1myivkj,27976,27977,55953
31472,,mpv3hjqa3ewj,27977,27978,55955
31473,,yqj4qjfvkhuj,27978,27979,55957
31474,,url:http://www.ingentaconnect.com/search/expand3fpub3dinfobike://els/09505849/1995/00000037/00000010/art9093226unc3d,27979,27980,55959
31475,,4r7ex1dden4j,27980,27981,55961
31476,,g0nt5egf2rqj,27981,27982,55963
31477,,prirnjsvnimj,27982,27983,55965
31478,,ecnha2ocwdmj,27983,27984,55967
31479,,ki7iktruffgj,27984,27985,55969
31480,,uoxyh4glznoj,27985,27986,55971
31481,,aczxykskg5kj,27986,27987,55973
31482,,wqkoxy4b8mwj,27987,27988,55975
31483,,aoxwvicpjigj,27988,27989,55977
31484,,qep4my1c-2cj,27989,27990,55979
31485,,yifjdtkktxmj,27990,27991,55981
31486,,o-wwi2h3ig0j,27991,27992,55983
31487,,fgymkzqykvsj,27992,27993,55985
31488,,rffxw1dfneej,27993,27994,55987
31489,,del2tsijdyej,27994,27995,55989
31490,,vvthyqygliwj,27995,27996,55991
31491,,1xysnh9nt0yj,27996,27997,55993
31492,,di_csofpw7gj,27997,27998,55995
31493,,e08ghdjyelej,27998,27999,55997
31494,,a7n7lztsmmsj,27999,28000,55999
31495,,clmzo4iaobij,28000,28001,56001
31496,,syszoylswhsj,28001,28002,56003
31497,,tkfjzsx5--4j,28002,28003,56005
31498,,5hojuaa1ar8j,28003,28004,56007
31499,,bl1cqnhbtyij,28004,28005,56009
31500,,ye7lvgmwao8j,28005,28006,56011
31501,,nwxpeialemcj,28006,28007,56013
31502,,gn1g0ivk4rgj,28007,28008,56015
31503,,ipup23boik8j,28008,28009,56017
31504,,7xhcbiraplgj,28009,28010,56019
31505,,r94wj3kt1q8j,28010,28011,56021
31506,,b0aypkpqtwsj,28011,28012,56023
31507,,51rm3vnxxb4j,28012,28013,56025
31508,,cq1n13ysfkyj,28013,28014,56027
31509,,yqomzsrboqmj,28014,28015,56029
31510,,ibis3szf6rsj,28015,28016,56031
31511,,rwhevgaxfkaj,28016,28017,56033
31512,,yhk02qgsx14j,28017,28018,56035
31513,,-3mehyntznoj,28018,28019,56037
31514,,kjjlejrk4zaj,28019,28020,56039
31515,,o1hupdj5jr4j,28020,28021,56041
31516,,cefbzorqzicj,28021,28022,56043
31517,,moyx5o4uvukj,28022,28023,56045
31518,,,28023,28024,56047
31519,,eijnzqewuv0j,28024,28025,56049
31520,,qqqibtuu0i0j,28025,28026,56051
31521,,c6si_0_azjsj,28026,28027,56053
31522,,bqud8us4g40j,28027,28028,56055
31523,,ilzd7jj_nigj,28028,28029,56057
31524,,0bu8xlezdhuj,28029,28030,56059
31525,,ed9q5emypy4j,28030,28031,56061
31526,,h1dcwgkuhgwj,28031,28032,56063
31527,,tpxhmg2g-44j,28032,28033,56065
31528,,onhzi2dfqxoj,28033,28034,56067
31529,,vizignbspmij,28034,28035,56069
31530,,ihd4xfburngj,28035,28036,56071
31531,,ws5nhh_kmf4j,28036,28037,56073
31532,,qzpepwroku8j,28037,28038,56075
31533,,jvaix6cpqhyj,28038,28039,56077
31534,,vkmw5m-vibyj,28039,28040,56079
31535,,xqy29rv7ewmj,28040,28041,56081
31536,,qlfxmspymeqj,28041,28042,56083
31537,,ifak79vcrf0j,28042,28043,56085
31538,,xy_rpfaaxtqj,28043,28044,56087
31539,,iafgpgb8v3ej,28044,28045,56089
31540,,9xqd4v21pkyj,28045,28046,56091
31541,,f24tulbitj8j,28046,28047,56093
31542,,url:http://doi.wiley.com/10.1002/anie.199213361,28047,28048,56095
31543,,rnk3xddcinkj,28048,28049,56097
31544,,uz4tb0pzlxqj,28049,28050,56099
31545,,qbxo-xj07kij,28050,28051,56101
31546,,rsu18eio2ecj,28051,28052,56103
31547,,lhotxk4k_uaj,28052,28053,56105
31548,,eswyqtxhbfuj,28053,28054,56107
31549,,1jgdwdbhwwej,28054,28055,56109
31550,,cc58sohztsyj,28055,28056,56111
31551,,wjs9vhopfcij,28057,28058,56115
31552,,1h_a7k3qsbqj,28058,28059,56117
31553,,ma-v_tupwqwj,28059,28060,56119
31554,,2dzniukxwjsj,28060,28061,56121
31555,,ki8jzzdk2quj,28061,28062,56123
31556,,mnsha_merruj,28062,28063,56125
31557,,7gdxeiumuiij,28063,28064,56127
31558,,v4t0egazmowj,28064,28065,56129
31559,,ouuuuk369jqj,28065,28066,56131
31560,,y-p51p6symmj,28066,28067,56133
31561,,rikfuxdikdkj,28067,28068,56135
31562,,,28068,28069,56137
31563,,t2_v8w_rrusj,28069,28070,56139
31564,,rwyohwyc-asj,28070,28071,56141
31565,,d4aenyxrazwj,28071,28072,56143
31566,,a7ndoanbwbsj,28072,28073,56145
31567,,jfv_ae63l1uj,28073,28074,56147
31568,,xibam4t157uj,28074,28075,56149
31569,,sy6ka50pawsj,28075,28076,56151
31570,,url:http://www.ingentaconnect.com/content/els/08830355/2001/00000035/00000003/art00022,28076,28077,56153
31571,,fmn9uxzoq-aj,28077,28078,56155
31572,,url:http://portal.acm.org/citation.cfm3fid3d885861.885870,28078,28079,56157
31573,,cg1goad_n1mj,28079,28080,56159
31574,,mlvgl0pzdcij,28080,28081,56161
31575,,v_f-dhtolkkj,28081,28082,56163
31576,,gugnlr-fhq0j,28082,28083,56165
31577,,94hrzis1n3mj,28083,28084,56167
31578,,isejnhpynmuj,28084,28085,56169
31579,,6878y7jfzsmj,28085,28086,56171
31580,,url:http://www.springerlink.com/index/rtcc57fuuw3cadrf.pdf,28086,28087,56173
31581,,s7mvd4emb5ij,28087,28088,56175
31582,,url:http://ieeexplore.ieee.org/iel5/2193/459/00009072.pdf3farnumber3d9072,28088,28089,56177
31583,,rr9mviovf9kj,28089,28090,56179
31584,,uaqgsdjt49gj,28090,28091,56181
31585,,zx1wrvwfjvyj,28091,28092,56183
31586,,j6fnc7htc2uj,28092,28093,56185
31587,,ttlbax2jumyj,28093,28094,56187
31588,,genapvp2tlkj,28094,28095,56189
31589,,qblf5efct1mj,28095,28096,56191
31590,,xkstsjvj27aj,28096,28097,56193
31591,,d045rwvrz6mj,28098,28099,56197
31592,,esjzsq-v4o4j,28099,28100,56199
31593,,dkmrgonrqdgj,28100,28101,56201
31594,,url:http://www.csa.com/partners/viewrecord.php3frequester3dgs26collection3dtrd26recid3dn8233082ah,28101,28102,56203
31595,,fhnznbje1wkj,28102,28103,56205
31596,,v95orshb51kj,28103,28104,56207
31597,,jtsl0mtwhlaj,28104,28105,56209
31598,,vefwzxlj49ej,28105,28106,56211
31599,,x1qpphk0in8j,28106,28107,56213
31600,,p_k5eurvy5qj,28107,28108,56215
31601,,1gfn3ycloecj,28108,28109,56217
31602,,url:http://www.csa.com/partners/viewrecord.php3frequester3dgs26collection3denv26recid3d9201928,28109,28110,56219
31603,,o4fqxsm9olcj,28110,28111,56221
31604,,getqmii3y2cj,28111,28112,56223
31605,,vq8u_3bnlcuj,28112,28113,56225
31606,,bdmaxvdrycgj,28113,28114,56227
31607,,z_y7zhqncgaj,28114,28115,56229
31608,,rggm-bbztvij,28115,28116,56231
31609,,f5wi6nxeki8j,28116,28117,56233
31610,,cboxcruol-wj,28117,28118,56235
31611,,3jmstx9hh28j,28118,28119,56237
31612,,r8ctklktf7yj,28119,28120,56239
31613,,m42j4evvk_wj,28120,28121,56241
31614,,url:http://portal.acm.org/citation.cfm3fid3d223868,28121,28122,56243
31615,,7eckuovcrdej,28122,28123,56245
31616,,,28123,28124,56247
31617,,url:http://portal.acm.org/ft_gateway.cfm3fid3d22387826type3dpdf26dl3dguide26dl3dacm26cfid3d1111111126cftoken3d2222222,28124,28125,56249
31618,,0rbotr1y2myj,28125,28126,56251
31619,,owntlrujswmj,28126,28127,56253
31620,,ugrguwiaibcj,28127,28128,56255
31621,,vrupdhn1tpqj,28128,28129,56257
31622,,8bkjffsxitkj,28129,28130,56259
31623,,kormcmaffd4j,28130,28131,56261
31624,,s9cwawr0ygaj,28131,28132,56263
31625,,a5htnysgnnkj,28132,28133,56265
31626,,dzendovauqoj,28133,28134,56267
31627,,sjezjbgrmm8j,28134,28135,56269
31628,,url:http://links.jstor.org/sici3fsici3d0146-4949(196723)8253a4253c505253akmooka253e2.0.co253b2-k,28135,28136,56271
31629,,c-k0pxzmxwyj,28136,28137,56273
31630,,mvweqo-v4o8j,28137,28138,56275
31631,,2h5rlgbpmzyj,28138,28139,56277
31632,,k6euocjhowwj,28139,28140,56279
31633,,nx99yefuslkj,28140,28141,56281
31634,,gcccbh7y3ikj,28141,28142,56283
31635,,eripq3t5_08j,28142,28143,56285
31636,,emsolhyokoaj,28143,28144,56287
31637,,lnpxguazkmgj,28144,28145,56289
31638,,7m46bm1crr0j,28145,28146,56291
31639,,zotg-gwke3mj,28146,28147,56293
31640,,2ocuenrmrvmj,28147,28148,56295
31641,,bgjrgkeiqquj,28148,28149,56297
31642,,cb0dkmyhposj,28149,28150,56299
31643,,qfioohjswcsj,28150,28151,56301
31644,,dqmi9u1erwoj,28151,28152,56303
31645,,okfxhgvpv2yj,28152,28153,56305
31646,,cn7qrr53peij,28153,28154,56307
31647,,cgrvboiiqs8j,28154,28155,56309
31648,,eucpnm5z4tsj,28155,28156,56311
31649,,ox34hu2lraqj,28156,28157,56313
31650,,ivwjrdfof8kj,28157,28158,56315
31651,,url:http://doi.wiley.com/10.1002/tl.133,28158,28159,56317
31652,,iazgdtiwhoij,28159,28160,56319
31653,,tv7vid8wiysj,28160,28161,56321
31654,,xm1hefxpwbkj,28161,28162,56323
31655,,sq_hg7jg7zej,28162,28163,56325
31656,,q9i6i1er7raj,28163,28164,56327
31657,,gvua9evm1bkj,28164,28165,56329
31658,,t4-_dfpk2smj,28165,28166,56331
31659,,ux8puvlvm4aj,28166,28167,56333
31660,,2shwbxo1834j,28167,28168,56335
31661,,j6z2gkmmwwoj,28169,28170,56339
31662,,url:http://portal.acm.org/citation.cfm3fid3d592093.592120,28170,28171,56341
31663,,slqhhp9ub7yj,28171,28172,56343
31664,,9ximanao8ykj,28172,28173,56345
31665,,bmajsozzdb0j,28174,28175,56349
31666,,ireacc-cgxqj,28175,28176,56351
31667,,hmsqbvskkjkj,28176,28177,56353
31668,,hrwkd0wlhioj,28177,28178,56355
31669,,wfelvzkq71gj,28178,28179,56357
31670,,buscjqlfzzkj,28179,28180,56359
31671,,s98ggfcged8j,28180,28181,56361
31672,,gqhen9qnazmj,28181,28182,56363
31673,,hzff2ycbodcj,28182,28183,56365
31674,,0yzhdho9wtcj,28183,28184,56367
31675,,lafwriyk_wsj,28184,28185,56369
31676,,ttt90bjxrtgj,28185,28186,56371
31677,,s_gdppllud0j,28186,28187,56373
31678,,_rstwfyfdecj,28187,28188,56375
31679,,o6yglinmkwij,28188,28189,56377
31680,,mubtqvr238yj,28189,28190,56379
31681,,g_gd7amelmcj,28190,28191,56381
31682,,nb-nk8bakqyj,28191,28192,56383
31683,,gjmbt7_chmqj,28192,28193,56385
31684,,eia-0vkebt4j,28193,28194,56387
31685,,snx8lbmxfjuj,28194,28195,56389
31686,,vqvmrrkjwsij,28196,28197,56393
31687,,65angfope7uj,28197,28198,56395
31688,,url:http://ieeexplore.ieee.org/xpl/abs_free.jsp3farnumber3d1320098,28198,28199,56397
31689,,ql0woivt4awj,28199,28200,56399
31690,,92a1pnl3njwj,28200,28201,56401
31691,,ij40zbzoiasj,28201,28202,56403
31692,,okgkdpbdomaj,28202,28203,56405
31693,,ns1rkwbq_smj,28203,28204,56407
31694,,purjfebacxqj,28204,28205,56409
31695,,sdpnkrrhv6aj,28205,28206,56411
31696,,70iqdihfrbsj,28206,28207,56413
31697,,olwdqr4l9eoj,28207,28208,56415
31698,,ilvxlvho-0gj,28208,28209,56417
31699,,b9ugllvnrs0j,28209,28210,56419
31700,,dzknbln3yisj,28210,28211,56421
31701,,zb9wveabdtij,28211,28212,56423
31702,,_hrmtgbd8yij,28212,28213,56425
31703,,rpetzpro7z8j,28213,28214,56427
31704,,i2-rwcjrxy8j,28214,28215,56429
31705,,fy37jxbzwugj,28215,28216,56431
31706,,hkpoqm4qcqcj,28216,28217,56433
31707,,chdowm3r3kkj,28217,28218,56435
31708,,,28218,28219,56437
31709,,ujba-dtpt3ij,28219,28220,56439
31710,,url:http://portal.acm.org/citation.cfm3fid3d234286.1057842,28220,28221,56441
31711,,tdivg8_n_esj,28221,28222,56443
31712,,pi7sh1rm55wj,28222,28223,56445
31713,,e7eyvs2bm7gj,28223,28224,56447
31714,,qirgcdi0tboj,28224,28225,56449
31715,,525wp4katycj,28225,28226,56451
31716,,mux3_n055eoj,28226,28227,56453
31717,,ogjzlfancfmj,28227,28228,56455
31718,,2wk8wbpq8cuj,28228,28229,56457
31719,,f0mkjwgodgqj,28229,28230,56459
31720,,xsrce3emtxgj,28230,28231,56461
31721,,orjcm1nktowj,28231,28232,56463
31722,,hf9ipuxlb-ij,28232,28233,56465
31723,,ixfaar-ukb4j,28233,28234,56467
31724,,jitgxgoqpwmj,28234,28235,56469
31725,,_fgoltff7tsj,28235,28236,56471
31726,,jdodxbkmxuoj,28236,28237,56473
31727,,axpniyvidioj,28237,28238,56475
31728,,2fnuim-q0x8j,28238,28239,56477
31729,,mya9hc-o_joj,28239,28240,56479
31730,,nmvs7c91i7qj,28240,28241,56481
31731,,wnqdk1qpalkj,28241,28242,56483
31732,,url:http://www.csa.com/partners/viewrecord.php3frequester3dgs26collection3dtrd26recid3d20021211038653mt26recid3da7423794ah,28242,28243,56485
31733,,lwp4rrvxbkqj,28243,28244,56487
31734,,bpvlz0ffr8wj,28244,28245,56489
31735,,kha0t4qv-w4j,28245,28246,56491
31736,,gdcnod_yia4j,28246,28247,56493
31737,,za5ibcnu_dyj,28247,28248,56495
31738,,0akjbwzu7n8j,28248,28249,56497
31739,,n0z8djjkrc0j,28249,28250,56499
31740,,u3upy6hhytqj,28250,28251,56501
31741,,mgwwnckt_owj,28251,28252,56503
31742,,fjgv62sjdjwj,28252,28253,56505
31743,,crtdwuslmk4j,28253,28254,56507
31744,,l6lb3-9ufa4j,28254,28255,56509
31745,,g1y6ukufqguj,28255,28256,56511
31746,,xxhkqtouikej,28256,28257,56513
31747,,4pqvhanjc3kj,28257,28258,56515
31748,,nnoxhguat3mj,28258,28259,56517
31749,,apulixhypq8j,28259,28260,56519
31750,,f2jf52swlqej,28260,28261,56521
31751,,url:http://portal.acm.org/ft_gateway.cfm3fid3d108370526type3dpdf,28261,28262,56523
31752,,wnjzejj84rij,28262,28263,56525
31753,,xidegmsvrhmj,28263,28264,56527
31754,,xdi6fbefajoj,28264,28265,56529
31755,,amtrinyvy-0j,28265,28266,56531
31756,,psdmy-ouz4cj,28266,28267,56533
31757,,f4tze3mbi1gj,28267,28268,56535
31758,,q4ttib_3nesj,28268,28269,56537
31759,,y9kxmzjbmzgj,28269,28270,56539
31760,,3kcodpvf1ucj,28270,28271,56541
31761,,nueii_jwteej,28271,28272,56543
31762,,9trcyhxai38j,28272,28273,56545
31763,,hcohuwt-sj8j,28273,28274,56547
31764,,a5enmdb9hbuj,28274,28275,56549
31765,,mam6jbpljhwj,28275,28276,56551
31766,,v6rwc0vank4j,28276,28277,56553
31767,,seyxdcoxtc0j,28277,28278,56555
31768,,vpmaah63sz8j,28278,28279,56557
31769,,zi6efihdodwj,28279,28280,56559
31770,,url:http://portal.acm.org/ft_gateway.cfm3fid3d100769326type3dpdf,28280,28281,56561
31771,,,28281,28282,56563
31772,,qyl5cgoxse0j,28282,28283,56565
31773,,jskyxym6iaej,28283,28284,56567
31774,,isch_6euttgj,28284,28285,56569
31775,,7gmhlkzidnwj,28285,28286,56571
31776,,kq4-kpa1urgj,28286,28287,56573
31777,,dghlcksatxyj,28287,28288,56575
31778,,leqyjdu1jfcj,28288,28289,56577
31779,,vpyghbg17lcj,28289,28290,56579
31780,,ueegiuroeeij,28290,28291,56581
31781,,qtorce2vurij,28291,28292,56583
31782,,tmrrlbfzffuj,28292,28293,56585
31783,,ti6elqthwqkj,28293,28294,56587
31784,,cnlcmbocmimj,28294,28295,56589
31785,,9luvrxhjsfij,28295,28296,56591
31786,,l5vwqtmjqt4j,28296,28297,56593
31787,,phfsmhtvozsj,28297,28298,56595
31788,,ees2kmukjdyj,28298,28299,56597
31789,,dtkiyr-necaj,28299,28300,56599
31790,,qs8qzxjcyqgj,28300,28301,56601
31791,,sfyiqcpg0rgj,28301,28302,56603
31792,,eo_enspi9koj,28302,28303,56605
31793,,xw5kv5t_wtaj,28303,28304,56607
31794,,jbkzxij01h8j,28304,28305,56609
31795,,c8pohztvxdkj,28305,28306,56611
31796,,9la3-ow7zz4j,28306,28307,56613
31797,,w_r7bd6pp3oj,28307,28308,56615
31798,,ejiw5luwspyj,28308,28309,56617
31799,,v1miy7niszmj,28309,28310,56619
31800,,qegvgp8swymj,28310,28311,56621
31801,,hq2koa_dhocj,28311,28312,56623
31802,,ulkyzy5twhkj,28312,28313,56625
31803,,duepczdcrbuj,28313,28314,56627
31804,,sc0pr5pmkzoj,28314,28315,56629
31805,,4vedkl_ndy8j,28315,28316,56631
31806,,qg53ay-b9maj,28316,28317,56633
31807,,w_nz61nqqbuj,28317,28318,56635
31808,,_lvdmphdfvej,28318,28319,56637
31809,,cd_xefditvkj,28319,28320,56639
31810,,n5celzizakcj,28320,28321,56641
31811,,wyadsaa9sbsj,28321,28322,56643
31812,,ax0kcfxj_gyj,28323,28324,56647
31813,,qtcsxccsi7uj,28324,28325,56649
31814,,wmu3mohrqfij,28325,28326,56651
31815,,5ibdtvfng04j,28326,28327,56653
31816,,drqt662uqksj,28327,28328,56655
31817,,byrjda5m6aqj,28328,28329,56657
31818,,url:http://portal.acm.org/citation.cfm3fid3d1027527.1027673,28329,28330,56659
31819,,i6mbvxqndwwj,28330,28331,56661
31820,,c2ybjlq0rwuj,28331,28332,56663
31821,,64raqfukwbkj,28332,28333,56665
31822,,url:http://www.csa.com/partners/viewrecord.php3frequester3dgs26collection3dtrd26recid3d20021214033595mt26recid3da7642834ah,28333,28334,56667
31823,,jqhucfbklxej,28334,28335,56669
31824,,fuifd6oyhaej,28335,28336,56671
31825,,xgw62etesqyj,28336,28337,56673
31826,,gn58vuxd72qj,28337,28338,56675
31827,,ezajm04qliij,28338,28339,56677
31828,,zy3vrcypvx4j,28339,28340,56679
31829,,oqphvr4wnrwj,28340,28341,56681
31830,,lgbkhvwrhwoj,28341,28342,56683
31831,,2eekwbxurqoj,28342,28343,56685
31832,,jpvzkq3mcruj,28343,28344,56687
31833,,jw-kbujhzzsj,28344,28345,56689
31834,,huznfpgaflcj,28345,28346,56691
31835,,lkyoz3t0igkj,28346,28347,56693
31836,,n4ayl3qij5wj,28347,28348,56695
31837,,aabsyqkzrbgj,28348,28349,56697
31838,,rre6wb3ttrkj,28349,28350,56699
31839,,vh-p916k_wij,28350,28351,56701
31840,,f9xcvc8qkpgj,28351,28352,56703
31841,,i6gpl8jn3ycj,28352,28353,56705
31842,,nmdowb6x67mj,28353,28354,56707
31843,,bgeyddwfchej,28354,28355,56709
31844,,mwupf5-hf_gj,28355,28356,56711
31845,,gvrdsgpbjgsj,28356,28357,56713
31846,,72l-cw_kohij,28357,28358,56715
31847,,k78jscodj1gj,28358,28359,56717
31848,,url:http://taylorandfrancis.metapress.com/index/g2kr0pprhnqhgwx8.pdf,28359,28360,56719
31849,,owopzrbvf9oj,28360,28361,56721
31850,,g3fdbqwxti4j,28361,28362,56723
31851,,ybqftj5_h2uj,28362,28363,56725
31852,,yzp9mdlteeej,28363,28364,56727
31853,,z3aloe2yyrwj,28364,28365,56729
31854,,wzlieqdii8sj,28365,28366,56731
31855,,56zjyr6p2auj,28366,28367,56733
31856,,lf681qndrv4j,28367,28368,56735
31857,,vnqmd9z2ficj,28368,28369,56737
31858,,url:http://www.ingentaconnect.com/search/expand3fpub3dinfobike://els/09505849/1998/00000040/00000005/art0005426unc3d,28369,28370,56739
31859,,uorzpjhysisj,28370,28371,56741
31860,,brgtlyjvcwmj,28371,28372,56743
31861,,myvsxjs0r90j,28372,28373,56745
31862,,vbrbaexgihij,28373,28374,56747
31863,,nahotskhdeyj,28374,28375,56749
31864,,r49bpdwriacj,28375,28376,56751
31865,,duybgt23u30j,28376,28377,56753
31866,,201dehaoiqej,28377,28378,56755
31867,,cri7tikjhusj,28378,28379,56757
31868,,fksdnu1ykrqj,28379,28380,56759
31869,,qzklte1ugj0j,28380,28381,56761
31870,,izxngbqp08oj,28381,28382,56763
31871,,bvp364f-n6sj,28382,28383,56765
31872,,_0jdidixa2yj,28383,28384,56767
31873,,nne_anlwreuj,28384,28385,56769
31874,,ylyz3z4og7yj,28385,28386,56771
31875,,dr1m51uxljaj,28386,28387,56773
31876,,,28387,28388,56775
31877,,xm1g9uw86aej,28388,28389,56777
31878,,z9jpciafwm0j,28389,28390,56779
31879,,4kijp2rkyewj,28390,28391,56781
31880,,24dan_xd-90j,28391,28392,56783
31881,,url:http://portal.acm.org/citation.cfm3fid3d507338.50736726dl3dguide26dl3dacm26idx3dj68926part3dperiodical26wanttype3dperiodical26title3dacm2520sigmod2520record26cfid3d1111111126cftoken3d2222222,28392,28393,56785
31882,,2ocdywzjvqoj,28393,28394,56787
31883,,inrxxc1kh_ej,28394,28395,56789
31884,,usryxsotmfkj,28395,28396,56791
31885,,ssriduyqjbmj,28396,28397,56793
31886,,6w7qkr2noskj,28397,28398,56795
31887,,gc7gt8xn0umj,28398,28399,56797
31888,,ahujsgwvbksj,28399,28400,56799
31889,,djpscahj4emj,28400,28401,56801
31890,,jc2tuqw5jtkj,28401,28402,56803
31891,,a0swbgos6qmj,28402,28403,56805
31892,,why6c3o-3wqj,28403,28404,56807
31893,,miachidgibkj,28404,28405,56809
31894,,wmrvhoa0dy8j,28405,28406,56811
31895,,a7phgbdsstkj,28406,28407,56813
31896,,myke1t5hle0j,28407,28408,56815
31897,,njwfuri3eqsj,28408,28409,56817
31898,,rrmixd3kgbcj,28409,28410,56819
31899,,zdcb5ivcnguj,28410,28411,56821
31900,,o0quzwmdxumj,28411,28412,56823
31901,,q2ckdfygb7yj,28412,28413,56825
31902,,o2wd8ar3wgwj,28413,28414,56827
31903,,lohvyfq5ciyj,28414,28415,56829
31904,,fhget_wukvej,28415,28416,56831
31905,,nrte48ftqsoj,28416,28417,56833
31906,,gqj74lcpbgyj,28417,28418,56835
31907,,mx-oqtuepz4j,28418,28419,56837
31908,,ycsjvvdswg0j,28420,28421,56841
31909,,k11_hztkq1wj,28421,28422,56843
31910,,5xwwxb87_74j,28423,28424,56847
31911,,u0pgd7b-zp4j,28424,28425,56849
31912,,ruyqfoxzydoj,28425,28426,56851
31913,,cwgvyhry8oij,28426,28427,56853
31914,,5i8ow86ghtmj,28427,28428,56855
31915,,url:http://www.springerlink.com/index/h8603xn1056tg353.pdf,28429,28430,56859
31916,,,28430,28431,56861
31917,,url:http://portal.acm.org/citation.cfm3fid3d150362.150365,28431,28432,56863
31918,,_wwpprphmo8j,28432,28433,56865
31919,,nsq_jemuom0j,28433,28434,56867
31920,,7pvituicduwj,28434,28435,56869
31921,,kajforwuur0j,28435,28436,56871
31922,,nnlyhghotcgj,28436,28437,56873
31923,,cmq7lkkxnt4j,28437,28438,56875
31924,,ovxhtvse3wcj,28438,28439,56877
31925,,ziujieqbbu0j,28439,28440,56879
31926,,3-su7bgt1k0j,28440,28441,56881
31927,,jkokoxqq0ocj,28441,28442,56883
31928,,ncyhiy7gymuj,28442,28443,56885
31929,,sb7evwnh6w4j,28443,28444,56887
31930,,vlkwbk1mk90j,28444,28445,56889
31931,,url:http://adsabs.harvard.edu/abs/1976infph..16...37c,28445,28446,56891
31932,,ugfuwnzya1oj,28446,28447,56893
31933,,b7elkgdk1fyj,28447,28448,56895
31934,,rgr0jcldhbwj,28448,28449,56897
31935,,467hzueaxoqj,28449,28450,56899
31936,,ghyosrruplsj,28450,28451,56901
31937,,url:http://portal.acm.org/citation.cfm3fid3d276305.27637726dl3dguide26dl3dguide26idx3d27630526part3dperiodical26wanttype3dperiodical26title3dacm2520sigmod2520record26cfid3d1111111126cftoken3d2222222,28451,28452,56903
31938,,2bu7glexij8j,28452,28453,56905
31939,,7p8_zvpew64j,28453,28454,56907
31940,,ljshqp2hitoj,28454,28455,56909
31941,,w1m_evkoja4j,28455,28456,56911
31942,,pgtn385isbij,28456,28457,56913
31943,,url:http://portal.acm.org/citation.cfm3fid3d34347.34352,28457,28458,56915
31944,,4h4p6i2hsqaj,28458,28459,56917
31945,,url:http://adsabs.harvard.edu/abs/1977phdt.........4u,28459,28460,56919
31946,,xf__jyhiniij,28460,28461,56921
31947,,q8hpjukzmt0j,28461,28462,56923
31948,,ktlhtod2pgmj,28462,28463,56925
31949,,jx1eda-ya_yj,28463,28464,56927
31950,,if1fiu4t6ooj,28464,28465,56929
31951,,igeurptxiw4j,28465,28466,56931
31952,,2zoe2il-weoj,28466,28467,56933
31953,,98ydy8bbnuqj,28467,28468,56935
31954,,v1cudpg1slyj,28468,28469,56937
31955,,vh6_iblbx5sj,28469,28470,56939
31956,,tb1dhgkg-esj,28470,28471,56941
31957,,pwdcjxshoncj,28471,28472,56943
31958,,cixnx_52xcwj,28472,28473,56945
31959,,0sctwkzv0i4j,28473,28474,56947
31960,,n1omswgtltuj,28474,28475,56949
31961,,jcqjqkzkqpwj,28475,28476,56951
31962,,y1fadzwvzjgj,28476,28477,56953
31963,,ee98qv4ovnqj,28477,28478,56955
31964,,ygejguaar9uj,28478,28479,56957
31965,,s6cz2wservcj,28479,28480,56959
31966,,_lfz6zjs2p0j,28480,28481,56961
31967,,6t74tivqusgj,28481,28482,56963
31968,,xuj0ddo2iiaj,28482,28483,56965
31969,,p7xm8nfadsmj,28483,28484,56967
31970,,,28484,28485,56969
31971,,8slr6f52atij,28485,28486,56971
31972,,hlv1gqsr_akj,28486,28487,56973
31973,,6pe6py0zscuj,28487,28488,56975
31974,,tpqt07w37faj,28488,28489,56977
31975,,ettpgykqmmmj,28489,28490,56979
31976,,jcnzj-ee2xsj,28490,28491,56981
31977,,xdftoekq9yqj,28491,28492,56983
31978,,6wluqvap2nsj,28492,28493,56985
31979,,xri6cehkadmj,28493,28494,56987
31980,,zl56vagxwqwj,28494,28495,56989
31981,,mzu58quyascj,28495,28496,56991
31982,,sqxiazeq1bgj,28496,28497,56993
31983,,s5rcmcrrrgaj,28497,28498,56995
31984,,5tuinv43cduj,28498,28499,56997
31985,,_xj-7at79joj,28499,28500,56999
31986,,j-kuna58acwj,28500,28501,57001
31987,,5qklperl8dwj,28501,28502,57003
31988,,twauyc2bwvmj,28502,28503,57005
31989,,ukxmgwjspikj,28503,28504,57007
31990,,nnj7_5grjt0j,28504,28505,57009
31991,,gf-qerkoz1gj,28505,28506,57011
31992,,6fomkb49i6wj,28506,28507,57013
31993,,muuxjx5fojkj,28507,28508,57015
31994,,ldxuav7ozgaj,28508,28509,57017
31995,,lvd0ifhlzfsj,28509,28510,57019
31996,,mtassr_znckj,28510,28511,57021
31997,,url:http://portal.acm.org/citation.cfm3fid3d28855026coll3dportal26dl3dacm,28512,28513,57025
31998,,pilbpjh5ptkj,28513,28514,57027
31999,,t1ebjlfevvij,28514,28515,57029
32000,,,28515,28516,57031
32001,,8q7p6rxjwqyj,28516,28517,57033
32002,,v8incw15jwcj,28517,28518,57035
32003,,g2tcl0qmgmuj,28518,28519,57037
32004,,bey6io4rybgj,28519,28520,57039
32005,,srhjajhtl-sj,28520,28521,57041
32006,,8kbnejywryyj,28521,28522,57043
32007,,seolo3fppo4j,28522,28523,57045
32008,,shi3jbyb9t0j,28523,28524,57047
32009,,wzfhmxrrrt0j,28524,28525,57049
32010,,c9pkcwr5taqj,28525,28526,57051
32011,,aeedqldl4ygj,28526,28527,57053
32012,,gwmqdua2tskj,28527,28528,57055
32013,,dbga1e-6lvkj,28528,28529,57057
32014,,_educr-8wxyj,28529,28530,57059
32015,,jmxpdrz4ez8j,28530,28531,57061
32016,,xobnxflb1r0j,28531,28532,57063
32017,,lmuxtw6pqnoj,28532,28533,57065
32018,,wjh6pemgfjmj,28533,28534,57067
32019,,smd5fkdawroj,28534,28535,57069
32020,,gz92a8bdtluj,28535,28536,57071
32021,,8gjc_dx9fwej,28537,28538,57075
32022,,0vz_pou8riuj,28538,28539,57077
32023,,url:http://links.jstor.org/sici3fsici3d0146-4949(196721)8253a2253c174253a2522atlfi253e2.0.co253b2-d,28539,28540,57079
32024,,vnpnsmtp5csj,28540,28541,57081
32025,,dvpbxeebxjkj,28541,28542,57083
32026,,t2dp1wd8jguj,28542,28543,57085
32027,,0b92x98nwt8j,28543,28544,57087
32028,,c24cwonhia4j,28544,28545,57089
32029,,s2pvrrkx0laj,28545,28546,57091
32030,,0w2xcpqyliaj,28546,28547,57093
32031,,szar2fp0tlsj,28547,28548,57095
32032,,gpfnw7fqmikj,28548,28549,57097
32033,,9ha179saa9ij,28549,28550,57099
32034,,yd-tdx8a9ykj,28550,28551,57101
32035,,rvqb41n24_8j,28551,28552,57103
32036,,_kqlbbtyqfmj,28552,28553,57105
32037,,ouxt2lsnnfkj,28553,28554,57107
32038,,53u4zc98easj,28554,28555,57109
32039,,hg4qzcxc4l0j,28555,28556,57111
32040,,0kcniph7tmgj,28556,28557,57113
32041,,xhl5lvzdndsj,28557,28558,57115
32042,,fxhqhrgpg8sj,28558,28559,57117
32043,,qdfggikl7q8j,28559,28560,57119
32044,,vem4i7xvdx8j,28560,28561,57121
32045,,vifxwx4nzquj,28561,28562,57123
32046,,_jb8jdfuapoj,28562,28563,57125
32047,,4jjt94t_q1uj,28563,28564,57127
32048,,url:http://portal.acm.org/ft_gateway.cfm3fid3d101778126type3dpdf,28564,28565,57129
32049,,r36nodmofwcj,28565,28566,57131
32050,,o_cofb-9l6ij,28566,28567,57133
32051,,6j3maceux7kj,28567,28568,57135
32052,,sjh10hxqve8j,28568,28569,57137
32053,,abv6xvt_v18j,28569,28570,57139
32054,,8oo0ilhuo5cj,28570,28571,57141
32055,,jgw9mch8gesj,28571,28572,57143
32056,,oawagi7f4skj,28572,28573,57145
32057,,oedzlexgsc0j,28573,28574,57147
32058,,myorwvrdtnyj,28574,28575,57149
32059,,u3vdeyzp1ruj,28575,28576,57151
32060,,pqkyc6wa2imj,28576,28577,57153
32061,,0ggp8uvp8qqj,28577,28578,57155
32062,,12gzq0_i3smj,28578,28579,57157
32063,,0wapp7uyaecj,28579,28580,57159
32064,,bgpoctlrol8j,28580,28581,57161
32065,,fsmdn6n-xbyj,28581,28582,57163
32066,,5hhmcechccej,28582,28583,57165
32067,,khrpvdmqdi4j,28583,28584,57167
32068,,gtnhy2fzez0j,28584,28585,57169
32069,,zsq0axwquguj,28585,28586,57171
32070,,3auz-rtpdv8j,28586,28587,57173
32071,,cr2mnug7n7gj,28587,28588,57175
32072,,bjzgkrty26ij,28588,28589,57177
32073,,f44nbgq96a4j,28589,28590,57179
32074,,5png01sq684j,28590,28591,57181
32075,,kgozlxgmg_0j,28591,28592,57183
32076,,kq3guboxqdsj,28592,28593,57185
32077,,rud3j4tojpsj,28593,28594,57187
32078,,url:http://pubs.acs.org/cgi-bin/abstract.cgi/achre4/2005/38/i06/abs/ar040091v.html,28594,28595,57189
32079,,rq2zdgzskq8j,28595,28596,57191
32080,,_crjmqep_huj,28596,28597,57193
32081,,dkdwg5zxjeoj,28597,28598,57195
32082,,5usanzkkwsuj,28598,28599,57197
32083,,lha19hqllv8j,28599,28600,57199
32084,,swvywxemmcwj,28600,28601,57201
32085,,5k09a_rw8gcj,28601,28602,57203
32086,,zyyb-uslfkej,28602,28603,57205
32087,,uuvaszybquej,28603,28604,57207
32088,,50gao1gg-fsj,28604,28605,57209
32089,,v7hqcqkepzwj,28605,28606,57211
32090,,ckaggjjn5xaj,28606,28607,57213
32091,,9ka4vhb-obkj,28607,28608,57215
32092,,iiyn4ft7v90j,28608,28609,57217
32093,,oyuq4etavvmj,28610,28611,57221
32094,,3dm6gwou26mj,28611,28612,57223
32095,,2xejs656mhqj,28612,28613,57225
32096,,kxae2ksuzlqj,28613,28614,57227
32097,,t0b9lk-uce4j,28614,28615,57229
32098,,viee8xs8624j,28615,28616,57231
32099,,tjpvcjicwzuj,28616,28617,57233
32100,,ukcm_kbgrqsj,28617,28618,57235
32101,,p_r4bylc-wwj,28618,28619,57237
32102,,olusx3cc9tsj,28619,28620,57239
32103,,0rfgbgzbnbqj,28620,28621,57241
32104,,fkczg-rqyf0j,28621,28622,57243
32105,,khttj9xqswmj,28622,28623,57245
32106,,kf4ue4t2tymj,28623,28624,57247
32107,,rr392a3wrzmj,28624,28625,57249
32108,,qof55i6m6buj,28625,28626,57251
32109,,yvgy7umvftkj,28626,28627,57253
32110,,aumbkdpid_ij,28627,28628,57255
32111,,j7c8vhxmrcmj,28628,28629,57257
32112,,omlpynndx1sj,28629,28630,57259
32113,,k6nhmtx1q6oj,28630,28631,57261
32114,,rpgyy-1fmy0j,28631,28632,57263
32115,,uam856r4beuj,28632,28633,57265
32116,,qmq5io26kjuj,28633,28634,57267
32117,,9thca-rdu6kj,28634,28635,57269
32118,,as2w3ajvflaj,28635,28636,57271
32119,,_r9t4phxe3qj,28636,28637,57273
32120,,3cah89gme1yj,28637,28638,57275
32121,,dnp-mmeu8-0j,28638,28639,57277
32122,,qncsmc7fft0j,28639,28640,57279
32123,,9f4obuig9tyj,28640,28641,57281
32124,,hw9q81j-ke4j,28641,28642,57283
32125,,wixdssgxcmuj,28642,28643,57285
32126,,xr8uujwjdwaj,28643,28644,57287
32127,,qwq_qmmeo4kj,28644,28645,57289
32128,,sm3xijnolzcj,28645,28646,57291
32129,,ohbpslp-5xwj,28646,28647,57293
32130,,url:http://doi.wiley.com/10.1002/ace.24,28647,28648,57295
32131,,2sijh6ix2quj,28648,28649,57297
32132,,url:http://www.csa.com/partners/viewrecord.php3frequester3dgs26collection3dtrd26recid3d0165516ci,28649,28650,57299
32133,,h7raxvylktyj,28650,28651,57301
32134,,9ohwxxov0juj,28651,28652,57303
32135,,2cnl-gqpldcj,28652,28653,57305
32136,,,28653,28654,57307
32137,,p_ckiknb6jej,28654,28655,57309
32138,,bxaqaqnusd0j,28655,28656,57311
32139,,gll1mkebtdmj,28656,28657,57313
32140,,gya0m9b1krgj,28658,28659,57317
32141,,futp_3ytjiuj,28659,28660,57319
32142,,yl6knmsdzzgj,28660,28661,57321
32143,,59qapgqwu_uj,28661,28662,57323
32144,,yalguflwq88j,28662,28663,57325
32145,,url:http://doi.wiley.com/10.1002/tl.158,28663,28664,57327
32146,,ex5nnlucz9aj,28664,28665,57329
32147,,x8sttnv3z-oj,28665,28666,57331
32148,,1msoaatktiyj,28666,28667,57333
32149,,pou2oy9ihrwj,28667,28668,57335
32150,,isoglc5uwesj,28668,28669,57337
32151,,tc47ikdxalaj,28669,28670,57339
32152,,saw28qwoibcj,28670,28671,57341
32153,,safiann1xtej,28671,28672,57343
32154,,frfvjun8t1uj,28672,28673,57345
32155,,04tzb16fumcj,28673,28674,57347
32156,,ahfovefqc2sj,28674,28675,57349
32157,,qmv924jvxcgj,28675,28676,57351
32158,,kabrkwwsfnoj,28676,28677,57353
32159,,ds0mmglrblij,28677,28678,57355
32160,,url:http://portal.acm.org/citation.cfm3fid3d237661.23767626dl3dacm26dl3dacm26type3dseries26idx3d23766126part3dproceedings26wanttype3dproceedings26title3dsymposium2520on2520principles2520of2520database2520systems26cfid3d1111111126cftoken3d2222222,28678,28679,57357
32161,,sflwmxkoh2cj,28679,28680,57359
32162,,32nspgg-maej,28680,28681,57361
32163,,6vdjb0cdsj4j,28681,28682,57363
32164,,siuwl15icryj,28682,28683,57365
32165,,mfvzqqx2yfmj,28683,28684,57367
32166,,url:http://adsabs.harvard.edu/abs/1974ge26ae..14q.809f,28684,28685,57369
32167,,bqjsudnelhaj,28685,28686,57371
32168,,4me3qkyuhnuj,28686,28687,57373
32169,,url:http://doi.wiley.com/10.1002/tl.7202,28687,28688,57375
32170,,hv8vdvfbp3wj,28688,28689,57377
32171,,pnjzds48cvuj,28689,28690,57379
32172,,rkpweoteyiej,28690,28691,57381
32173,,url:http://portal.acm.org/citation.cfm3fid3d1073204.1073325,28691,28692,57383
32174,,osskeltkvb0j,28692,28693,57385
32175,,plyka1nkaryj,28693,28694,57387
32176,,bwbvqjfgz7qj,28694,28695,57389
32177,,wqxkffp8qzoj,28695,28696,57391
32178,,dyc6x34z2ykj,28696,28697,57393
32179,,0olmh6w4s7yj,28697,28698,57395
32180,,5l3yaclemaqj,28699,28700,57399
32181,,hlizt9w6rjcj,28700,28701,57401
32182,,v-iqb-z-70qj,28701,28702,57403
32183,,0tltwdto-gkj,28702,28703,57405
32184,,fdqajooy44mj,28703,28704,57407
32185,,dmxnnc8ihw4j,28704,28705,57409
32186,,ma7nwfigtaoj,28705,28706,57411
32187,,znzzkfijpuqj,28706,28707,57413
32188,,vvb-chlv4g8j,28707,28708,57415
32189,,ohpcamwtqe4j,28708,28709,57417
32190,,ggoe-v2olr8j,28709,28710,57419
32191,,oxbxvisnyp0j,28710,28711,57421
32192,,52czovbneuej,28711,28712,57423
32193,,uhlnfpkzxvuj,28712,28713,57425
32194,,4t3ds4qexr0j,28713,28714,57427
32195,,iryjv1r5lqwj,28714,28715,57429
32196,,y21rpmrop9cj,28715,28716,57431
32197,,f_yceqql_n0j,28716,28717,57433
32198,,f5oaxlgcesmj,28717,28718,57435
32199,,k-xq9npydzsj,28718,28719,57437
32200,,z8mbv1sgxe8j,28719,28720,57439
32201,,bivka5ltelej,28720,28721,57441
32202,,nohvgr7zm7qj,28721,28722,57443
32203,,jmyha7e95xaj,28722,28723,57445
32204,,ntxi_iygbt4j,28723,28724,57447
32205,,n4f4rbvzdaoj,28724,28725,57449
32206,,ava1zqx-uluj,28725,28726,57451
32207,,xnfitm0xtqij,28726,28727,57453
32208,,url:http://www.csa.com/partners/viewrecord.php3frequester3dgs26collection3dtrd26recid3d20021211038652mt26recid3da7423786ah,28727,28728,57455
32209,,ogkktxirq9kj,28728,28729,57457
32210,,dkoijqatfrsj,28729,28730,57459
32211,,bt8mdqszm-wj,28730,28731,57461
32212,,x2slajlfxaej,28731,28732,57463
32213,,2tvydbnyioij,28732,28733,57465
32214,,ayv8h9ii4vsj,28733,28734,57467
32215,,xxaycgu8qqkj,28734,28735,57469
32216,,_8ywaaivg4wj,28735,28736,57471
32217,,mfn4fagligyj,28736,28737,57473
32218,,kfhj2otcoaij,28737,28738,57475
32219,,2jzogwei9nuj,28738,28739,57477
32220,,url:http://portal.acm.org/citation.cfm3fid3d55203.55206,28739,28740,57479
32221,,w6i2bu61udyj,28740,28741,57481
32222,,efuci4kz63cj,28741,28742,57483
32223,,kpydafnsxfkj,28742,28743,57485
32224,,pldih_dpaxgj,28743,28744,57487
32225,,gegchhwnnhqj,28744,28745,57489
32226,,qlbji8stqogj,28746,28747,57493
32227,,2_dwhq626isj,28748,28749,57497
32228,,lfx646jqhn0j,28749,28750,57499
32229,,nfxo4mgpoeij,28751,28752,57503
32230,,oyny6pugswuj,28752,28753,57505
32231,,kyh8dyqejs4j,28753,28754,57507
32232,,kplo16dtaeoj,28754,28755,57509
32233,,lh_pqxjrfcwj,28755,28756,57511
32234,,kinwovccnnuj,28756,28757,57513
32235,,zklt81i90b4j,28757,28758,57515
32236,,6967-52f39wj,28758,28759,57517
32237,,1booz74yyhaj,28759,28760,57519
32238,,mtuaspwdhxoj,28760,28761,57521
32239,,1c11ub5lwzcj,28761,28762,57523
32240,,url:http://doi.wiley.com/10.1002/ace.7305,28762,28763,57525
32241,,t0qfaxf68syj,28763,28764,57527
32242,,8ge2xzswvhaj,28764,28765,57529
32243,,hhvnfcxeogcj,28765,28766,57531
32244,,a1renvlunyej,28766,28767,57533
32245,,ge_pr9pvl1kj,28767,28768,57535
32246,,jk28jp0tvkoj,28768,28769,57537
32247,,_zj2u7_qxjuj,28769,28770,57539
32248,,v-c60vve36gj,28770,28771,57541
32249,,nrqvcgvuemsj,28771,28772,57543
32250,,k0pxrr7k9wuj,28772,28773,57545
32251,,me8be0m4zdij,28773,28774,57547
32252,,m1e-niosaesj,28774,28775,57549
32253,,r35t7bmql3aj,28775,28776,57551
32254,,imbhhuxmzacj,28776,28777,57553
32255,,ocqnrp-xz70j,28777,28778,57555
32256,,yypjs1rqh-8j,28778,28779,57557
32257,,w0_0inawv_qj,28780,28781,57561
32258,,,28781,28782,57563
32259,,iap_xe0nshyj,28782,28783,57565
32260,,oqafzpl0zgaj,28783,28784,57567
32261,,nuyptie6274j,28784,28785,57569
32262,,x31dehq6scaj,28785,28786,57571
32263,,q2vlj6_w6ryj,28786,28787,57573
32264,,lqiev6plf_aj,28787,28788,57575
32265,,6pguuu_7v30j,28788,28789,57577
32266,,qgxihlppfymj,28789,28790,57579
32267,,txrpcqnmrscj,28790,28791,57581
32268,,url:http://adsabs.harvard.edu/abs/1982mit..reptt....j,28791,28792,57583
32269,,y9u-wkv71aej,28792,28793,57585
32270,,ofmtsospjhyj,28793,28794,57587
32271,,ymke8uzbncsj,28794,28795,57589
32272,,wfvlvav3azej,28795,28796,57591
32273,,jubv0nolaeij,28796,28797,57593
32274,,9cl3o2d5cw4j,28797,28798,57595
32275,,kjerdtqfrwqj,28798,28799,57597
32276,,vn--ryf-idoj,28799,28800,57599
32277,,send-xcbg5wj,28800,28801,57601
32278,,cgycdfhjtpaj,28801,28802,57603
32279,,di5q4zybhpkj,28802,28803,57605
32280,,5q4z6kby8cij,28803,28804,57607
32281,,9ithrgvrsyaj,28804,28805,57609
32282,,f18t2xtkfyoj,28805,28806,57611
32283,,ytwdyorznxmj,28806,28807,57613
32284,,z7rdsbn5mpwj,28807,28808,57615
32285,,pora9uvclnej,28808,28809,57617
32286,,n4wvcng1wfsj,28809,28810,57619
32287,,p48gwllfiswj,28810,28811,57621
32288,,wc-xmmpvah4j,28811,28812,57623
32289,,_navzeg1oqkj,28812,28813,57625
32290,,url:http://portal.acm.org/citation.cfm3fid3d9874926coll3dportal26dl3dacm,28813,28814,57627
32291,,ygcfowwgjaij,28814,28815,57629
32292,,jlrvtck3tzmj,28815,28816,57631
32293,,aaqut4ws6fcj,28817,28818,57635
32294,,gw6jybgcsxej,28818,28819,57637
32295,,q28u7tptgi0j,28819,28820,57639
32296,,sq0uw0ov6tsj,28820,28821,57641
32297,,a_h93nj_v4ej,28821,28822,57643
32298,,,28822,28823,57645
32299,,h7mukjumjmgj,28823,28824,57647
32300,,ckbwvusmshsj,28824,28825,57649
32301,,nncvegjgztsj,28825,28826,57651
32302,,xnwcnwoipm0j,28826,28827,57653
32303,,rifm5wunlzqj,28827,28828,57655
32304,,zht0ufwg038j,28828,28829,57657
32305,,e1pyibttvioj,28829,28830,57659
32306,,qjqbzdmugwej,28830,28831,57661
32307,,lxbd37k5_zij,28831,28832,57663
32308,,jbuwybjtzruj,28832,28833,57665
32309,,opkvdnk61lgj,28833,28834,57667
32310,,vvuqdxvpmyej,28834,28835,57669
32311,,eicrqsy2lqej,28835,28836,57671
32312,,zx_rn4h2st0j,28836,28837,57673
32313,,oylhyu7sy24j,28837,28838,57675
32314,,3p1dyzubkzij,28838,28839,57677
32315,,q4vktxi0ww0j,28839,28840,57679
32316,,sxla6isfeocj,28840,28841,57681
32317,,o3hu8n8mw9cj,28841,28842,57683
32318,,ijyhamdmzycj,28842,28843,57685
32319,,ai_fvkwnhyoj,28843,28844,57687
32320,,myx_pjkhrt4j,28844,28845,57689
32321,,lt7xmvvp8jkj,28845,28846,57691
32322,,copfibarld0j,28846,28847,57693
32323,,avty8yy4hkkj,28847,28848,57695
32324,,8jswkjipbnij,28848,28849,57697
32325,,9cp16zksc7kj,28849,28850,57699
32326,,mdsjvlx16yaj,28850,28851,57701
32327,,znvpkfczbnoj,28851,28852,57703
32328,,eslyfnghpyaj,28852,28853,57705
32329,,elshuekkk_uj,28853,28854,57707
32330,,fgpkujefcrmj,28854,28855,57709
32331,,jhwxdedcpduj,28855,28856,57711
32332,,p6ro8vcqbwcj,28856,28857,57713
32333,,nzmqxvgefgqj,28857,28858,57715
32334,,dpc42sjobswj,28858,28859,57717
32335,,url:http://www.csa.com/partners/viewrecord.php3frequester3dgs26collection3dtrd26recid3d2147105ci,28859,28860,57719
32336,,y_p6c0xykbyj,28860,28861,57721
32337,,7jj9qxbdm2uj,28861,28862,57723
32338,,qtnd5nz0ntej,28862,28863,57725
32339,,_og5sc6yhzwj,28863,28864,57727
32340,,znfcgff2q70j,28864,28865,57729
32341,,1dkkwroqeeyj,28865,28866,57731
32342,,n1idh4c-adwj,28866,28867,57733
32343,,mdj1tptrd54j,28867,28868,57735
32344,,k8sxli2p5e4j,28868,28869,57737
32345,,url:http://ieeexplore.ieee.org/iel1/2206/2088/00057645.pdf3farnumber3d57645,28869,28870,57739
32346,,nwey_tetn_uj,28870,28871,57741
32347,,yzlqnqjjvcyj,28871,28872,57743
32348,,tprky5_u2f8j,28872,28873,57745
32349,,dra_osyaxmaj,28873,28874,57747
32350,,xm91l_wnftyj,28874,28875,57749
32351,,bhvtby4wvgaj,28875,28876,57751
32352,,url:http://www.uwstout.edu/lib/thesis/2001/2001wachterj.pdf,28876,28877,57753
32353,,yiivpq6beluj,28877,28878,57755
32354,,3f2n93keyi0j,28878,28879,57757
32355,,d-tx-gdqqz8j,28879,28880,57759
32356,,url:http://www.springerlink.com/index/ytpab711b92nce7j.pdf,28880,28881,57761
32357,,7dfhnmae13qj,28881,28882,57763
32358,,2vfmbovomusj,28882,28883,57765
32359,,rnv_oy9hsxwj,28883,28884,57767
32360,,coset17ss40j,28884,28885,57769
32361,,1_sklvrbsbkj,28885,28886,57771
32362,,fugtoxxof6gj,28886,28887,57773
32363,,i90c8kcpqooj,28887,28888,57775
32364,,3m2qs2jlbwcj,28888,28889,57777
32365,,klivlrtwxdij,28889,28890,57779
32366,,orbhe1glz2kj,28890,28891,57781
32367,,pdbcau_cg-aj,28891,28892,57783
32368,,url:http://www.blackwell-synergy.com/links/doi/10.1111/j.1467-8306.1972.tb00847.x/abs/,28892,28893,57785
32369,,f7yjz4ivkisj,28893,28894,57787
32370,,lgrutu7qbzkj,28894,28895,57789
32371,,uazdygmkftaj,28895,28896,57791
32372,,k1esvml1v8gj,28896,28897,57793
32373,,34xg3yx9iiwj,28897,28898,57795
32374,,ai71vlvnlzmj,28898,28899,57797
32375,,jevu8jxf9h0j,28899,28900,57799
32376,,ighs0chglpuj,28900,28901,57801
32377,,url:http://doi.wiley.com/10.1002/ev.1063,28901,28902,57803
32378,,zbeupeuoilaj,28902,28903,57805
32379,,xjqajlzvlb0j,28903,28904,57807
32380,,mfytlju__imj,28904,28905,57809
32381,,z8bbn2co11uj,28905,28906,57811
32382,,nbprhp0mpayj,28906,28907,57813
32383,,zae_vagxbmuj,28907,28908,57815
32384,,kgrnfbp-iaqj,28908,28909,57817
32385,,q7s0qkbrwl8j,28909,28910,57819
32386,,0zxuyz32kraj,28910,28911,57821
32387,,9czyqulpyzwj,28911,28912,57823
32388,,9einuzvl7zsj,28912,28913,57825
32389,,potb57gcptoj,28913,28914,57827
32390,,pjabu8f1wjij,28914,28915,57829
32391,,gkj1fsei00yj,28915,28916,57831
32392,,vpuy1ssmy5qj,28916,28917,57833
32393,,7o6xzcdrtycj,28917,28918,57835
32394,,vm-et2kmcm8j,28918,28919,57837
32395,,h3bjgxxmkcqj,28919,28920,57839
32396,,7kawvn8kj10j,28920,28921,57841
32397,,imt9z5bg9i0j,28921,28922,57843
32398,,j40mgpwz2xkj,28922,28923,57845
32399,,joviykkpktmj,28923,28924,57847
32400,,4-fwpsoweraj,28924,28925,57849
32401,,wres6joboo0j,28925,28926,57851
32402,,bqpve6kpwmej,28926,28927,57853
32403,,narvzmsrzpij,28927,28928,57855
32404,,in4qrsifynwj,28928,28929,57857
32405,,2h7zqifyfqmj,28929,28930,57859
32406,,d5itgc5kwq8j,28930,28931,57861
32407,,yzumahoe0doj,28931,28932,57863
32408,,20epxjcqipkj,28932,28933,57865
32409,,d2_lsyp3cw8j,28933,28934,57867
32410,,geogzg4hsysj,28934,28935,57869
32411,,f6p86nssmdsj,28935,28936,57871
32412,,8yccrtwfyoej,28936,28937,57873
32413,,yyo48b5hk04j,28937,28938,57875
32414,,b61v12fl2ugj,28938,28939,57877
32415,,bsbq3ynv_mej,28939,28940,57879
32416,,ekcv75g99tsj,28940,28941,57881
32417,,h4u62yhgtaaj,28941,28942,57883
32418,,ll-liqfgnxqj,28942,28943,57885
32419,,lptgqm3kmtaj,28943,28944,57887
32420,,url:http://portal.acm.org/ft_gateway.cfm3fid3d102759226type3dpdf,28944,28945,57889
32421,,gymqokjfdwgj,28945,28946,57891
32422,,8bld-1l1at4j,28946,28947,57893
32423,,2eap-olo-1uj,28948,28949,57897
32424,,zlmrds0gwngj,28949,28950,57899
32425,,tmzn6uibstqj,28951,28952,57903
32426,,mjpwuopq108j,28952,28953,57905
32427,,81lij3xvgc8j,28953,28954,57907
32428,,wylb8yymlyej,28954,28955,57909
32429,,du-7syikjbmj,28955,28956,57911
32430,,fsda8-xt-j8j,28956,28957,57913
32431,,url:http://portal.acm.org/ft_gateway.cfm3fid3d109965326type3dpdf,28957,28958,57915
32432,,hsgj_xnvfsaj,28958,28959,57917
32433,,hqgiqu8q-f0j,28959,28960,57919
32434,,wmobwefmq-8j,28960,28961,57921
32435,,m04edzqvlgqj,28961,28962,57923
32436,,rr0lltl9qt8j,28962,28963,57925
32437,,iyvaaoydwyuj,28963,28964,57927
32438,,n6t-qmzgyi8j,28964,28965,57929
32439,,on0yzrdwygcj,28965,28966,57931
32440,,7w2mprokepyj,28966,28967,57933
32441,,opqdugp7jlsj,28967,28968,57935
32442,,tvpthhtgwk8j,28968,28969,57937
32443,,jso5ezit0mgj,28969,28970,57939
32444,,mm3pitj0ggqj,28970,28971,57941
32445,,gydxfc6m5aoj,28971,28972,57943
32446,,wyxcoad7li4j,28972,28973,57945
32447,,g_kskh0vse8j,28973,28974,57947
32448,,a1l2vafi4cej,28974,28975,57949
32449,,slgo2dzre0oj,28975,28976,57951
32450,,4xzfe3mouysj,28976,28977,57953
32451,,0gphxvx6qxqj,28977,28978,57955
32452,,huwsrvk5qnuj,28978,28979,57957
32453,,qvtbmgxipigj,28979,28980,57959
32454,,nenn4usis9kj,28980,28981,57961
32455,,uharhpk9tgsj,28981,28982,57963
32456,,miyphitui0wj,28982,28983,57965
32457,,8dlp53pbkyuj,28983,28984,57967
32458,,url:http://doi.wiley.com/10.1002/ev.1258,28984,28985,57969
32459,,wfon35nnbwwj,28985,28986,57971
32460,,b70s3d2k_kmj,28986,28987,57973
32461,,url:http://doi.wiley.com/10.1002/tl.67,28987,28988,57975
32462,,au_jore4aj0j,28988,28989,57977
32463,,te9bznjzqvcj,28989,28990,57979
32464,,wsypyfkcf8kj,28990,28991,57981
32465,,ooyk-cvpogcj,28991,28992,57983
32466,,slljtkss9_oj,28992,28993,57985
32467,,url:http://doi.wiley.com/10.1002/tl.6912,28993,28994,57987
32468,,kq9kip-nv5yj,28994,28995,57989
32469,,vac3dt28c_mj,28995,28996,57991
32470,,zfrecvia2_mj,28996,28997,57993
32471,,z-pole5zabsj,28997,28998,57995
32472,,tekosrri-qqj,28998,28999,57997
32473,,kbl9tldetwqj,28999,29000,57999
32474,,zha09wyvdjwj,29000,29001,58001
32475,,xdh6ze6lwryj,29001,29002,58003
32476,,g9mapgfryz0j,29002,29003,58005
32477,,url:http://www.springerlink.com/index/k2r2g437w8600v5r.pdf,29003,29004,58007
32478,,xu0orjltpamj,29004,29005,58009
32479,,t2c9uq9z9sej,29005,29006,58011
32480,,lpvt0v7spl8j,29006,29007,58013
32481,,44h9md16cycj,29007,29008,58015
32482,,e7lyowjjxu0j,29008,29009,58017
32483,,url:http://adsabs.harvard.edu/abs/1977aero.rept.....s,29009,29010,58019
32484,,iwke8zuydiuj,29010,29011,58021
32485,,idwg_kp6dhmj,29011,29012,58023
32486,,x0l08snpxruj,29012,29013,58025
32487,,q4twb3jms60j,29013,29014,58027
32488,,sgqdnnewdokj,29014,29015,58029
32489,,bjalcq-kciij,29015,29016,58031
32490,,sd9cchv4d8uj,29016,29017,58033
32491,,rhl24wnub7yj,29017,29018,58035
32492,,biw5xpusq8gj,29018,29019,58037
32493,,3blrwy1cd04j,29019,29020,58039
32494,,rkwprckmgmuj,29020,29021,58041
32495,,vh0j_ju5vdoj,29021,29022,58043
32496,,kumlhn4g2j8j,29022,29023,58045
32497,,fywa5ujx4rqj,29023,29024,58047
32498,,url:http://portal.acm.org/citation.cfm3fid3d33519126dl3dguide26dl3dacm26type3dissue26idx3d33519126part3dperiodical26wanttype3dperiodical26title3dacm2520sigmod2520record26cfid3d1111111126cftoken3d2222222,29024,29025,58049
32499,,2mse6dru6ocj,29025,29026,58051
32500,,ky8yc9te2nqj,29026,29027,58053
32501,,kosgm8jvwjmj,29027,29028,58055
32502,,r5kqn2yt_4cj,29028,29029,58057
32503,,xvh0uaabhm8j,29029,29030,58059
32504,,vcoioi9hjraj,29030,29031,58061
32505,,h8wcsps3psej,29031,29032,58063
32506,,9x_dknudlaej,29032,29033,58065
32507,,url:http://www.csa.com/partners/viewrecord.php3frequester3dgs26collection3dtrd26recid3d8204540537md,29034,29035,58069
32508,,ot4koehpgqmj,29035,29036,58071
32509,,odjdsygre7gj,29036,29037,58073
32510,,f5xlv3tkhv0j,29037,29038,58075
32511,,xipuedqlrsyj,29038,29039,58077
32512,,g9munx-auzsj,29039,29040,58079
32513,,wt_m1yhwmbaj,29040,29041,58081
32514,,brrivrepz-uj,29041,29042,58083
32515,,tfj7rihgwi0j,29042,29043,58085
32516,,i7ci50mqozmj,29043,29044,58087
32517,,jbccsbuoenoj,29044,29045,58089
32518,,vtmlxfknidwj,29045,29046,58091
32519,,f5nvogarz5kj,29046,29047,58093
32520,,klpldfhnzjcj,29047,29048,58095
32521,,dfpjsvuhniej,29048,29049,58097
32522,,url:http://ieeexplore.ieee.org/iel5/9217/29235/01320042.pdf3farnumber3d1320042,29049,29050,58099
32523,,kvsmvlcdtkaj,29050,29051,58101
32524,,5yyq8rjtizqj,29051,29052,58103
32525,,1py3vfu5f_kj,29052,29053,58105
32526,,obxi6t9-ktwj,29053,29054,58107
32527,,vwl9k-iw0vyj,29054,29055,58109
32528,,url:http://www.springerlink.com/index/k204287302504726.pdf,29055,29056,58111
32529,,iznvyetnubgj,29056,29057,58113
32530,,htlil2c_e5wj,29057,29058,58115
32531,,buynngjt8m8j,29058,29059,58117
32532,,u_-scp9jx6oj,29059,29060,58119
32533,,n5bejmajwjqj,29060,29061,58121
32534,,h6nocxmfvoij,29061,29062,58123
32535,,dadlrqckcc8j,29062,29063,58125
32536,,gvasqiaftioj,29063,29064,58127
32537,,url:http://doi.wiley.com/10.1002/ange.200390621,29064,29065,58129
32538,,5yore0zpgpcj,29065,29066,58131
32539,,fhbmjxjjjfij,29066,29067,58133
32540,,url:http://portal.acm.org/ft_gateway.cfm3fid3d17464226type3dpdf26dl3dguide26dl3dacm26cfid3d1111111126cftoken3d2222222,29067,29068,58135
32541,,psseqor7_boj,29068,29069,58137
32542,,rvwnf2oq6o8j,29069,29070,58139
32543,,u-crsqikqvgj,29070,29071,58141
32544,,_bpie73lx5gj,29072,29073,58145
32545,,mvbvlwdogy4j,29073,29074,58147
32546,,ebzqm6ekl9ej,29074,29075,58149
32547,,ok2fxlktggcj,29075,29076,58151
32548,,iiowmbwwwqkj,29076,29077,58153
32549,,_56e4uwgrz0j,29077,29078,58155
32550,,whgxd-l0_4ej,29078,29079,58157
32551,,9rc9my6g9tmj,29079,29080,58159
32552,,mi53y5rs0rej,29080,29081,58161
32553,,8luo2coagqaj,29081,29082,58163
32554,,7k9hvhvfzlij,29082,29083,58165
32555,,jodillyhanij,29083,29084,58167
32556,,fyk5kj74oz8j,29084,29085,58169
32557,,dpyxvmkzsbcj,29085,29086,58171
32558,,korjsglsocaj,29086,29087,58173
32559,,btppxqvaqsuj,29087,29088,58175
32560,,p2cks9wq7v8j,29088,29089,58177
32561,,tfkyigp-3s4j,29089,29090,58179
32562,,url:http://www.csa.com/partners/viewrecord.php3frequester3dgs26collection3dtrd26recid3d8205710317md,29090,29091,58181
32563,,xjptuiyvem0j,29091,29092,58183
32564,,kdcs26ts6myj,29092,29093,58185
32565,,cffqihpsaw4j,29093,29094,58187
32566,,ffqt-ch49ysj,29094,29095,58189
32567,,l3u5tobx6t8j,29095,29096,58191
32568,,qtsbbzx9zraj,29096,29097,58193
32569,,3rccv95_vfuj,29097,29098,58195
32570,,pthohr4nfawj,29098,29099,58197
32571,,xlqtdb8aghcj,29099,29100,58199
32572,,8e0dpyu306cj,29100,29101,58201
32573,,url:http://adsabs.harvard.edu/abs/1976scom.nasa..738k,29101,29102,58203
32574,,1fkcou28paej,29102,29103,58205
32575,,fsscrxaxhumj,29103,29104,58207
32576,,fhnoztfgqecj,29104,29105,58209
32577,,xctcdy9kbq4j,29105,29106,58211
32578,,prm2r92gdeej,29106,29107,58213
32579,,acci3cajh4ij,29107,29108,58215
32580,,fvhqsuvlgpkj,29108,29109,58217
32581,,mhijituyjccj,29109,29110,58219
32582,,5_rn1xnevrqj,29110,29111,58221
32583,,a37l0xuimqwj,29111,29112,58223
32584,,u-kctxp7mg0j,29112,29113,58225
32585,,b1kjzsffxewj,29113,29114,58227
32586,,heax8oospkgj,29114,29115,58229
32587,,nlphmodrdwyj,29115,29116,58231
32588,,url:http://www.csa.com/partners/viewrecord.php3frequester3dgs26collection3denv26recid3d8913247,29116,29117,58233
32589,,url:http://portal.acm.org/citation.cfm3fid3d604264.60428326coll3dguide26dl3dacm26type3dissue26idx3dj68926part3dperiodical26wanttype3dperiodical26title3dacm2520sigmod2520record26cfid3d1111111126cftoken3d2222222,29117,29118,58235
32590,,_ybiss27rukj,29118,29119,58237
32591,,zhzojheqrykj,29119,29120,58239
32592,,kmwloqxdspqj,29120,29121,58241
32593,,qnk5e-nlkxsj,29121,29122,58243
32594,,n_pn9no3d_wj,29122,29123,58245
32595,,jkzaghvu1wkj,29123,29124,58247
32596,,url:http://www.csa.com/partners/viewrecord.php3frequester3dgs26collection3dtrd26recid3da7340049ah,29124,29125,58249
32597,,7fz7cs79omaj,29125,29126,58251
32598,,,29126,29127,58253
32599,,muznt5ovelqj,29127,29128,58255
32600,,url:http://portal.acm.org/citation.cfm3fid3d223874,29128,29129,58257
32601,,7jvbvnj0_g8j,29129,29130,58259
32602,,,29130,29131,58261
32603,,ut1c6a_rpkqj,29131,29132,58263
32604,,zeftqrr4ufqj,29132,29133,58265
32605,,vavam89pzhgj,29133,29134,58267
32606,,sjwdqwdz_4uj,29134,29135,58269
32607,,rez2kr7v4dwj,29135,29136,58271
32608,,xqqb_vz9juyj,29136,29137,58273
32609,,txxoi2kkfmuj,29137,29138,58275
32610,,so4mslw0ms4j,29138,29139,58277
32611,,url:http://adsabs.harvard.edu/abs/1984phdt........38s,29139,29140,58279
32612,,mitunyujysoj,29140,29141,58281
32613,,kv2rsbn4n4cj,29141,29142,58283
32614,,yphbb35dgmgj,29142,29143,58285
32615,,wygjqdmrwt8j,29143,29144,58287
32616,,ihd7bv2uhsuj,29144,29145,58289
32617,,f7pkshuabjqj,29145,29146,58291
32618,,bilni2vp9vgj,29146,29147,58293
32619,,f346v5spabqj,29147,29148,58295
32620,,url:http://www.csa.com/partners/viewrecord.php3frequester3dgs26collection3dtrd26recid3dn9210566ah,29148,29149,58297
32621,,7dqb_cw4fjij,29149,29150,58299
32622,,5f3qcqjayl4j,29150,29151,58301
32623,,url:http://portal.acm.org/citation.cfm3fid3d984490,29151,29152,58303
32624,,osum3bj1rekj,29152,29153,58305
32625,,re2uklzr2g0j,29153,29154,58307
32626,,aljikv3a1acj,29154,29155,58309
32627,,1c9tajynbxwj,29155,29156,58311
32628,,url:http://doi.wiley.com/10.1002/ace.148,29156,29157,58313
32629,,rw9qdxqvpryj,29157,29158,58315
32630,,uzshrxhltiej,29158,29159,58317
32631,,url:http://links.jstor.org/sici3fsici3d0146-4949(196321252f22)4253a2253c199253athocps253e2.0.co253b2-o,29159,29160,58319
32632,,kpve1lwbhj8j,29160,29161,58321
32633,,4qguy7hidywj,29161,29162,58323
32634,,e43ib-ohaqgj,29162,29163,58325
32635,,fwxnttjrpayj,29163,29164,58327
32636,,yrl5vuyysjyj,29164,29165,58329
32637,,lsutbpm4jxgj,29165,29166,58331
32638,,ly2vaxzur1cj,29166,29167,58333
32639,,nb6qodpgnpuj,29167,29168,58335
32640,,5gnnh4thnmej,29168,29169,58337
32641,,cvmjnabalnqj,29169,29170,58339
32642,,wrl8l1y7ciej,29170,29171,58341
32643,,r7di5q-qzlcj,29171,29172,58343
32644,,ufqbgla8hykj,29173,29174,58347
32645,,lfsctaiu_coj,29174,29175,58349
32646,,3teyzjkhcmqj,29175,29176,58351
32647,,pqx8etflmaij,29176,29177,58353
32648,,ofxnnqh7xcij,29177,29178,58355
32649,,mh0vnfmclxsj,29178,29179,58357
32650,,rlbucmckl1oj,29179,29180,58359
32651,,py7vaa1sdtsj,29180,29181,58361
32652,,19cqr-xx40cj,29181,29182,58363
32653,,wvwz377ytikj,29182,29183,58365
32654,,dcecg1udalkj,29183,29184,58367
32655,,t4alhp7mvg8j,29184,29185,58369
32656,,xftzpkqhasej,29185,29186,58371
32657,,3sf6a906gj4j,29186,29187,58373
32658,,-8vatohmxiqj,29187,29188,58375
32659,,8j4f5-ionqaj,29188,29189,58377
32660,,url:http://www.csa.com/partners/viewrecord.php3frequester3dgs26collection3dtrd26recid3d155938ws26recid3d199301550072md,29189,29190,58379
32661,,r-0r_i-_o7wj,29190,29191,58381
32662,,ltj_eqtinluj,29191,29192,58383
32663,,3qf3beqndzuj,29192,29193,58385
32664,,bpudjk-i9ryj,29193,29194,58387
32665,,wtbhdjdtkjgj,29194,29195,58389
32666,,xzapgbwiajwj,29195,29196,58391
32667,,l6weqrowol8j,29196,29197,58393
32668,,safmorfvt5aj,29197,29198,58395
32669,,ha1cvnpnfbij,29198,29199,58397
32670,,49xqjvajwuyj,29199,29200,58399
32671,,mox0a1dsotij,29200,29201,58401
32672,,xb5rxk4zdvij,29201,29202,58403
32673,,hbdojbozgc8j,29202,29203,58405
32674,,gekcroq6aiwj,29203,29204,58407
32675,,fj3o02npuc4j,29204,29205,58409
32676,,w3avbg4o7jej,29205,29206,58411
32677,,efrqmqtrozgj,29206,29207,58413
32678,,fuf4elu04luj,29208,29209,58417
32679,,sjyijqczbw0j,29209,29210,58419
32680,,,29210,29211,58421
32681,,xcwi-0yoixij,29211,29212,58423
32682,,brv2i46ci7mj,29212,29213,58425
32683,,n5ndb3plzisj,29213,29214,58427
32684,,xikjvcbr3fwj,29214,29215,58429
32685,,ja10mtcpnegj,29216,29217,58433
32686,,2w8ohbyjn-wj,29217,29218,58435
32687,,ammdliv7lmyj,29218,29219,58437
32688,,1rujg2tvzyyj,29219,29220,58439
32689,,4vctg0q1sz4j,29220,29221,58441
32690,,3pexnormxacj,29221,29222,58443
32691,,ra7rzp8qa2oj,29222,29223,58445
32692,,a7ljcxtdkvmj,29223,29224,58447
32693,,gz1dp-brzvcj,29224,29225,58449
32694,,cjru3vsoctsj,29225,29226,58451
32695,,2ofyn8ha2ogj,29226,29227,58453
32696,,b-5tpnrz9nyj,29227,29228,58455
32697,,dkels9tp1mgj,29228,29229,58457
32698,,vagytwr4wzyj,29229,29230,58459
32699,,rgedmtfpfy4j,29230,29231,58461
32700,,pzyavbg_0msj,29231,29232,58463
32701,,laomt0ua76uj,29232,29233,58465
32702,,f2hj_igihj8j,29233,29234,58467
32703,,8e9grszjfhwj,29234,29235,58469
32704,,ull3bzmbtaaj,29235,29236,58471
32705,,,29236,29237,58473
32706,,gxypdvgi29qj,29237,29238,58475
32707,,ozgs2zafd-mj,29239,29240,58479
32708,,url:http://links.jstor.org/sici3fsici3d0146-4949(196123)2253a3253c39253agoogi2522253e2.0.co253b2-z,29240,29241,58481
32709,,fmqvax1o9gkj,29241,29242,58483
32710,,fgobnnl-jlej,29242,29243,58485
32711,,ham-jlij_2yj,29244,29245,58489
32712,,dbldfxhkkhwj,29245,29246,58491
32713,,zf3ksmjqnp0j,29246,29247,58493
32714,,jut_lkrxjyuj,29247,29248,58495
32715,,xpwg7tdmrjmj,29248,29249,58497
32716,,gd71hf-varwj,29249,29250,58499
32717,,uh7k4iz1lj4j,29250,29251,58501
32718,,tppitlzzfyoj,29251,29252,58503
32719,,tirpurgfzy0j,29252,29253,58505
32720,,pjwykjak2qkj,29253,29254,58507
32721,,t_bcaiebsdej,29254,29255,58509
32722,,mtztcinluvyj,29255,29256,58511
32723,,vu_vo2059vuj,29256,29257,58513
32724,,p_-uwy9s6aaj,29257,29258,58515
32725,,url:http://www.csa.com/partners/viewrecord.php3frequester3dgs26collection3dtrd26recid3dn9210427ah,29258,29259,58517
32726,,mg7puzu2h2wj,29259,29260,58519
32727,,-9ypztu9almj,29260,29261,58521
32728,,ane5pi3uyjwj,29261,29262,58523
32729,,tjg5memyvwij,29262,29263,58525
32730,,glgv3mb9zv8j,29263,29264,58527
32731,,wb6k4ws5bduj,29264,29265,58529
32732,,pbw9nop9e9oj,29266,29267,58533
32733,,oxictqk6qlsj,29267,29268,58535
32734,,hsrcwqe_sx0j,29268,29269,58537
32735,,xe-wajszcz0j,29269,29270,58539
32736,,rea1n6oveagj,29270,29271,58541
32737,,2ceevqz0hgyj,29271,29272,58543
32738,,v3qo5dg_bikj,29272,29273,58545
32739,,l_3ng21a5vsj,29273,29274,58547
32740,,kp31zx001sqj,29274,29275,58549
32741,,tt52f5msygsj,29275,29276,58551
32742,,lmay0odsd5ej,29276,29277,58553
32743,,joztan8igxij,29277,29278,58555
32744,,zdfxvjh6ca8j,29278,29279,58557
32745,,dvs2nbebb4mj,29279,29280,58559
32746,,pbytnzbzwrkj,29280,29281,58561
32747,,sybhke8dlbgj,29281,29282,58563
32748,,1iu-tzzqvekj,29282,29283,58565
32749,,riqiraivpmmj,29283,29284,58567
32750,,lwduxoy1cjqj,29285,29286,58571
32751,,qnzsjk1ouoyj,29286,29287,58573
32752,,mdy84aij-q8j,29287,29288,58575
32753,,url:http://portal.acm.org/ft_gateway.cfm3fid3d108375726type3dpdf,29288,29289,58577
32754,,fqvyqi8ckp8j,29289,29290,58579
32755,,url:http://www.springerlink.com/index/k4rdh7m1cvtl9bmq.pdf,29290,29291,58581
32756,,d0ipw45wntsj,29291,29292,58583
32757,,8uwerdxucewj,29292,29293,58585
32758,,95yilicffwoj,29293,29294,58587
32759,,opgy1syoptgj,29294,29295,58589
32760,,618y7yxy8kuj,29295,29296,58591
32761,,ve0wovabbfqj,29296,29297,58593
32762,,url:http://www.iop.org/ej/article/0022-3735/17/9/003/jev17i9p734.pdf,29297,29298,58595
32763,,8fv7we_gszoj,29298,29299,58597
32764,,0zcutd7tojkj,29299,29300,58599
32765,,u8ty2xf--hoj,29300,29301,58601
32766,,url:http://doi.wiley.com/10.1002/he.107,29301,29302,58603
32767,,yzqp953-bo4j,29303,29304,58607
32768,,a9mzywrgfskj,29304,29305,58609
32769,,rrrw1hrh0gsj,29305,29306,58611
32770,,v-krlxvsrm8j,29306,29307,58613
32771,,0nrhtyiek9ej,29307,29308,58615
32772,,qbgfu0icdz0j,29308,29309,58617
32773,,x_9pvp0jncej,29309,29310,58619
32774,,mqnpxatmdnaj,29310,29311,58621
32775,,xivlkzdsx4ej,29311,29312,58623
32776,,grgsthpoliuj,29312,29313,58625
32777,,7dodjzuwegej,29313,29314,58627
32778,,ek5qtzulssqj,29314,29315,58629
32779,,m0fh31yceu0j,29315,29316,58631
32780,,fdel6x4ngsqj,29316,29317,58633
32781,,j1zz-yzbpsij,29317,29318,58635
32782,,_8u3tglg57yj,29318,29319,58637
32783,,sm2h_15iqcsj,29319,29320,58639
32784,,prahtxw7yf8j,29320,29321,58641
32785,,rm1zlng-smsj,29321,29322,58643
32786,,jsmgwtl391cj,29322,29323,58645
32787,,nrkqfasbqfyj,29323,29324,58647
32788,,fgw7o-rlqlcj,29324,29325,58649
32789,,kjlydwmxvjuj,29325,29326,58651
32790,,url:http://portal.acm.org/ft_gateway.cfm3fid3d103159126type3dpdf,29326,29327,58653
32791,,url:http://portal.acm.org/ft_gateway.cfm3fid3d110125626type3dpdf,29327,29328,58655
32792,,atwqyf6lcuwj,29328,29329,58657
32793,,s9vzrevdxggj,29329,29330,58659
32794,,i3njaoh_po0j,29330,29331,58661
32795,,gqoovmnq7isj,29331,29332,58663
32796,,m6j52ns8vr0j,29332,29333,58665
32797,,wzpg98k88tej,29333,29334,58667
32798,,lweoeljp1rgj,29334,29335,58669
32799,,kpbbeo8y4hej,29335,29336,58671
32800,,fgumgoepbuoj,29336,29337,58673
32801,,8zpojgxbvrqj,29337,29338,58675
32802,,url:http://portal.acm.org/ft_gateway.cfm3fid3d110129226type3dpdf,29338,29339,58677
32803,,zlq0ecomssmj,29339,29340,58679
32804,,ddt9qnnplimj,29340,29341,58681
32805,,3rnolt3bniej,29341,29342,58683
32806,,8aj1cako7iij,29342,29343,58685
32807,,mfosml8c0s4j,29343,29344,58687
32808,,dob8d3xcxjcj,29344,29345,58689
32809,,icq7-lebur8j,29345,29346,58691
32810,,ks6fha-hyfyj,29346,29347,58693
32811,,-5qe4kqkuxsj,29347,29348,58695
32812,,nbw-rul5-uwj,29348,29349,58697
32813,,at5mhn-zyrqj,29349,29350,58699
32814,,azf9gvefzp4j,29350,29351,58701
32815,,sg3ykchnirgj,29351,29352,58703
32816,,i1laagcwndmj,29352,29353,58705
32817,,nk_sew_0p2kj,29353,29354,58707
32818,,6sxh7dsxdowj,29354,29355,58709
32819,,hxvhvylfpcwj,29355,29356,58711
32820,,xanrc9he8k4j,29356,29357,58713
32821,,url:http://doi.wiley.com/10.1002/he.60,29357,29358,58715
32822,,m_s9_woyhnkj,29358,29359,58717
32823,,jk91-qolxtyj,29359,29360,58719
32824,,l0cft-zhm3wj,29360,29361,58721
32825,,y65l0cyqgwkj,29361,29362,58723
32826,,n_m6hjbw8iyj,29362,29363,58725
32827,,ie9drwlb6e8j,29363,29364,58727
32828,,hznwbfv3ph0j,29364,29365,58729
32829,,srwcnf_oaruj,29366,29367,58733
32830,,7zzvk7qwqjyj,29367,29368,58735
32831,,orctbyfbzdoj,29368,29369,58737
32832,,2vmz9ywkpzuj,29369,29370,58739
32833,,lfiqpqzuxmaj,29370,29371,58741
32834,,lpbkdbuesc8j,29371,29372,58743
32835,,tnjddtfztawj,29372,29373,58745
32836,,xakgztfug1wj,29373,29374,58747
32837,,l8eqerhsricj,29374,29375,58749
32838,,ja55priwrmqj,29375,29376,58751
32839,,c8sngovewpkj,29376,29377,58753
32840,,26ebpznrcnij,29377,29378,58755
32841,,gx-502x6n0sj,29378,29379,58757
32842,,a5qgqedykvwj,29379,29380,58759
32843,,hqxzfos7_9oj,29380,29381,58761
32844,,url:http://links.jstor.org/sici3fsici3d0146-4949(196324)4253a1253c5253aatvost253e2.0.co253b2-q,29381,29382,58763
32845,,ri-awufoe5uj,29382,29383,58765
32846,,4gnidzejtsuj,29383,29384,58767
32847,,g4akad0dy6kj,29384,29385,58769
32848,,fmbzmxv7tsaj,29385,29386,58771
32849,,x2hucxkw4z4j,29386,29387,58773
32850,,1nixqc2vhzkj,29387,29388,58775
32851,,pek9mbpttqej,29388,29389,58777
32852,,hf2wegn3wfuj,29389,29390,58779
32853,,mye87ebvhbej,29390,29391,58781
32854,,2mwppkhz3myj,29391,29392,58783
32855,,q5ys-yppbe4j,29392,29393,58785
32856,,3fndmp11wbmj,29393,29394,58787
32857,,qlgirp4zaemj,29394,29395,58789
32858,,op0mcqg0vnsj,29395,29396,58791
32859,,a7mbnkxakikj,29396,29397,58793
32860,,310zrf_pqbij,29397,29398,58795
32861,,hgxavrom_nwj,29398,29399,58797
32862,,azh6ibxlchqj,29399,29400,58799
32863,,,29400,29401,58801
32864,,pvzppcgl_wej,29401,29402,58803
32865,,adffnrdvkfuj,29402,29403,58805
32866,,ho2nily7tfij,29403,29404,58807
32867,,6usypcqmcgij,29404,29405,58809
32868,,7a-enkusdumj,29405,29406,58811
32869,,u-tfnrwhudcj,29406,29407,58813
32870,,xf2kqfa5xquj,29407,29408,58815
32871,,t0lorlvnitaj,29408,29409,58817
32872,,wkedd2blacaj,29409,29410,58819
32873,,_f4auvfjpomj,29410,29411,58821
32874,,m04skitsxx0j,29411,29412,58823
32875,,pymoxqr-0zgj,29412,29413,58825
32876,,gzdo12uwjdwj,29413,29414,58827
32877,,h8smmxboj0wj,29414,29415,58829
32878,,8caisvpqtv4j,29415,29416,58831
32879,,avlvtskpinej,29416,29417,58833
32880,,c-xpcctkousj,29417,29418,58835
32881,,wuppxmyjwu0j,29418,29419,58837
32882,,q6fmtaj1oouj,29419,29420,58839
32883,,inm_ihzlmlej,29420,29421,58841
32884,,n7zpdbf313ij,29421,29422,58843
32885,,ymf3nglluioj,29422,29423,58845
32886,,c8lwmb2-an0j,29423,29424,58847
32887,,1tvxngvfhwqj,29424,29425,58849
32888,,wgka9dunfvsj,29425,29426,58851
32889,,6ymq7msbxyoj,29426,29427,58853
32890,,ntf1tamgczaj,29427,29428,58855
32891,,iwbn4buulqsj,29428,29429,58857
32892,,eztsjq3wfsqj,29429,29430,58859
32893,,a0xxalun4pqj,29430,29431,58861
32894,,nzeuq9mfnpcj,29431,29432,58863
32895,,mnqvfihfg1aj,29432,29433,58865
32896,,soljskiipo4j,29433,29434,58867
32897,,r2ztdcucr8aj,29434,29435,58869
32898,,unaxmvrzitgj,29435,29436,58871
32899,,hvavtyodzvmj,29436,29437,58873
32900,,tt3xjo6urtej,29437,29438,58875
32901,,epuf9ogilogj,29438,29439,58877
32902,,leq4upfcizcj,29439,29440,58879
32903,,9fychplivwkj,29440,29441,58881
32904,,ghgucesy2qgj,29441,29442,58883
32905,,y1amxuhozluj,29442,29443,58885
32906,,kly1nrk4__mj,29443,29444,58887
32907,,ildkdwtgnhwj,29444,29445,58889
32908,,byd_-5em2moj,29445,29446,58891
32909,,p6l_armyh_4j,29446,29447,58893
32910,,95-razgqctuj,29447,29448,58895
32911,,i9wqptyfxzcj,29448,29449,58897
32912,,yl6kv1uloxwj,29449,29450,58899
32913,,fkmtaleed2yj,29450,29451,58901
32914,,onpb98u7bpej,29451,29452,58903
32915,,nognjgcmevsj,29452,29453,58905
32916,,mqkugjttb40j,29453,29454,58907
32917,,ckxvxbodsw0j,29454,29455,58909
32918,,-2pjnavqc8oj,29455,29456,58911
32919,,izjrpow2n54j,29456,29457,58913
32920,,j5zrnfjsjm8j,29459,29460,58919
32921,,q7n4dnznr1ej,29460,29461,58921
32922,,2z0eqnfxrcsj,29461,29462,58923
32923,,tog2bne1i5aj,29462,29463,58925
32924,,ws4mhelvl0yj,29463,29464,58927
32925,,url:http://portal.acm.org/ft_gateway.cfm3fid3d110136126type3dpdf,29464,29465,58929
32926,,ohceplw5ivkj,29465,29466,58931
32927,,vtzvsbto9jcj,29466,29467,58933
32928,,2ryskgs6lugj,29467,29468,58935
32929,,vjvukbz-comj,29468,29469,58937
32930,,hmgnewxu_ecj,29469,29470,58939
32931,,e6zpj7ob8tyj,29470,29471,58941
32932,,5nvl8wcmn_kj,29471,29472,58943
32933,,ajmzbyfa3aqj,29472,29473,58945
32934,,url:http://links.jstor.org/sici3fsici3d0146-4949(196623)7253a3253c270253aforc253e2.0.co253b2-i,29473,29474,58947
32935,,dogu0i_nyg0j,29474,29475,58949
32936,,cizgddebvh0j,29475,29476,58951
32937,,qwmmtugnypsj,29476,29477,58953
32938,,w8pfz7qyb0kj,29477,29478,58955
32939,,tynregyyyryj,29478,29479,58957
32940,,url:http://portal.acm.org/ft_gateway.cfm3fid3d110119126type3dpdf,29479,29480,58959
32941,,vbha-6gl9-kj,29480,29481,58961
32942,,bs40r86jneej,29481,29482,58963
32943,,utl3gt5draij,29482,29483,58965
32944,,url:http://www.csa.com/partners/viewrecord.php3frequester3dgs26collection3dtrd26recid3dn9210539ah,29483,29484,58967
32945,,ofrnwqlx6xqj,29484,29485,58969
32946,,dk1hpjeo_mwj,29485,29486,58971
32947,,es39ibr1tgoj,29486,29487,58973
32948,,dzktif9alskj,29487,29488,58975
32949,,g9nj23et_ocj,29488,29489,58977
32950,,wsy7q1djdcsj,29489,29490,58979
32951,,hgnnz_ppbv8j,29491,29492,58983
32952,,2mkav7rxjl8j,29493,29494,58987
32953,,afsgzwskfocj,29494,29495,58989
32954,,0mtexou7gzcj,29495,29496,58991
32955,,q6h7igz08mij,29496,29497,58993
32956,,dlr-yeuc3jaj,29497,29498,58995
32957,,si2a6ljthuij,29498,29499,58997
32958,,url:http://portal.acm.org/citation.cfm3fid3d222991,29499,29500,58999
32959,,bdhfpyhw1_aj,29500,29501,59001
32960,,xnidyaann2qj,29501,29502,59003
32961,,icuqk7ny1wwj,29502,29503,59005
32962,,jltv7dhxevcj,29503,29504,59007
32963,,url:http://adsabs.harvard.edu/abs/1980phdt........15j,29504,29505,59009
32964,,rjzsweiiogaj,29505,29506,59011
32965,,l-hwkpxz_x0j,29506,29507,59013
32966,,th1-xssw23uj,29507,29508,59015
32967,,url:http://doi.wiley.com/10.1002/he.80,29508,29509,59017
32968,,1nzfo_zlxmoj,29509,29510,59019
32969,,vmu3h7jh_u8j,29510,29511,59021
32970,,tb7k7ewiyhaj,29511,29512,59023
32971,,,29512,29513,59025
32972,,hexoot9hiz4j,29513,29514,59027
32973,,rdpjjfzq2cwj,29515,29516,59031
32974,,z4ov9mmes4qj,29516,29517,59033
32975,,6gs0kmejxnqj,29517,29518,59035
32976,,mjmhocwd3jmj,29518,29519,59037
32977,,g4p3k22hy_oj,29519,29520,59039
32978,,8evwyw3vvqoj,29520,29521,59041
32979,,9dd9eja0yhij,29521,29522,59043
32980,,ckm5ijzud5sj,29522,29523,59045
32981,,nlhs-fqawaoj,29523,29524,59047
32982,,mom_anhfcfqj,29524,29525,59049
32983,,bwe6p3dqgcmj,29525,29526,59051
32984,,zki0iwbu40mj,29526,29527,59053
32985,,ezyqt2_lje8j,29527,29528,59055
32986,,rumjpu6p2g4j,29528,29529,59057
32987,,bgtksynyse4j,29529,29530,59059
32988,,a-jnk0uo2pwj,29530,29531,59061
32989,,_7sy8pfjeusj,29531,29532,59063
32990,,opfk5zx5vfmj,29532,29533,59065
32991,,yujoxttrvs4j,29533,29534,59067
32992,,bggv5i5kplaj,29534,29535,59069
32993,,2somyofouuij,29535,29536,59071
32994,,m7os8njtqomj,29536,29537,59073
32995,,pii_5xfsh2sj,29537,29538,59075
32996,,3ekfmbrdx1yj,29538,29539,59077
32997,,url:http://portal.acm.org/citation.cfm3fid3d171926.171955,29539,29540,59079
32998,,3fkwsnmtilsj,29540,29541,59081
32999,,onsc6cehbsyj,29541,29542,59083
33000,,wlcetzq_choj,29542,29543,59085
33001,,gp36tpmxdiqj,29543,29544,59087
33002,,bxzt8lctt2cj,29544,29545,59089
33003,,pki-hwhdkpaj,29545,29546,59091
33004,,doj3elrwd4aj,29546,29547,59093
33005,,3kstndoll6gj,29547,29548,59095
33006,,zhcskifl7x8j,29548,29549,59097
33007,,5tr6thhsuryj,29549,29550,59099
33008,,gi7n9eqitx4j,29550,29551,59101
33009,,qdsblcz4oawj,29551,29552,59103
33010,,3jurgjesboqj,29552,29553,59105
33011,,r3qgbh9ygj4j,29554,29555,59109
33012,,d9jp6wkgyhmj,29555,29556,59111
33013,,url:http://www.csa.com/partners/viewrecord.php3frequester3dgs26collection3dtrd26recid3d155968ws26recid3d199301550083md,29556,29557,59113
33014,,9vqxj5c5lsyj,29557,29558,59115
33015,,reu4oz68zlaj,29558,29559,59117
33016,,ad6lvwcp710j,29559,29560,59119
33017,,foiw8l---xqj,29560,29561,59121
33018,,en0clckhww8j,29561,29562,59123
33019,,3x4arvzvy0qj,29562,29563,59125
33020,,url:http://links.jstor.org/sici3fsici3d0146-4949(196023)1253a3253c5253anmatro253e2.0.co253b2-o,29563,29564,59127
33021,,guxpijuy7-ej,29564,29565,59129
33022,,trwudfqwjcyj,29565,29566,59131
33023,,,29566,29567,59133
33024,,gc1sdnwjkf8j,29567,29568,59135
33025,,_7cubanay8sj,29568,29569,59137
33026,,urof37frehwj,29569,29570,59139
33027,,ami_buuba4uj,29570,29571,59141
33028,,nhm7mlq0dlgj,29571,29572,59143
33029,,olttvwcl9cmj,29572,29573,59145
33030,,apvauhwkkp4j,29573,29574,59147
33031,,f6owrywydnsj,29574,29575,59149
33032,,rob48bqqgmmj,29575,29576,59151
33033,,p8arqgs0wb0j,29576,29577,59153
33034,,0eo3fsgbtuij,29577,29578,59155
33035,,znwjx4a_5v0j,29578,29579,59157
33036,,url:http://portal.acm.org/citation.cfm3fid3d1055577,29579,29580,59159
33037,,wpkfvglxqwej,29580,29581,59161
33038,,url:http://adsabs.harvard.edu/abs/1985mit..reptu....w,29581,29582,59163
33039,,htpqlwxzdm4j,29582,29583,59165
33040,,jawr59nladoj,29583,29584,59167
33041,,yh3zzkkfuhgj,29584,29585,59169
33042,,6l71kghtnmoj,29585,29586,59171
33043,,9sjnrq2_gzmj,29586,29587,59173
33044,,_jkd4ucct-aj,29587,29588,59175
33045,,uqqqkkk6a9wj,29588,29589,59177
33046,,owbfu8ncewcj,29589,29590,59179
33047,,vp7z1tq92gaj,29590,29591,59181
33048,,g2z2jscnrqmj,29591,29592,59183
33049,,x5by8kbxxpwj,29592,29593,59185
33050,,gemt6mrl7uqj,29593,29594,59187
33051,,5rs8t9xjelqj,29595,29596,59191
33052,,jmuxg_ehlkcj,29596,29597,59193
33053,,wqq81updffej,29597,29598,59195
33054,,_uvftkx9hwqj,29598,29599,59197
33055,,z4ziv5agttcj,29599,29600,59199
33056,,pmty1d0nle4j,29600,29601,59201
33057,,bvbluulmof0j,29601,29602,59203
33058,,2zzvjzdnu0qj,29602,29603,59205
33059,,emutwjopb5qj,29603,29604,59207
33060,,tg-rbbqbcfyj,29604,29605,59209
33061,,2agzs7tkydyj,29605,29606,59211
33062,,bnjivkmvhucj,29606,29607,59213
33063,,s1rbe46vsfwj,29607,29608,59215
33064,,95vjrnkf6l0j,29608,29609,59217
33065,,hmgszmejh1wj,29609,29610,59219
33066,,qvf6atlimlmj,29610,29611,59221
33067,,vhkg2x_3rlwj,29611,29612,59223
33068,,zhy8krsiutsj,29613,29614,59227
33069,,url:http://portal.acm.org/citation.cfm3fid3d808388,29614,29615,59229
33070,,bw0beuccpjcj,29615,29616,59231
33071,,drhxqsjdbokj,29616,29617,59233
33072,,7eq4fselxckj,29617,29618,59235
33073,,nvldgvinnn8j,29618,29619,59237
33074,,uw8lhdxxuvsj,29619,29620,59239
33075,,iebvyyq1hioj,29620,29621,59241
33076,,3noci_6sjbgj,29621,29622,59243
33077,,url:http://ieeexplore.ieee.org/iel2/575/5225/00202223.pdf3farnumber3d202223,29622,29623,59245
33078,,zxad2wr3lbsj,29623,29624,59247
33079,,url:http://portal.acm.org/ft_gateway.cfm3fid3d109338326type3dpdf,29624,29625,59249
33080,,xuaznal9eb4j,29625,29626,59251
33081,,url:http://www.csa.com/partners/viewrecord.php3frequester3dgs26collection3dtrd26recid3dn9210563ah,29626,29627,59253
33082,,8tjrdr3axa8j,29627,29628,59255
33083,,dmyddzdsiasj,29628,29629,59257
33084,,ams5bqa8cdgj,29630,29631,59261
33085,,ceftct1lvvej,29631,29632,59263
33086,,gltsbus8brkj,29632,29633,59265
33087,,cygsqd6y4jyj,29633,29634,59267
33088,,7z_clih85guj,29634,29635,59269
33089,,gm0gkwwxkaoj,29635,29636,59271
33090,,url:http://www.csa.com/partners/viewrecord.php3frequester3dgs26collection3dtrd26recid3d200111000452mt26recid3da0032585ah,29636,29637,59273
33091,,0htuex8qecaj,29637,29638,59275
33092,,krtgnb5tbfyj,29638,29639,59277
33093,,emlakxskbl4j,29639,29640,59279
33094,,iotlbr0lkzij,29640,29641,59281
33095,,wg2240x0yvaj,29641,29642,59283
33096,,zjoqznmzleyj,29642,29643,59285
33097,,h0m2v7zwl7sj,29643,29644,59287
33098,,j4tiipoah48j,29644,29645,59289
33099,,ftjluvcwreaj,29645,29646,59291
33100,,rzqx7qdcts8j,29646,29647,59293
33101,,kb1gqyc-h64j,29648,29649,59297
33102,,qfv0qnxuy1aj,29649,29650,59299
33103,,gbfoufqht4wj,29650,29651,59301
33104,,xinqv9iy_fwj,29651,29652,59303
33105,,3ilducghmkuj,29652,29653,59305
33106,,u99hqlqt9jej,29653,29654,59307
33107,,kewc1upsb-kj,29654,29655,59309
33108,,jsvlequbvpaj,29655,29656,59311
33109,,g59hj98p3lkj,29656,29657,59313
33110,,wctksjqgvdsj,29657,29658,59315
33111,,dsflgejboa4j,29658,29659,59317
33112,,xwjzm_8kqzyj,29659,29660,59319
33113,,y_3tqgfq_h0j,29660,29661,59321
33114,,vi7-lunfq4uj,29661,29662,59323
33115,,z6s4bt1k9wij,29662,29663,59325
33116,,f3_gt6i5o7oj,29663,29664,59327
33117,,jgsb1fxbte4j,29664,29665,59329
33118,,pif2jz9nkiaj,29665,29666,59331
33119,,uf4wxbia6fmj,29666,29667,59333
33120,,rgvvcqxmtnyj,29667,29668,59335
33121,,85zxwfsafu4j,29668,29669,59337
33122,,5pj1wwl3wi8j,29669,29670,59339
33123,,04s-gqy_qh8j,29670,29671,59341
33124,,pqjncds_sr4j,29671,29672,59343
33125,,fun58il2b0mj,29672,29673,59345
33126,,kpojarnbi1kj,29673,29674,59347
33127,,ubqlscec7zmj,29674,29675,59349
33128,,clhkri6oboqj,29675,29676,59351
33129,,z95hh7a1msij,29676,29677,59353
33130,,dskhasfphqsj,29677,29678,59355
33131,,url:http://portal.acm.org/ft_gateway.cfm3fid3d110137926type3dpdf,29678,29679,59357
33132,,b5b2spk9u6wj,29679,29680,59359
33133,,dpnlki3plg0j,29680,29681,59361
33134,,taopkgyezgqj,29681,29682,59363
33135,,qgggnasei_aj,29682,29683,59365
33136,,y7bbf7rgii8j,29683,29684,59367
33137,,t4os1oo8vt4j,29684,29685,59369
33138,,,29685,29686,59371
33139,,wf2-sxlgau4j,29686,29687,59373
33140,,fcm6hqe3chkj,29687,29688,59375
33141,,hblmr2m3yx8j,29688,29689,59377
33142,,h7eklvkwqimj,29689,29690,59379
33143,,hxj71rqcnhqj,29690,29691,59381
33144,,-3laxrnpdjij,29691,29692,59383
33145,,hib5oqauh-uj,29693,29694,59387
33146,,qzqlobliuq8j,29694,29695,59389
33147,,dnyda0cfgt4j,29695,29696,59391
33148,,igvswmsy3ikj,29696,29697,59393
33149,,dig58duy97uj,29697,29698,59395
33150,,4agfhwvjtxcj,29698,29699,59397
33151,,biz3tqnxjskj,29699,29700,59399
33152,,ndo6uddf0cuj,29700,29701,59401
33153,,o8dgh42rlzyj,29701,29702,59403
33154,,5p-8nuarxxyj,29702,29703,59405
33155,,gvmahapj37yj,29703,29704,59407
33156,,yq0d98oejkmj,29704,29705,59409
33157,,3nksewj6mz0j,29705,29706,59411
33158,,ulvrecd5xx4j,29707,29708,59415
33159,,ltr-rrz8qbwj,29708,29709,59417
33160,,0jqphhxwlxoj,29709,29710,59419
33161,,lvtlfzsxqaoj,29710,29711,59421
33162,,_dk4kc2ewfej,29711,29712,59423
33163,,b842mqt_xfij,29712,29713,59425
33164,,tnpz4dbljuwj,29713,29714,59427
33165,,jrxx_zwal0kj,29714,29715,59429
33166,,uqd6l3cuqlqj,29715,29716,59431
33167,,erkigeihox0j,29716,29717,59433
33168,,ozmjp8ttg-cj,29717,29718,59435
33169,,url:http://links.jstor.org/sici3fsici3d0146-4949(196721)8253a2253c319253aeip253e2.0.co253b2-r,29718,29719,59437
33170,,d7gldcpq6pwj,29719,29720,59439
33171,,kbs3fliuhrmj,29720,29721,59441
33172,,64ov6jvm5gij,29721,29722,59443
33173,,kdacz_ckqu0j,29722,29723,59445
33174,,2bwwc9brof0j,29723,29724,59447
33175,,qcpis1sbsw0j,29724,29725,59449
33176,,s5dqbt5ttm8j,29725,29726,59451
33177,,mieu6onf9-ej,29726,29727,59453
33178,,wwl1iur35_gj,29727,29728,59455
33179,,yjmhkkh_vx0j,29728,29729,59457
33180,,spiekgfrrtwj,29729,29730,59459
33181,,vcyial-8xeuj,29730,29731,59461
33182,,f9-hofeh3umj,29731,29732,59463
33183,,e-6ry3kg9jqj,29732,29733,59465
33184,,jfu7cwd1lhqj,29733,29734,59467
33185,,buwa7rnb4c8j,29734,29735,59469
33186,,bnlynhyoihuj,29735,29736,59471
33187,,ywshckpm164j,29736,29737,59473
33188,,bif2jrwml0ej,29737,29738,59475
33189,,stdl0a7gamqj,29738,29739,59477
33190,,,29739,29740,59479
33191,,rtqfgsxutzkj,29740,29741,59481
33192,,xabasrlh-dgj,29741,29742,59483
33193,,cjz9is1tbjej,29742,29743,59485
33194,,aqmroun1ebij,29743,29744,59487
33195,,onbea3lc0-ij,29744,29745,59489
33196,,cukmloq9khoj,29745,29746,59491
33197,,dkgb68vlnbuj,29746,29747,59493
33198,,znoaqe4chj0j,29748,29749,59497
33199,,5q9v4wps4ksj,29749,29750,59499
33200,,5kyjjo0uxlmj,29750,29751,59501
33201,,4coo-jt2pyoj,29751,29752,59503
33202,,f-t-p4xnoywj,29752,29753,59505
33203,,sgatudejp2wj,29753,29754,59507
33204,,besn7jboa74j,29755,29756,59511
33205,,2yuzgjqmjnsj,29756,29757,59513
33206,,url:http://www.springerlink.com/index/n851829278x746n1.pdf,29757,29758,59515
33207,,jn04znyjy3uj,29758,29759,59517
33208,,pojxt880k-aj,29759,29760,59519
33209,,xpiffdhg1rij,29760,29761,59521
33210,,1j93qsjp7fgj,29761,29762,59523
33211,,wtlcp72pjjcj,29762,29763,59525
33212,,iiynzukei40j,29763,29764,59527
33213,,6tsfl5hs_wej,29764,29765,59529
33214,,xbhuth_mmigj,29765,29766,59531
33215,,djvkltzlwxcj,29766,29767,59533
33216,,qsusvqyi3j8j,29767,29768,59535
33217,,xbm4gs7mom0j,29768,29769,59537
33218,,oyw7uy7ij6qj,29769,29770,59539
33219,,igohjlat5qyj,29770,29771,59541
33220,,ys70nnogg_aj,29771,29772,59543
33221,,d878tsbwkv4j,29772,29773,59545
33222,,czbfornijbqj,29774,29775,59549
33223,,ncokpszozbgj,29775,29776,59551
33224,,5rqo1dvswvkj,29776,29777,59553
33225,,oqxstxbhkasj,29777,29778,59555
33226,,nwgqb7qk4lej,29778,29779,59557
33227,,tqxfdqbtw6kj,29779,29780,59559
33228,,oqwo8tpoyhsj,29780,29781,59561
33229,,6ka3zl8qalsj,29781,29782,59563
33230,,qen7gvkszc4j,29782,29783,59565
33231,,,29783,29784,59567
33232,,jgnz46qpa-oj,29784,29785,59569
33233,,url:http://portal.acm.org/ft_gateway.cfm3fid3d102776726type3dpdf,29785,29786,59571
33234,,4r6x8jfmeawj,29786,29787,59573
33235,,icruuiolkqij,29787,29788,59575
33236,,easgjamx2acj,29788,29789,59577
33237,,3ljtsthcbpmj,29789,29790,59579
33238,,qgkkdx0ozluj,29790,29791,59581
33239,,jxmq4of4gn4j,29791,29792,59583
33240,,skwupfhjvlkj,29792,29793,59585
33241,,wl3nz6dy1lmj,29793,29794,59587
33242,,pqol_c_qwrsj,29794,29795,59589
33243,,_pxgtgigr-4j,29795,29796,59591
33244,,ifz8bypprc0j,29796,29797,59593
33245,,zdacqmys9duj,29797,29798,59595
33246,,htfn2rmfiu4j,29798,29799,59597
33247,,ixw-dedku38j,29799,29800,59599
33248,,xb5vsndpl4ej,29801,29802,59603
33249,,q_wgzvi7gyuj,29802,29803,59605
33250,,qiqe9tauxgoj,29803,29804,59607
33251,,jhujhoogonuj,29804,29805,59609
33252,,fjcikqz23ouj,29805,29806,59611
33253,,pxrzh4xyc_oj,29806,29807,59613
33254,,wcbvsixkuocj,29807,29808,59615
33255,,3qinxns_fjcj,29808,29809,59617
33256,,url:http://www.csa.com/partners/viewrecord.php3frequester3dgs26collection3dtrd26recid3dn9210401ah,29809,29810,59619
33257,,hrj8us8rvx0j,29810,29811,59621
33258,,z1g0u8e5314j,29811,29812,59623
33259,,dm1ps2aqcnuj,29812,29813,59625
33260,,m-blk09le30j,29813,29814,59627
33261,,6yvqx-yzkbyj,29814,29815,59629
33262,,xmiwejrliwij,29815,29816,59631
33263,,seyhsl13hnyj,29816,29817,59633
33264,,miq6ilv7fl0j,29817,29818,59635
33265,,hdpxkmysgguj,29818,29819,59637
33266,,x-dbrlmprnyj,29819,29820,59639
33267,,wdcl-to0zgej,29820,29821,59641
33268,,4zjo_jnsbj4j,29821,29822,59643
33269,,baxujxf0f4ej,29822,29823,59645
33270,,qby5ukdbww8j,29823,29824,59647
33271,,yhznwmo6t2wj,29824,29825,59649
33272,,al0sfnhykjej,29825,29826,59651
33273,,3mekva4_lcij,29826,29827,59653
33274,,m508pb3snuwj,29827,29828,59655
33275,,3alvt5v2qtoj,29828,29829,59657
33276,,url:http://doi.ieeecomputersociety.org/10.1109/tkde.2004.63,29830,29831,59661
33277,,pszpvq8wlywj,29831,29832,59663
33278,,nxtvziwy81ij,29832,29833,59665
33279,,rv2gssrgyamj,29833,29834,59667
33280,,hy1rj8ox-zej,29834,29835,59669
33281,,cvpwhxpjnauj,29835,29836,59671
33282,,nsoqc8sggjcj,29836,29837,59673
33283,,fy7f5hcwi8sj,29837,29838,59675
33284,,url:http://doi.wiley.com/10.1002/ace.135,29838,29839,59677
33285,,rzxxlvtvdp0j,29839,29840,59679
33286,,frm-l5ca5waj,29840,29841,59681
33287,,url:http://adsabs.harvard.edu/abs/1988umas.rept.....l,29841,29842,59683
33288,,url:http://www.springerlink.com/index/k172n8x5509538un.pdf,29842,29843,59685
33289,,wb5cw1w-12ej,29843,29844,59687
33290,,ckb0m1fkxxcj,29844,29845,59689
33291,,tjrrzrdhixcj,29845,29846,59691
33292,,pgyvrfa9cnmj,29846,29847,59693
33293,,0pb7gf7epmcj,29847,29848,59695
33294,,plmilmeair4j,29848,29849,59697
33295,,xregh_bwzysj,29849,29850,59699
33296,,nbqlc0u1j88j,29850,29851,59701
33297,,zafksnznmjkj,29851,29852,59703
33298,,url:http://adsabs.harvard.edu/abs/1980phdt........23d,29852,29853,59705
33299,,g2hzt2qtajgj,29853,29854,59707
33300,,nfgn7p9prt4j,29854,29855,59709
33301,,yxokxpbjcfsj,29855,29856,59711
33302,,url:http://portal.acm.org/citation.cfm3fid3d58232626dl3dacm26coll3dportal26cfid3d1111111126cftoken3d2222222,29856,29857,59713
33303,,gahnemeffsqj,29857,29858,59715
33304,,maf7z2tq2lij,29858,29859,59717
33305,,yqjivcn6xdcj,29859,29860,59719
33306,,m_dlp00a1scj,29860,29861,59721
33307,,qryzxhvd-pqj,29861,29862,59723
33308,,kuv6y4waq7sj,29862,29863,59725
33309,,rfewswr5av4j,29863,29864,59727
33310,,o3vnupmi3aaj,29864,29865,59729
33311,,1qwnra_8duij,29865,29866,59731
33312,,32nvawy_gmoj,29866,29867,59733
33313,,8ur_e3iv39gj,29867,29868,59735
33314,,avzkwlbcp58j,29868,29869,59737
33315,,osz0tqkycdcj,29869,29870,59739
33316,,zj4jyrp_fgkj,29870,29871,59741
33317,,url:http://www.csa.com/partners/viewrecord.php3frequester3dgs26collection3dtrd26recid3da8223598ah,29871,29872,59743
33318,,,29872,29873,59745
33319,,zysmmdnghuaj,29873,29874,59747
33320,,wbr6xncc4w4j,29874,29875,59749
33321,,bbylvkgzj-8j,29875,29876,59751
33322,,eu3s0mvurjqj,29876,29877,59753
33323,,hdvedwrfmy4j,29877,29878,59755
33324,,41pzngklpe8j,29878,29879,59757
33325,,mdgdtw60w34j,29879,29880,59759
33326,,ymexiap5en0j,29880,29881,59761
33327,,ogkovgdgpc4j,29881,29882,59763
33328,,url:http://portal.acm.org/ft_gateway.cfm3fid3d110134926type3dpdf,29882,29883,59765
33329,,vx5pa9tuhwej,29883,29884,59767
33330,,moo6fysj1puj,29885,29886,59771
33331,,xziy9wnuvzwj,29886,29887,59773
33332,,lpswfhsokcmj,29887,29888,59775
33333,,url:http://www.csa.com/partners/viewrecord.php3frequester3dgs26collection3denv26recid3d8913260,29888,29889,59777
33334,,2azyx07r9vkj,29889,29890,59779
33335,,ah2bj64-l7mj,29890,29891,59781
33336,,wukl835xgaej,29891,29892,59783
33337,,yrycc0nvum4j,29892,29893,59785
33338,,8-vudnmpvugj,29893,29894,59787
33339,,f7jtaj5jezoj,29894,29895,59789
33340,,m5wsta_dsyaj,29895,29896,59791
33341,,kym9kdp_1zsj,29896,29897,59793
33342,,qz2qt01c8z0j,29897,29898,59795
33343,,jwxot2xpkwaj,29898,29899,59797
33344,,ilznkjxzr6qj,29899,29900,59799
33345,,3j3bp68bmlij,29900,29901,59801
33346,,ojszsmwjugkj,29901,29902,59803
33347,,8iknbbgfw0oj,29902,29903,59805
33348,,gj50no3hjaaj,29903,29904,59807
33349,,_nuslghe2kkj,29904,29905,59809
33350,,kob9nefep5uj,29905,29906,59811
33351,,mcn1g8of_dij,29906,29907,59813
33352,,ikinn_m4btgj,29907,29908,59815
33353,,cpbwyz1f4xyj,29908,29909,59817
33354,,_bin9kk1fluj,29910,29911,59821
33355,,qq-ed3bo_t8j,29911,29912,59823
33356,,oqg91htknjaj,29912,29913,59825
33357,,ghkbowcci-ij,29913,29914,59827
33358,,emij10nfqmqj,29914,29915,59829
33359,,url:http://www.csa.com/partners/viewrecord.php3frequester3dgs26collection3dtrd26recid3dn9210396ah,29915,29916,59831
33360,,auw2kkhiu3sj,29916,29917,59833
33361,,5aghg0ga9d4j,29917,29918,59835
33362,,thayssg4f5ij,29918,29919,59837
33363,,juk8otx9xrcj,29919,29920,59839
33364,,ojh46tybdlaj,29920,29921,59841
33365,,dlah-47euvqj,29921,29922,59843
33366,,m_r27bt4ad0j,29923,29924,59847
33367,,iw-se1ojmjij,29924,29925,59849
33368,,mkl76xtcmwqj,29925,29926,59851
33369,,1mjukrsyxioj,29926,29927,59853
33370,,0-4mw6twjpuj,29927,29928,59855
33371,,skq1qehdztmj,29928,29929,59857
33372,,zprardpkju8j,29929,29930,59859
33373,,j__0onkhoxij,29930,29931,59861
33374,,pxgoumfdnzoj,29931,29932,59863
33375,,j_o_2lnjxqej,29932,29933,59865
33376,,37bpizg8etmj,29933,29934,59867
33377,,hhq_9mkcmqkj,29934,29935,59869
33378,,ce7vvqt2z80j,29935,29936,59871
33379,,l4fftubhl34j,29936,29937,59873
33380,,yqsgl-bnvx4j,29937,29938,59875
33381,,62hm_69yibgj,29938,29939,59877
33382,,a1ruui5jh20j,29939,29940,59879
33383,,g77-fkulkraj,29940,29941,59881
33384,,aa5ttx_dghgj,29941,29942,59883
33385,,rjeinujvki8j,29942,29943,59885
33386,,uhzznapoencj,29943,29944,59887
33387,,ebqilhye3zuj,29944,29945,59889
33388,,vgx7zakgj-sj,29945,29946,59891
33389,,url:http://portal.acm.org/ft_gateway.cfm3fid3d110118426type3dpdf,29946,29947,59893
33390,,y1shrhkdvjkj,29947,29948,59895
33391,,d5-j63d3e3kj,29948,29949,59897
33392,,url:http://portal.acm.org/citation.cfm3fid3d984518,29949,29950,59899
33393,,f9mpbt0jugsj,29950,29951,59901
33394,,3h3vj870clej,29951,29952,59903
33395,,loejhcdf_9ij,29952,29953,59905
33396,,ddf0r1sj2fmj,29953,29954,59907
33397,,earxanikxrqj,29954,29955,59909
33398,,bkyfj51y0uwj,29955,29956,59911
33399,,4m_gftoq5c8j,29956,29957,59913
33400,,a-81fulqu5oj,29957,29958,59915
33401,,24nkpciz284j,29959,29960,59919
33402,,qrj6e6sboo8j,29960,29961,59921
33403,,drazxapj2rgj,29961,29962,59923
33404,,jcfyxqhan_8j,29962,29963,59925
33405,,1n-wdxcwxpcj,29963,29964,59927
33406,,url:http://www.csa.com/partners/viewrecord.php3frequester3dgs26collection3dtrd26recid3d9008110923md,29964,29965,59929
33407,,9oxsbxqahisj,29965,29966,59931
33408,,z2apmgz8fdaj,29966,29967,59933
33409,,1i1aecdzpbcj,29967,29968,59935
33410,,,29969,29970,59939
33411,,qfsloz5jry4j,29970,29971,59941
33412,,jz8hdvk_02yj,29971,29972,59943
33413,,nn4kc3qcga0j,29972,29973,59945
33414,,0smuksm2tvmj,29973,29974,59947
33415,,wlb-qr2nfvkj,29974,29975,59949
33416,,gima8zksqgyj,29975,29976,59951
33417,,pnapfhubntsj,29976,29977,59953
33418,,i5jnup7roggj,29977,29978,59955
33419,,uv6nmj7jeggj,29978,29979,59957
33420,,,29979,29980,59959
33421,,n1zka3o9zw8j,29980,29981,59961
33422,,url:http://portal.acm.org/citation.cfm3fid3d234286.1057823,29981,29982,59963
33423,,2vfsc9ozouyj,29982,29983,59965
33424,,url:http://www.csa.com/partners/viewrecord.php3frequester3dgs26collection3dtrd26recid3dn9210549ah,29983,29984,59967
33425,,mbz959k40wkj,29984,29985,59969
33426,,wm-tlogb8yej,29985,29986,59971
33427,,2k1xpdhm2huj,29986,29987,59973
33428,,540e3sgkyi0j,29987,29988,59975
33429,,yeqbx33vmrkj,29988,29989,59977
33430,,batouoliw9mj,29990,29991,59981
33431,,iay9himy06kj,29992,29993,59985
33432,,2w9mp_znqroj,29994,29995,59989
33433,,vnxnmhnfrt8j,29995,29996,59991
33434,,pe6bl41ypiij,29996,29997,59993
33435,,z9mxic2tjj0j,29997,29998,59995
33436,,hgvdqyghvfmj,29998,29999,59997
33437,,7pxxrs2in1sj,29999,30000,59999
33438,,1t0lpynf5ssj,30000,30001,60001
33439,,,30001,30002,60003
33440,,hpbpatc5cwmj,30002,30003,60005
33441,,vgf5xyz-mbij,30003,30004,60007
33442,,zrb-ptwjqtqj,30004,30005,60009
33443,,txgkh684_okj,30005,30006,60011
33444,,brngunfeommj,30006,30007,60013
33445,,e9ois9wjh38j,30007,30008,60015
33446,,mfawvvox1usj,30008,30009,60017
33447,,d9u9g1duixgj,30010,30011,60021
33448,,vf0-ersfx5qj,30011,30012,60023
33449,,wu4qn6ehvbuj,30012,30013,60025
33450,,bz9wlko5yuoj,30013,30014,60027
33451,,ja_rgosx8qij,30014,30015,60029
33452,,ivvcdg7o0owj,30015,30016,60031
33453,,9rtozbrefkyj,30016,30017,60033
33454,,nszqx1kjykaj,30017,30018,60035
33455,,fox6jobtsdqj,30018,30019,60037
33456,,z-dwhartyn4j,30019,30020,60039
33457,,jnkiclsjxskj,30020,30021,60041
33458,,lfm8l6r4eowj,30021,30022,60043
33459,,j0sprd3dn78j,30022,30023,60045
33460,,mf79qwf__cij,30023,30024,60047
33461,,noegmb0vp9wj,30024,30025,60049
33462,,ykidyihm0tcj,30025,30026,60051
33463,,uww0twk1hfqj,30026,30027,60053
33464,,cj8aqtsyayej,30027,30028,60055
33465,,lodtepmo05qj,30028,30029,60057
33466,,ii0s1xvebtsj,30029,30030,60059
33467,,9kuwsshte9kj,30030,30031,60061
33468,,sqvaic_tafej,30031,30032,60063
33469,,liswoqu-kpej,30032,30033,60065
33470,,xtdfwtzcqjkj,30033,30034,60067
33471,,axuv-3jz9hcj,30034,30035,60069
33472,,h2x0vn2im4aj,30035,30036,60071
33473,,4p-sbcoss4mj,30036,30037,60073
33474,,tj7x_pis3z8j,30037,30038,60075
33475,,omq0lh3l9kgj,30038,30039,60077
33476,,arhxkdbbsg8j,30039,30040,60079
33477,,smtc_d3fbycj,30040,30041,60081
33478,,mi1nsimirdsj,30041,30042,60083
33479,,5hstpubtz1qj,30042,30043,60085
33480,,vaech73ln1gj,30043,30044,60087
33481,,6sxhs10fl6yj,30044,30045,60089
33482,,oxtd748vmwmj,30045,30046,60091
33483,,0sjmezmyleij,30046,30047,60093
33484,,ctllw60q1roj,30047,30048,60095
33485,,xhhcpboyydcj,30048,30049,60097
33486,,sadehfwalwij,30049,30050,60099
33487,,vf1vdno5x44j,30050,30051,60101
33488,,url:http://www.csa.com/partners/viewrecord.php3frequester3dgs26collection3dtrd26recid3d9011720447md26recid3d9010g2d0341ed,30051,30052,60103
33489,,pxxjq7cgds0j,30052,30053,60105
33490,,url:http://doi.wiley.com/10.1002/tl.156,30053,30054,60107
33491,,ioi9xj3lfmsj,30054,30055,60109
33492,,ip5tz_n2kxyj,30055,30056,60111
33493,,7oln-cbh_jsj,30056,30057,60113
33494,,5vr8c6g8dnoj,30057,30058,60115
33495,,bool9d4dqykj,30058,30059,60117
33496,,sk7diwcszrwj,30059,30060,60119
33497,,zvkfasipk0qj,30060,30061,60121
33498,,0fzb1bvpceij,30061,30062,60123
33499,,kf6qaztpz0sj,30062,30063,60125
33500,,mufaf2zoliwj,30063,30064,60127
33501,,pcb-vha0h50j,30064,30065,60129
33502,,9zdjzsv3mcej,30065,30066,60131
33503,,fqe6cxyv12kj,30066,30067,60133
33504,,b9ys_2rwcraj,30067,30068,60135
33505,,3u4lpko7yhuj,30068,30069,60137
33506,,0nvfx32tmxuj,30069,30070,60139
33507,,afqrsfpme-aj,30070,30071,60141
33508,,w34jqquum84j,30071,30072,60143
33509,,dzna2zymdzsj,30072,30073,60145
33510,,r98jdz0ybwaj,30073,30074,60147
33511,,8wpri_dzzj8j,30074,30075,60149
33512,,1mnqdixpwy8j,30075,30076,60151
33513,,zw2_ecmatn4j,30076,30077,60153
33514,,i8nz3gxgd0kj,30077,30078,60155
33515,,fj8scacsxwgj,30078,30079,60157
33516,,nsm3vitkxnuj,30079,30080,60159
33517,,sjzjkn72jacj,30080,30081,60161
33518,,iz49d5-o6zqj,30081,30082,60163
33519,,3az3z1gx6ogj,30082,30083,60165
33520,,ui74scor9qij,30083,30084,60167
33521,,r3cj8epktiqj,30084,30085,60169
33522,,yo8wmh4_etqj,30085,30086,60171
33523,,url:http://www.csa.com/partners/viewrecord.php3frequester3dgs26collection3dtrd26recid3d155932ws26recid3d199301550066md,30086,30087,60173
33524,,paf9ukslpjej,30087,30088,60175
33525,,tce4vg0crm8j,30088,30089,60177
33526,,fvkbpltbfjgj,30089,30090,60179
33527,,oogwb7uhv5oj,30091,30092,60183
33528,,hm29iifz_lmj,30092,30093,60185
33529,,ocxpkujzakaj,30093,30094,60187
33530,,lzae3r3rxbsj,30094,30095,60189
33531,,2xg1tjwh2myj,30095,30096,60191
33532,,_sf3fsagxrmj,30096,30097,60193
33533,,vdyxol8ka1cj,30098,30099,60197
33534,,jumzux26it0j,30099,30100,60199
33535,,url:http://links.jstor.org/sici3fsici3d0146-4949(196221252f22)3253a2253c79253a2522catlc253e2.0.co253b2-2523,30100,30101,60201
33536,,lhboyyb7tt0j,30101,30102,60203
33537,,9oaba_el3smj,30102,30103,60205
33538,,url:http://www.csa.com/partners/viewrecord.php3frequester3dgs26collection3denv26recid3d7703829,30103,30104,60207
33539,,ptsgpdqi28gj,30104,30105,60209
33540,,oyyqxhse6goj,30105,30106,60211
33541,,jvk95-isli8j,30106,30107,60213
33542,,sxmwjgsisaqj,30107,30108,60215
33543,,url:http://www.springerlink.com/index/k3tx565702123283.pdf,30108,30109,60217
33544,,ycnz-qsgj9kj,30109,30110,60219
33545,,tkaemuhge9cj,30110,30111,60221
33546,,yga6nwbywbyj,30111,30112,60223
33547,,pzntygjih7uj,30112,30113,60225
33548,,l4diwiv_rxaj,30113,30114,60227
33549,,fu-uq4hu8qsj,30114,30115,60229
33550,,8oskvvqzz58j,30115,30116,60231
33551,,se8mlcscwgkj,30116,30117,60233
33552,,_97ctemkznmj,30117,30118,60235
33553,,idl8hzavxloj,30118,30119,60237
33554,,poutz1rrj6kj,30119,30120,60239
33555,,hya1wnxociqj,30120,30121,60241
33556,,hwasva3yat4j,30121,30122,60243
33557,,rbur1vu0hlij,30122,30123,60245
33558,,o3fwciyn00mj,30123,30124,60247
33559,,__zs2kleijcj,30124,30125,60249
33560,,_tmiejvqhjwj,30125,30126,60251
33561,,qp2znceifn4j,30126,30127,60253
33562,,zxomsyd8-k0j,30127,30128,60255
33563,,qwvivilc-n0j,30128,30129,60257
33564,,v_opv9u2c9aj,30129,30130,60259
33565,,39fq_vw6wo0j,30130,30131,60261
33566,,gu5invvxbewj,30131,30132,60263
33567,,w61skflio3aj,30132,30133,60265
33568,,6pd0rgfn9auj,30133,30134,60267
33569,,nhf4-5y0et4j,30134,30135,60269
33570,,tulkxfc-29ej,30135,30136,60271
33571,,yvq1dlpqehuj,30136,30137,60273
33572,,qyrqfracrdgj,30137,30138,60275
33573,,i-yhgaxp9oqj,30139,30140,60279
33574,,stg3rdvxqzqj,30140,30141,60281
33575,,url:http://portal.acm.org/ft_gateway.cfm3fid3d13029726type3dpdf26dl3dportal26dl3dacm26cfid3d1111111126cftoken3d2222222,30141,30142,60283
33576,,v1tjybp-ejqj,30142,30143,60285
33577,,rp9c9l1jd1wj,30143,30144,60287
33578,,,30144,30145,60289
33579,,4dftqeb6wusj,30145,30146,60291
33580,,xsh41e_hdcwj,30146,30147,60293
33581,,n586m0atkeij,30147,30148,60295
33582,,dze1_txlgrij,30148,30149,60297
33583,,23k90orfbbsj,30149,30150,60299
33584,,oro_t8cek2wj,30150,30151,60301
33585,,jawnpugh5zaj,30151,30152,60303
33586,,url:http://adsabs.harvard.edu/abs/1995mit..rept.....j,30152,30153,60305
33587,,w3hwj-zcnakj,30153,30154,60307
33588,,ibohwly4zmij,30155,30156,60311
33589,,ycj2vyhpx3ij,30156,30157,60313
33590,,_mfspylusimj,30157,30158,60315
33591,,vk_oxoan-yoj,30159,30160,60319
33592,,7zdured14q0j,30160,30161,60321
33593,,url:http://links.jstor.org/sici3fsici3d0146-4949(196624252f21)7253a1253c76253afkaws253e2.0.co253b2-g,30161,30162,60323
33594,,ng0azre-vaij,30162,30163,60325
33595,,nuzkpw8dbboj,30163,30164,60327
33596,,ukyoprbaplej,30164,30165,60329
33597,,eiv0xxsonaqj,30165,30166,60331
33598,,1ytpccczhc8j,30166,30167,60333
33599,,ulorz-0pyyij,30167,30168,60335
33600,,url:http://portal.acm.org/citation.cfm3fid3d24588826dl3dacm26coll3dportal26cfid3d1111111126cftoken3d2222222,30168,30169,60337
33601,,fczrruzyv9ej,30169,30170,60339
33602,,vb6j8i9kbfwj,30170,30171,60341
33603,,epdcmt3lpcqj,30171,30172,60343
33604,,25s8-hyk6ruj,30172,30173,60345
33605,,87nt3sekzjsj,30173,30174,60347
33606,,url:http://portal.acm.org/citation.cfm3fid3d983070.98307326coll3dguide26dl3dacm26idx3dj68926part3dperiodical26wanttype3dperiodical26title3dacm2520sigmod2520record26cfid3d1111111126cftoken3d2222222,30174,30175,60349
33607,,lezkwyurcpkj,30175,30176,60351
33608,,url:http://adsabs.harvard.edu/abs/1979phdt........52r,30176,30177,60353
33609,,lfv1pmbvn2ej,30177,30178,60355
33610,,m662akgovoaj,30178,30179,60357
33611,,3hwtd1sh2kqj,30180,30181,60361
33612,,krbr-djgevaj,30181,30182,60363
33613,,j-kbeikvdcaj,30182,30183,60365
33614,,mzrzii5ts7ij,30183,30184,60367
33615,,3wp_hjxml34j,30184,30185,60369
33616,,gqo8pbzvmygj,30185,30186,60371
33617,,vxk9rjogibej,30186,30187,60373
33618,,6pmaiaiekmaj,30187,30188,60375
33619,,s-zyhelcqwaj,30188,30189,60377
33620,,f6v6uibdmfsj,30189,30190,60379
33621,,djw1g3pahecj,30190,30191,60381
33622,,sbpwxgquumij,30191,30192,60383
33623,,5ynl6k2osxcj,30192,30193,60385
33624,,8v8blrquqf8j,30193,30194,60387
33625,,lwl_xkhfqycj,30194,30195,60389
33626,,aao_e6mafiwj,30195,30196,60391
33627,,yjbug2wl4cqj,30196,30197,60393
33628,,bq0nc7yzhs0j,30197,30198,60395
33629,,_gbre2d8leej,30198,30199,60397
33630,,2unwt-xvaxsj,30199,30200,60399
33631,,qysoox4e1noj,30200,30201,60401
33632,,qoe1xucor6mj,30201,30202,60403
33633,,nuzvnqqbmryj,30202,30203,60405
33634,,by3kolb1kruj,30203,30204,60407
33635,,qesb6yom8zej,30204,30205,60409
33636,,78f75lvtkruj,30205,30206,60411
33637,,lpw558rrthwj,30206,30207,60413
33638,,joxj3zrqp4wj,30207,30208,60415
33639,,ce88r1zl67wj,30208,30209,60417
33640,,iar7iinupykj,30209,30210,60419
33641,,5sa4osfwxnyj,30210,30211,60421
33642,,texj0kyr8vmj,30211,30212,60423
33643,,ridccbdo0_gj,30212,30213,60425
33644,,dbw1gve2u5uj,30213,30214,60427
33645,,m8iluruzqwsj,30214,30215,60429
33646,,74t7dmfyhzuj,30215,30216,60431
33647,,3kl6n3m-qboj,30216,30217,60433
33648,,nufhc9syansj,30217,30218,60435
33649,,zcwsqho5_pyj,30218,30219,60437
33650,,zxoi0zd8jeij,30219,30220,60439
33651,,ukmrwci_mrcj,30220,30221,60441
33652,,bjtngkw6l3kj,30221,30222,60443
33653,,2f7-isogcpcj,30223,30224,60447
33654,,qmrgotosjn0j,30224,30225,60449
33655,,mlo3q_6ll1sj,30225,30226,60451
33656,,0uwdqegqyqgj,30226,30227,60453
33657,,cezl-z0cnuwj,30227,30228,60455
33658,,zilw4fwf36sj,30228,30229,60457
33659,,1r-a2apzxuuj,30229,30230,60459
33660,,6pk8u2ahrrqj,30230,30231,60461
33661,,l1npupufsmcj,30231,30232,60463
33662,,ayovagq1wyqj,30232,30233,60465
33663,,4rrcivmo9iij,30233,30234,60467
33664,,mwr-zox4iawj,30234,30235,60469
33665,,jpi8bvhj9kcj,30235,30236,60471
33666,,nj1oikaaipyj,30236,30237,60473
33667,,q0jwux3au0mj,30237,30238,60475
33668,,coflvpq_vqcj,30238,30239,60477
33669,,,30239,30240,60479
33670,,tiutz_ve_emj,30240,30241,60481
33671,,ltu6qktcowkj,30241,30242,60483
33672,,h2t0arjnajgj,30242,30243,60485
33673,,urdgvnlw15ej,30243,30244,60487
33674,,t-gydnj6ugyj,30244,30245,60489
33675,,7xfjllm7z_sj,30245,30246,60491
33676,,fbixuu5fgawj,30246,30247,60493
33677,,aytl1gimookj,30247,30248,60495
33678,,gxyn9cxgsiqj,30248,30249,60497
33679,,oforceoi2iyj,30249,30250,60499
33680,,pd4rtzyng4qj,30250,30251,60501
33681,,bgdfoa4l9qij,30251,30252,60503
33682,,evoslmjhs3ej,30252,30253,60505
33683,,jto5cvku0k0j,30253,30254,60507
33684,,mzrhkh61bxcj,30254,30255,60509
33685,,url:http://portal.acm.org/ft_gateway.cfm3fid3d102767626type3dpdf,30255,30256,60511
33686,,gv_vriv3wt0j,30256,30257,60513
33687,,zjycplupl4ij,30257,30258,60515
33688,,kt8ksseunv4j,30258,30259,60517
33689,,0vfsjxq-y6ej,30259,30260,60519
33690,,secy3gkewngj,30260,30261,60521
33691,,romgq2czr-kj,30261,30262,60523
33692,,4hfo6nh5rxyj,30262,30263,60525
33693,,gxvi54gvoegj,30263,30264,60527
33694,,ltcg8lmuyzij,30264,30265,60529
33695,,pnredinlsl0j,30265,30266,60531
33696,,lt5tphugd9aj,30266,30267,60533
33697,,7-tja0p3ohoj,30267,30268,60535
33698,,j0k5ef6n0wij,30268,30269,60537
33699,,mqu247rrjxsj,30269,30270,60539
33700,,jurxtwp_ue8j,30270,30271,60541
33701,,49mbv5up5acj,30271,30272,60543
33702,,cwu6kjdyjk4j,30272,30273,60545
33703,,url:http://portal.acm.org/ft_gateway.cfm3fid3d108371226type3dpdf,30273,30274,60547
33704,,c7jakawvz-cj,30274,30275,60549
33705,,6rd5pscsuy8j,30276,30277,60553
33706,,doxl2frql0mj,30277,30278,60555
33707,,ugi8gwontksj,30278,30279,60557
33708,,cqbnc79ttbsj,30279,30280,60559
33709,,q2tvcu4bsegj,30280,30281,60561
33710,,ybrgkohoqokj,30281,30282,60563
33711,,url:http://portal.acm.org/citation.cfm3fid3d983038.98303926coll3dguide26dl3dacm26idx3dj68926part3dperiodical26wanttype3dperiodical26title3dacm2520sigmod2520record26cfid3d1111111126cftoken3d2222222,30282,30283,60565
33712,,7zbo8fa_ayyj,30283,30284,60567
33713,,itvphygybzaj,30284,30285,60569
33714,,orxs8f8kqcqj,30285,30286,60571
33715,,hkawtm0bmoej,30286,30287,60573
33716,,n5rwlna4p7sj,30287,30288,60575
33717,,kzbrqho_tuej,30288,30289,60577
33718,,qhvo-tw-ukgj,30289,30290,60579
33719,,g3g41ewnorkj,30290,30291,60581
33720,,03z5ijhl2mgj,30291,30292,60583
33721,,baolftiw5t4j,30292,30293,60585
33722,,9t4mce85ht4j,30293,30294,60587
33723,,0ew2or9fojkj,30294,30295,60589
33724,,5ao36xje30aj,30295,30296,60591
33725,,url:http://portal.acm.org/citation.cfm3fid3d362084.36209126dl3dguide26dl3dacm26idx3dj68926part3dperiodical26wanttype3dperiodical26title3dacm2520sigmod2520record26cfid3d1111111126cftoken3d2222222,30296,30297,60593
33726,,gycwx2e-mkoj,30297,30298,60595
33727,,rvouv45qxasj,30298,30299,60597
33728,,url:http://portal.acm.org/ft_gateway.cfm3fid3d76981526type3dhtml26dl3dguide26dl3dacm26cfid3d1111111126cftoken3d2222222,30299,30300,60599
33729,,igc9ruge3eoj,30300,30301,60601
33730,,wdpcdbqwt1cj,30301,30302,60603
33731,,ywthfsu8-cmj,30302,30303,60605
33732,,ej8_p3bzi8sj,30303,30304,60607
33733,,jdzoctclel4j,30304,30305,60609
33734,,t07melvrsn0j,30306,30307,60613
33735,,umehzp-tm_qj,30307,30308,60615
33736,,url:http://doi.wiley.com/10.1002/he.10608,30308,30309,60617
33737,,gpomusisz6wj,30309,30310,60619
33738,,jmlaj5r_kc4j,30310,30311,60621
33739,,xwasbziv-yuj,30311,30312,60623
33740,,9h2pmuth7muj,30312,30313,60625
33741,,rdqk0rdegvoj,30314,30315,60629
33742,,n7dtwdrb11cj,30315,30316,60631
33743,,uf4ofdo1bukj,30316,30317,60633
33744,,tjc6rwvcdmaj,30317,30318,60635
33745,,akh41zgloowj,30318,30319,60637
33746,,hbd44tqn70oj,30319,30320,60639
33747,,nzqwokfjweej,30320,30321,60641
33748,,y_1tpfqmdmij,30321,30322,60643
33749,,f-eldetd-ssj,30322,30323,60645
33750,,3xkenbvzbnqj,30323,30324,60647
33751,,3unrjjqowcij,30324,30325,60649
33752,,qs8ha_-_uymj,30325,30326,60651
33753,,hiwuww1puxcj,30326,30327,60653
33754,,fziau5xqeo4j,30327,30328,60655
33755,,-0_riirq1iij,30328,30329,60657
33756,,cfjgku0tw_sj,30329,30330,60659
33757,,khacqibqznyj,30330,30331,60661
33758,,qk2gebyyedgj,30331,30332,60663
33759,,cxkiw_5-4mqj,30332,30333,60665
33760,,6hgdatqwtnwj,30333,30334,60667
33761,,3addyuq_xxoj,30334,30335,60669
33762,,3npvkd6vsruj,30335,30336,60671
33763,,wjg_sycysosj,30336,30337,60673
33764,,uocfhnyrx6wj,30337,30338,60675
33765,,b8molkcvms4j,30339,30340,60679
33766,,_77jqet3lqgj,30340,30341,60681
33767,,dofxvzdlehgj,30341,30342,60683
33768,,p04qcwpyymaj,30342,30343,60685
33769,,_s99ssbpggij,30343,30344,60687
33770,,n-wwb-bnon4j,30344,30345,60689
33771,,tkis3uync3wj,30345,30346,60691
33772,,rhxtoqahq4gj,30346,30347,60693
33773,,url:http://portal.acm.org/ft_gateway.cfm3fid3d110193826type3dpdf,30348,30349,60697
33774,,sfqpeft79pkj,30349,30350,60699
33775,,mow81hpmqa0j,30350,30351,60701
33776,,59vfo0wrdlkj,30351,30352,60703
33777,,ys4bp68983sj,30352,30353,60705
33778,,rbrkrg_34lij,30353,30354,60707
33779,,o5-6yvoxpokj,30354,30355,60709
33780,,1fs-qn_sdh4j,30355,30356,60711
33781,,kfzthocml-ej,30356,30357,60713
33782,,4lruncu4hkoj,30357,30358,60715
33783,,ihnkxswtotij,30358,30359,60717
33784,,sjaygv723ysj,30360,30361,60721
33785,,xskomexpwy8j,30361,30362,60723
33786,,9k9zp2uupmqj,30362,30363,60725
33787,,c2m6wqdssiwj,30363,30364,60727
33788,,hlit3v_uxbmj,30364,30365,60729
33789,,ycxvp7thbtsj,30365,30366,60731
33790,,_7vs4wsyyqyj,30366,30367,60733
33791,,uxrhhlgg7lij,30367,30368,60735
33792,,xlyfgjg_foij,30368,30369,60737
33793,,xtfmz9y6gpqj,30369,30370,60739
33794,,dn2vfny0oecj,30370,30371,60741
33795,,zc9wcby28nej,30371,30372,60743
33796,,nvdrcpn3qe0j,30373,30374,60747
33797,,lnhnvcdluxqj,30374,30375,60749
33798,,jqjbnipfffuj,30375,30376,60751
33799,,blafhhbvv-0j,30376,30377,60753
33800,,02hy-g02exsj,30377,30378,60755
33801,,yovyqzr5e7kj,30378,30379,60757
33802,,bynun8gqrbwj,30379,30380,60759
33803,,3ier_j-1ynij,30380,30381,60761
33804,,ae-_nqdjoboj,30381,30382,60763
33805,,8h_8jlw7so8j,30382,30383,60765
33806,,url:http://www.csa.com/partners/viewrecord.php3frequester3dgs26collection3denv26recid3d7409051,30383,30384,60767
33807,,ou618g3lmm4j,30384,30385,60769
33808,,66zx6yxtqnmj,30385,30386,60771
33809,,py0wilqrpckj,30386,30387,60773
33810,,a4luwod7aeyj,30387,30388,60775
33811,,zfd-vt5bygqj,30389,30390,60779
33812,,url:http://www.csa.com/partners/viewrecord.php3frequester3dgs26collection3denv26recid3d2596966,30390,30391,60781
33813,,uueehm3ce2cj,30391,30392,60783
33814,,emwir5gffraj,30392,30393,60785
33815,,jw49qfqtutmj,30393,30394,60787
33816,,jecmetnvgggj,30394,30395,60789
33817,,und-mxyiq1qj,30395,30396,60791
33818,,jdatrjfxd9uj,30396,30397,60793
33819,,y5olw_4vtmsj,30397,30398,60795
33820,,lq2rj40jhraj,30398,30399,60797
33821,,7isxgvb8wpwj,30399,30400,60799
33822,,yrh6y29kae0j,30400,30401,60801
33823,,yiq4j72cxicj,30401,30402,60803
33824,,hkti41rewikj,30402,30403,60805
33825,,-8kwwt7zor8j,30403,30404,60807
33826,,dewypbhlk4cj,30404,30405,60809
33827,,h4movizlfwwj,30405,30406,60811
33828,,1bkjnhsgdcoj,30407,30408,60815
33829,,lqni0zkr5kyj,30408,30409,60817
33830,,url:http://www.blackwell-synergy.com/links/doi/10.1111/1475-4762.00024,30409,30410,60819
33831,,iwpv62xqrsij,30410,30411,60821
33832,,dpof3gq7ohuj,30411,30412,60823
33833,,tmdlfmlijxij,30412,30413,60825
33834,,muianl9autyj,30413,30414,60827
33835,,jngswpu0q9mj,30414,30415,60829
33836,,fuxwzbctwhoj,30415,30416,60831
33837,,i-imt_x_taqj,30416,30417,60833
33838,,tsh--sxe8c8j,30417,30418,60835
33839,,url:http://www.springerlink.com/index/wj19r6h3ejxv1104.pdf,30418,30419,60837
33840,,brwoag9x_fij,30419,30420,60839
33841,,fjm5ttie56oj,30420,30421,60841
33842,,2d3sc2xrnxsj,30421,30422,60843
33843,,cvdfz6_ojaej,30422,30423,60845
33844,,tpnaax7mwnej,30423,30424,60847
33845,,yjp9agyvenkj,30424,30425,60849
33846,,zudac6doiuyj,30425,30426,60851
33847,,egurdgiswtqj,30426,30427,60853
33848,,mupxyzarnwwj,30428,30429,60857
33849,,c95ytisgz4ej,30429,30430,60859
33850,,rbbt071uf-oj,30430,30431,60861
33851,,rszte0qoeumj,30431,30432,60863
33852,,url:http://portal.acm.org/ft_gateway.cfm3fid3d13087826type3dpdf26coll3dguide26dl3dacm26cfid3d1111111126cftoken3d2222222,30432,30433,60865
33853,,q3d_e_liqsij,30433,30434,60867
33854,,pftt9rv2omcj,30435,30436,60871
33855,,ccdzjoq4tcsj,30436,30437,60873
33856,,gcrqc4qtzbuj,30438,30439,60877
33857,,fr0smpjablmj,30439,30440,60879
33858,,1rfttkhx4puj,30440,30441,60881
33859,,rwcjnucmfqij,30441,30442,60883
33860,,jqqsmb7vaaaj,30442,30443,60885
33861,,xuuqmvbds1ij,30444,30445,60889
33862,,url:http://www.csa.com/partners/viewrecord.php3frequester3dgs26collection3dtrd26recid3d0116834ci,30445,30446,60891
33863,,nu2pq7zyotqj,30446,30447,60893
33864,,o4j3xrfoenqj,30447,30448,60895
33865,,wvyw6dvtmjoj,30448,30449,60897
33866,,iil8_638es4j,30449,30450,60899
33867,,bbjzyol9ilkj,30450,30451,60901
33868,,ndb8lepl0vej,30451,30452,60903
33869,,ucnsw7pizu4j,30452,30453,60905
33870,,afwnrjidtqyj,30453,30454,60907
33871,,uq4vxf5kczmj,30454,30455,60909
33872,,qz09u4dt_kij,30455,30456,60911
33873,,brp_jv_skdoj,30456,30457,60913
33874,,jrxkhwbrmn8j,30457,30458,60915
33875,,p7vmu5rzpbmj,30458,30459,60917
33876,,r2yzkby-pkwj,30459,30460,60919
33877,,tfofgeaurr4j,30460,30461,60921
33878,,url:http://portal.acm.org/ft_gateway.cfm3fid3d109973926type3dpdf,30461,30462,60923
33879,,0ek2opeeouqj,30462,30463,60925
33880,,i9frasnmyeqj,30463,30464,60927
33881,,jqwgi4bhgqkj,30464,30465,60929
33882,,lqel9mlmy4aj,30465,30466,60931
33883,,xr84fxaazjcj,30466,30467,60933
33884,,dckq15w_zfqj,30467,30468,60935
33885,,dhybgbokayej,30468,30469,60937
33886,,qf3qzxi1gxej,30469,30470,60939
33887,,kgbuafe_0dmj,30470,30471,60941
33888,,ofv6boeimr4j,30471,30472,60943
33889,,_hmyi_fef1ej,30472,30473,60945
33890,,urq-uz7vyxmj,30473,30474,60947
33891,,3e0kbh8-nwwj,30474,30475,60949
33892,,gu2kvstjxx0j,30475,30476,60951
33893,,2ciqd4jybtgj,30476,30477,60953
33894,,csodqmg8jsuj,30477,30478,60955
33895,,wobvoyodn5sj,30478,30479,60957
33896,,gstq8-r1uamj,30479,30480,60959
33897,,m6con4v4nrkj,30480,30481,60961
33898,,sckdkeet1qij,30481,30482,60963
33899,,d7wr-a2pscej,30482,30483,60965
33900,,xfvlmuwlgpoj,30483,30484,60967
33901,,ctdpt1x-0g8j,30484,30485,60969
33902,,upnlxp9wpkuj,30485,30486,60971
33903,,sr2nkhzcruwj,30486,30487,60973
33904,,nibfguikx7mj,30487,30488,60975
33905,,bckiu6bvzfkj,30488,30489,60977
33906,,url:http://www.csa.com/partners/viewrecord.php3frequester3dgs26collection3dtrd26recid3d0835520ci,30489,30490,60979
33907,,lwpkvo7psecj,30490,30491,60981
33908,,k6woiog-ogsj,30491,30492,60983
33909,,32-nia0te9mj,30492,30493,60985
33910,,sxhsobnl-tsj,30493,30494,60987
33911,,6ylbb6ww3ycj,30494,30495,60989
33912,,ymptuo1vhu8j,30495,30496,60991
33913,,bxjbgqfbbj4j,30496,30497,60993
33914,,rxx3kyg5pjyj,30497,30498,60995
33915,,6bdrsitmcmmj,30498,30499,60997
33916,,url:http://www.csa.com/partners/viewrecord.php3frequester3dgs26collection3dtrd26recid3dn9227496ah,30499,30500,60999
33917,,197skbtv91sj,30500,30501,61001
33918,,2pwwkxequmoj,30501,30502,61003
33919,,vj0xg03fcuqj,30502,30503,61005
33920,,n0vjfenx8i0j,30503,30504,61007
33921,,gqg6okzxk1qj,30504,30505,61009
33922,,q2xrxhed-aaj,30505,30506,61011
33923,,8iszty5jtwaj,30506,30507,61013
33924,,,30507,30508,61015
33925,,io8xhe7hfnaj,30508,30509,61017
33926,,m_8zvbt1tsij,30509,30510,61019
33927,,xfodp9bxo_4j,30510,30511,61021
33928,,qhillrogas0j,30511,30512,61023
33929,,url:http://doi.wiley.com/10.1002/tl.79,30512,30513,61025
33930,,h0sblxr3xqkj,30513,30514,61027
33931,,qtzpewlizsyj,30514,30515,61029
33932,,hhklynupzw0j,30515,30516,61031
33933,,ha9qzdeidagj,30516,30517,61033
33934,,tfvv7qtuniej,30517,30518,61035
33935,,bbeft23fhakj,30518,30519,61037
33936,,3qgay7vszdmj,30519,30520,61039
33937,,qkenv8btaaqj,30520,30521,61041
33938,,tf9zhfljrbcj,30521,30522,61043
33939,,g6vd1gqtj5ej,30522,30523,61045
33940,,7pf82qpuhf0j,30523,30524,61047
33941,,yzyhgjuzpiwj,30524,30525,61049
33942,,qam9l0sf8eej,30525,30526,61051
33943,,pwzc1lxi-0uj,30526,30527,61053
33944,,url:http://portal.acm.org/ft_gateway.cfm3fid3d18156026type3dpdf26coll3dguide26dl3dacm26cfid3d1111111126cftoken3d2222222,30527,30528,61055
33945,,5xvyljzb-b8j,30528,30529,61057
33946,,nt4h9onsfhaj,30529,30530,61059
33947,,rf1sz80vdrkj,30530,30531,61061
33948,,zumidtbskiej,30531,30532,61063
33949,,x1tt6vvubhkj,30532,30533,61065
33950,,qhhiznwem3wj,30533,30534,61067
33951,,keoexd9f3iqj,30534,30535,61069
33952,,xrgmouklv9uj,30535,30536,61071
33953,,6ez7ypcs4f0j,30536,30537,61073
33954,,b40qqokrkjkj,30537,30538,61075
33955,,ylocc2itqokj,30538,30539,61077
33956,,kp2snzqojpwj,30539,30540,61079
33957,,dkbcsacvitsj,30540,30541,61081
33958,,hfuj-rkwlpmj,30541,30542,61083
33959,,2yrc2_wmajoj,30542,30543,61085
33960,,h6-940ugigij,30543,30544,61087
33961,,azv4dkw3rrkj,30544,30545,61089
33962,,gtscxnn4mvaj,30545,30546,61091
33963,,ib1l5irtndaj,30546,30547,61093
33964,,ggi1y0ojax0j,30547,30548,61095
33965,,v6cthz2mff8j,30548,30549,61097
33966,,wpglmftnqqyj,30549,30550,61099
33967,,_ovqwqxl8q8j,30550,30551,61101
33968,,9wcx75opddsj,30551,30552,61103
33969,,gy6urumkia4j,30552,30553,61105
33970,,5c8itqi7y2yj,30553,30554,61107
33971,,rsi8zewaqa4j,30554,30555,61109
33972,,twelemdufemj,30555,30556,61111
33973,,vasfk2awl1ij,30556,30557,61113
33974,,s1mpixzuybyj,30557,30558,61115
33975,,bihsdb8of1mj,30558,30559,61117
33976,,url:http://www.csa.com/partners/viewrecord.php3frequester3dgs26collection3dtrd26recid3d1106837ci,30559,30560,61119
33977,,oqksxr6k72uj,30560,30561,61121
33978,,ivoawjcdggkj,30561,30562,61123
33979,,pkarsh_y6tej,30562,30563,61125
33980,,jyvbbxlv-smj,30563,30564,61127
33981,,v_cvwal33ycj,30564,30565,61129
33982,,apb-m57jyt8j,30565,30566,61131
33983,,tynovhnjfb0j,30566,30567,61133
33984,,u9s4ama4fooj,30567,30568,61135
33985,,url:http://portal.acm.org/ft_gateway.cfm3fid3d109956126type3dpdf,30568,30569,61137
33986,,rxfqvmsq_xwj,30569,30570,61139
33987,,bnv7r8k83xsj,30570,30571,61141
33988,,vlksqptm_gcj,30571,30572,61143
33989,,xqnhykgar_gj,30572,30573,61145
33990,,nspzje-tiyaj,30573,30574,61147
33991,,pky_dtb8mkaj,30574,30575,61149
33992,,im34ahidln8j,30575,30576,61151
33993,,1dv_hygrr34j,30576,30577,61153
33994,,irpltuswmtgj,30577,30578,61155
33995,,_shuu6sts6qj,30579,30580,61159
33996,,vqoaj_rflnij,30580,30581,61161
33997,,f1tg8rfssecj,30581,30582,61163
33998,,her1rh2uelwj,30582,30583,61165
33999,,url:http://links.jstor.org/sici3fsici3d0146-4949(196023)1253a3253c22253arw(asc253e2.0.co253b2-a,30583,30584,61167
34000,,zmhkvq-bksaj,30584,30585,61169
34001,,03nbstdehncj,30585,30586,61171
34002,,url:http://doi.wiley.com/10.1002/ace.126,30586,30587,61173
34003,,zz4fkbvv_muj,30587,30588,61175
34004,,wgfivfvs0vgj,30588,30589,61177
34005,,fyt_brlrehaj,30589,30590,61179
34006,,z2qsy4hcnbwj,30590,30591,61181
34007,,bo2bvkwygt4j,30591,30592,61183
34008,,url:http://portal.acm.org/ft_gateway.cfm3fid3d110118326type3dpdf,30592,30593,61185
34009,,url:http://portal.acm.org/ft_gateway.cfm3fid3d109964826type3dpdf,30593,30594,61187
34010,,ki5exxjigpgj,30594,30595,61189
34011,,ldoyuwdeab8j,30595,30596,61191
34012,,vyyx5h5ndeuj,30596,30597,61193
34013,,np7tvejmacoj,30597,30598,61195
34014,,url:http://doi.wiley.com/10.1002/he.145,30598,30599,61197
34015,,ws8owqv8ztaj,30599,30600,61199
34016,,5q7nsyrpl8yj,30600,30601,61201
34017,,kgw_i8sbic0j,30601,30602,61203
34018,,xvhco2jf6ymj,30602,30603,61205
34019,,url:http://www.csa.com/partners/viewrecord.php3frequester3dgs26collection3dtrd26recid3da8622908ah,30603,30604,61207
34020,,uzip8fkl5woj,30605,30606,61211
34021,,phcdcjqrd6ij,30606,30607,61213
34022,,s8980hxzdukj,30607,30608,61215
34023,,szivkspuic8j,30608,30609,61217
34024,,9awzcg_pyxuj,30609,30610,61219
34025,,7ud77lsums8j,30610,30611,61221
34026,,gqzcxxw4lf8j,30611,30612,61223
34027,,gl4wen8pxcoj,30612,30613,61225
34028,,y6grmacr74yj,30613,30614,61227
34029,,prdqvbxw3f4j,30614,30615,61229
34030,,y_u_qs1fbjoj,30615,30616,61231
34031,,f53-jdfblbwj,30616,30617,61233
34032,,kw2k33qgqz0j,30617,30618,61235
34033,,p4ilr9shz5ej,30618,30619,61237
34034,,amu1ueofrzsj,30619,30620,61239
34035,,h8ykchubg3kj,30620,30621,61241
34036,,c2lileuiszqj,30621,30622,61243
34037,,mcc7dkr8yeoj,30622,30623,61245
34038,,ev-hgbw6ru0j,30623,30624,61247
34039,,pb0kjy-fblij,30624,30625,61249
34040,,vviikp7rngcj,30625,30626,61251
34041,,url:http://www.ingentaconnect.com/content/pep/jae/2003/00000217/00000008/art00004,30626,30627,61253
34042,,xub-ii-jqpuj,30627,30628,61255
34043,,nfeybzjf0lgj,30628,30629,61257
34044,,ut1909mouasj,30629,30630,61259
34045,,p5oqsib9_psj,30630,30631,61261
34046,,zitpgnuveyoj,30631,30632,61263
34047,,2mfjomr3suqj,30632,30633,61265
34048,,yrcxca3nuwgj,30633,30634,61267
34049,,xf-xpo-wicsj,30634,30635,61269
34050,,krpe5vlmtp8j,30635,30636,61271
34051,,x8rxanxzexgj,30636,30637,61273
34052,,s-mwjzwmkbej,30637,30638,61275
34053,,nxxs51zpsgqj,30638,30639,61277
34054,,uwrewt_c-hkj,30639,30640,61279
34055,,yxusqhxbma0j,30640,30641,61281
34056,,jimks9d5jrqj,30641,30642,61283
34057,,zrsgwaiijfaj,30642,30643,61285
34058,,mrgoviycaroj,30643,30644,61287
34059,,h0orocyzofyj,30644,30645,61289
34060,,l3dkeoj-xncj,30645,30646,61291
34061,,obilfkmx_0mj,30646,30647,61293
34062,,,30647,30648,61295
34063,,ijkx0izpd-sj,30648,30649,61297
34064,,jrabyjref_aj,30649,30650,61299
34065,,url:http://portal.acm.org/ft_gateway.cfm3fid3d110135526type3dpdf,30650,30651,61301
34066,,wdmkvkshq48j,30651,30652,61303
34067,,2doqs2eo8loj,30652,30653,61305
34068,,2z3i7xitwnij,30653,30654,61307
34069,,hbn1zbneavkj,30654,30655,61309
34070,,xobz58atbw8j,30655,30656,61311
34071,,jegz1u3jq6kj,30656,30657,61313
34072,,xsa791ukxfsj,30657,30658,61315
34073,,ubrej6p9-58j,30658,30659,61317
34074,,yvqak_s4uw4j,30659,30660,61319
34075,,1isyo0kcqpuj,30660,30661,61321
34076,,0hd2o8tehbej,30661,30662,61323
34077,,pnj5igovyowj,30662,30663,61325
34078,,url:http://www.springerlink.com/index/wnm1533210l8k602.pdf,30663,30664,61327
34079,,2yzdyapaq1oj,30664,30665,61329
34080,,url:http://portal.acm.org/ft_gateway.cfm3fid3d106620026type3dpdf,30666,30667,61333
34081,,pgx_xr06cpkj,30667,30668,61335
34082,,sjxhtgxtm9uj,30668,30669,61337
34083,,cpsb044vguyj,30669,30670,61339
34084,,f2fcmroamtwj,30670,30671,61341
34085,,8e3jcv1cf68j,30671,30672,61343
34086,,nsvqjgqfg1qj,30672,30673,61345
34087,,rstewq1dqkyj,30673,30674,61347
34088,,mxesesgtrcmj,30674,30675,61349
34089,,_ysx5yqhcmqj,30675,30676,61351
34090,,y_uzoin20b8j,30676,30677,61353
34091,,wlg-n_ioarij,30677,30678,61355
34092,,8-rsv2a8jxkj,30678,30679,61357
34093,,zwwmbqllfv8j,30680,30681,61361
34094,,alm-rph2tpwj,30681,30682,61363
34095,,08tsxdfr0vmj,30682,30683,61365
34096,,mwzs4fyiayoj,30683,30684,61367
34097,,,30684,30685,61369
34098,,iimuzoklknej,30685,30686,61371
34099,,ue-rw_dohgoj,30686,30687,61373
34100,,qw4zsdcezoij,30687,30688,61375
34101,,url:http://www.ingentaconnect.com/search/expand3fpub3dinfobike://els/09505849/1997/00000039/00000007/art0000426unc3d,30688,30689,61377
34102,,m-bmn9lt9kcj,30689,30690,61379
34103,,url:http://doi.wiley.com/10.1002/he.94,30690,30691,61381
34104,,ioikf14iwzkj,30691,30692,61383
34105,,254cgxk0btwj,30692,30693,61385
34106,,nf0lcqnjgwmj,30693,30694,61387
34107,,eq3unmdpr04j,30694,30695,61389
34108,,bnrj8pqn5usj,30695,30696,61391
34109,,2ckpxxbnbmaj,30696,30697,61393
34110,,tp3xnwmyrrkj,30697,30698,61395
34111,,vs7xx4p-3iwj,30698,30699,61397
34112,,dkbj4rzvwl8j,30699,30700,61399
34113,,irtkba0mgesj,30700,30701,61401
34114,,ggvbktymgfkj,30701,30702,61403
34115,,hzf5oeeshlyj,30702,30703,61405
34116,,aqkq24li39cj,30703,30704,61407
34117,,2ho0b0hcqm8j,30704,30705,61409
34118,,z89oj6othj0j,30705,30706,61411
34119,,6v0hd9qrreoj,30706,30707,61413
34120,,0l2cosgkhssj,30707,30708,61415
34121,,wmqytzvz1hqj,30709,30710,61419
34122,,o34mzzrxkgsj,30710,30711,61421
34123,,b3zbcgdtgp0j,30711,30712,61423
34124,,aolzwpjevwij,30712,30713,61425
34125,,n38rtqtsitej,30713,30714,61427
34126,,hax3pazcijaj,30714,30715,61429
34127,,li3awe0ujryj,30715,30716,61431
34128,,ts4lpkzs6qcj,30716,30717,61433
34129,,om90cqvcvpmj,30717,30718,61435
34130,,u1sxuudqlusj,30718,30719,61437
34131,,4dkdeorojb0j,30719,30720,61439
34132,,_j7eguopwsuj,30720,30721,61441
34133,,l3z5iofjjj4j,30721,30722,61443
34134,,0d0tnv6dpnqj,30722,30723,61445
34135,,0mcw0z3ycw8j,30723,30724,61447
34136,,sulxxrxt2bij,30724,30725,61449
34137,,qqhf_tuq5ioj,30725,30726,61451
34138,,qpt7q8uawhmj,30726,30727,61453
34139,,movvccbfecyj,30727,30728,61455
34140,,5m8abori3qwj,30728,30729,61457
34141,,rf5mqxstn_4j,30729,30730,61459
34142,,9qjoyqhxoluj,30730,30731,61461
34143,,hsd3ueed7rej,30731,30732,61463
34144,,ls7hvls0uxuj,30732,30733,61465
34145,,wkmd4cxdk_sj,30733,30734,61467
34146,,h_g4xopuq6wj,30734,30735,61469
34147,,yh6y4xwemyuj,30735,30736,61471
34148,,bvpdtslj0kwj,30736,30737,61473
34149,,ia6grnjekeoj,30737,30738,61475
34150,,qsvjr0qnsjuj,30738,30739,61477
34151,,18hdlyynh3mj,30739,30740,61479
34152,,5vvocgfpjugj,30740,30741,61481
34153,,dv6g5os5dxsj,30741,30742,61483
34154,,nqdjvdxbunyj,30742,30743,61485
34155,,a6p2lvm8yuij,30743,30744,61487
34156,,rjtyebmokkaj,30744,30745,61489
34157,,q1k0fiklsxoj,30745,30746,61491
34158,,elkw31nm4tkj,30746,30747,61493
34159,,msvxrno5ejwj,30747,30748,61495
34160,,vb44vktgbguj,30748,30749,61497
34161,,h69oxloxbrij,30749,30750,61499
34162,,sd3yhh3yp8qj,30750,30751,61501
34163,,shj0cnwdjh8j,30751,30752,61503
34164,,bimwdlogfsij,30752,30753,61505
34165,,ugilhobnhhoj,30753,30754,61507
34166,,z-1dxhiom8ej,30754,30755,61509
34167,,url:http://doi.wiley.com/10.1002/ace.8103,30755,30756,61511
34168,,yxx8f8dyc28j,30756,30757,61513
34169,,tbc8wkvoyxyj,30757,30758,61515
34170,,2polq-odligj,30758,30759,61517
34171,,emq1-lnb-3oj,30759,30760,61519
34172,,rpestekttaaj,30760,30761,61521
34173,,d3qprd7sp_ij,30761,30762,61523
34174,,_hnlooj4-puj,30762,30763,61525
34175,,cemxivnj4yyj,30763,30764,61527
34176,,ezp7ye9vkaij,30764,30765,61529
34177,,97o0rfrhu9mj,30765,30766,61531
34178,,vixmldt9rwuj,30766,30767,61533
34179,,310zwnxnkmij,30767,30768,61535
34180,,gzp8guncotaj,30768,30769,61537
34181,,mnuzhne5ef0j,30769,30770,61539
34182,,t7_i218mjdqj,30770,30771,61541
34183,,dwtpn8iidwsj,30771,30772,61543
34184,,ubf6bt1o9omj,30772,30773,61545
34185,,qxksgwpkxtmj,30773,30774,61547
34186,,kqqmfde7qzqj,30774,30775,61549
34187,,3jb0z71c_1wj,30775,30776,61551
34188,,cxyk0bogqhwj,30776,30777,61553
34189,,oc1opodqx70j,30777,30778,61555
34190,,igfhbqriuv4j,30778,30779,61557
34191,,nzgqpbxvgyuj,30780,30781,61561
34192,,4hhmchszagwj,30781,30782,61563
34193,,kwx0caal_nmj,30782,30783,61565
34194,,1abqb-ordjyj,30783,30784,61567
34195,,gznpwkvhawmj,30784,30785,61569
34196,,wlaciq9ipj8j,30785,30786,61571
34197,,spp3jpk2ylcj,30786,30787,61573
34198,,aj5mcoqwnryj,30787,30788,61575
34199,,f6pfmaif60qj,30788,30789,61577
34200,,38-jm7hccnij,30789,30790,61579
34201,,izyeysmqko4j,30790,30791,61581
34202,,2hfdw1b0vgcj,30791,30792,61583
34203,,7sd6445hnc8j,30792,30793,61585
34204,,mdjanq6hqomj,30793,30794,61587
34205,,url:http://portal.acm.org/citation.cfm3fid3d320610.32061126dl3dguide26dl3dacm26idx3dj77726part3dperiodical26wanttype3dperiodical26title3dacm2520transactions2520on2520database2520systems2520(tods)26cfid3d1111111126cftoken3d2222222,30794,30795,61589
34206,,emlxw_1uj7ej,30795,30796,61591
34207,,url:http://portal.acm.org/citation.cfm3fid3d244220,30796,30797,61593
34208,,xbqmpeyxuhwj,30797,30798,61595
34209,,rzschblr-t8j,30798,30799,61597
34210,,iwr_lq8nrhij,30799,30800,61599
34211,,js40bxlpa2oj,30800,30801,61601
34212,,l45jr6xc8uqj,30801,30802,61603
34213,,htgmi4vyu4mj,30802,30803,61605
34214,,f8cxwrryc-ej,30803,30804,61607
34215,,tggbf96zqk0j,30804,30805,61609
34216,,uxvro9fefgoj,30805,30806,61611
34217,,h6xgrqr54m4j,30806,30807,61613
34218,,d19jkf_vqkmj,30807,30808,61615
34219,,ptghp2chqhyj,30808,30809,61617
34220,,onsde7tif40j,30809,30810,61619
34221,,rzhm_j-bicyj,30810,30811,61621
34222,,aprva4f-whsj,30811,30812,61623
34223,,g4mwc14u8m4j,30812,30813,61625
34224,,n1gvqxg5neej,30813,30814,61627
34225,,h1faqnitogoj,30814,30815,61629
34226,,url:http://portal.acm.org/citation.cfm3fid3d171926.171992,30815,30816,61631
34227,,x3yqhrvuuh4j,30816,30817,61633
34228,,aalomwvjv8ij,30817,30818,61635
34229,,rbk9oydn9twj,30818,30819,61637
34230,,8flamxkhhigj,30819,30820,61639
34231,,2lhwzb9ropej,30820,30821,61641
34232,,5j5izittdamj,30821,30822,61643
34233,,_qhdkrs4vnoj,30822,30823,61645
34234,,cfvj2kv3l4sj,30823,30824,61647
34235,,k62ewwesrkuj,30824,30825,61649
34236,,oc3-85jabgij,30825,30826,61651
34237,,f5ifiwb3wi8j,30826,30827,61653
34238,,ewnjsuii-lej,30827,30828,61655
34239,,ganuul81p1ij,30828,30829,61657
34240,,vexnrjafr8kj,30829,30830,61659
34241,,3xh1rbo3veej,30830,30831,61661
34242,,jv75v9z_mqij,30831,30832,61663
34243,,c-xaelzlj_4j,30832,30833,61665
34244,,url:http://portal.acm.org/citation.cfm3fid3d38713,30833,30834,61667
34245,,yp-0gwna-7wj,30834,30835,61669
34246,,h7libh6_jkgj,30835,30836,61671
34247,,p68l1uyvktoj,30836,30837,61673
34248,,kjb99wammfwj,30837,30838,61675
34249,,yirhubwudmgj,30838,30839,61677
34250,,3bwppf3e_kij,30839,30840,61679
34251,,ii-rsgadsdej,30840,30841,61681
34252,,2dih60_opiqj,30841,30842,61683
34253,,8-q8b0ufqk0j,30842,30843,61685
34254,,yy2prb3npbij,30843,30844,61687
34255,,g0eouulygfcj,30844,30845,61689
34256,,rdhgewcxkboj,30845,30846,61691
34257,,url:http://www.csa.com/partners/viewrecord.php3frequester3dgs26collection3dtrd26recid3dn9210504ah,30846,30847,61693
34258,,d0y2niii_r8j,30847,30848,61695
34259,,f1mtqkazfjuj,30848,30849,61697
34260,,2askuiy38vmj,30849,30850,61699
34261,,m92y7d3pzaej,30850,30851,61701
34262,,khfbq-mawisj,30851,30852,61703
34263,,47zsogazttyj,30852,30853,61705
34264,,vr1efzi9zesj,30853,30854,61707
34265,,ucdmk8xwatsj,30854,30855,61709
34266,,jtqkqgqemvej,30855,30856,61711
34267,,ls3lctc1zymj,30856,30857,61713
34268,,onuyvaetq2aj,30857,30858,61715
34269,,9olqspjpueqj,30858,30859,61717
34270,,p4owuruljy0j,30859,30860,61719
34271,,6obpcjx9qrgj,30860,30861,61721
34272,,og7nepci5jqj,30861,30862,61723
34273,,8n_ovtjlcdaj,30862,30863,61725
34274,,8p3b24dv7qqj,30863,30864,61727
34275,,ijuejwoykyij,30864,30865,61729
34276,,7iz_cijwyhwj,30865,30866,61731
34277,,n32ydw9gcvkj,30866,30867,61733
34278,,l4lzzyfbaqgj,30868,30869,61737
34279,,svomvhwmjgej,30869,30870,61739
34280,,x6i5l_xweykj,30870,30871,61741
34281,,yeph53lehouj,30871,30872,61743
34282,,esdl1h7wdy0j,30872,30873,61745
34283,,pycdja0qozaj,30873,30874,61747
34284,,zdansd89mzyj,30874,30875,61749
34285,,cfeyd7lnrfaj,30875,30876,61751
34286,,xdjnonzzlguj,30876,30877,61753
34287,,131hiudwysqj,30877,30878,61755
34288,,guhmtoukegij,30878,30879,61757
34289,,e4y44mnuvk8j,30879,30880,61759
34290,,vfrqkpx2bkmj,30880,30881,61761
34291,,lga3y25wchoj,30881,30882,61763
34292,,n5q8ky0xdhmj,30882,30883,61765
34293,,sbs4ulluzrqj,30883,30884,61767
34294,,rrogpzxbrrmj,30884,30885,61769
34295,,si779d-yqz4j,30885,30886,61771
34296,,jl_5bbgfposj,30886,30887,61773
34297,,cnuny_vrms0j,30887,30888,61775
34298,,vcurf2_de-oj,30888,30889,61777
34299,,3y6iaf8kcosj,30889,30890,61779
34300,,rjssvgcp-rcj,30890,30891,61781
34301,,ncxilj9zo3uj,30891,30892,61783
34302,,qpdcw8xlbbej,30892,30893,61785
34303,,4ugsjnvfl0uj,30893,30894,61787
34304,,v1fl2vdxv6wj,30895,30896,61791
34305,,yy0roloxj_aj,30896,30897,61793
34306,,5tmbuxdy19kj,30897,30898,61795
34307,,kxkjszl1mygj,30898,30899,61797
34308,,fhnidd9jksoj,30899,30900,61799
34309,,c_0day8stz8j,30900,30901,61801
34310,,6bbezqaud74j,30901,30902,61803
34311,,e8mibrzkrqmj,30902,30903,61805
34312,,url:http://www.csa.com/partners/viewrecord.php3frequester3dgs26collection3dtrd26recid3dn9210540ah,30903,30904,61807
34313,,kkvd8rsy_h4j,30905,30906,61811
34314,,_wbyqe_abrqj,30906,30907,61813
34315,,1s8crafhhymj,30907,30908,61815
34316,,zdquc3xfg8yj,30908,30909,61817
34317,,xytmosoiq4ij,30909,30910,61819
34318,,0f4rv7bvqr8j,30910,30911,61821
34319,,eir4rbio7hsj,30912,30913,61825
34320,,mch_krrflgcj,30913,30914,61827
34321,,fwbpk9hdgkwj,30914,30915,61829
34322,,pdnx_iutv-uj,30915,30916,61831
34323,,1nettj1lmjqj,30916,30917,61833
34324,,_fvwlfjyw44j,30918,30919,61837
34325,,ilt6mnp0rhaj,30919,30920,61839
34326,,lvumedkszpmj,30920,30921,61841
34327,,7ilvfbbcncqj,30921,30922,61843
34328,,36ulry3xq04j,30922,30923,61845
34329,,mnfqlf5km9wj,30923,30924,61847
34330,,hcjwb7vv2hej,30924,30925,61849
34331,,x3pjiss_wtcj,30925,30926,61851
34332,,afubut1w_kej,30926,30927,61853
34333,,xojsze-vegoj,30927,30928,61855
34334,,o2cgl7da2q0j,30928,30929,61857
34335,,bqm-3cp6brwj,30930,30931,61861
34336,,vrptw4-mbeoj,30931,30932,61863
34337,,d74bku_7mi4j,30932,30933,61865
34338,,pn9pqlf2bb4j,30933,30934,61867
34339,,5v96bnl4rtyj,30934,30935,61869
34340,,afzdkbeexfaj,30935,30936,61871
34341,,0wagzpncrvij,30936,30937,61873
34342,,r8-csqwpolsj,30937,30938,61875
34343,,igi6dhs0ukyj,30939,30940,61879
34344,,wlclc745w78j,30940,30941,61881
34345,,59akjz-qe9ij,30941,30942,61883
34346,,xqnxvg8fz-qj,30942,30943,61885
34347,,k222curyjnmj,30943,30944,61887
34348,,udbfc81ls0kj,30944,30945,61889
34349,,24b2ebyxaagj,30945,30946,61891
34350,,an-tom8-ghyj,30946,30947,61893
34351,,glrihowwlv0j,30947,30948,61895
34352,,zsavuw_gpjkj,30948,30949,61897
34353,,nnvecckr22yj,30949,30950,61899
34354,,pkee0n5yzk0j,30950,30951,61901
34355,,xul8tw2zc_sj,30951,30952,61903
34356,,m_bi0qpqrpwj,30952,30953,61905
34357,,url:http://portal.acm.org/ft_gateway.cfm3fid3d110195726type3dpdf,30953,30954,61907
34358,,4ndfsvzjt9qj,30954,30955,61909
34359,,xdh37ixw8n0j,30955,30956,61911
34360,,7ottd7189gsj,30956,30957,61913
34361,,tjxvuzynotyj,30957,30958,61915
34362,,wsmz8vj0dvuj,30958,30959,61917
34363,,wqkshz42_6qj,30959,30960,61919
34364,,flvvgat42kmj,30960,30961,61921
34365,,r-9mwzb_wrkj,30961,30962,61923
34366,,ln9sf_ivdngj,30962,30963,61925
34367,,chuojcukjp0j,30963,30964,61927
34368,,lx8jmagh_1qj,30964,30965,61929
34369,,e1-xa7pa8owj,30965,30966,61931
34370,,4mzjjhsrsooj,30966,30967,61933
34371,,ckl2khlvdgqj,30967,30968,61935
34372,,oy2fh5bzr3cj,30968,30969,61937
34373,,iasjb2p9g1uj,30969,30970,61939
34374,,rbsg9dtibasj,30970,30971,61941
34375,,w8t3mb1uhbqj,30971,30972,61943
34376,,j2bfslpw3t4j,30972,30973,61945
34377,,rp6fl1-csm0j,30973,30974,61947
34378,,cqsspajg6qaj,30974,30975,61949
34379,,ow5wenekwymj,30975,30976,61951
34380,,_twhixv2enmj,30976,30977,61953
34381,,ylpnb72w8uyj,30977,30978,61955
34382,,nkxtt6bqgn0j,30978,30979,61957
34383,,dphry0upqi8j,30979,30980,61959
34384,,h19xw76hkeyj,30980,30981,61961
34385,,hd8un09qzikj,30981,30982,61963
34386,,url:http://www.csa.com/partners/viewrecord.php3frequester3dgs26collection3dtrd26recid3d0424429en,30982,30983,61965
34387,,ebwq0j3m3w0j,30983,30984,61967
34388,,hfrwsh1cthuj,30984,30985,61969
34389,,n8ewz5rqancj,30985,30986,61971
34390,,epeeehzpoe4j,30986,30987,61973
34391,,qeabzopx79sj,30987,30988,61975
34392,,achof67jrp0j,30988,30989,61977
34393,,m-9jch9qgrqj,30989,30990,61979
34394,,0js2dsc0e48j,30990,30991,61981
34395,,8r21iroeckij,30991,30992,61983
34396,,c6ni0zksvusj,30992,30993,61985
34397,,url:http://www.csa.com/partners/viewrecord.php3frequester3dgs26collection3denv26recid3d8913252,30993,30994,61987
34398,,fjwd_xjnpcoj,30994,30995,61989
34399,,ks8-rodiw44j,30995,30996,61991
34400,,lcmppl8mewcj,30996,30997,61993
34401,,xwzqgt8hntmj,30997,30998,61995
34402,,4wh_t4fvveaj,30998,30999,61997
34403,,yk0aays1vpyj,30999,31000,61999
34404,,8i6ofkiuawqj,31000,31001,62001
34405,,3jypytn3qh4j,31001,31002,62003
34406,,lqvx6camozwj,31002,31003,62005
34407,,tsb5vzhbcf8j,31003,31004,62007
34408,,url:http://adsabs.harvard.edu/abs/1978phdt.........7f,31004,31005,62009
34409,,7q1a_itw674j,31005,31006,62011
34410,,klk62e-pdyaj,31006,31007,62013
34411,,dwwxmie3c7ij,31007,31008,62015
34412,,t0iy8qmxdhgj,31008,31009,62017
34413,,hipezhq5wzwj,31010,31011,62021
34414,,nidfj0eipqcj,31011,31012,62023
34415,,url:http://doi.wiley.com/10.1002/(sici)1097-0339(199707)17:1253c67::aid-dc15253e3.0.co3b2-8,31012,31013,62025
34416,,kcodbbaodn0j,31013,31014,62027
34417,,wn22xv54zzkj,31014,31015,62029
34418,,u5-jmwfrztgj,31015,31016,62031
34419,,gn5thxoouzkj,31016,31017,62033
34420,,,31017,31018,62035
34421,,lvcseluelwij,31018,31019,62037
34422,,kywyde4m00kj,31019,31020,62039
34423,,aqcc8n2hq6aj,31020,31021,62041
34424,,j0j3aps8ucyj,31021,31022,62043
34425,,ilvnunyz04sj,31022,31023,62045
34426,,uvzmrznvwqaj,31023,31024,62047
34427,,smucg_raeywj,31024,31025,62049
34428,,4c4_ahnhyywj,31025,31026,62051
34429,,f3snx_8p3mcj,31026,31027,62053
34430,,wsubag5qlf8j,31027,31028,62055
34431,,zudnegc7zyoj,31028,31029,62057
34432,,nmosprko_saj,31029,31030,62059
34433,,jbvhyt-1ghij,31030,31031,62061
34434,,0fxmyhtanloj,31031,31032,62063
34435,,thtt2lg4_z8j,31032,31033,62065
34436,,2ik42lewtq8j,31033,31034,62067
34437,,phtzh7ozdzoj,31034,31035,62069
34438,,e8yn9s5iufmj,31035,31036,62071
34439,,csou59gzgoqj,31036,31037,62073
34440,,unnepnkuz2aj,31037,31038,62075
34441,,b0jcvga7uzoj,31038,31039,62077
34442,,phvdtb89lsaj,31039,31040,62079
34443,,_rggkefp9vkj,31040,31041,62081
34444,,ep5trsliqvmj,31041,31042,62083
34445,,10fyofnrrouj,31042,31043,62085
34446,,uex6dgpm-saj,31043,31044,62087
34447,,6aawdpwgrvkj,31044,31045,62089
34448,,zhnemlbks5qj,31045,31046,62091
34449,,07dt02yx07aj,31046,31047,62093
34450,,url:http://portal.acm.org/ft_gateway.cfm3fid3d106618426type3dpdf,31047,31048,62095
34451,,nuvjplwimlaj,31048,31049,62097
34452,,rdadk-d-vqij,31049,31050,62099
34453,,vzut72sbg0gj,31050,31051,62101
34454,,xt22zb1sha8j,31051,31052,62103
34455,,url:http://www.ncbi.nlm.nih.gov/entrez/query.fcgi3fcmd3dretrieve26db3dpubmed26list_uids3d36810926dopt3dcitation,31052,31053,62105
34456,,81mdu6yckvgj,31053,31054,62107
34457,,vxjc06vscyqj,31054,31055,62109
34458,,kvittrduxjkj,31055,31056,62111
34459,,dkxx9bu2hsij,31056,31057,62113
34460,,cpsxhfmxh2cj,31057,31058,62115
34461,,tyj8a25l-mwj,31058,31059,62117
34462,,byuqob9afrcj,31059,31060,62119
34463,,g4zkmdxlwtij,31060,31061,62121
34464,,m-b0kazfbiqj,31061,31062,62123
34465,,v6tlh_pmu6ej,31062,31063,62125
34466,,qxtat4gwq8mj,31063,31064,62127
34467,,mwjln1tmrrgj,31064,31065,62129
34468,,c7e3wvhih7sj,31065,31066,62131
34469,,d4khf1g4icij,31066,31067,62133
34470,,d7smba6nj5qj,31067,31068,62135
34471,,9lgfabpg1lsj,31068,31069,62137
34472,,kxjcssga4mmj,31069,31070,62139
34473,,6jnh41odjzmj,31070,31071,62141
34474,,ckw2wo23aocj,31071,31072,62143
34475,,j02hjoo8nx8j,31072,31073,62145
34476,,vgddexzsf-8j,31073,31074,62147
34477,,f1pvhzmn_k4j,31074,31075,62149
34478,,j7mecwde3myj,31075,31076,62151
34479,,99oknsijyiij,31076,31077,62153
34480,,jhy5lnq4v18j,31077,31078,62155
34481,,c9o1rtblfg4j,31078,31079,62157
34482,,krxcblnsybuj,31079,31080,62159
34483,,tcaoiofzafij,31080,31081,62161
34484,,p7dfzns6vl8j,31082,31083,62165
34485,,27lnh5du2msj,31083,31084,62167
34486,,7uw9500pmwmj,31084,31085,62169
34487,,i76vsfi49xwj,31085,31086,62171
34488,,s_qusxuyyboj,31086,31087,62173
34489,,3pnawcig4baj,31087,31088,62175
34490,,2r6t9gezb28j,31088,31089,62177
34491,,egh6ny5ukygj,31089,31090,62179
34492,,chcd3k2ufjkj,31090,31091,62181
34493,,k8pbwr1g_ccj,31091,31092,62183
34494,,aqmbs2_wos8j,31092,31093,62185
34495,,xn2pzkchmyaj,31093,31094,62187
34496,,numtpn7ndioj,31094,31095,62189
34497,,wwg3me9l1joj,31095,31096,62191
34498,,url:http://www.ncbi.nlm.nih.gov/entrez/query.fcgi3fcmd3dretrieve26db3dpubmed26list_uids3d68270326dopt3dcitation,31096,31097,62193
34499,,4itmqir3h70j,31097,31098,62195
34500,,11jjtt5joyuj,31098,31099,62197
34501,,uikfwmstusgj,31099,31100,62199
34502,,vbmxtqow_euj,31100,31101,62201
34503,,url:http://www.csa.com/partners/viewrecord.php3frequester3dgs26collection3dtrd26recid3d0658355ci,31101,31102,62203
34504,,qbzoqc5bxhej,31102,31103,62205
34505,,qcyvv4ps73oj,31103,31104,62207
34506,,weroavsivuij,31104,31105,62209
34507,,vbsepu14zpkj,31105,31106,62211
34508,,nard9nizxuuj,31106,31107,62213
34509,,uglxyoa7quyj,31107,31108,62215
34510,,fh-wadpwnl0j,31108,31109,62217
34511,,gk8bupaflzij,31109,31110,62219
34512,,ahfqdjgu9ywj,31110,31111,62221
34513,,tu0u2si03jkj,31111,31112,62223
34514,,7vpnh22islwj,31112,31113,62225
34515,,rumkefagtiuj,31113,31114,62227
34516,,hpmrsvagcagj,31114,31115,62229
34517,,e73gkl6wvz0j,31115,31116,62231
34518,,jsng7mv0zjoj,31116,31117,62233
34519,,6llaqf_kcdgj,31117,31118,62235
34520,,tg1khsa5d_wj,31118,31119,62237
34521,,nqhighfkweoj,31120,31121,62241
34522,,slxja5ravamj,31121,31122,62243
34523,,l6uvryx9siqj,31122,31123,62245
34524,,9mo4dl8lbqmj,31123,31124,62247
34525,,wivnu-g7k24j,31124,31125,62249
34526,,9snqljdgxyyj,31125,31126,62251
34527,,q8lnjbmi8mkj,31126,31127,62253
34528,,wkggokqpvzqj,31127,31128,62255
34529,,varur-ihf2ij,31128,31129,62257
34530,,yly5os6nnjyj,31129,31130,62259
34531,,njfhk9diwr0j,31130,31131,62261
34532,,kyysdyh6dm0j,31131,31132,62263
34533,,vnfanxtgrwej,31132,31133,62265
34534,,p6h0ruzp7e8j,31133,31134,62267
34535,,bhkrpavxuwqj,31134,31135,62269
34536,,7of1hyk-vnkj,31135,31136,62271
34537,,qf8os1o2ym4j,31136,31137,62273
34538,,prwfac5npdaj,31137,31138,62275
34539,,iiodiwuuddqj,31138,31139,62277
34540,,7tbu0viuklgj,31139,31140,62279
34541,,,31140,31141,62281
34542,,lbpnxnetyswj,31141,31142,62283
34543,,ppel5kousxcj,31142,31143,62285
34544,,fmeuqmtvcdij,31143,31144,62287
34545,,g6amwnclvkwj,31144,31145,62289
34546,,3feogsgg3wqj,31145,31146,62291
34547,,kixceymty-aj,31146,31147,62293
34548,,url:http://www.springerlink.com/index/xp6t31k111537474.pdf,31147,31148,62295
34549,,x8wuackis7wj,31148,31149,62297
34550,,h3jbowb5p_kj,31149,31150,62299
34551,,ccsv2oz_pksj,31150,31151,62301
34552,,vzg-aqu2ao0j,31151,31152,62303
34553,,xrtj0wmgkkgj,31152,31153,62305
34554,,chvkfqy2zwij,31153,31154,62307
34555,,j6bnuc98vaej,31154,31155,62309
34556,,abz0ik_t8tcj,31155,31156,62311
34557,,eqelpjxiyj4j,31156,31157,62313
34558,,0bkqmofihimj,31157,31158,62315
34559,,k3jc-wk2pigj,31158,31159,62317
34560,,zgrn02uddgaj,31159,31160,62319
34561,,gma2xdcukowj,31160,31161,62321
34562,,56iifetl5myj,31161,31162,62323
34563,,iibzfoy_rfkj,31162,31163,62325
34564,,url:http://portal.acm.org/ft_gateway.cfm3fid3d108374126type3dpdf,31163,31164,62327
34565,,9k-g427m5b4j,31164,31165,62329
34566,,lnogbukpoaqj,31165,31166,62331
34567,,x1sg15xvmduj,31166,31167,62333
34568,,jnkac2v0n4yj,31167,31168,62335
34569,,astp2ryoafuj,31168,31169,62337
34570,,ddg41eyxznij,31169,31170,62339
34571,,qqjxajdyz7cj,31171,31172,62343
34572,,bxwduxdvj1sj,31172,31173,62345
34573,,c6hka5urpf8j,31173,31174,62347
34574,,qcyz3ojxznsj,31174,31175,62349
34575,,stdg6toktlkj,31175,31176,62351
34576,,fxbnnx-pfgwj,31176,31177,62353
34577,,hqrcmyswihcj,31177,31178,62355
34578,,azayaq-rcosj,31178,31179,62357
34579,,uyfghz-y4kyj,31179,31180,62359
34580,,0gzanusvenuj,31180,31181,62361
34581,,83lioj0zjcoj,31181,31182,62363
34582,,,31182,31183,62365
34583,,9bybuknsukcj,31183,31184,62367
34584,,tupnckdwaiqj,31184,31185,62369
34585,,plelyyfy1msj,31185,31186,62371
34586,,izh6zs60lwkj,31186,31187,62373
34587,,ffimx8syiz0j,31187,31188,62375
34588,,rky3tevq4kgj,31189,31190,62379
34589,,rzaejdmkuwmj,31190,31191,62381
34590,,-5fmnryiyywj,31191,31192,62383
34591,,iwcgxgaf2coj,31192,31193,62385
34592,,url:http://www.csa.com/partners/viewrecord.php3frequester3dgs26collection3dtrd26recid3d1109121ci,31193,31194,62387
34593,,wz6a6iax9bej,31194,31195,62389
34594,,kmywnsys7-uj,31195,31196,62391
34595,,1y3pex2eswcj,31196,31197,62393
34596,,url:http://portal.acm.org/citation.cfm3fid3d171926.172023,31197,31198,62395
34597,,cetfnymi9s0j,31199,31200,62399
34598,,ereiyhspfukj,31200,31201,62401
34599,,a1qw59hfwomj,31201,31202,62403
34600,,chvdze20014j,31202,31203,62405
34601,,ar1dbp7waqsj,31203,31204,62407
34602,,rz6sz4bhftcj,31204,31205,62409
34603,,wgc2g8byzrej,31206,31207,62413
34604,,bsn9nylmcxyj,31207,31208,62415
34605,,lxo9oxwthccj,31208,31209,62417
34606,,hrdzdk2bs20j,31210,31211,62421
34607,,lujkcxbl9qaj,31211,31212,62423
34608,,tyfl2xeozlaj,31212,31213,62425
34609,,a5dy9fkfqumj,31213,31214,62427
34610,,lb5o_yp7xdgj,31214,31215,62429
34611,,gzfkzpc4n9kj,31215,31216,62431
34612,,6fv-c_ab7oqj,31216,31217,62433
34613,,5vex0f_o-hkj,31217,31218,62435
34614,,lq80ib-_obcj,31218,31219,62437
34615,,3fyiolw7e8cj,31219,31220,62439
34616,,tcoxnj0mbfmj,31220,31221,62441
34617,,k-vp3xbnzhqj,31221,31222,62443
34618,,fsy-8s86jacj,31222,31223,62445
34619,,3coa4fvkzouj,31223,31224,62447
34620,,4ms85pvjuluj,31224,31225,62449
34621,,url:http://www.csa.com/partners/viewrecord.php3frequester3dgs26collection3dtrd26recid3d199306720318md,31225,31226,62451
34622,,tuxja50-l8cj,31227,31228,62455
34623,,lbysb5dhgsmj,31228,31229,62457
34624,,vtxg1ycrqlkj,31229,31230,62459
34625,,bju-8m2weloj,31230,31231,62461
34626,,yki3doclulsj,31231,31232,62463
34627,,i66ro0gjcvaj,31232,31233,62465
34628,,3hbfzigfneyj,31233,31234,62467
34629,,xjed4lcr1e8j,31234,31235,62469
34630,,gkuofymkq2uj,31235,31236,62471
34631,,mx_c_qnyibij,31236,31237,62473
34632,,i3adm8ndw9cj,31237,31238,62475
34633,,7bgmvlu9pi4j,31238,31239,62477
34634,,vpbw9jvncp0j,31239,31240,62479
34635,,2orssrpt3jej,31240,31241,62481
34636,,9nczbq9zwzij,31241,31242,62483
34637,,7buvxkcigf0j,31242,31243,62485
34638,,07tim2ebef0j,31243,31244,62487
34639,,mzttqktilnyj,31244,31245,62489
34640,,rr_52mk9f5wj,31245,31246,62491
34641,,zej055lbtnwj,31247,31248,62495
34642,,ewl4u0lset8j,31248,31249,62497
34643,,iopvwbsfefwj,31249,31250,62499
34644,,schampcdtsgj,31250,31251,62501
34645,,w2aqbq42qpyj,31251,31252,62503
34646,,mcbhkdtlkxij,31252,31253,62505
34647,,0rapx6lka_ij,31253,31254,62507
34648,,uc80glhictaj,31254,31255,62509
34649,,jfsvnfueawsj,31255,31256,62511
34650,,fhjhyet9qpoj,31256,31257,62513
34651,,l7kkxveyxzqj,31257,31258,62515
34652,,url:http://portal.acm.org/ft_gateway.cfm3fid3d102775726type3dpdf,31258,31259,62517
34653,,vrcx1ynkfisj,31259,31260,62519
34654,,3lhebv6ffz4j,31260,31261,62521
34655,,bgrv3xwyjhej,31261,31262,62523
34656,,otd_nihyv3ij,31262,31263,62525
34657,,anuzj3yt4ekj,31263,31264,62527
34658,,72mptaphf6mj,31264,31265,62529
34659,,ajtfpkxs-ycj,31265,31266,62531
34660,,zviizlde-ikj,31267,31268,62535
34661,,wmljtnvtrlkj,31268,31269,62537
34662,,x2pnkqbexvkj,31269,31270,62539
34663,,d0mos-d2suej,31270,31271,62541
34664,,mvlfjf9oyigj,31271,31272,62543
34665,,spyeqdkemmmj,31272,31273,62545
34666,,au3mz6lajtcj,31273,31274,62547
34667,,n58_xodq6egj,31274,31275,62549
34668,,d8uyf_n0gnyj,31275,31276,62551
34669,,lyb83srpjpej,31276,31277,62553
34670,,_egbq5hyujgj,31277,31278,62555
34671,,eci5etvzsoqj,31278,31279,62557
34672,,url:http://portal.acm.org/citation.cfm3fid3d33547626dl3dacm26coll3dportal26cfid3d1111111126cftoken3d2222222,31279,31280,62559
34673,,dymjewaduwuj,31280,31281,62561
34674,,ifzpflzqfl4j,31281,31282,62563
34675,,mhrevz9fxb4j,31282,31283,62565
34676,,gyaenarqeccj,31283,31284,62567
34677,,qz0xxz1vdvsj,31284,31285,62569
34678,,1qpca_ahktyj,31285,31286,62571
34679,,or40xjqpofcj,31286,31287,62573
34680,,waaopgt3t-0j,31287,31288,62575
34681,,b8axbhazziqj,31289,31290,62579
34682,,5lj5kguunxoj,31290,31291,62581
34683,,url:http://portal.acm.org/ft_gateway.cfm3fid3d110133426type3dpdf,31291,31292,62583
34684,,zvxplw9g330j,31292,31293,62585
34685,,jthq9necocuj,31293,31294,62587
34686,,j3j7jghl-scj,31294,31295,62589
34687,,efvshcd54vcj,31295,31296,62591
34688,,j4aof60qt1ij,31296,31297,62593
34689,,jiumjufmum0j,31297,31298,62595
34690,,fkrgmlfaejsj,31298,31299,62597
34691,,9k-ildmcdhgj,31299,31300,62599
34692,,qcqo5hu2nnaj,31300,31301,62601
34693,,x8xuv8p6geyj,31301,31302,62603
34694,,_dy_y9cuc7mj,31302,31303,62605
34695,,t9ugvawqw-gj,31303,31304,62607
34696,,9fd2xny-cuyj,31304,31305,62609
34697,,url:http://portal.acm.org/ft_gateway.cfm3fid3d109338726type3dpdf,31305,31306,62611
34698,,mujpprmu4yoj,31306,31307,62613
34699,,m_fl_junfroj,31307,31308,62615
34700,,ws7oik_ul9oj,31308,31309,62617
34701,,tu5poh7xl4yj,31309,31310,62619
34702,,g0uewpjagdyj,31310,31311,62621
34703,,tkloo3chswoj,31311,31312,62623
34704,,cel5yg0heraj,31312,31313,62625
34705,,ujux-epdldij,31313,31314,62627
34706,,nh44p8yytouj,31314,31315,62629
34707,,alsywylsdocj,31315,31316,62631
34708,,qsqeczbugvsj,31317,31318,62635
34709,,f19e_16weroj,31318,31319,62637
34710,,uwdqjp_1lhgj,31319,31320,62639
34711,,wmyhsqkkh8uj,31320,31321,62641
34712,,ze9dyemgbfgj,31321,31322,62643
34713,,ibtcu5hruf4j,31322,31323,62645
34714,,wc9o2qelfmuj,31323,31324,62647
34715,,lxyvmhubifuj,31324,31325,62649
34716,,an9pavknltcj,31325,31326,62651
34717,,ab9koozaszej,31326,31327,62653
34718,,h4jz7oh3a7aj,31327,31328,62655
34719,,j5rmq6m8gsuj,31328,31329,62657
34720,,la_2im8hw7sj,31329,31330,62659
34721,,hsdoa1zy0zoj,31330,31331,62661
34722,,8pt19bilehej,31331,31332,62663
34723,,url:http://www.springerlink.com/index/h58452q268h44281.pdf,31332,31333,62665
34724,,url:http://links.jstor.org/sici3fsici3d0146-4949(196622)7253a2253c183253a2522hbopa253e2.0.co253b2-e,31333,31334,62667
34725,,mwsz7yejt8sj,31334,31335,62669
34726,,afvvxwv0n8ej,31335,31336,62671
34727,,dauo9usozdaj,31336,31337,62673
34728,,x0cx7korpcsj,31337,31338,62675
34729,,g3l1jsv9t8ij,31338,31339,62677
34730,,94vrc1mlywcj,31339,31340,62679
34731,,qytca-c_rquj,31340,31341,62681
34732,,dwb5wpttvqyj,31341,31342,62683
34733,,dca00mu9lg8j,31342,31343,62685
34734,,n7lztjwwflwj,31343,31344,62687
34735,,1burebcmpyqj,31344,31345,62689
34736,,pkdk8gl9ic8j,31345,31346,62691
34737,,ilqdnllessej,31346,31347,62693
34738,,uiky4tnb75uj,31347,31348,62695
34739,,_mxfp9gheqqj,31348,31349,62697
34740,,mftvcb3i3twj,31349,31350,62699
34741,,py5xhulocr8j,31350,31351,62701
34742,,lv86d8rf0tqj,31351,31352,62703
34743,,ccp9rskobc4j,31352,31353,62705
34744,,3358tf8ektqj,31353,31354,62707
34745,,5-tzco3ibiwj,31354,31355,62709
34746,,vppjzzqdhswj,31355,31356,62711
34747,,url:http://adsabs.harvard.edu/abs/1983phdt........22m,31356,31357,62713
34748,,qcsm4gulocqj,31357,31358,62715
34749,,fet4fp5tm3mj,31358,31359,62717
34750,,ahdlhryhmhij,31360,31361,62721
34751,,kp2t3glqi3cj,31361,31362,62723
34752,,w9pg4ftixo0j,31362,31363,62725
34753,,d-qqmabsihoj,31363,31364,62727
34754,,ow5ifwqjbs4j,31364,31365,62729
34755,,9fosqjxcqdgj,31365,31366,62731
34756,,php9okb6rtyj,31366,31367,62733
34757,,cnptmkyn5nyj,31367,31368,62735
34758,,m5klqo_i20yj,31368,31369,62737
34759,,gdpxkujgvjsj,31369,31370,62739
34760,,ggm5xfgbl2aj,31370,31371,62741
34761,,xgay-z5ze0mj,31371,31372,62743
34762,,mg08ouxjsi4j,31372,31373,62745
34763,,hmwzaof2utgj,31373,31374,62747
34764,,8abhqduued4j,31374,31375,62749
34765,,uu-q_hmcn4kj,31375,31376,62751
34766,,nwyqgut7rk0j,31376,31377,62753
34767,,fwp8lbj8klmj,31377,31378,62755
34768,,url:http://adsabs.harvard.edu/abs/1994mit..reptq....l,31378,31379,62757
34769,,ydwpidgwwoij,31379,31380,62759
34770,,pjb_kao7l94j,31380,31381,62761
34771,,niga0pyx-tuj,31381,31382,62763
34772,,3nxblvy0-huj,31382,31383,62765
34773,,fxxikhp-0acj,31383,31384,62767
34774,,hkdaa9utmxyj,31384,31385,62769
34775,,4euqhkdkgnoj,31385,31386,62771
34776,,kplw9e4cr94j,31386,31387,62773
34777,,g7rhf0x1rqij,31388,31389,62777
34778,,phjocbl_cwkj,31389,31390,62779
34779,,hpwdomb8y6wj,31391,31392,62783
34780,,kokvryxwahgj,31392,31393,62785
34781,,nzucyd-ompqj,31393,31394,62787
34782,,a6vqmhjixnuj,31394,31395,62789
34783,,7c9xwpxoj3qj,31395,31396,62791
34784,,tggdz7lp7swj,31396,31397,62793
34785,,qaimy9owyp4j,31397,31398,62795
34786,,qv2efukwjacj,31398,31399,62797
34787,,a-wzrbvjsrmj,31399,31400,62799
34788,,tuz-fjos6i0j,31400,31401,62801
34789,,frwflw2e96cj,31401,31402,62803
34790,,srcdfy9rxk4j,31402,31403,62805
34791,,f3vqpdaybygj,31403,31404,62807
34792,,p1mxewp73cmj,31404,31405,62809
34793,,_qooszh1ncsj,31405,31406,62811
34794,,x-ybhedkjgmj,31406,31407,62813
34795,,_hlpteoqd80j,31407,31408,62815
34796,,kvabddcezwqj,31408,31409,62817
34797,,vqprccyc8yqj,31409,31410,62819
34798,,dpynb8h86hmj,31410,31411,62821
34799,,duhyeru5dzkj,31411,31412,62823
34800,,13dqpu7z73gj,31412,31413,62825
34801,,xyefeyutoqyj,31413,31414,62827
34802,,xqtawb1qtcyj,31414,31415,62829
34803,,k3ee5_6ijnmj,31415,31416,62831
34804,,rwcuav2sbi4j,31416,31417,62833
34805,,xtr47jyrfjej,31417,31418,62835
34806,,,31418,31419,62837
34807,,8wcnyb0-pt0j,31420,31421,62841
34808,,difewi3cac8j,31421,31422,62843
34809,,yebyal2yes0j,31422,31423,62845
34810,,7nli4al8zq8j,31423,31424,62847
34811,,dy49pp9z2xyj,31424,31425,62849
34812,,ydixj4d8vigj,31425,31426,62851
34813,,gigqcmgnufoj,31426,31427,62853
34814,,0hsch0xi9sgj,31427,31428,62855
34815,,oxtskcula44j,31428,31429,62857
34816,,ujxyeqtdk1sj,31429,31430,62859
34817,,isy25njymwij,31430,31431,62861
34818,,ehnt_jhgtuyj,31431,31432,62863
34819,,zptgxo96stoj,31432,31433,62865
34820,,j52xgqqb8rkj,31433,31434,62867
34821,,nopetm4wvsyj,31434,31435,62869
34822,,evfuc1dqunwj,31435,31436,62871
34823,,h2ncu3zwlgej,31436,31437,62873
34824,,t2jnx9yrsv8j,31437,31438,62875
34825,,1ljxsrlneb8j,31438,31439,62877
34826,,m_sj9zaegksj,31439,31440,62879
34827,,yzvgqiwh66ej,31440,31441,62881
34828,,4epxata6klmj,31441,31442,62883
34829,,mitzae1njroj,31442,31443,62885
34830,,whtecls11zuj,31443,31444,62887
34831,,175gvbhyl8wj,31444,31445,62889
34832,,8lbdhvljraej,31445,31446,62891
34833,,8gvlzvyvivyj,31446,31447,62893
34834,,i_uin_1coisj,31447,31448,62895
34835,,hrssmbnto8ej,31448,31449,62897
34836,,tqydverwytej,31449,31450,62899
34837,,mscwodvhhqij,31450,31451,62901
34838,,vq4ubctptw0j,31451,31452,62903
34839,,c8vhtakggmaj,31452,31453,62905
34840,,zykq-d9iep0j,31453,31454,62907
34841,,cmdhl8ot_saj,31454,31455,62909
34842,,tdcrurgnwdij,31455,31456,62911
34843,,syhhpekcz-8j,31456,31457,62913
34844,,kptq63wcgv4j,31457,31458,62915
34845,,ga3heqmt9nej,31458,31459,62917
34846,,tfwhdybre78j,31459,31460,62919
34847,,jfhs3j_cpcmj,31460,31461,62921
34848,,v560mcgv7y0j,31461,31462,62923
34849,,_valtwxfnq0j,31462,31463,62925
34850,,url:http://portal.acm.org/ft_gateway.cfm3fid3d39000226type3dpdf,31463,31464,62927
34851,,nafap_ykbh8j,31464,31465,62929
34852,,vb20mbaj6r4j,31465,31466,62931
34853,,4gt0krd9rp0j,31466,31467,62933
34854,,urfs1mvwtrej,31467,31468,62935
34855,,wkntrh8t9cuj,31468,31469,62937
34856,,isey2runkkoj,31469,31470,62939
34857,,tsjxionagyqj,31470,31471,62941
34858,,v1g1kpon4iuj,31471,31472,62943
34859,,clua8okvs0yj,31472,31473,62945
34860,,fuyt83itp4ij,31473,31474,62947
34861,,ebaetzta6tij,31474,31475,62949
34862,,demv733wpeaj,31475,31476,62951
34863,,0ccaytiis8oj,31476,31477,62953
34864,,opvcq6uvmzuj,31477,31478,62955
34865,,ldilw9hssd8j,31478,31479,62957
34866,,oyj_4csz-rsj,31479,31480,62959
34867,,url:http://www.ncbi.nlm.nih.gov/entrez/query.fcgi3fcmd3dretrieve26db3dpubmed26list_uids3d35573526dopt3dcitation,31480,31481,62961
34868,,xv-hunbih68j,31481,31482,62963
34869,,m5lqy6iyydgj,31483,31484,62967
34870,,8brpfdyozpwj,31484,31485,62969
34871,,xfwyi66bclij,31485,31486,62971
34872,,ao86vlwn0dcj,31486,31487,62973
34873,,278rzswwgzmj,31487,31488,62975
34874,,t_fy_x5asc8j,31488,31489,62977
34875,,q3csi8prx0gj,31489,31490,62979
34876,,4olcd3hn7qmj,31490,31491,62981
34877,,7j4oa3joy7gj,31491,31492,62983
34878,,q8-en-wva54j,31492,31493,62985
34879,,kegtcgia-n0j,31493,31494,62987
34880,,1g4-2q2etwgj,31494,31495,62989
34881,,dwkggorg39sj,31495,31496,62991
34882,,ayman-q-xvuj,31496,31497,62993
34883,,ppqlz2ymzd4j,31497,31498,62995
34884,,url:http://www.ingentaconnect.com/search/expand3fpub3dinfobike://els/13891286/2000/00000034/00000001/art0009326unc3d,31498,31499,62997
34885,,jhnotztit1kj,31499,31500,62999
34886,,nvl6xlpc4yij,31500,31501,63001
34887,,nfet_ylj1p8j,31501,31502,63003
34888,,suwjwuxcypkj,31502,31503,63005
34889,,dbhzjhedrrgj,31503,31504,63007
34890,,8n_wqgl5rrgj,31504,31505,63009
34891,,f68tkd_hnx4j,31505,31506,63011
34892,,yoivcx81pewj,31506,31507,63013
34893,,b--m0mgqzawj,31507,31508,63015
34894,,du8drlyid0sj,31509,31510,63019
34895,,r9eyykckwhoj,31510,31511,63021
34896,,f94sknvsok0j,31511,31512,63023
34897,,qx5ydhgfbvuj,31512,31513,63025
34898,,bmxkqwjdzmgj,31513,31514,63027
34899,,url:http://www.springerlink.com/index/h10820434437l021.pdf,31514,31515,63029
34900,,h-bkyjk0h28j,31515,31516,63031
34901,,8gmzq1ielquj,31516,31517,63033
34902,,lirailspkz0j,31517,31518,63035
34903,,b8xnqoodr2oj,31518,31519,63037
34904,,7co7q7t96nkj,31519,31520,63039
34905,,_tamp_olj-wj,31521,31522,63043
34906,,4hyvsnbbg7cj,31522,31523,63045
34907,,sxfkaektiqyj,31523,31524,63047
34908,,hqb88ednpqsj,31524,31525,63049
34909,,ctjr_cbi_goj,31525,31526,63051
34910,,uyinaefy5tgj,31526,31527,63053
34911,,ecyhtua87coj,31527,31528,63055
34912,,mzt1xbegsyyj,31528,31529,63057
34913,,kzrm1tilrxwj,31529,31530,63059
34914,,x8aw3tr7upyj,31530,31531,63061
34915,,4mqwxc0vu6uj,31531,31532,63063
34916,,bya4avexza8j,31532,31533,63065
34917,,egl2738pn3yj,31533,31534,63067
34918,,ccbkcycl0gwj,31534,31535,63069
34919,,mvc6o_qepgej,31535,31536,63071
34920,,8wq3klayxwyj,31536,31537,63073
34921,,vulzzikqhfkj,31537,31538,63075
34922,,rvbtiexfxssj,31538,31539,63077
34923,,w5uwwracts0j,31539,31540,63079
34924,,url:http://www.ncbi.nlm.nih.gov/entrez/query.fcgi3fcmd3dretrieve26db3dpubmed26list_uids3d1602888326dopt3dcitation,31540,31541,63081
34925,,5_p2plk8odyj,31541,31542,63083
34926,,pd_vsntdpxsj,31542,31543,63085
34927,,cj7vcfcbsbmj,31543,31544,63087
34928,,kf4wouypizwj,31544,31545,63089
34929,,6ggxtey_ghij,31545,31546,63091
34930,,url:http://www.ncbi.nlm.nih.gov/entrez/query.fcgi3fcmd3dretrieve26db3dpubmed26list_uids3d68270226dopt3dcitation,31546,31547,63093
34931,,6a8okbyu4tqj,31547,31548,63095
34932,,zbambe17lyqj,31548,31549,63097
34933,,gikwrx708hmj,31549,31550,63099
34934,,trru_mkr7puj,31550,31551,63101
34935,,lv0aj27lrgqj,31551,31552,63103
34936,,dej2n4r5xz4j,31552,31553,63105
34937,,a1yw9jwpm8wj,31553,31554,63107
34938,,rzzxqs428yyj,31554,31555,63109
34939,,pbqncqssnyej,31555,31556,63111
34940,,u6z_r1kqa40j,31556,31557,63113
34941,,2p1jt3rv5vwj,31557,31558,63115
34942,,lv-thb_60agj,31558,31559,63117
34943,,u-jqwbv8m4oj,31559,31560,63119
34944,,hphehdjhosyj,31560,31561,63121
34945,,url:http://portal.acm.org/ft_gateway.cfm3fid3d24590826type3dpdf26dl3dguide26dl3dacm26cfid3d1111111126cftoken3d2222222,31561,31562,63123
34946,,bn3a2v-zehcj,31562,31563,63125
34947,,8dn4weszjhoj,31563,31564,63127
34948,,hlpl075vn8kj,31564,31565,63129
34949,,axfzax5eka0j,31566,31567,63133
34950,,b6ych7d4qaej,31567,31568,63135
34951,,dwqsyoex1coj,31568,31569,63137
34952,,64zuxfje90ej,31569,31570,63139
34953,,nrn2zof34u4j,31570,31571,63141
34954,,icp--0koxbuj,31571,31572,63143
34955,,dfr2bb2uexmj,31572,31573,63145
34956,,5np7k58rx38j,31573,31574,63147
34957,,b6x4ooivf2oj,31574,31575,63149
34958,,znvtqg1cixaj,31575,31576,63151
34959,,ybl5bkyxp5qj,31576,31577,63153
34960,,uedqgthazj4j,31577,31578,63155
34961,,f50tkqz1woqj,31578,31579,63157
34962,,ca45qspvjpqj,31579,31580,63159
34963,,e6s9ur72xzmj,31580,31581,63161
34964,,tft_cmgt_c4j,31581,31582,63163
34965,,g2qycezaiowj,31582,31583,63165
34966,,jcbbgytn5x0j,31583,31584,63167
34967,,obyxjwr985kj,31584,31585,63169
34968,,pjnljjkgvm4j,31585,31586,63171
34969,,aqwh4cjmh8ij,31586,31587,63173
34970,,ed2gtij3wxcj,31587,31588,63175
34971,,1gqgv6uz2x0j,31588,31589,63177
34972,,url:http://www.csa.com/partners/viewrecord.php3frequester3dgs26collection3dtrd26recid3d8409720599md,31589,31590,63179
34973,,1eu2aosig4ij,31590,31591,63181
34974,,url:http://journals.iucr.org/c/issues/1999/11/00/cf1329/cf1329.pdf,31591,31592,63183
34975,,8baynvd9ozaj,31592,31593,63185
34976,,nsyzsz78xm8j,31593,31594,63187
34977,,ty52pzlqn9oj,31594,31595,63189
34978,,i-tpdyrqblej,31595,31596,63191
34979,,4kqwbibhvtcj,31596,31597,63193
34980,,url:http://doi.wiley.com/10.1002/ace.139,31597,31598,63195
34981,,siopymhebu0j,31598,31599,63197
34982,,brbzltubgs8j,31599,31600,63199
34983,,ujy-joy6wiij,31600,31601,63201
34984,,pebymuwopusj,31601,31602,63203
34985,,c221gfs5vvoj,31602,31603,63205
34986,,4pnhi50vlaoj,31603,31604,63207
34987,,hwn5s9an-_oj,31604,31605,63209
34988,,xwbdfekg5isj,31605,31606,63211
34989,,zcuaou3_jw8j,31606,31607,63213
34990,,cq36xrnzydwj,31607,31608,63215
34991,,j-ztjj4youcj,31608,31609,63217
34992,,zyzs16w6kfgj,31609,31610,63219
34993,,hu1tiukpj6wj,31610,31611,63221
34994,,url:http://www.csa.com/partners/viewrecord.php3frequester3dgs26collection3dtrd26recid3da8622993ah,31611,31612,63223
34995,,url:http://portal.acm.org/citation.cfm3fid3d156883.15688926dl3dguide26dl3dacm26idx3dj68926part3dperiodical26wanttype3dperiodical26title3dacm2520sigmod2520record26cfid3d1111111126cftoken3d2222222,31612,31613,63225
34996,,dyexe_u9mqcj,31613,31614,63227
34997,,jdlop37c1soj,31614,31615,63229
34998,,lrjbpxjwmu0j,31615,31616,63231
34999,,hzptgzk7iraj,31616,31617,63233
35000,,32nqr2_pt_uj,31617,31618,63235
35001,,nryl7uphuikj,31618,31619,63237
35002,,vc-lspbdc8sj,31620,31621,63241
35003,,e6ghy0k2mh4j,31621,31622,63243
35004,,tuvuq2y-5zgj,31622,31623,63245
35005,,xzxfci120euj,31623,31624,63247
35006,,h0dgleqlpbmj,31624,31625,63249
35007,,fxziel_htv8j,31625,31626,63251
35008,,jtyvfsscswqj,31626,31627,63253
35009,,ishuerinswsj,31627,31628,63255
35010,,hcvjhok3yq8j,31628,31629,63257
35011,,bmaxumjjuxij,31629,31630,63259
35012,,ckjwrjlnk1wj,31630,31631,63261
35013,,i0jq2r7sfe4j,31631,31632,63263
35014,,i4nzfwhv_a8j,31632,31633,63265
35015,,9ancxm4thasj,31633,31634,63267
35016,,url:http://portal.acm.org/ft_gateway.cfm3fid3d108377726type3dpdf,31634,31635,63269
35017,,smigwun4qfgj,31635,31636,63271
35018,,url:http://adsabs.harvard.edu/abs/1976infph..16..225c,31637,31638,63275
35019,,nwm2z_wglksj,31638,31639,63277
35020,,zitjatwg4xmj,31639,31640,63279
35021,,,31640,31641,63281
35022,,5jowdcfoikmj,31641,31642,63283
35023,,cvvo6ieue9mj,31642,31643,63285
35024,,qw_llh_l7ioj,31643,31644,63287
35025,,cob-kks9ulmj,31644,31645,63289
35026,,3pbneyv1zhej,31645,31646,63291
35027,,73tkfdnktzej,31646,31647,63293
35028,,ypdgpz3wx7mj,31647,31648,63295
35029,,,31648,31649,63297
35030,,r2q02kl1k1mj,31650,31651,63301
35031,,etk0gqriitsj,31651,31652,63303
35032,,ew41s0-pidkj,31652,31653,63305
35033,,jdl7uelpucwj,31653,31654,63307
35034,,kbgjlt8ko7cj,31655,31656,63311
35035,,bunuy6zugeij,31656,31657,63313
35036,,sgolwtbjjvwj,31657,31658,63315
35037,,rqm-ob4eqh4j,31658,31659,63317
35038,,ywchunamt-0j,31659,31660,63319
35039,,7dcro3xo5z4j,31660,31661,63321
35040,,g-7g_zi3tcij,31661,31662,63323
35041,,l56-j_msz4uj,31662,31663,63325
35042,,r4btcwp3hp0j,31663,31664,63327
35043,,io_rkgadl9sj,31664,31665,63329
35044,,dfya9_qek2wj,31665,31666,63331
35045,,vwdwtx0dk7qj,31666,31667,63333
35046,,s3lgwxg6nw8j,31667,31668,63335
35047,,url:http://www.csa.com/partners/viewrecord.php3frequester3dgs26collection3dtrd26recid3d0609719ci,31668,31669,63337
35048,,tnvf8x1xssej,31669,31670,63339
35049,,odk5y0i8a1yj,31670,31671,63341
35050,,bohjn8sqnisj,31671,31672,63343
35051,,ucnlqjvdlaoj,31672,31673,63345
35052,,url:http://ieeexplore.ieee.org/xpl/abs_free.jsp3farnumber3d331733,31673,31674,63347
35053,,url:http://portal.acm.org/ft_gateway.cfm3fid3d108625826type3dpdf,31674,31675,63349
35054,,fxitffz6ntuj,31675,31676,63351
35055,,-5rw5bflfy8j,31676,31677,63353
35056,,mr1snd1g8okj,31677,31678,63355
35057,,evvn78z6iuoj,31678,31679,63357
35058,,iprzj4yesuuj,31679,31680,63359
35059,,g21f0lo-nzij,31680,31681,63361
35060,,cazwo1zlujij,31681,31682,63363
35061,,fbx9w4962lkj,31682,31683,63365
35062,,d5bg9f7_lgmj,31684,31685,63369
35063,,znqodvmibxij,31685,31686,63371
35064,,url:http://www.csa.com/partners/viewrecord.php3frequester3dgs26collection3dtrd26recid3dn9210425ah,31686,31687,63373
35065,,nn9a9gducpij,31687,31688,63375
35066,,ld4qko65lcej,31688,31689,63377
35067,,tsj7ymeqfh4j,31689,31690,63379
35068,,ey1wzbjqec4j,31690,31691,63381
35069,,fgq8hquukp4j,31691,31692,63383
35070,,l_y3bccpr9ij,31692,31693,63385
35071,,ebddnl_l_hmj,31693,31694,63387
35072,,ui6teqg--ggj,31695,31696,63391
35073,,qerv6u2f3hoj,31696,31697,63393
35074,,7itkjxkt18qj,31697,31698,63395
35075,,url:http://portal.acm.org/ft_gateway.cfm3fid3d110116026type3dpdf,31698,31699,63397
35076,,url:http://doi.wiley.com/10.1002/he.166,31699,31700,63399
35077,,vjx9r32hguwj,31700,31701,63401
35078,,syrv68dxdsuj,31701,31702,63403
35079,,xlmnxiprrvqj,31702,31703,63405
35080,,ox33shhon2ej,31703,31704,63407
35081,,edbmj2vs5_aj,31704,31705,63409
35082,,gu0rpovfqlgj,31705,31706,63411
35083,,wkgjeihh2h8j,31706,31707,63413
35084,,url:http://portal.acm.org/ft_gateway.cfm3fid3d110138526type3dpdf,31707,31708,63415
35085,,tvymdtyfgiwj,31708,31709,63417
35086,,k_foojjgu5mj,31709,31710,63419
35087,,mebv3sngoo8j,31710,31711,63421
35088,,ysegnazllcmj,31711,31712,63423
35089,,dm4lca25nogj,31712,31713,63425
35090,,hpl327dlc10j,31713,31714,63427
35091,,88khjxbxkqqj,31714,31715,63429
35092,,1cd28pd7v_yj,31715,31716,63431
35093,,pkziftw1ltgj,31716,31717,63433
35094,,_oe77edfddwj,31717,31718,63435
35095,,url:http://doi.wiley.com/10.1002/he.165,31718,31719,63437
35096,,8zgahqz5bjmj,31719,31720,63439
35097,,f7rcjxkwvlsj,31720,31721,63441
35098,,hm-2jw9slbuj,31721,31722,63443
35099,,jbpsr_oaeaoj,31722,31723,63445
35100,,xxaescoteuoj,31723,31724,63447
35101,,vr6pop5lknmj,31724,31725,63449
35102,,4yed9m0linwj,31725,31726,63451
35103,,ppbipw7s6msj,31726,31727,63453
35104,,mckavnackncj,31727,31728,63455
35105,,52ccuvwykcoj,31728,31729,63457
35106,,xzgdbb1xypmj,31729,31730,63459
35107,,_ueyx0wdb-sj,31732,31733,63465
35108,,zudb8qrxyz8j,31733,31734,63467
35109,,tb5bhqzafoij,31734,31735,63469
35110,,yj7--9tubc4j,31735,31736,63471
35111,,w55ssr50sroj,31736,31737,63473
35112,,uv8la_eoro0j,31737,31738,63475
35113,,abf7hkuaoh8j,31738,31739,63477
35114,,tp1_lryelcwj,31739,31740,63479
35115,,iplo-xgnywuj,31740,31741,63481
35116,,f9q1hwu6jlyj,31741,31742,63483
35117,,4m_zfz0kp7cj,31742,31743,63485
35118,,paldmzcytgkj,31743,31744,63487
35119,,v821t7bdgbmj,31744,31745,63489
35120,,w1b6odtiyaij,31745,31746,63491
35121,,9g9hnq0twpmj,31746,31747,63493
35122,,4hxwsxt59gmj,31747,31748,63495
35123,,bycefsfirj8j,31748,31749,63497
35124,,pddfb3gg6hmj,31749,31750,63499
35125,,4s8hl8ttkdsj,31750,31751,63501
35126,,ywa9xg9emqmj,31751,31752,63503
35127,,oi62csk63v8j,31752,31753,63505
35128,,mm5zayrygpyj,31753,31754,63507
35129,,url:http://www.csa.com/partners/viewrecord.php3frequester3dgs26collection3dtrd26recid3d20021211001536mt26recid3da8622992ah,31754,31755,63509
35130,,0kph8f3yqxgj,31755,31756,63511
35131,,f82yfvqf6vij,31756,31757,63513
35132,,i0kmxbpe50ej,31757,31758,63515
35133,,url:http://portal.acm.org/ft_gateway.cfm3fid3d108376026type3dpdf,31758,31759,63517
35134,,fm5rfl08nksj,31759,31760,63519
35135,,666stbilzg4j,31760,31761,63521
35136,,gs7qv6fcyxqj,31762,31763,63525
35137,,arrixic0sekj,31763,31764,63527
35138,,8k4uvxtokokj,31764,31765,63529
35139,,wjnsdqkgvw0j,31765,31766,63531
35140,,eauu9kzq_zej,31766,31767,63533
35141,,bg-fnwo-2n0j,31767,31768,63535
35142,,_hsgimut6igj,31768,31769,63537
35143,,rjns_7m6cyyj,31769,31770,63539
35144,,6kazxg-pewyj,31771,31772,63543
35145,,1ufq52qqeruj,31772,31773,63545
35146,,je6n61vpahij,31773,31774,63547
35147,,kmb-3xcfuuqj,31774,31775,63549
35148,,bicvwyr0zrsj,31775,31776,63551
35149,,1lfyxg1vcg8j,31776,31777,63553
35150,,darc8i5fkr0j,31777,31778,63555
35151,,j18qewclx8kj,31778,31779,63557
35152,,2tx9hcmrspgj,31779,31780,63559
35153,,btx5mdmhvukj,31780,31781,63561
35154,,4n2g8jefysij,31781,31782,63563
35155,,ygwhlacjvkgj,31782,31783,63565
35156,,ajf3hnaairij,31783,31784,63567
35157,,k1f3-rf_b94j,31784,31785,63569
35158,,tgz16vwj-bgj,31785,31786,63571
35159,,mf9ygo1dvgcj,31786,31787,63573
35160,,kankaydrmzoj,31787,31788,63575
35161,,mp5ymzcd1vmj,31788,31789,63577
35162,,26bkdpgw4q4j,31789,31790,63579
35163,,ets2awxasl8j,31790,31791,63581
35164,,eywgmv5nltyj,31791,31792,63583
35165,,y-zvocymscaj,31792,31793,63585
35166,,tekir38urhqj,31793,31794,63587
35167,,csf2rcnndoyj,31794,31795,63589
35168,,atxg0_snymwj,31796,31797,63593
35169,,0juy0yjkrfcj,31797,31798,63595
35170,,uv0hc1qrwosj,31798,31799,63597
35171,,hdak_aaldwoj,31799,31800,63599
35172,,jjo8bbux_1wj,31800,31801,63601
35173,,qqneeqfjmmoj,31801,31802,63603
35174,,kgvs-2ah5iij,31802,31803,63605
35175,,-4acz57fuvoj,31803,31804,63607
35176,,ortcifg9fbij,31804,31805,63609
35177,,q-jxnwzzunej,31805,31806,63611
35178,,b6p04ak75buj,31806,31807,63613
35179,,abtfse8hmogj,31807,31808,63615
35180,,vvmtsinclzmj,31808,31809,63617
35181,,dg7bm5yqlnaj,31809,31810,63619
35182,,kc44usy2dgsj,31810,31811,63621
35183,,h73uxqebeswj,31811,31812,63623
35184,,ex6mlidlz6ij,31812,31813,63625
35185,,x53gscec41kj,31813,31814,63627
35186,,5nbomj0hmbsj,31814,31815,63629
35187,,url:http://portal.acm.org/ft_gateway.cfm3fid3d108623526type3dpdf,31815,31816,63631
35188,,zbcqvb5wtwsj,31816,31817,63633
35189,,f3hc_ii84ukj,31818,31819,63637
35190,,wsmowzdalsoj,31819,31820,63639
35191,,ncei-bjggmij,31820,31821,63641
35192,,ntjtgmw0fksj,31821,31822,63643
35193,,sj-uerr3pv8j,31822,31823,63645
35194,,c0ws50wqmymj,31823,31824,63647
35195,,o2oy3acwlzij,31824,31825,63649
35196,,jq_gyjkibjaj,31825,31826,63651
35197,,o8nvemxnxk0j,31826,31827,63653
35198,,uh9xcz13psij,31827,31828,63655
35199,,ltfijn5digqj,31828,31829,63657
35200,,za8rsk2wzuej,31829,31830,63659
35201,,-7kkszdjlfsj,31831,31832,63663
35202,,0zokzwmy26ej,31832,31833,63665
35203,,8-vkpfeh4k4j,31833,31834,63667
35204,,inojlgrtspwj,31834,31835,63669
35205,,35dl9m43smuj,31835,31836,63671
35206,,_56yi0hesxej,31836,31837,63673
35207,,nabn3bn0blsj,31837,31838,63675
35208,,rssgiouxl0ij,31838,31839,63677
35209,,8hbb443ueu8j,31839,31840,63679
35210,,fujyaa9xsv0j,31840,31841,63681
35211,,kevx52jdbgqj,31841,31842,63683
35212,,dxvwqeojbjqj,31842,31843,63685
35213,,_3x1fnci_3oj,31843,31844,63687
35214,,ncrxdsksb94j,31845,31846,63691
35215,,1a4es7qd5vej,31846,31847,63693
35216,,2dirogujy4sj,31847,31848,63695
35217,,izncmenh3i4j,31848,31849,63697
35218,,wzx8cygvogyj,31849,31850,63699
35219,,658mg_h_rpkj,31850,31851,63701
35220,,qj2omqdfb0uj,31851,31852,63703
35221,,mynqepkwszyj,31852,31853,63705
35222,,ydh7bcnibikj,31853,31854,63707
35223,,kofgsx1cwqcj,31854,31855,63709
35224,,t73louryvaij,31855,31856,63711
35225,,vifclp3m_jmj,31856,31857,63713
35226,,bizfof7buf8j,31857,31858,63715
35227,,vk0wbgpxzqej,31858,31859,63717
35228,,url:http://portal.acm.org/citation.cfm3fid3dseries9729.134479,31859,31860,63719
35229,,jyxwn30vhc4j,31860,31861,63721
35230,,t7i85mmrrxgj,31862,31863,63725
35231,,mvk23-2iougj,31863,31864,63727
35232,,z-dqaom7m0ej,31864,31865,63729
35233,,20rv3tu9mnqj,31865,31866,63731
35234,,q1rfuhgyyn0j,31866,31867,63733
35235,,xnj8u3sr83yj,31867,31868,63735
35236,,hw0rfofrg_ej,31868,31869,63737
35237,,enxrqegnlh8j,31869,31870,63739
35238,,7qdukmr2fhaj,31870,31871,63741
35239,,6fk4jyanxq4j,31871,31872,63743
35240,,4xx-rcm-mfij,31872,31873,63745
35241,,3crij7kqdmcj,31873,31874,63747
35242,,_lcb6vjqbgyj,31874,31875,63749
35243,,nl33cjqpxumj,31875,31876,63751
35244,,u8v_klajqs4j,31876,31877,63753
35245,,zsupdroafbqj,31877,31878,63755
35246,,pgi6ex6gxwyj,31878,31879,63757
35247,,osmq44x1lcqj,31879,31880,63759
35248,,xot25alqs2qj,31880,31881,63761
35249,,kr41az-1sgej,31881,31882,63763
35250,,ueuyhkgezrkj,31882,31883,63765
35251,,6pcngwwyki0j,31883,31884,63767
35252,,wln360eas8oj,31884,31885,63769
35253,,5wq24vlntv4j,31885,31886,63771
35254,,h5p097mmf4ij,31886,31887,63773
35255,,dy8vtucnkq4j,31887,31888,63775
35256,,url:http://adsabs.harvard.edu/abs/1976phdt.......181s,31888,31889,63777
35257,,zmpg3twoouoj,31889,31890,63779
35258,,ciy5lki3qzcj,31890,31891,63781
35259,,vvys-3fnuzaj,31891,31892,63783
35260,,ooyxqc_3umsj,31892,31893,63785
35261,,qn6fkbiducgj,31893,31894,63787
35262,,7-yt5k5r8waj,31894,31895,63789
35263,,e3ua6n2ddtoj,31895,31896,63791
35264,,irqayrowt4cj,31896,31897,63793
35265,,t4pmerhbjauj,31897,31898,63795
35266,,qe-t13onj8ej,31899,31900,63799
35267,,_z93gtadxvej,31900,31901,63801
35268,,ss2flj-adouj,31901,31902,63803
35269,,pthmovz-c4yj,31902,31903,63805
35270,,u7puv-neeoej,31903,31904,63807
35271,,44mvyckl6pij,31904,31905,63809
35272,,zb53-llbxt8j,31905,31906,63811
35273,,cu1-j2ruicsj,31906,31907,63813
35274,,gkpzavnur48j,31907,31908,63815
35275,,k0cybm3qayyj,31908,31909,63817
35276,,vm6wzz7eepej,31909,31910,63819
35277,,biv7nf9qwbyj,31910,31911,63821
35278,,fos2_gf1ppoj,31911,31912,63823
35279,,nm_evruqon0j,31912,31913,63825
35280,,jdcso-z4tpgj,31913,31914,63827
35281,,eoo-xsotosgj,31914,31915,63829
35282,,v9d5lhnuvfgj,31915,31916,63831
35283,,jm7x8wil86aj,31916,31917,63833
35284,,dulirisvamqj,31917,31918,63835
35285,,bopyb8hce_yj,31918,31919,63837
35286,,jlqwdegwzvqj,31919,31920,63839
35287,,ilc2w5ewku0j,31920,31921,63841
35288,,wci-n7r156gj,31921,31922,63843
35289,,url:http://www.ncbi.nlm.nih.gov/entrez/query.fcgi3fcmd3dretrieve26db3dpubmed26list_uids3d1641174026dopt3dcitation,31922,31923,63845
35290,,nul0aglopzyj,31923,31924,63847
35291,,asglvctlh6aj,31924,31925,63849
35292,,qmojfmc31juj,31925,31926,63851
35293,,-c9hzjbon2gj,31926,31927,63853
35294,,etpz7as667sj,31927,31928,63855
35295,,zftbq7uqvo4j,31928,31929,63857
35296,,i9nci4grgmqj,31929,31930,63859
35297,,4mymuqndpkuj,31930,31931,63861
35298,,ndzv1vyl3cej,31931,31932,63863
35299,,url:http://portal.acm.org/citation.cfm3fid3d872757.87283326dl3dportal26dl3da2520cm26type3dseries26idx3d87275726part3dproceedings26wanttype3dproceedings26title3dinternational2520conference2520on2520management2520of2520data2520and2520symposium2520on2520principles2520of2520database2520systems26cfid3d1111111126cftoken3d2222222,31932,31933,63865
35300,,vfqkvm1dmn0j,31933,31934,63867
35301,,sradlqsoaboj,31934,31935,63869
35302,,sloizykqjz4j,31935,31936,63871
35303,,url:http://portal.acm.org/citation.cfm3fid3d25326026dl3dguide26dl3dguide26type3dproceeding26idx3dseries47326part3dproceedings26wanttype3dproceedings26title3dinternational2520conference2520on2520management2520of2520data2520and2520symposium2520on2520principles2520of2520database2520systems26cfid3d1111111126cftoken3d2222222,31936,31937,63873
35304,,hpk1v5nbx38j,31937,31938,63875
35305,,c85vtvhzmjuj,31938,31939,63877
35306,,bek9hkuj_kyj,31939,31940,63879
35307,,bs_qya_wiigj,31940,31941,63881
35308,,ytp9ddwzp3uj,31941,31942,63883
35309,,rwjzvd4ywwqj,31942,31943,63885
35310,,rpkfr4bbsxuj,31943,31944,63887
35311,,_jsjurwqfpsj,31944,31945,63889
35312,,6at6xzj858yj,31945,31946,63891
35313,,x4sfuvfzr7oj,31946,31947,63893
35314,,jnvmxab77faj,31947,31948,63895
35315,,neenkusnnumj,31948,31949,63897
35316,,9l2ad_a7dyoj,31949,31950,63899
35317,,wfdjoo3j3r8j,31950,31951,63901
35318,,q2mwesjh5bej,31951,31952,63903
35319,,kzyrnrblsqwj,31952,31953,63905
35320,,46udy8knwmij,31953,31954,63907
35321,,ret-ycwk2x8j,31954,31955,63909
35322,,v9er70knnm0j,31955,31956,63911
35323,,5ujj4s6kxl4j,31956,31957,63913
35324,,qj7m9l9dshqj,31957,31958,63915
35325,,h-oitwcx_ckj,31958,31959,63917
35326,,yafedxbfcssj,31959,31960,63919
35327,,5rgew1q4shcj,31960,31961,63921
35328,,zdkn438qov4j,31961,31962,63923
35329,,opi1wgtthc0j,31962,31963,63925
35330,,pmtihehzv0kj,31963,31964,63927
35331,,ousmi0yhpxcj,31964,31965,63929
35332,,0nnvi2x084uj,31965,31966,63931
35333,,bt-7jlyce38j,31966,31967,63933
35334,,c-x90wy9p5cj,31967,31968,63935
35335,,usr90fjlo0uj,31968,31969,63937
35336,,h5o-wyfedmoj,31969,31970,63939
35337,,hew1gr_0xouj,31971,31972,63943
35338,,3kulb8dutzgj,31972,31973,63945
35339,,8jttpoqc2rkj,31974,31975,63949
35340,,k19d4mpgxlkj,31975,31976,63951
35341,,azvbo7xlonqj,31976,31977,63953
35342,,sufrsugehowj,31977,31978,63955
35343,,tvgarbj5gtgj,31978,31979,63957
35344,,6ldtaxozgr0j,31979,31980,63959
35345,,wilus9uccw4j,31980,31981,63961
35346,,_r0-nywjit8j,31981,31982,63963
35347,,t64mlkazhaej,31982,31983,63965
35348,,bpcy1y7o6a4j,31983,31984,63967
35349,,eyiihvpcnfqj,31984,31985,63969
35350,,0milknwsuq8j,31985,31986,63971
35351,,bfs_w6s1xdaj,31986,31987,63973
35352,,url:http://portal.acm.org/ft_gateway.cfm3fid3d102776926type3dpdf,31987,31988,63975
35353,,ou-gpvwfwxgj,31988,31989,63977
35354,,t46qi-0o-ogj,31989,31990,63979
35355,,xrkfv1fdxt4j,31990,31991,63981
35356,,usw1yvsmpzcj,31991,31992,63983
35357,,igvxrvqk9gwj,31992,31993,63985
35358,,i_slfha-z44j,31993,31994,63987
35359,,rdfcjocyvfgj,31994,31995,63989
35360,,typ51atuhjyj,31995,31996,63991
35361,,mjovbrgxh_yj,31996,31997,63993
35362,,vwo-x6su0voj,31997,31998,63995
35363,,flsuunhe1q4j,31998,31999,63997
35364,,24uabsnbjt0j,31999,32000,63999
35365,,url:http://www.csa.com/partners/viewrecord.php3frequester3dgs26collection3dtrd26recid3dn9210376ah,32000,32001,64001
35366,,c3nflzjxht4j,32001,32002,64003
35367,,ihiijsfrfisj,32002,32003,64005
35368,,pr0jlg1scbyj,32003,32004,64007
35369,,4qwts0sar9gj,32004,32005,64009
35370,,h7nfztayt6mj,32005,32006,64011
35371,,url:http://pubs.acs.org/cgi-bin/abstract.cgi/achre4/2005/38/i08/abs/ar040071t.html,32006,32007,64013
35372,,xkzuyru7q9kj,32007,32008,64015
35373,,nw1etyvhl-mj,32008,32009,64017
35374,,hlhodnwlnwsj,32009,32010,64019
35375,,mayinyeom9kj,32010,32011,64021
35376,,dpfucttfffyj,32011,32012,64023
35377,,ger9lxfrmp4j,32012,32013,64025
35378,,a8uqtrwcrsmj,32013,32014,64027
35379,,h_ye_do5ucyj,32014,32015,64029
35380,,ancvvkw32syj,32015,32016,64031
35381,,url:http://portal.acm.org/citation.cfm3fid3d197434,32016,32017,64033
35382,,j3jm-4q0hy0j,32017,32018,64035
35383,,t7fkqt7t6wuj,32018,32019,64037
35384,,q9fssxk_4vcj,32019,32020,64039
35385,,j6xb8rqvohyj,32020,32021,64041
35386,,3rb2-ybmnsmj,32022,32023,64045
35387,,u6jsqepxubej,32023,32024,64047
35388,,mvzf3bi4yjsj,32024,32025,64049
35389,,tki4op8tt3aj,32025,32026,64051
35390,,jaj5khrxrk4j,32026,32027,64053
35391,,r5ko_qktjaaj,32027,32028,64055
35392,,beb7izss5tyj,32028,32029,64057
35393,,j1swzb-lthkj,32030,32031,64061
35394,,8nixbfonlluj,32031,32032,64063
35395,,url:http://portal.acm.org/ft_gateway.cfm3fid3d35320826type3dpdf26dl3dguide26dl3dacm26cfid3d1111111126cftoken3d2222222,32032,32033,64065
35396,,5lndkzaulpmj,32033,32034,64067
35397,,gk27unsp4vsj,32034,32035,64069
35398,,bq1jhd0u-noj,32036,32037,64073
35399,,ubrrox1qhdwj,32037,32038,64075
35400,,lq2fvc54-kej,32038,32039,64077
35401,,url:http://www.csa.com/partners/viewrecord.php3frequester3dgs26collection3dtrd26recid3dn9210377ah,32039,32040,64079
35402,,ncsg1tnn6r4j,32040,32041,64081
35403,,u8fm2covh34j,32041,32042,64083
35404,,10fzv5nmmmoj,32042,32043,64085
35405,,6xvbehm6fsuj,32043,32044,64087
35406,,q1sadafpg38j,32044,32045,64089
35407,,url:http://doi.wiley.com/10.1002/he.75,32045,32046,64091
35408,,7z4eyiw0_c4j,32046,32047,64093
35409,,d4okzpyduscj,32047,32048,64095
35410,,vruoliw7gnyj,32048,32049,64097
35411,,c0qgppvxo4ij,32049,32050,64099
35412,,kqasztmiwc8j,32050,32051,64101
35413,,djpfoidxwgmj,32051,32052,64103
35414,,url:http://www.csa.com/partners/viewrecord.php3frequester3dgs26collection3dtrd26recid3d0516579ci,32052,32053,64105
35415,,5jxkbi5l1fyj,32053,32054,64107
35416,,6vbymfdabnyj,32054,32055,64109
35417,,pms9sktbbzcj,32055,32056,64111
35418,,ith9dxp9okwj,32056,32057,64113
35419,,qye_tfrgwvaj,32057,32058,64115
35420,,cxxd8fe-zpij,32058,32059,64117
35421,,1yphqxqkpv4j,32059,32060,64119
35422,,qmvdk5vfbhaj,32060,32061,64121
35423,,t4ya7khehxij,32061,32062,64123
35424,,oaihmjqxw8sj,32062,32063,64125
35425,,egyxxpotjzyj,32063,32064,64127
35426,,url:http://www.csa.com/partners/viewrecord.php3frequester3dgs26collection3dtrd26recid3dn9210421ah,32064,32065,64129
35427,,07xgbpx_81oj,32066,32067,64133
35428,,4g5dhlt9eraj,32067,32068,64135
35429,,8xb9qgfnogyj,32068,32069,64137
35430,,1ucgp2rgy20j,32069,32070,64139
35431,,sf9w1uz_xpwj,32070,32071,64141
35432,,ovlocj8gdowj,32071,32072,64143
35433,,chivmvahdjij,32072,32073,64145
35434,,du3gnqcrkj0j,32073,32074,64147
35435,,l94unikla7yj,32074,32075,64149
35436,,ykydmukkggij,32075,32076,64151
35437,,jsiyplhrnnuj,32076,32077,64153
35438,,9-zxybd5rggj,32077,32078,64155
35439,,url:http://portal.acm.org/citation.cfm3fid3d592196.59232826dl3dportal26dl3dacm26cfid3d1111111126cftoken3d2222222,32078,32079,64157
35440,,url:http://portal.acm.org/citation.cfm3fid3d1073204.1073302,32079,32080,64159
35441,,vmyyxe4xknij,32080,32081,64161
35442,,tt6kycf5rbyj,32081,32082,64163
35443,,pcz6jv-nqdqj,32082,32083,64165
35444,,lbai9gvibtgj,32083,32084,64167
35445,,k25oxjit8hoj,32084,32085,64169
35446,,wq_hgmirvtwj,32085,32086,64171
35447,,2r6a5qjmmpyj,32086,32087,64173
35448,,url:http://ieeexplore.ieee.org/xpl/abs_free.jsp3farnumber3d1320092,32087,32088,64175
35449,,beso36stb5cj,32088,32089,64177
35450,,id_udc04riaj,32089,32090,64179
35451,,borqbbgufbsj,32090,32091,64181
35452,,4o2umuh449ej,32091,32092,64183
35453,,iyq4mc1vaa0j,32092,32093,64185
35454,,wcv-usicnjmj,32093,32094,64187
35455,,u20jqc_igy0j,32094,32095,64189
35456,,t6idcmh47swj,32095,32096,64191
35457,,4b-pmhc8dzaj,32096,32097,64193
35458,,wwl7nk5vbvoj,32097,32098,64195
35459,,ywjvcjvru-yj,32098,32099,64197
35460,,x7fyrhlypjoj,32099,32100,64199
35461,,url:http://www.springerlink.com/index/r74k242j25264185.pdf,32101,32102,64203
35462,,9eir-w0iyn8j,32102,32103,64205
35463,,ec5qxiguikqj,32104,32105,64209
35464,,r6ysz-dmxygj,32105,32106,64211
35465,,kmdct8eabnuj,32106,32107,64213
35466,,ozwu9v4iqu8j,32107,32108,64215
35467,,bmk5xx8pcu0j,32108,32109,64217
35468,,url:http://portal.acm.org/ft_gateway.cfm3fid3d109961126type3dpdf,32109,32110,64219
35469,,3yienjtlmaij,32110,32111,64221
35470,,ou9pzvbthawj,32111,32112,64223
35471,,az6hlmvztjej,32112,32113,64225
35472,,a2ffsvam81mj,32113,32114,64227
35473,,1phy6wlxctkj,32114,32115,64229
35474,,yh5g871zzzqj,32115,32116,64231
35475,,7baj8jsaxy4j,32116,32117,64233
35476,,j9-6aiowtmcj,32117,32118,64235
35477,,rbcgvxyx39ij,32118,32119,64237
35478,,sz6x2xhjpegj,32119,32120,64239
35479,,64d1biwuqhoj,32120,32121,64241
35480,,q9vhux9lormj,32121,32122,64243
35481,,kch4zzrozmkj,32122,32123,64245
35482,,ytjbyvcw5k4j,32123,32124,64247
35483,,g3knsznuik4j,32124,32125,64249
35484,,j8i7yfifdwoj,32126,32127,64253
35485,,url:http://www.csa.com/partners/viewrecord.php3frequester3dgs26collection3dtrd26recid3dn9210450ah,32127,32128,64255
35486,,efcdniwakn8j,32128,32129,64257
35487,,xjzqkmttyxij,32129,32130,64259
35488,,8bylq21q1hwj,32130,32131,64261
35489,,lhijpzjbriaj,32131,32132,64263
35490,,tzwkyej7xe8j,32132,32133,64265
35491,,xd4wo6xm8buj,32133,32134,64267
35492,,fea7snbb3kij,32134,32135,64269
35493,,vpbzxvlwetyj,32135,32136,64271
35494,,jfjqtkj_iyuj,32136,32137,64273
35495,,1onn9_jpnqwj,32137,32138,64275
35496,,ll4drjvtqb8j,32138,32139,64277
35497,,m2kzf_e1ue4j,32139,32140,64279
35498,,aysnakd53uaj,32140,32141,64281
35499,,url:http://portal.acm.org/citation.cfm3fid3d974121.97413026coll3dguide26dl3dacm26type3dissue26idx3dj68926part3dperiodical26wanttype3dperiodical26title3dacm2520sigmod2520record26cfid3d1111111126cftoken3d2222222,32141,32142,64283
35500,,xf4wfjtm-r8j,32142,32143,64285
35501,,vospqvr0hwqj,32143,32144,64287
35502,,4ybmevh5hekj,32144,32145,64289
35503,,tmqudkkyaqwj,32145,32146,64291
35504,,usqxs14rdd4j,32146,32147,64293
35505,,qsg9v7pyk04j,32147,32148,64295
35506,,_op6tevyu3ej,32148,32149,64297
35507,,cjrwis64ghgj,32149,32150,64299
35508,,zkamidjexyuj,32150,32151,64301
35509,,mkujq2-yjxij,32151,32152,64303
35510,,lnjkvxxeexmj,32152,32153,64305
35511,,3ptq6hozx1cj,32153,32154,64307
35512,,v5sqmjvl5coj,32154,32155,64309
35513,,url:http://ieeexplore.ieee.org/xpl/abs_free.jsp3farnumber3d1320071,32155,32156,64311
35514,,fjack48ag-4j,32156,32157,64313
35515,,m4mb5pmrpoej,32157,32158,64315
35516,,a-yxbfouzpkj,32158,32159,64317
35517,,emk8zjqyjvoj,32159,32160,64319
35518,,yig7cupvomsj,32160,32161,64321
35519,,hzzuypa1khij,32161,32162,64323
35520,,arxeenyhrcmj,32162,32163,64325
35521,,url:http://doi.wiley.com/10.1002/tl.25,32163,32164,64327
35522,,iyg4xccsrqkj,32164,32165,64329
35523,,gnpma77bkpwj,32165,32166,64331
35524,,jghp3wi3zu4j,32166,32167,64333
35525,,htxburusttqj,32167,32168,64335
35526,,yoda6tu23s8j,32168,32169,64337
35527,,o5i8qsawvboj,32169,32170,64339
35528,,elenyy7emqij,32170,32171,64341
35529,,wphstqikr8wj,32171,32172,64343
35530,,1keer7mos54j,32172,32173,64345
35531,,xq97fvgqazaj,32173,32174,64347
35532,,7o_dfrxhl98j,32174,32175,64349
35533,,-2jurbcl_awj,32175,32176,64351
35534,,g59jwiswmiyj,32176,32177,64353
35535,,o5iykie5bwqj,32177,32178,64355
35536,,rutdd1qbhj0j,32178,32179,64357
35537,,6fpgnayhloij,32179,32180,64359
35538,,qebpxqbtvfmj,32180,32181,64361
35539,,xeoyiglx9suj,32181,32182,64363
35540,,w4eoll8edxij,32182,32183,64365
35541,,vpw-mnzasduj,32183,32184,64367
35542,,w3qkf3vj8byj,32184,32185,64369
35543,,jenldr497yqj,32185,32186,64371
35544,,poaxvy1_2zuj,32186,32187,64373
35545,,n7o7esgjjisj,32187,32188,64375
35546,,aobngdoodhaj,32188,32189,64377
35547,,hkrb0f83jmij,32189,32190,64379
35548,,ijg1xyfqyxaj,32190,32191,64381
35549,,w4-tdbufwi8j,32191,32192,64383
35550,,0hsib-c45tyj,32192,32193,64385
35551,,iyzvnuitdryj,32193,32194,64387
35552,,f-pepm30nsyj,32194,32195,64389
35553,,s_vjfzmlgd4j,32195,32196,64391
35554,,w0eycekyn1ij,32196,32197,64393
35555,,msymath5hk0j,32197,32198,64395
35556,,tmurcjqbtxmj,32198,32199,64397
35557,,kwpjy6lkauuj,32199,32200,64399
35558,,aa_prdb1v8aj,32201,32202,64403
35559,,h6syvhqloauj,32202,32203,64405
35560,,co1wdbpzs0wj,32203,32204,64407
35561,,ls4p1a9vdg4j,32204,32205,64409
35562,,mzx5zbmvw9aj,32205,32206,64411
35563,,,32206,32207,64413
35564,,ckzbhcuvaaqj,32207,32208,64415
35565,,ewvirnmtjrgj,32208,32209,64417
35566,,ixnbkvutxu8j,32209,32210,64419
35567,,qjqn1duhp-4j,32210,32211,64421
35568,,ipwa594lcxmj,32211,32212,64423
35569,,oqmsqs0qhcyj,32212,32213,64425
35570,,qhorwdxer3qj,32213,32214,64427
35571,,zpaomcu5phqj,32214,32215,64429
35572,,zwh3ofnbem0j,32215,32216,64431
35573,,0bjo61madbij,32216,32217,64433
35574,,xifhfxe0hy0j,32217,32218,64435
35575,,vib1lpacofkj,32218,32219,64437
35576,,cnhixcszeucj,32219,32220,64439
35577,,l4moxo64xpcj,32220,32221,64441
35578,,u5p-gxq7ffij,32221,32222,64443
35579,,bhmp6vk5c-qj,32222,32223,64445
35580,,wqw4ez9ecuej,32224,32225,64449
35581,,8-z0pjrz6qaj,32225,32226,64451
35582,,znzf9etjg08j,32226,32227,64453
35583,,ubtghgv1nvmj,32227,32228,64455
35584,,mbnwn57duucj,32228,32229,64457
35585,,hpmu1t1cjhuj,32229,32230,64459
35586,,kjohq8eqaeej,32230,32231,64461
35587,,8brxmos2g1cj,32231,32232,64463
35588,,pbzkvdhteyej,32232,32233,64465
35589,,xmx74r-ofzaj,32233,32234,64467
35590,,g4vgg17ecekj,32234,32235,64469
35591,,st8xpfk_xy8j,32235,32236,64471
35592,,url:http://www.springerlink.com/index/h122x75608750547.pdf,32236,32237,64473
35593,,baizjzbwofij,32237,32238,64475
35594,,gan0bzfeitcj,32238,32239,64477
35595,,xcjhb3c_304j,32239,32240,64479
35596,,o8svalbxzygj,32240,32241,64481
35597,,url:http://www.csa.com/partners/viewrecord.php3frequester3dgs26collection3dtrd26recid3dn9210481ah,32241,32242,64483
35598,,9fdcz0arvgoj,32242,32243,64485
35599,,rgrlaq5wn50j,32243,32244,64487
35600,,wn6ixvxuu34j,32244,32245,64489
35601,,ajig-q6j5uwj,32245,32246,64491
35602,,url:http://portal.acm.org/ft_gateway.cfm3fid3d50735526type3dpdf26dl3dguide26dl3dacm26cfid3d1111111126cftoken3d2222222,32246,32247,64493
35603,,q1zq4iwht3mj,32247,32248,64495
35604,,ymalpqb2hlsj,32249,32250,64499
35605,,cyrlqrabekwj,32250,32251,64501
35606,,fuosdnfcdv0j,32251,32252,64503
35607,,_z-4kxtgzscj,32252,32253,64505
35608,,xny4xz5vrhij,32254,32255,64509
35609,,dtllnn97xqkj,32255,32256,64511
35610,,psffgnnpn_yj,32256,32257,64513
35611,,url:http://doi.wiley.com/10.1002/anie.200390594,32257,32258,64515
35612,,yfvzxaturbuj,32258,32259,64517
35613,,zrfhbiodt-yj,32259,32260,64519
35614,,url:http://www.csa.com/partners/viewrecord.php3frequester3dgs26collection3dtrd26recid3da8622933ah,32260,32261,64521
35615,,z34--jqcvraj,32261,32262,64523
35616,,ecblf8qavtwj,32262,32263,64525
35617,,url:http://portal.acm.org/citation.cfm3fid3d192593.19263926dl3dguide26dl3dacm26type3dseries26idx3d19259326part3dproceedings26wanttype3dproceedings26title3dinternational2520multimedia2520conference26cfid3d1111111126cftoken3d2222222,32263,32264,64527
35618,,utdehxxvqrmj,32264,32265,64529
35619,,logrg4fe5-sj,32265,32266,64531
35620,,sxvhwf7xulkj,32266,32267,64533
35621,,ysyhtrtaw_4j,32267,32268,64535
35622,,url:http://www.ingentaconnect.com/search/expand3fpub3dinfobike://els/09505849/2003/00000045/00000006/art0003126unc3d,32268,32269,64537
35623,,mkeuwj0laq8j,32269,32270,64539
35624,,yafiitswebyj,32270,32271,64541
35625,,wind8yvybnkj,32271,32272,64543
35626,,ycdfuqassn0j,32272,32273,64545
35627,,s1pyvywuyggj,32273,32274,64547
35628,,bd2iab5ur5mj,32274,32275,64549
35629,,sxatiduo8jmj,32275,32276,64551
35630,,fzeottyvskej,32277,32278,64555
35631,,pyn9khtw_i8j,32278,32279,64557
35632,,h9s8n77hkwkj,32279,32280,64559
35633,,ibrp_mvyqu4j,32280,32281,64561
35634,,5dazyrlplt8j,32281,32282,64563
35635,,zca3ap4fx_oj,32282,32283,64565
35636,,3vlnbblfub0j,32283,32284,64567
35637,,hg1_fste9scj,32284,32285,64569
35638,,aym5ctsktjgj,32285,32286,64571
35639,,7cgdwhaiuhuj,32286,32287,64573
35640,,dtwnj3h4rs0j,32287,32288,64575
35641,,ikodc8z7fiyj,32288,32289,64577
35642,,wwbagjxc718j,32289,32290,64579
35643,,avymafgtvlej,32290,32291,64581
35644,,mksxps2lfxcj,32291,32292,64583
35645,,f3v6nxrtivij,32292,32293,64585
35646,,odke4a5yviwj,32293,32294,64587
35647,,nezm1q6g45gj,32294,32295,64589
35648,,gpmk5c9khkqj,32295,32296,64591
35649,,nbigvjwu640j,32296,32297,64593
35650,,7ejtcdzryymj,32297,32298,64595
35651,,ypz7nopu-l8j,32298,32299,64597
35652,,url:http://engine.cqvip.com/content/tq/94044x/1999/016/002/gc15_tq3_3512946.pdf,32299,32300,64599
35653,,0jouozz6fg4j,32300,32301,64601
35654,,mqpt0yb3alsj,32301,32302,64603
35655,,iubeta9ku6aj,32302,32303,64605
35656,,w3zyzmmht80j,32303,32304,64607
35657,,9fvzqj_nlcyj,32304,32305,64609
35658,,5fc4rmizrccj,32305,32306,64611
35659,,irel9rbyr48j,32306,32307,64613
35660,,_eagia9cstyj,32307,32308,64615
35661,,rhdnbod9zryj,32308,32309,64617
35662,,ytbma_5-q2sj,32309,32310,64619
35663,,xzcmh37v46yj,32310,32311,64621
35664,,o8eifc2esjcj,32311,32312,64623
35665,,esqruvr-dpgj,32312,32313,64625
35666,,8zsiu6v4uqaj,32313,32314,64627
35667,,gv55chyy8imj,32314,32315,64629
35668,,,32315,32316,64631
35669,,wrltjtiowtij,32316,32317,64633
35670,,swbgy2gxkb0j,32317,32318,64635
35671,,mqdncsx8tykj,32318,32319,64637
35672,,rpyshuxa5myj,32319,32320,64639
35673,,nxtlhaprknyj,32320,32321,64641
35674,,yogrdszjjjcj,32321,32322,64643
35675,,url:http://doi.wiley.com/10.1002/he.10609,32322,32323,64645
35676,,vtdu8nvdyouj,32323,32324,64647
35677,,spw8pk1hek0j,32324,32325,64649
35678,,gfckt5omfgaj,32325,32326,64651
35679,,yqyn9zvviyej,32326,32327,64653
35680,,tiqq4sk1y7gj,32327,32328,64655
35681,,cijp1em5k3gj,32328,32329,64657
35682,,6inhlbmgfaej,32329,32330,64659
35683,,tjt1ddhgnguj,32330,32331,64661
35684,,url:http://www.ingentaconnect.com/content/els/09505849/1996/00000038/00000010/art01094,32331,32332,64663
35685,,indxr5yhwi8j,32332,32333,64665
35686,,dhvywzzjbv8j,32333,32334,64667
35687,,iod7mbvybkoj,32334,32335,64669
35688,,g4fsulgcpuyj,32335,32336,64671
35689,,emianjeay3ej,32336,32337,64673
35690,,4uken1wlca0j,32337,32338,64675
35691,,xupscisgtjsj,32338,32339,64677
35692,,5ilu35w-h5uj,32339,32340,64679
35693,,mp5bt7qg58uj,32340,32341,64681
35694,,yfbrlsol2eaj,32341,32342,64683
35695,,zgbojl3lcguj,32342,32343,64685
35696,,xa5z31dkf7wj,32343,32344,64687
35697,,wjj60t2pxhgj,32344,32345,64689
35698,,hv9hhkgp-ygj,32345,32346,64691
35699,,etq23xt3va0j,32346,32347,64693
35700,,ftzdm9ggljij,32347,32348,64695
35701,,fgce-ihxg0uj,32348,32349,64697
35702,,guxevgl-u_wj,32349,32350,64699
35703,,ekkwfqgaaiij,32350,32351,64701
35704,,9v3h2crjnayj,32351,32352,64703
35705,,uolelqagnguj,32352,32353,64705
35706,,ho67dt3j4pij,32353,32354,64707
35707,,q26h43vl8qgj,32354,32355,64709
35708,,m-yn3eqi1j0j,32355,32356,64711
35709,,metlwsgjltgj,32356,32357,64713
35710,,url:http://portal.acm.org/citation.cfm3fid3d983061.98306326coll3dguide26dl3dacm26idx3dj68926part3dperiodical26wanttype3dperiodical26title3dacm2520sigmod2520record26cfid3d1111111126cftoken3d2222222,32357,32358,64715
35711,,yeo04rphehej,32358,32359,64717
35712,,ssqu8_w13nij,32359,32360,64719
35713,,65zwzj--rf8j,32360,32361,64721
35714,,ebxh5gwbenmj,32361,32362,64723
35715,,ntj3nn_j0cij,32362,32363,64725
35716,,b9dokurludoj,32363,32364,64727
35717,,jfocvdnqw68j,32364,32365,64729
35718,,qymtiur3eaqj,32365,32366,64731
35719,,vmqbhgba8o0j,32366,32367,64733
35720,,x_tig1jbqccj,32367,32368,64735
35721,,tuia0sfkf2mj,32368,32369,64737
35722,,rd1q9smyka0j,32369,32370,64739
35723,,nqx3de0stgaj,32370,32371,64741
35724,,rpw-iuzhqgej,32371,32372,64743
35725,,ilbsfoxzncqj,32372,32373,64745
35726,,kuyvvtlhvxcj,32373,32374,64747
35727,,9wnph2ovrsaj,32374,32375,64749
35728,,3mifpmowafuj,32375,32376,64751
35729,,i5y-z9ssez0j,32376,32377,64753
35730,,i3s_wlj1wlyj,32377,32378,64755
35731,,pbaqkjenusmj,32378,32379,64757
35732,,sgpwwaihkfkj,32379,32380,64759
35733,,jnyzwcuahf8j,32380,32381,64761
35734,,mi0x2u56uvyj,32382,32383,64765
35735,,url:http://doi.wiley.com/10.1002/anie.198804261,32383,32384,64767
35736,,al6intn-si4j,32384,32385,64769
35737,,2hk923hirwcj,32385,32386,64771
35738,,dwzr2cqnsqwj,32386,32387,64773
35739,,seo0xm_hxyij,32387,32388,64775
35740,,ilh0dt3_yosj,32388,32389,64777
35741,,ik8bwtk-9gej,32389,32390,64779
35742,,idywnpdh9osj,32390,32391,64781
35743,,7v5yqsyj084j,32391,32392,64783
35744,,url:http://portal.acm.org/ft_gateway.cfm3fid3d63743526type3dpdf26dl3dguide26dl3dacm26cfid3d1111111126cftoken3d2222222,32392,32393,64785
35745,,6epeuoq1510j,32393,32394,64787
35746,,r1q0mcu-uiej,32394,32395,64789
35747,,lxfe_a9zn_aj,32395,32396,64791
35748,,url:http://www.csa.com/partners/viewrecord.php3frequester3dgs26collection3dtrd26recid3d0607126ci,32396,32397,64793
35749,,4z_nx-gu6kaj,32397,32398,64795
35750,,k4uc3uq9hr0j,32398,32399,64797
35751,,u_v_sdm2afkj,32399,32400,64799
35752,,bnq8mcg91sij,32400,32401,64801
35753,,nex2zx484hsj,32401,32402,64803
35754,,cdonxeomnosj,32402,32403,64805
35755,,o5vaawidfxoj,32403,32404,64807
35756,,7jm7c181qnuj,32404,32405,64809
35757,,6v9dzi437qmj,32405,32406,64811
35758,,tdrfgwflodcj,32406,32407,64813
35759,,v2drshdj4twj,32407,32408,64815
35760,,pnqkxwthb1uj,32408,32409,64817
35761,,,32409,32410,64819
35762,,dlt9v8yumlsj,32410,32411,64821
35763,,s3szegwdauyj,32411,32412,64823
35764,,hy31nhwxhlcj,32412,32413,64825
35765,,hhodndp7k_8j,32413,32414,64827
35766,,s0yn89mlggij,32414,32415,64829
35767,,jtlnffrgfm8j,32415,32416,64831
35768,,rgsugeahxyuj,32416,32417,64833
35769,,gztlmcbhcscj,32417,32418,64835
35770,,url:http://www.springerlink.com/index/25j7gv80l2213162.pdf,32419,32420,64839
35771,,zx5eu_pgmlcj,32420,32421,64841
35772,,pw234_refhuj,32421,32422,64843
35773,,6swtupgapmaj,32422,32423,64845
35774,,77d3vpinthqj,32423,32424,64847
35775,,url:http://portal.acm.org/citation.cfm3fid3d74180.74185,32424,32425,64849
35776,,xuyxgjhk8aaj,32425,32426,64851
35777,,w5uxfc5fheoj,32426,32427,64853
35778,,xgk6t4_wonwj,32428,32429,64857
35779,,osqhq4nq_-8j,32429,32430,64859
35780,,suk4lybqyt8j,32430,32431,64861
35781,,c2fwird-xgoj,32431,32432,64863
35782,,vfrqwsfdxpej,32432,32433,64865
35783,,_1mkf9dpmgej,32433,32434,64867
35784,,dt_l91imol0j,32434,32435,64869
35785,,svikphy1puwj,32435,32436,64871
35786,,idprllcqosaj,32436,32437,64873
35787,,,32437,32438,64875
35788,,g4frelika3gj,32438,32439,64877
35789,,nca_djpx01gj,32440,32441,64881
35790,,4dydyxqaagej,32441,32442,64883
35791,,o9kz65u395gj,32442,32443,64885
35792,,3vhepuitghuj,32443,32444,64887
35793,,hqwqz9xvwmej,32444,32445,64889
35794,,pj6ryffffg8j,32445,32446,64891
35795,,chez8pkj4luj,32446,32447,64893
35796,,nnb4ldk2goej,32447,32448,64895
35797,,ssdzbu4gg7gj,32448,32449,64897
35798,,3sjs4ufjfr8j,32449,32450,64899
35799,,ajm3-gjx51qj,32450,32451,64901
35800,,yjbvyihky3ej,32451,32452,64903
35801,,ixqv1mi2muoj,32452,32453,64905
35802,,qkohyn2lsxuj,32453,32454,64907
35803,,9akh8qzclraj,32454,32455,64909
35804,,fgpfpfweok4j,32455,32456,64911
35805,,ofnbgxmakuqj,32456,32457,64913
35806,,puh7b_zu4kgj,32457,32458,64915
35807,,ambcsizre1ij,32458,32459,64917
35808,,rfk9ed96wvsj,32459,32460,64919
35809,,jusqlf48k1ij,32460,32461,64921
35810,,gk7mtojhrlgj,32462,32463,64925
35811,,w2isp1mupxmj,32463,32464,64927
35812,,4fzqbmxwyq0j,32465,32466,64931
35813,,soisi-zsa8sj,32466,32467,64933
35814,,i0c65loye60j,32467,32468,64935
35815,,rrhuoukln1gj,32468,32469,64937
35816,,l2meu8dlu8ij,32469,32470,64939
35817,,dwdrozyracgj,32470,32471,64941
35818,,um8foriv_poj,32471,32472,64943
35819,,iipir35qeaoj,32472,32473,64945
35820,,tgphkuygcz0j,32473,32474,64947
35821,,d-wmezmpphoj,32474,32475,64949
35822,,sprnp6u5am8j,32475,32476,64951
35823,,8zaeij0imacj,32476,32477,64953
35824,,avnxqehs_e4j,32477,32478,64955
35825,,pq8ddzxscu0j,32478,32479,64957
35826,,ydfcqfsfeaoj,32479,32480,64959
35827,,fcqlixjm8ncj,32480,32481,64961
35828,,it6mveovzvuj,32481,32482,64963
35829,,esqrr3mwfvoj,32483,32484,64967
35830,,xs_mlthrieuj,32484,32485,64969
35831,,sr_fm2qzb64j,32485,32486,64971
35832,,awnznonjt7mj,32486,32487,64973
35833,,url:http://portal.acm.org/ft_gateway.cfm3fid3d37579626type3dpdf26dl3dguide26dl3dacm26cfid3d1111111126cftoken3d2222222,32487,32488,64975
35834,,mo9likrjsuaj,32488,32489,64977
35835,,g2rvesq6kyqj,32489,32490,64979
35836,,cmfsqrislb8j,32491,32492,64983
35837,,a72vlw7jh3ej,32492,32493,64985
35838,,oapzsmvosemj,32493,32494,64987
35839,,pzevepiihn8j,32494,32495,64989
35840,,famdoh3d3syj,32496,32497,64993
35841,,asg-4_by8l0j,32497,32498,64995
35842,,lrzh8stqgwyj,32498,32499,64997
35843,,gzvcmmjksfij,32499,32500,64999
35844,,assvrbfe7mij,32500,32501,65001
35845,,ftxweqaizkqj,32502,32503,65005
35846,,zx0rgfy4zw4j,32503,32504,65007
35847,,ho_zpjtpxfaj,32504,32505,65009
35848,,url:http://www.csa.com/partners/viewrecord.php3frequester3dgs26collection3dtrd26recid3dn9210580ah,32505,32506,65011
35849,,e3rcyr9tmjmj,32506,32507,65013
35850,,ftwc55hx6lkj,32507,32508,65015
35851,,xhxaj_nxgyij,32508,32509,65017
35852,,hsh9qaqni64j,32509,32510,65019
35853,,fhkhyr-6ksmj,32510,32511,65021
35854,,ml0v-2nsfuyj,32511,32512,65023
35855,,tpmsm_vhhjyj,32512,32513,65025
35856,,8yqxjaoqb-0j,32513,32514,65027
35857,,3froni_1pl4j,32514,32515,65029
35858,,drpox6haehij,32515,32516,65031
35859,,chxpgutfynaj,32516,32517,65033
35860,,upv-id9k6-qj,32518,32519,65037
35861,,cnnvqyvfzusj,32519,32520,65039
35862,,kmqepvgv3xcj,32520,32521,65041
35863,,oaimazitk9cj,32521,32522,65043
35864,,ha5d3a8x80uj,32522,32523,65045
35865,,br1tshd9ctej,32523,32524,65047
35866,,,32524,32525,65049
35867,,sgxlzr_h6maj,32525,32526,65051
35868,,9x8oweuqpzwj,32526,32527,65053
35869,,_mxes0vhgqcj,32527,32528,65055
35870,,xyycahzdah8j,32528,32529,65057
35871,,teanjgc2dq0j,32529,32530,65059
35872,,ory7-bbwjdkj,32530,32531,65061
35873,,a7pgmezp_rcj,32531,32532,65063
35874,,url:http://portal.acm.org/citation.cfm3fid3d615232.61523526dl3dguide26dl3dguide26type3dissue26idx3dj86926part3dperiodical26wanttype3dperiodical26title3dthe2520vldb2520journal25202526mdash253b2520the2520international2520journal2520on2520very2520large2520data2520bases26cfid3d1111111126cftoken3d2222222,32532,32533,65065
35875,,6bsgies6aywj,32533,32534,65067
35876,,mvp7b1_0owkj,32534,32535,65069
35877,,qlzlnmnldqaj,32535,32536,65071
35878,,dx5knn7gadkj,32536,32537,65073
35879,,iazy0x07el8j,32538,32539,65077
35880,,azqn2ynec30j,32539,32540,65079
35881,,url:http://www.csa.com/partners/viewrecord.php3frequester3dgs26collection3denv26recid3d2650930,32540,32541,65081
35882,,81kdj5fjnryj,32542,32543,65085
35883,,fzbnz_c_21oj,32543,32544,65087
35884,,xxs-itxx_d0j,32544,32545,65089
35885,,rdndjzvwuaqj,32545,32546,65091
35886,,as4b1xce_gqj,32547,32548,65095
35887,,x_51h6bs3oqj,32548,32549,65097
35888,,hhdw2caiizwj,32549,32550,65099
35889,,4sb8z_swhokj,32550,32551,65101
35890,,url:http://www.springerlink.com/index/x9444efljerrrh1r.pdf,32551,32552,65103
35891,,zfjulnd8oemj,32552,32553,65105
35892,,url:http://www.springerlink.com/index/q225m21mmw126pv2.pdf,32553,32554,65107
35893,,9wz6aqykkuoj,32554,32555,65109
35894,,cxqdvrn_agqj,32556,32557,65113
35895,,fv5fnrmuv7ej,32557,32558,65115
35896,,lqbsd_uwj5yj,32559,32560,65119
35897,,ydzscy-4cmsj,32560,32561,65121
35898,,vtwabnl-vuuj,32561,32562,65123
35899,,jmh0k3a6hrqj,32562,32563,65125
35900,,vvdh7bqo-awj,32563,32564,65127
35901,,url:http://portal.acm.org/citation.cfm3fid3d1073204.1073220,32564,32565,65129
35902,,omhbgkwztk8j,32565,32566,65131
35903,,yxz8koo0wpej,32566,32567,65133
35904,,oiykdzjpmfmj,32568,32569,65137
35905,,ekxhmbzxbyej,32569,32570,65139
35906,,phwelusmub8j,32570,32571,65141
35907,,url:http://doi.wiley.com/10.1002/he.21,32571,32572,65143
35908,,url:http://portal.acm.org/citation.cfm3fid3d615204.61520526dl3dportal26dl3dacm26type3dissue26idx3dj86926part3dperiodical26wanttype3dperiodical26title3dthe2520vldb2520journal25202526mdash253b2520the2520international2520journal2520on2520very2520large2520data2520bases26cfid3d1111111126cftoken3d2222222,32572,32573,65145
35909,,5iohkq8tsiwj,32573,32574,65147
35910,,ihhvpmp2bhoj,32575,32576,65151
35911,,ypjk3wljlkij,32576,32577,65153
35912,,41s9matij8cj,32577,32578,65155
35913,,d3drxannd0wj,32578,32579,65157
35914,,xyqcareagpwj,32579,32580,65159
35915,,ukn4dupjys0j,32580,32581,65161
35916,,r7n8eri7x5aj,32581,32582,65163
35917,,reqju2vmsg4j,32582,32583,65165
35918,,gxgad05e9auj,32583,32584,65167
35919,,9o9i5kxbgyqj,32584,32585,65169
35920,,f9x2jrvnrmyj,32585,32586,65171
35921,,0cgml5jp_3cj,32587,32588,65175
35922,,pdaa4smq6soj,32589,32590,65179
35923,,url:http://portal.acm.org/citation.cfm3fid3d170035.17155826coll3dguide26dl3dacm26cfid3d1111111126cftoken3d2222222,32590,32591,65181
35924,,oc7dahjuhqwj,32591,32592,65183
35925,,ltxtkdtibnaj,32592,32593,65185
35926,,7dgplscn8ioj,32593,32594,65187
35927,,qa7mdmqaehoj,32594,32595,65189
35928,,2yelxbjifrkj,32595,32596,65191
35929,,g7roizmpc1ej,32596,32597,65193
35930,,kcwysnmh0zqj,32597,32598,65195
35931,,46aixxbmd6sj,32598,32599,65197
35932,,b7gkdysiysaj,32599,32600,65199
35933,,pmthkvj_rxoj,32600,32601,65201
35934,,jie3ypnlz7qj,32601,32602,65203
35935,,bsk3qtexmiyj,32602,32603,65205
35936,,,32603,32604,65207
35937,,yqxmjl7a3j0j,32604,32605,65209
35938,,url:http://www.ingentaconnect.com/search/expand3fpub3dinfobike://pep/jae/2002/00000216/00000001/art0000826unc3d,32605,32606,65211
35939,,rv9cjykfp3qj,32606,32607,65213
35940,,twtyqqtq_3sj,32607,32608,65215
35941,,idw3qxblc2wj,32608,32609,65217
35942,,lnuiecrqolkj,32609,32610,65219
35943,,uhhlmraejioj,32610,32611,65221
35944,,url:http://portal.acm.org/citation.cfm3fid3d38714.3874226coll3dguide26dl3dguide26idx3dj68926part3dperiodical26wanttype3dperiodical26title3dacm2520sigmod2520record26cfid3d1111111126cftoken3d2222222,32611,32612,65223
35945,,zupds8rtzuqj,32612,32613,65225
35946,,url:http://portal.acm.org/citation.cfm3fid3d382274.38240326dl3dguide26dl3dacm26idx3dj68926part3dperiodical26wanttype3dperiodical26title3dacm2520sigmod2520record26cfid3d1111111126cftoken3d2222222,32613,32614,65227
35947,,url:http://portal.acm.org/ft_gateway.cfm3fid3d110199626type3dpdf,32614,32615,65229
35948,,sn7f5mawzxgj,32615,32616,65231
35949,,ozfyxopq77ej,32616,32617,65233
35950,,xekjj5bs144j,32617,32618,65235
35951,,sdzw7oah07sj,32618,32619,65237
35952,,url:http://portal.acm.org/citation.cfm3fid3d110344.110337,32619,32620,65239
35953,,n6hzprrb9ukj,32620,32621,65241
35954,,6hlejbwokfkj,32621,32622,65243
35955,,mag86j6pnc0j,32622,32623,65245
35956,,8trxfqhmepij,32623,32624,65247
35957,,m0saweggoj4j,32624,32625,65249
35958,,ch6fkzb03zmj,32625,32626,65251
35959,,lbn02xmdx-aj,32626,32627,65253
35960,,awmshjr1mfej,32627,32628,65255
35961,,t474zwgnis0j,32628,32629,65257
35962,,9xp2uhtuzqij,32629,32630,65259
35963,,fjtamvae7ogj,32630,32631,65261
35964,,gu5cufazgloj,32631,32632,65263
35965,,jwyn61bbsbmj,32632,32633,65265
35966,,i5ficzekksuj,32633,32634,65267
35967,,thlpkbivelkj,32634,32635,65269
35968,,7ixgztwsbl4j,32635,32636,65271
35969,,n5kngmcpz-cj,32636,32637,65273
35970,,cvibh8m6nwij,32637,32638,65275
35971,,noxwiyfh-iej,32638,32639,65277
35972,,gqazh1x_f5mj,32639,32640,65279
35973,,ptx5pb8raogj,32640,32641,65281
35974,,hhhvhynmd6kj,32641,32642,65283
35975,,0c417mp2_gij,32642,32643,65285
35976,,9sfxg9mm1hij,32643,32644,65287
35977,,0bzxcd5pmtsj,32644,32645,65289
35978,,6ztmf-2zmmoj,32645,32646,65291
35979,,tdsouavlbnwj,32646,32647,65293
35980,,nz_fgnt88bcj,32647,32648,65295
35981,,c0xnjjljqzkj,32648,32649,65297
35982,,url:http://doi.wiley.com/10.1002/ev.1283,32649,32650,65299
35983,,,32650,32651,65301
35984,,v8k4u43z6v8j,32651,32652,65303
35985,,,32653,32654,65307
35986,,ddmgjochvnej,32654,32655,65309
35987,,rpu1-jeyio8j,32655,32656,65311
35988,,lpvqk8fvi68j,32656,32657,65313
35989,,v8-voarfbhuj,32657,32658,65315
35990,,plfi00y29iqj,32658,32659,65317
35991,,ovjgzngwyj4j,32659,32660,65319
35992,,,32660,32661,65321
35993,,ib2vbaxygc4j,32661,32662,65323
35994,,cf4jzvngovgj,32662,32663,65325
35995,,l0jdhni1dlij,32663,32664,65327
35996,,bhskbnpbixsj,32664,32665,65329
35997,,3nu7z0eztesj,32665,32666,65331
35998,,ddpooylses4j,32666,32667,65333
35999,,url:http://portal.acm.org/ft_gateway.cfm3fid3d27446126type3dpdf26dl3dguide26dl3dacm26cfid3d1111111126cftoken3d2222222,32667,32668,65335
36000,,h3ponj-upwsj,32668,32669,65337
36001,,vxwuidfo5uyj,32669,32670,65339
36002,,rsmb3a8b6icj,32670,32671,65341
36003,,n-cd808u_38j,32671,32672,65343
36004,,dmzmqqgug_oj,32673,32674,65347
36005,,lbuvfzdoodij,32674,32675,65349
36006,,-6uioeursyuj,32675,32676,65351
36007,,url:http://www.csa.com/partners/viewrecord.php3frequester3dgs26collection3dtrd26recid3d0791348ci,32676,32677,65353
36008,,srz7ted0sqsj,32677,32678,65355
36009,,ux6yyapqecij,32678,32679,65357
36010,,qw9xctc4odgj,32679,32680,65359
36011,,kkhmzaosjgyj,32680,32681,65361
36012,,c0jjo0tzbrkj,32681,32682,65363
36013,,flszpuk3zxqj,32683,32684,65367
36014,,8cnetfsuzpyj,32684,32685,65369
36015,,zprsxjjruvej,32685,32686,65371
36016,,,32686,32687,65373
36017,,lmhdju6hivoj,32687,32688,65375
36018,,p03bx_gbyeyj,32689,32690,65379
36019,,1zeqitxybgsj,32690,32691,65381
36020,,url:http://www.csa.com/partners/viewrecord.php3frequester3dgs26collection3dtrd26recid3d0002014ci,32691,32692,65383
36021,,pjotwo40i-yj,32692,32693,65385
36022,,6ghro3h_ae4j,32693,32694,65387
36023,,_kw6-x5edmoj,32694,32695,65389
36024,,fewg8ea2cycj,32695,32696,65391
36025,,7ciijby_ur8j,32696,32697,65393
36026,,dgqtkdpxqcwj,32697,32698,65395
36027,,4k9peenj9u4j,32698,32699,65397
36028,,ehfrphxgfbej,32699,32700,65399
36029,,a97nx4hbpk4j,32700,32701,65401
36030,,s9z7tua9l4sj,32701,32702,65403
36031,,iq8p1_s2x44j,32702,32703,65405
36032,,lznwarz9a84j,32703,32704,65407
36033,,nvkrlseg3usj,32704,32705,65409
36034,,c-vaona7z7ej,32706,32707,65413
36035,,pgki2975vcij,32708,32709,65417
36036,,7hvpxnu4db8j,32709,32710,65419
36037,,zhjanqjf-0gj,32710,32711,65421
36038,,jbgwtsciqksj,32711,32712,65423
36039,,_uszaseejxkj,32712,32713,65425
36040,,ts25mvqxwhej,32713,32714,65427
36041,,ffmzknx6gboj,32714,32715,65429
36042,,gu-dox4-eeyj,32715,32716,65431
36043,,ioaipef4lzkj,32716,32717,65433
36044,,ods49u1di0aj,32717,32718,65435
36045,,spm4e8enojej,32718,32719,65437
36046,,7qqy0kvu0ukj,32719,32720,65439
36047,,,32720,32721,65441
36048,,4sokssdy9wwj,32721,32722,65443
36049,,zrpr08v-dxaj,32722,32723,65445
36050,,nksfim1ejgwj,32723,32724,65447
36051,,mzkt1ntvupyj,32724,32725,65449
36052,,dazfgbs3dqyj,32725,32726,65451
36053,,1d1sqwdyjdcj,32726,32727,65453
36054,,skp_214qitij,32727,32728,65455
36055,,dpyollfppcoj,32728,32729,65457
36056,,o3lll6m9rbaj,32729,32730,65459
36057,,mmih36i2pssj,32730,32731,65461
36058,,2zpr-tav6fkj,32731,32732,65463
36059,,amw4umnv33qj,32732,32733,65465
36060,,gstfwrvhn70j,32733,32734,65467
36061,,le_bu9ztueij,32734,32735,65469
36062,,vuv86invvfcj,32735,32736,65471
36063,,lmekx7tyy9kj,32736,32737,65473
36064,,ri6je0j3-ngj,32737,32738,65475
36065,,xqtzgyeymyuj,32738,32739,65477
36066,,y7h0orpnq8ej,32739,32740,65479
36067,,yjiappaxamej,32740,32741,65481
36068,,h88zlgwsiu8j,32741,32742,65483
36069,,zi9lhgkxl-cj,32742,32743,65485
36070,,7iyqrfgvuvkj,32743,32744,65487
36071,,_kkkrrdguagj,32744,32745,65489
36072,,dtlgw3by-h0j,32745,32746,65491
36073,,b0e28n5ehycj,32747,32748,65495
36074,,bn1mq6uug9qj,32749,32750,65499
36075,,_btf_3na1eij,32750,32751,65501
36076,,tnyuhmd3mmqj,32751,32752,65503
36077,,piepsrrnfp4j,32752,32753,65505
36078,,ew9ylzomnckj,32753,32754,65507
36079,,krcisbjgjzwj,32754,32755,65509
36080,,bn2q5sl6ilwj,32755,32756,65511
36081,,gswvl79jojej,32756,32757,65513
36082,,uiodhw9fbyej,32757,32758,65515
36083,,bocc59o1otmj,32758,32759,65517
36084,,qtwzlqdco-uj,32759,32760,65519
36085,,dlr5fq9tnaqj,32760,32761,65521
36086,,miety2spqf4j,32761,32762,65523
36087,,k10k-labji8j,32762,32763,65525
36088,,fatmo-pkz6ej,32763,32764,65527
36089,,nfersfdpyfwj,32765,32766,65531
36090,,nizq2-qmonuj,32766,32767,65533
36091,,wzzhww4m1nqj,32767,32768,65535
36092,,fv8hyici5_cj,32768,32769,65537
36093,,s3cwa_4oiw0j,32769,32770,65539
36094,,obfiuekixc0j,32770,32771,65541
36095,,_aqxvwbx6jaj,32771,32772,65543
36096,,q-y-x4th590j,32772,32773,65545
36097,,jjfrxbcopuaj,32773,32774,65547
36098,,luaknhao3rej,32774,32775,65549
36099,,xawxqf9fnomj,32775,32776,65551
36100,,2nv8qv3rinij,32776,32777,65553
36101,,lskst2q8o1mj,32777,32778,65555
36102,,eordoke7tuqj,32778,32779,65557
36103,,ulim7z3lqpmj,32779,32780,65559
36104,,sfkyjlprfd4j,32780,32781,65561
36105,,dyentk-_dzoj,32781,32782,65563
36106,,z7aijl3nf0mj,32782,32783,65565
36107,,guqmpe_elugj,32783,32784,65567
36108,,r5bd_prkpeqj,32784,32785,65569
36109,,bjaxmxpai24j,32785,32786,65571
36110,,xb8ozky0_akj,32786,32787,65573
36111,,9i7gjbw8qzaj,32787,32788,65575
36112,,lytjmjmpo8ij,32788,32789,65577
36113,,sqog0h5o8ryj,32789,32790,65579
36114,,zr3bigqp2qcj,32790,32791,65581
36115,,1hkuityt4qkj,32791,32792,65583
36116,,0yrycrc0g3mj,32792,32793,65585
36117,,gpkcoqraxauj,32793,32794,65587
36118,,fp4vc7gbdkaj,32794,32795,65589
36119,,osn-h-ojr5wj,32795,32796,65591
36120,,url:http://www.csa.com/partners/viewrecord.php3frequester3dgs26collection3denv26recid3d8913250,32796,32797,65593
36121,,,32797,32798,65595
36122,,dkkaqtwpiicj,32798,32799,65597
36123,,44gyyu5oigej,32799,32800,65599
36124,,,32800,32801,65601
36125,,thcjlr-hbbaj,32801,32802,65603
36126,,kqbj5z0oyyqj,32802,32803,65605
36127,,nhhizjrvxgqj,32803,32804,65607
36128,,jlccbmrlywgj,32804,32805,65609
36129,,mfrmp2y5e-oj,32805,32806,65611
36130,,vrczulvf-eqj,32806,32807,65613
36131,,q6wn_crkegaj,32807,32808,65615
36132,,pnesyhwlpjoj,32808,32809,65617
36133,,kget2vmuxf4j,32809,32810,65619
36134,,6yxbfr_u6fwj,32810,32811,65621
36135,,z2bklvuux3cj,32811,32812,65623
36136,,3phliyg7mkoj,32812,32813,65625
36137,,uwc4wxslbkcj,32813,32814,65627
36138,,b4jgyztpm-qj,32814,32815,65629
36139,,mot1e6hlgdmj,32815,32816,65631
36140,,x1gcckowjk0j,32816,32817,65633
36141,,msywddfeaikj,32817,32818,65635
36142,,0tyrivp3lioj,32818,32819,65637
36143,,dza1hrv8ynuj,32819,32820,65639
36144,,url:http://www.springerlink.com/index/q700t5483078123v.pdf,32820,32821,65641
36145,,g4ti8eehu8ej,32821,32822,65643
36146,,gh08ewiyotuj,32822,32823,65645
36147,,oybz1sqgroij,32823,32824,65647
36148,,url:http://portal.acm.org/ft_gateway.cfm3fid3d12648526type3dpdf26coll3dguide26dl3dacm26cfid3d1111111126cftoken3d2222222,32824,32825,65649
36149,,25kj4dwczjej,32825,32826,65651
36150,,i6d4mhmn3mmj,32826,32827,65653
36151,,bfllptfm39cj,32827,32828,65655
36152,,fpzfcbyzqsoj,32828,32829,65657
36153,,fmcrlnaimpsj,32829,32830,65659
36154,,,32830,32831,65661
36155,,x4hkjdeyfmyj,32831,32832,65663
36156,,sviiiyct-iyj,32832,32833,65665
36157,,2uuccyt1fgcj,32833,32834,65667
36158,,iwahz2dopcqj,32834,32835,65669
36159,,19eg8cznzogj,32835,32836,65671
36160,,s7cziqwizsyj,32836,32837,65673
36161,,url:http://portal.acm.org/citation.cfm3fid3d171926.172025,32837,32838,65675
36162,,ntbrbyy7na8j,32838,32839,65677
36163,,isn5stfbxp4j,32839,32840,65679
36164,,1ogaxjx7mpmj,32840,32841,65681
36165,,rz2_ufz4aloj,32841,32842,65683
36166,,ohiznkqjuf8j,32842,32843,65685
36167,,pg72fqyvaj4j,32843,32844,65687
36168,,ewguoja1wi8j,32844,32845,65689
36169,,jhhet1ozkp4j,32845,32846,65691
36170,,_ys_5vub2moj,32847,32848,65695
36171,,_lwleog3wuoj,32848,32849,65697
36172,,url:http://doi.wiley.com/10.1002/ace.141,32849,32850,65699
36173,,rbp4ukbybegj,32850,32851,65701
36174,,xttwpnltcmij,32851,32852,65703
36175,,tjrefog96zej,32852,32853,65705
36176,,url:http://portal.acm.org/citation.cfm3fid3d1083592.1083671,32853,32854,65707
36177,,mtif-v-enzsj,32854,32855,65709
36178,,n_1qdiqnv0kj,32855,32856,65711
36179,,vecglq3yyf0j,32856,32857,65713
36180,,q_m03qrime0j,32857,32858,65715
36181,,rdagqbf2qxoj,32858,32859,65717
36182,,wbtaezw7gdgj,32859,32860,65719
36183,,,32860,32861,65721
36184,,aalg-gjgu5gj,32861,32862,65723
36185,,o7pzw976hh8j,32862,32863,65725
36186,,bl4szse-icqj,32863,32864,65727
36187,,1vzvr7_kkywj,32864,32865,65729
36188,,9l5eyp9cacij,32865,32866,65731
36189,,erxtkt6gvm8j,32866,32867,65733
36190,,kx5oa9gxiocj,32867,32868,65735
36191,,-2ib1nqgxbcj,32868,32869,65737
36192,,,32869,32870,65739
36193,,klccrj7z93mj,32870,32871,65741
36194,,p7py1bnqgraj,32871,32872,65743
36195,,z0pxx4tc3buj,32872,32873,65745
36196,,xxmundc-ilij,32873,32874,65747
36197,,5g4qe78z07yj,32874,32875,65749
36198,,nep_y_t6qgmj,32875,32876,65751
36199,,1skefbrog54j,32876,32877,65753
36200,,uhzqfs1skxaj,32877,32878,65755
36201,,mvzise9kd88j,32878,32879,65757
36202,,rzk-coznw1sj,32879,32880,65759
36203,,ebfizrzwkiuj,32880,32881,65761
36204,,7m_xggnopq8j,32881,32882,65763
36205,,lu_mzskcnaej,32882,32883,65765
36206,,vrvptjapdmcj,32883,32884,65767
36207,,vlvrywaqwraj,32884,32885,65769
36208,,d4dburmw0bkj,32885,32886,65771
36209,,hmjf3lpmrncj,32886,32887,65773
36210,,url:http://portal.acm.org/ft_gateway.cfm3fid3d109958826type3dpdf,32887,32888,65775
36211,,d4jtzvawesij,32888,32889,65777
36212,,jv7geeb6soej,32889,32890,65779
36213,,zqsrgf1kneuj,32890,32891,65781
36214,,59mxtpuiw2mj,32891,32892,65783
36215,,t0asg9xms9yj,32892,32893,65785
36216,,tkfyabmvedqj,32893,32894,65787
36217,,rvjeh8iqd98j,32894,32895,65789
36218,,url:http://portal.acm.org/ft_gateway.cfm3fid3d60187726type3dpdf26dl3dguide26dl3dacm26cfid3d1111111126cftoken3d2222222,32895,32896,65791
36219,,wvagxt8sm38j,32896,32897,65793
36220,,h3iihna9r2gj,32897,32898,65795
36221,,euyqpymhdyij,32898,32899,65797
36222,,whhhyloqwxsj,32899,32900,65799
36223,,pvni0yqrqtqj,32900,32901,65801
36224,,9-dhbe6t16ij,32901,32902,65803
36225,,9wr9hjiwifej,32902,32903,65805
36226,,uzrmgqqyb8ij,32903,32904,65807
36227,,lelk5ga4iukj,32904,32905,65809
36228,,z5ny6lurgsij,32905,32906,65811
36229,,h1rwvqxzihuj,32906,32907,65813
36230,,url:http://portal.acm.org/ft_gateway.cfm3fid3d109967026type3dpdf,32907,32908,65815
36231,,honmpub-yywj,32908,32909,65817
36232,,nxdrt01khfsj,32909,32910,65819
36233,,az-tlxst2xuj,32910,32911,65821
36234,,s1sfkyhomuqj,32911,32912,65823
36235,,ypybfz4-1uqj,32912,32913,65825
36236,,ofwtbnggigkj,32913,32914,65827
36237,,9uf3uzbgjhgj,32914,32915,65829
36238,,eszwkhgzoboj,32915,32916,65831
36239,,qq06eyb30syj,32916,32917,65833
36240,,el9osj6lqfqj,32917,32918,65835
36241,,hhlx8jse3ywj,32918,32919,65837
36242,,nnadg919z64j,32919,32920,65839
36243,,url:http://www.csa.com/partners/viewrecord.php3frequester3dgs26collection3dtrd26recid3d0990398ci,32920,32921,65841
36244,,xmq60pg7ggij,32921,32922,65843
36245,,9k_mmbilhh0j,32923,32924,65847
36246,,zr1rpzb_oncj,32924,32925,65849
36247,,dyt7gniuzgsj,32925,32926,65851
36248,,url:http://doi.wiley.com/10.1002/tl.8103,32926,32927,65853
36249,,9vozijzrwp8j,32927,32928,65855
36250,,ve8k4auz-n0j,32928,32929,65857
36251,,6ucrwkqfisoj,32930,32931,65861
36252,,guziynfrhjkj,32931,32932,65863
36253,,oilmnygi_nsj,32932,32933,65865
36254,,xn6odnl_yaij,32933,32934,65867
36255,,7vgozr5zllqj,32934,32935,65869
36256,,roejls8mhfsj,32935,32936,65871
36257,,wbs3onc5aggj,32936,32937,65873
36258,,yyzr30jp_g8j,32937,32938,65875
36259,,-6ddacxvsnmj,32938,32939,65877
36260,,vwixn3ixyumj,32939,32940,65879
36261,,gesjlr9zncuj,32940,32941,65881
36262,,giah15r0eloj,32941,32942,65883
36263,,pdjdumoo82qj,32942,32943,65885
36264,,e0dmmslhktcj,32943,32944,65887
36265,,7uryd0v1kxoj,32944,32945,65889
36266,,onsh-v2yngmj,32945,32946,65891
36267,,uwp95fxqzeqj,32946,32947,65893
36268,,qhjfw-eecsqj,32947,32948,65895
36269,,37sfqz35zqgj,32948,32949,65897
36270,,c5dls8gtlo8j,32949,32950,65899
36271,,j_cdooi9jkoj,32950,32951,65901
36272,,nq40w4newwgj,32951,32952,65903
36273,,jtwcpfsluxyj,32952,32953,65905
36274,,yfk0dpzmqdkj,32953,32954,65907
36275,,mdmgp4jwwjmj,32954,32955,65909
36276,,iztxudvqyg8j,32955,32956,65911
36277,,4ekaqhznr-oj,32956,32957,65913
36278,,fvas1tel0x4j,32957,32958,65915
36279,,6quyfv-zppkj,32958,32959,65917
36280,,k_4u-3sdrp0j,32959,32960,65919
36281,,8rnexo5a34qj,32960,32961,65921
36282,,cebu3z6zmxwj,32961,32962,65923
36283,,dsvdcoswfzkj,32962,32963,65925
36284,,ohidm8y7ax4j,32963,32964,65927
36285,,url:http://portal.acm.org/ft_gateway.cfm3fid3d109969626type3dpdf,32964,32965,65929
36286,,pfdtyzjm6sqj,32965,32966,65931
36287,,url:http://www.springerlink.com/index/x273r9628m238h34.pdf,32966,32967,65933
36288,,0zem8adjqcij,32967,32968,65935
36289,,rocfurl2r3yj,32968,32969,65937
36290,,k6wk2dtyu0ej,32969,32970,65939
36291,,y8hg2jlycecj,32970,32971,65941
36292,,url:http://www.csa.com/partners/viewrecord.php3frequester3dgs26collection3dtrd26recid3d0116690ci,32971,32972,65943
36293,,a9knis5ht-ij,32972,32973,65945
36294,,wxvu_l74afmj,32973,32974,65947
36295,,-8vl_arexioj,32974,32975,65949
36296,,uklkgsjyenqj,32975,32976,65951
36297,,c0bn_qgxcy0j,32976,32977,65953
36298,,xybfaojubzsj,32977,32978,65955
36299,,lprwz36khacj,32978,32979,65957
36300,,y4fyb_bv2akj,32979,32980,65959
36301,,3byhg5vh-aej,32980,32981,65961
36302,,odpkxdymwhsj,32981,32982,65963
36303,,rpv_l-3dztkj,32982,32983,65965
36304,,m7xksyqffu0j,32983,32984,65967
36305,,6freyueh5rcj,32984,32985,65969
36306,,dicveelwtwkj,32985,32986,65971
36307,,m_n55lcmf-sj,32986,32987,65973
36308,,zympjyazs6qj,32987,32988,65975
36309,,gr4n_xadafej,32988,32989,65977
36310,,lf2mfkw48noj,32989,32990,65979
36311,,url:http://ieeexplore.ieee.org/iel1/2206/1845/00050590.pdf3farnumber3d50590,32990,32991,65981
36312,,rx6obtojrwwj,32991,32992,65983
36313,,vqxhrxokpu4j,32992,32993,65985
36314,,upxwtgmrcx0j,32993,32994,65987
36315,,url:http://doi.wiley.com/10.1002/tl.145,32994,32995,65989
36316,,p_cahllekxsj,32995,32996,65991
36317,,tlo_sgzjnc4j,32996,32997,65993
36318,,1n2itsal8ukj,32997,32998,65995
36319,,fxcnu_x9h7ej,32998,32999,65997
36320,,rd_ar0_fasaj,32999,33000,65999
36321,,f-sojbeje2qj,33000,33001,66001
36322,,iqcrdfg8mikj,33001,33002,66003
36323,,yrekpe6c4qkj,33002,33003,66005
36324,,sc_ovhdnziuj,33003,33004,66007
36325,,zjnyclmsv1ej,33004,33005,66009
36326,,url:http://www.ingentaconnect.com/search/expand3fpub3dinfobike://pep/jae/2003/00000217/00000002/art0000126unc3d,33005,33006,66011
36327,,p8lasccnigqj,33006,33007,66013
36328,,ewortdkfowkj,33007,33008,66015
36329,,83jt6mn9-_ij,33008,33009,66017
36330,,gtnlyymxgrmj,33009,33010,66019
36331,,gceawqt71t0j,33010,33011,66021
36332,,5m6nxkdsulyj,33011,33012,66023
36333,,_wtghqna890j,33012,33013,66025
36334,,jxftoihwap0j,33013,33014,66027
36335,,skwd9gx_8mej,33014,33015,66029
36336,,mwk8mrs1uw4j,33016,33017,66033
36337,,akicmaiqvysj,33017,33018,66035
36338,,vfxedydrpk0j,33018,33019,66037
36339,,tmrg1t5egbkj,33019,33020,66039
36340,,wifnnuw2yz0j,33020,33021,66041
36341,,ce9iyfndhzmj,33021,33022,66043
36342,,5uzzuuucxqgj,33022,33023,66045
36343,,z15rbb_lnbgj,33023,33024,66047
36344,,hfzpouxfe0aj,33024,33025,66049
36345,,x-vebg6wio4j,33025,33026,66051
36346,,oydm0o0j_cej,33026,33027,66053
36347,,4qiskzscwmcj,33027,33028,66055
36348,,r9pqx5-dzymj,33028,33029,66057
36349,,ha-rqvf4izaj,33029,33030,66059
36350,,jlyy7c0-cnij,33030,33031,66061
36351,,vpkoa4r_su8j,33031,33032,66063
36352,,0fpehveoo24j,33032,33033,66065
36353,,h7dyhkduyeoj,33033,33034,66067
36354,,ntccpmd0zpoj,33034,33035,66069
36355,,kfnnclyq4xyj,33035,33036,66071
36356,,hq1mzq1gwguj,33036,33037,66073
36357,,wjnc6702qlej,33038,33039,66077
36358,,gtoqnqwwnwaj,33039,33040,66079
36359,,ev37tv2l_eqj,33040,33041,66081
36360,,gkkrw7d32r0j,33041,33042,66083
36361,,0wendod--oej,33042,33043,66085
36362,,galj7tbeyemj,33043,33044,66087
36363,,p262xrqq9-qj,33044,33045,66089
36364,,7qx78i4jhs4j,33045,33046,66091
36365,,h32efj9gi6gj,33046,33047,66093
36366,,qiicznhiugkj,33047,33048,66095
36367,,ifh0m1skv6yj,33048,33049,66097
36368,,v9wni_z5lfgj,33049,33050,66099
36369,,url:http://doi.wiley.com/10.1002/tl.70,33050,33051,66101
36370,,eptaqugccymj,33051,33052,66103
36371,,gt0ggqofli8j,33052,33053,66105
36372,,carmbvnk-skj,33053,33054,66107
36373,,url:http://portal.acm.org/ft_gateway.cfm3fid3d35310326type3dpdf26dl3dguide26dl3dacm26cfid3d1111111126cftoken3d2222222,33054,33055,66109
36374,,ievjmtz_z9sj,33055,33056,66111
36375,,nk9xn7_n0p8j,33056,33057,66113
36376,,hx4fm40x2hsj,33057,33058,66115
36377,,-jjv3uyhh-8j,33058,33059,66117
36378,,ni7lxwqh72mj,33060,33061,66121
36379,,t-avyn2l1-0j,33061,33062,66123
36380,,e681mybagn0j,33063,33064,66127
36381,,,33064,33065,66129
36382,,zfamlu9jdykj,33065,33066,66131
36383,,ersjtngoscsj,33066,33067,66133
36384,,6sodtrkziucj,33067,33068,66135
36385,,dsbc_ssmus4j,33068,33069,66137
36386,,y7j0sm6wo2kj,33069,33070,66139
36387,,v90sc1q8nroj,33070,33071,66141
36388,,8ct2sbz52naj,33071,33072,66143
36389,,1d-m7w-gsvaj,33072,33073,66145
36390,,5sg1yo3uqawj,33073,33074,66147
36391,,pjflyaeuvhmj,33074,33075,66149
36392,,tin6epzv2gkj,33075,33076,66151
36393,,xqv0dhmrylyj,33076,33077,66153
36394,,itzzmtvkrrej,33077,33078,66155
36395,,gjtro6n_054j,33078,33079,66157
36396,,nuzhcjeyur4j,33079,33080,66159
36397,,dxfdamvhaqwj,33080,33081,66161
36398,,mlm1fzarl68j,33081,33082,66163
36399,,yc0agzc91eij,33082,33083,66165
36400,,q2yo55nq4lqj,33084,33085,66169
36401,,luhhimbjzxcj,33085,33086,66171
36402,,grchbh2z2skj,33086,33087,66173
36403,,plcdptnvgggj,33087,33088,66175
36404,,51vkewuxxlij,33088,33089,66177
36405,,sguc-iwfmbcj,33089,33090,66179
36406,,,33090,33091,66181
36407,,2ioaaiqufhgj,33091,33092,66183
36408,,ux2fedp7lwaj,33092,33093,66185
36409,,mkyr3nuh2h4j,33093,33094,66187
36410,,ogohygnxsxwj,33094,33095,66189
36411,,l3zqybmftnsj,33095,33096,66191
36412,,kfdaxl7y0jyj,33096,33097,66193
36413,,yt6km18ghiij,33097,33098,66195
36414,,u6b_e5zjx_yj,33098,33099,66197
36415,,dlqd1frczdij,33099,33100,66199
36416,,_01h9wgv1ugj,33100,33101,66201
36417,,url:http://portal.acm.org/ft_gateway.cfm3fid3d110199026type3dpdf,33101,33102,66203
36418,,2z6p61hzdwyj,33102,33103,66205
36419,,eulxvht-fnmj,33103,33104,66207
36420,,jqceo72meryj,33104,33105,66209
36421,,jgnez37ijscj,33105,33106,66211
36422,,bp6moaqvzhyj,33106,33107,66213
36423,,url:http://www.csa.com/partners/viewrecord.php3frequester3dgs26collection3dtrd26recid3dn9210364ah,33107,33108,66215
36424,,sal9tjzv_lgj,33108,33109,66217
36425,,url:http://www.csa.com/partners/viewrecord.php3frequester3dgs26collection3dtrd26recid3d20021214039899mt26recid3da7423805ah,33109,33110,66219
36426,,kuuek-ybqqmj,33110,33111,66221
36427,,ycisz_4dxi8j,33111,33112,66223
36428,,xqrxry50pmqj,33112,33113,66225
36429,,ld3jrjyyrbgj,33113,33114,66227
36430,,fxbkrtd5nvij,33114,33115,66229
36431,,rq_chzy0xgqj,33115,33116,66231
36432,,0spc6ovjcw4j,33116,33117,66233
36433,,npau9fuvflaj,33117,33118,66235
36434,,9zwvmfn0ucoj,33118,33119,66237
36435,,fdz--nkh6foj,33119,33120,66239
36436,,,33120,33121,66241
36437,,xmrpor8jfeuj,33121,33122,66243
36438,,e68j7sontt4j,33122,33123,66245
36439,,xnnbinmxaqcj,33123,33124,66247
36440,,a2yewc7llbmj,33124,33125,66249
36441,,url:http://portal.acm.org/ft_gateway.cfm3fid3d110127026type3dpdf,33125,33126,66251
36442,,e44hcx2ibduj,33126,33127,66253
36443,,8r1za0wbbhej,33127,33128,66255
36444,,sw5bcxhie_4j,33128,33129,66257
36445,,url:http://links.jstor.org/sici3fsici3d0146-4949(196121252f22)2253a2253c5253a2522papif253e2.0.co253b2-h,33129,33130,66259
36446,,ahmorsqtuy8j,33130,33131,66261
36447,,7yq28_l2uioj,33131,33132,66263
36448,,zt0el1n_2h4j,33132,33133,66265
36449,,x98rt0mo-7oj,33133,33134,66267
36450,,5a3wsngbe-gj,33134,33135,66269
36451,,ewsb9pfjos8j,33135,33136,66271
36452,,y9k_lztb8hyj,33136,33137,66273
36453,,wp7szolfolqj,33137,33138,66275
36454,,url:http://www.csa.com/partners/viewrecord.php3frequester3dgs26collection3dtrd26recid3da8622963ah,33138,33139,66277
36455,,olgn6chb4akj,33139,33140,66279
36456,,jzbvg5zzmgsj,33140,33141,66281
36457,,dkswuu2z6rgj,33141,33142,66283
36458,,jfzfalz74aoj,33142,33143,66285
36459,,t936dofmnhej,33143,33144,66287
36460,,dioyeuqpha8j,33145,33146,66291
36461,,bq5cuke-vukj,33146,33147,66293
36462,,ujzc3kx4ecoj,33147,33148,66295
36463,,8q5ri3gwwm0j,33148,33149,66297
36464,,xbc9wp2giwgj,33150,33151,66301
36465,,fpuybwkqecsj,33151,33152,66303
36466,,cxbtgheyor0j,33152,33153,66305
36467,,op9smr1hp2gj,33153,33154,66307
36468,,url:http://portal.acm.org/ft_gateway.cfm3fid3d102770826type3dpdf,33154,33155,66309
36469,,2-w8j0tatdsj,33155,33156,66311
36470,,url:http://ieeexplore.ieee.org/iel5/10304/32737/01536696.pdf3farnumber3d1536696,33156,33157,66313
36471,,hutz23tc7z8j,33157,33158,66315
36472,,0ax9sw6wvxkj,33158,33159,66317
36473,,z6m6iqngnvmj,33159,33160,66319
36474,,oxdj7d1a09mj,33160,33161,66321
36475,,gkdle0v62gcj,33161,33162,66323
36476,,7i7xa5pr4_ej,33162,33163,66325
36477,,fnijla5xlb4j,33163,33164,66327
36478,,ik_m3raicjuj,33164,33165,66329
36479,,u3wlrruk7z8j,33165,33166,66331
36480,,url:http://portal.acm.org/citation.cfm3fid3d319684,33166,33167,66333
36481,,6-et37x0fv8j,33167,33168,66335
36482,,qcbfkp5hmj8j,33168,33169,66337
36483,,vlylozqzzxej,33169,33170,66339
36484,,lnlvepklacaj,33170,33171,66341
36485,,bf3597ivopcj,33171,33172,66343
36486,,u7w0sus1edej,33172,33173,66345
36487,,1fw8piwlpyqj,33173,33174,66347
36488,,xtj-pyh3s4gj,33174,33175,66349
36489,,i0_ur4npdgwj,33175,33176,66351
36490,,tfszf5iqeqaj,33176,33177,66353
36491,,z4cijeyxqa8j,33177,33178,66355
36492,,vt76r8-ltdwj,33178,33179,66357
36493,,hubrp1bhlyuj,33179,33180,66359
36494,,qgu3sgqht-ej,33180,33181,66361
36495,,bxpqhjgdtkoj,33181,33182,66363
36496,,n7y3qylpmfqj,33182,33183,66365
36497,,npbtcgo0mekj,33183,33184,66367
36498,,ywd1mtyusw8j,33184,33185,66369
36499,,tzvonrujanej,33185,33186,66371
36500,,7vtzyqgpctgj,33186,33187,66373
36501,,ficuvb1q0auj,33187,33188,66375
36502,,ve7hahpsauwj,33188,33189,66377
36503,,0ihat5dfwquj,33189,33190,66379
36504,,ewhra85gwwkj,33190,33191,66381
36505,,u8jny2iwiwij,33191,33192,66383
36506,,iww-gsyhlsuj,33192,33193,66385
36507,,ujg5elnh7scj,33193,33194,66387
36508,,qceuwoznwa4j,33194,33195,66389
36509,,r2fa9px0y-uj,33195,33196,66391
36510,,heox0vu4-jcj,33196,33197,66393
36511,,e-k7xkl3pgkj,33198,33199,66397
36512,,uflhddbor5oj,33199,33200,66399
36513,,8loyoktwz_8j,33200,33201,66401
36514,,q1b-gzdxugej,33201,33202,66403
36515,,jp4jijmnuy8j,33202,33203,66405
36516,,eq-98hcgqtgj,33203,33204,66407
36517,,mohnviwti88j,33204,33205,66409
36518,,0tv3g1p3_loj,33205,33206,66411
36519,,nnpqhezwguaj,33206,33207,66413
36520,,a6kw_7runxkj,33207,33208,66415
36521,,aafuuc1tcouj,33208,33209,66417
36522,,cqlj99jkq4ej,33209,33210,66419
36523,,pvsfkvzngd4j,33212,33213,66425
36524,,qo0qvykafsmj,33213,33214,66427
36525,,zy1qfqzp8s8j,33214,33215,66429
36526,,atb54o8j2oaj,33215,33216,66431
36527,,bepozs51tyoj,33216,33217,66433
36528,,mbvahgfvz9ej,33217,33218,66435
36529,,ndpqwnlwawuj,33218,33219,66437
36530,,pykigftbmd0j,33219,33220,66439
36531,,zzlrqc169q8j,33220,33221,66441
36532,,ff23mnsdlh8j,33221,33222,66443
36533,,_vvzbr4rdvoj,33222,33223,66445
36534,,mswoujo5cyej,33223,33224,66447
36535,,url:http://portal.acm.org/ft_gateway.cfm3fid3d14137926type3dpdf,33224,33225,66449
36536,,url:http://ieeexplore.ieee.org/iel5/35/23771/01091089.pdf3farnumber3d1091089,33225,33226,66451
36537,,cfvosnm-ebmj,33226,33227,66453
36538,,url:http://portal.acm.org/citation.cfm3fid3d144111.144164,33227,33228,66455
36539,,t2g5hx2__qqj,33228,33229,66457
36540,,eixt-sq4ue0j,33229,33230,66459
36541,,xadkxwjsyqqj,33230,33231,66461
36542,,u764rkqsmkgj,33231,33232,66463
36543,,rst38ljpta8j,33232,33233,66465
36544,,1e3as8lkfrmj,33233,33234,66467
36545,,ld4zyspn7okj,33234,33235,66469
36546,,url:http://portal.acm.org/ft_gateway.cfm3fid3d108370126type3dpdf,33235,33236,66471
36547,,qvvf2hekeqej,33236,33237,66473
36548,,38dqducralqj,33237,33238,66475
36549,,kaq5elrzrqsj,33238,33239,66477
36550,,yfhmkvqewmij,33239,33240,66479
36551,,zxaxlqvoy5ij,33240,33241,66481
36552,,rryugyjc6p0j,33241,33242,66483
36553,,gatvqyza1luj,33242,33243,66485
36554,,ckhcqh8tlfsj,33243,33244,66487
36555,,i2tqqquglt4j,33244,33245,66489
36556,,ta7qwvwlnomj,33245,33246,66491
36557,,urlblohmcq4j,33246,33247,66493
36558,,dirm_fgakoaj,33247,33248,66495
36559,,o2qgdf4l94mj,33248,33249,66497
36560,,gfpyii3s0aij,33249,33250,66499
36561,,nnhiccsiht0j,33250,33251,66501
36562,,vrx-jmoggxwj,33251,33252,66503
36563,,ivb0y-51gz8j,33252,33253,66505
36564,,swmp9dy4ttej,33253,33254,66507
36565,,vktm8bbxqb4j,33254,33255,66509
36566,,gv_xtvlj-rwj,33255,33256,66511
36567,,pfv38ctcmjoj,33256,33257,66513
36568,,4nijuftplwcj,33257,33258,66515
36569,,url:http://www.csa.com/partners/viewrecord.php3frequester3dgs26collection3dtrd26recid3d821422co,33258,33259,66517
36570,,6gpsjvp79vkj,33259,33260,66519
36571,,qenn_bs7-pgj,33260,33261,66521
36572,,qqxnu65cmosj,33261,33262,66523
36573,,2wrdgm_1ujwj,33262,33263,66525
36574,,vfdygcc3qysj,33263,33264,66527
36575,,348myfmimboj,33264,33265,66529
36576,,rbb0yy-_pygj,33266,33267,66533
36577,,r3stiei4emsj,33267,33268,66535
36578,,_x-nxhmgc18j,33268,33269,66537
36579,,lg2cuuqgu-4j,33269,33270,66539
36580,,kg2wqrcqdoyj,33270,33271,66541
36581,,erirjpwl0emj,33271,33272,66543
36582,,fjvhpm3h-uyj,33272,33273,66545
36583,,_8zuif8ye_0j,33273,33274,66547
36584,,qungbxsvjpsj,33274,33275,66549
36585,,naga3hpjulaj,33275,33276,66551
36586,,pnybonbzzvwj,33276,33277,66553
36587,,b-va1c3t13gj,33277,33278,66555
36588,,ervalur3gsyj,33278,33279,66557
36589,,cpaqmcx-g5aj,33279,33280,66559
36590,,u5cbiazhonkj,33280,33281,66561
36591,,,33281,33282,66563
36592,,uehhq_09vmij,33282,33283,66565
36593,,y_jefiqtlmkj,33283,33284,66567
36594,,d_7qffl5oy4j,33284,33285,66569
36595,,,33285,33286,66571
36596,,hv5sujouu3yj,33286,33287,66573
36597,,cbsg-igx65cj,33287,33288,66575
36598,,qa5ix8sndsuj,33288,33289,66577
36599,,reuvkhjm2puj,33289,33290,66579
36600,,9yleqlxqgxij,33290,33291,66581
36601,,acprwp5gibaj,33291,33292,66583
36602,,url:http://portal.acm.org/citation.cfm3fid3d1101149.1101219,33292,33293,66585
36603,,gp7vfk8l96sj,33293,33294,66587
36604,,m2erln2ajbkj,33294,33295,66589
36605,,a6eul3xnyawj,33295,33296,66591
36606,,myff63cz4luj,33297,33298,66595
36607,,n0kqw8-j7z0j,33298,33299,66597
36608,,byayzprk7k0j,33299,33300,66599
36609,,url:http://doi.wiley.com/10.1002/ev.1619,33300,33301,66601
36610,,z8utems4_wsj,33301,33302,66603
36611,,fjekmq-e5sgj,33302,33303,66605
36612,,slmhu3l7dz0j,33303,33304,66607
36613,,ydhzak2krgyj,33304,33305,66609
36614,,kmgpo8hbogyj,33305,33306,66611
36615,,url:http://portal.acm.org/ft_gateway.cfm3fid3d14100426type3dpdf26coll3dguide26dl3dacm26cfid3d1111111126cftoken3d2222222,33306,33307,66613
36616,,url:http://portal.acm.org/citation.cfm3fid3d98751,33307,33308,66615
36617,,unbv0skjxh4j,33308,33309,66617
36618,,rhl40sr5lpej,33309,33310,66619
36619,,srhjty2_dvwj,33310,33311,66621
36620,,8p44qpp4h9oj,33311,33312,66623
36621,,rqxd_avt9s4j,33312,33313,66625
36622,,r4gw_mm3mmwj,33313,33314,66627
36623,,d1wp_f8yd5mj,33314,33315,66629
36624,,wqxekmp9y78j,33315,33316,66631
36625,,cawzr6_bhbej,33316,33317,66633
36626,,rnb8sdaouc8j,33317,33318,66635
36627,,tke6g8xqpzsj,33318,33319,66637
36628,,eim3dqvs0kcj,33319,33320,66639
36629,,g_ccbi89ozwj,33320,33321,66641
36630,,psfim7sp0waj,33321,33322,66643
36631,,ku0x0_4bkz0j,33322,33323,66645
36632,,l35azlrlwyoj,33323,33324,66647
36633,,ulfez2kwm18j,33324,33325,66649
36634,,ppe_v5zt140j,33325,33326,66651
36635,,_02-k9vcjv8j,33326,33327,66653
36636,,1dnprfpx6kcj,33327,33328,66655
36637,,gvmv3emtmvgj,33328,33329,66657
36638,,lvzduh47gcaj,33329,33330,66659
36639,,qzfra87b4hej,33330,33331,66661
36640,,okuulxozmwkj,33331,33332,66663
36641,,di4kv6d3zbwj,33332,33333,66665
36642,,4vks8olwr6mj,33333,33334,66667
36643,,z_zdub1qpeoj,33334,33335,66669
36644,,hgdzd8citv8j,33335,33336,66671
36645,,8csu_r3qukaj,33336,33337,66673
36646,,tctqnbxr29mj,33337,33338,66675
36647,,buf3qy196paj,33338,33339,66677
36648,,hzpiocoyvl0j,33339,33340,66679
36649,,oisir0fajs8j,33340,33341,66681
36650,,yph8pvdl5awj,33341,33342,66683
36651,,hw9hiujczuuj,33342,33343,66685
36652,,qxykeh-fnqmj,33343,33344,66687
36653,,qgor1lk7fc8j,33344,33345,66689
36654,,ybaoyzwkvzwj,33345,33346,66691
36655,,tmdgkj4g1mej,33346,33347,66693
36656,,tol8czls984j,33347,33348,66695
36657,,i9wqr1yxer4j,33348,33349,66697
36658,,1x8g-w3a4wej,33349,33350,66699
36659,,uhgr-wdpvzmj,33350,33351,66701
36660,,admdnsy5zucj,33351,33352,66703
36661,,f7sg6xfaxcej,33352,33353,66705
36662,,vfnb_ivk0soj,33353,33354,66707
36663,,8smo1k1gabsj,33354,33355,66709
36664,,rpkyh6nbk6qj,33355,33356,66711
36665,,kb8rnxclhw0j,33356,33357,66713
36666,,swm6pkw-jaqj,33357,33358,66715
36667,,b7ez1hjyhiij,33358,33359,66717
36668,,mdnm4tiktxuj,33359,33360,66719
36669,,zwe81lfcr44j,33360,33361,66721
36670,,rcv3ukepnk0j,33361,33362,66723
36671,,m34wdarsssmj,33362,33363,66725
36672,,etuzlcctsd8j,33363,33364,66727
36673,,dtclmlmrfxij,33364,33365,66729
36674,,m_b-e17dfdoj,33365,33366,66731
36675,,m04de-q6gv8j,33366,33367,66733
36676,,ml1-iyrteiij,33369,33370,66739
36677,,cuvj8svrad0j,33370,33371,66741
36678,,pww7hdef-lqj,33371,33372,66743
36679,,cmfdhquxxhmj,33372,33373,66745
36680,,nc4-sxczfamj,33373,33374,66747
36681,,xdolek64dimj,33374,33375,66749
36682,,4sbe1lbanzuj,33375,33376,66751
36683,,5yjjutcr8imj,33376,33377,66753
36684,,5_g78n9vxgsj,33377,33378,66755
36685,,dpqgq6n1jnkj,33378,33379,66757
36686,,rhmvqzyra6wj,33379,33380,66759
36687,,1bwwbz7moioj,33381,33382,66763
36688,,nn33dlrix4kj,33382,33383,66765
36689,,skkkrvdxgvsj,33383,33384,66767
36690,,sxn3gsd_5taj,33384,33385,66769
36691,,ssd8m_kyzauj,33385,33386,66771
36692,,f-hy7vphvy0j,33386,33387,66773
36693,,vlv480h49v8j,33387,33388,66775
36694,,fru_zn00migj,33388,33389,66777
36695,,url:http://portal.acm.org/ft_gateway.cfm3fid3d106520726type3dpdf,33389,33390,66779
36696,,dxxdkudodlgj,33390,33391,66781
36697,,0igejzw7h7ij,33391,33392,66783
36698,,ctnurfwp5iuj,33392,33393,66785
36699,,9wltxnktm_ej,33393,33394,66787
36700,,mdr5cqpilu8j,33394,33395,66789
36701,,lduaymelthoj,33395,33396,66791
36702,,aexruibzpioj,33396,33397,66793
36703,,p0yyqcjyahwj,33397,33398,66795
36704,,bttheca-x7kj,33398,33399,66797
36705,,p4gggzwk-zaj,33399,33400,66799
36706,,cllrs5uiihij,33400,33401,66801
36707,,uc8mwfpn0duj,33401,33402,66803
36708,,4_yydwmhfasj,33402,33403,66805
36709,,jr8cqftcrwcj,33403,33404,66807
36710,,ckw_yapdv1ej,33404,33405,66809
36711,,zr2xharc-gmj,33405,33406,66811
36712,,d-vziimlj08j,33406,33407,66813
36713,,ljyrtngp_kkj,33407,33408,66815
36714,,dlxkbeojri0j,33408,33409,66817
36715,,cudkqf6nmvqj,33409,33410,66819
36716,,zz61cicf7rcj,33410,33411,66821
36717,,url:http://doi.wiley.com/10.1002/ace.8504,33411,33412,66823
36718,,opfft7_oiyyj,33412,33413,66825
36719,,kkqthuq6iiyj,33413,33414,66827
36720,,obfyephq5tsj,33414,33415,66829
36721,,z1wpz0rlywmj,33415,33416,66831
36722,,cjofmifz3mwj,33416,33417,66833
36723,,xbgojzs4awsj,33417,33418,66835
36724,,wi8uodyhqpmj,33418,33419,66837
36725,,wkg60lmgubcj,33419,33420,66839
36726,,k27zw1l_agqj,33420,33421,66841
36727,,url:http://www.csa.com/partners/viewrecord.php3frequester3dgs26collection3denv26recid3d1963858,33421,33422,66843
36728,,c2ng7rwq6bwj,33422,33423,66845
36729,,owtm6kbwjjkj,33423,33424,66847
36730,,,33424,33425,66849
36731,,frjdrbth_40j,33425,33426,66851
36732,,p3h1cc3714mj,33426,33427,66853
36733,,jcm8sbxlgrmj,33427,33428,66855
36734,,fq3cfkab9d8j,33428,33429,66857
36735,,hpt5sft61cej,33429,33430,66859
36736,,url:http://www.springerlink.com/index/m22809848733582r.pdf,33430,33431,66861
36737,,kh7puc71djkj,33431,33432,66863
36738,,neytylqkgryj,33432,33433,66865
36739,,avzfef_qh6mj,33433,33434,66867
36740,,7zpcisoauy4j,33434,33435,66869
36741,,rr2ad7q3jvgj,33435,33436,66871
36742,,mhfj1ukknj8j,33436,33437,66873
36743,,c_kke1do4g8j,33437,33438,66875
36744,,xytw581yzwsj,33438,33439,66877
36745,,url:http://portal.acm.org/ft_gateway.cfm3fid3d102763326type3dpdf,33439,33440,66879
36746,,pbbxony3d8ij,33440,33441,66881
36747,,rzigvjnxoxwj,33441,33442,66883
36748,,gaa50fzwlhoj,33443,33444,66887
36749,,4zduuz1vf0ij,33445,33446,66891
36750,,abi_tyg1iqqj,33446,33447,66893
36751,,rxdhyjwfwtwj,33447,33448,66895
36752,,mcswwdbo6x4j,33448,33449,66897
36753,,lqljjnwua1cj,33449,33450,66899
36754,,kjvrr9rb09sj,33450,33451,66901
36755,,bbwtfvo3-agj,33451,33452,66903
36756,,ncqgcdyj_hij,33453,33454,66907
36757,,url:http://doi.wiley.com/10.1002/ev.1491,33454,33455,66909
36758,,x8-okj8boumj,33455,33456,66911
36759,,url:http://www.kluweronline.com/article.asp3fpips3d509221126pdf3d1,33456,33457,66913
36760,,bukqbicy88gj,33457,33458,66915
36761,,url:http://portal.acm.org/ft_gateway.cfm3fid3d106623926type3dpdf,33458,33459,66917
36762,,mdauynun2_sj,33459,33460,66919
36763,,agfwtxrkvs8j,33460,33461,66921
36764,,mxptyfl6okoj,33461,33462,66923
36765,,00-t_like8qj,33462,33463,66925
36766,,url:http://ieeexplore.ieee.org/iel2/796/2456/00070269.pdf3farnumber3d70269,33463,33464,66927
36767,,d0b0rjsmdtgj,33464,33465,66929
36768,,jhq1zfd5pamj,33465,33466,66931
36769,,url:http://www.csa.com/partners/viewrecord.php3frequester3dgs26collection3dtrd26recid3dn9210496ah,33466,33467,66933
36770,,vf9c_i6rtykj,33467,33468,66935
36771,,pyd_oa0dxq8j,33468,33469,66937
36772,,gneuojf4uwej,33469,33470,66939
36773,,kmagdb9vzjoj,33470,33471,66941
36774,,zbjvuskqqrij,33471,33472,66943
36775,,cpmlt65er1wj,33472,33473,66945
36776,,rsw-qkri754j,33473,33474,66947
36777,,cxup7vs8jhej,33474,33475,66949
36778,,0ddihzzuahsj,33475,33476,66951
36779,,1j3auztzygcj,33476,33477,66953
36780,,hwg3szapmlyj,33477,33478,66955
36781,,isioucr79t8j,33478,33479,66957
36782,,4wgwyafvexcj,33479,33480,66959
36783,,reovld25dgaj,33480,33481,66961
36784,,vwrbw2eeus4j,33481,33482,66963
36785,,frghi1ngdn4j,33482,33483,66965
36786,,aihpwbubih4j,33483,33484,66967
36787,,zoumf210s0sj,33484,33485,66969
36788,,_4qcvzhs9q0j,33485,33486,66971
36789,,xl1jscb79kej,33486,33487,66973
36790,,uga_yzn0q_yj,33487,33488,66975
36791,,mtlqknyfd70j,33488,33489,66977
36792,,qha0atxwvxcj,33489,33490,66979
36793,,2mbirxxncwmj,33490,33491,66981
36794,,bgsk7b0dseyj,33491,33492,66983
36795,,xr2ns4fm89oj,33492,33493,66985
36796,,mt7baxqhwuej,33493,33494,66987
36797,,lbq7bzizng4j,33494,33495,66989
36798,,fk6dz1xxl9ej,33495,33496,66991
36799,,hwebsamhwwcj,33496,33497,66993
36800,,gkd99rpndi8j,33497,33498,66995
36801,,rf8nvhjl4psj,33498,33499,66997
36802,,dsed9uzjbuuj,33499,33500,66999
36803,,hp3u_cpnujqj,33500,33501,67001
36804,,7bzs4i77rzwj,33501,33502,67003
36805,,m83rfwh2lioj,33502,33503,67005
36806,,ceoyngcupumj,33503,33504,67007
36807,,csd8wmsf1o8j,33505,33506,67011
36808,,eb1of91_nisj,33506,33507,67013
36809,,url:http://www.csa.com/partners/viewrecord.php3frequester3dgs26collection3dtrd26recid3dn9210408ah,33507,33508,67015
36810,,mrg1m5j3c6uj,33508,33509,67017
36811,,8fsiiua6ecej,33509,33510,67019
36812,,py-dslmftruj,33510,33511,67021
36813,,gxsvjhsuqcaj,33511,33512,67023
36814,,4da9p8bs3kcj,33512,33513,67025
36815,,kpupaw5kklsj,33513,33514,67027
36816,,tkq6nymsvxsj,33514,33515,67029
36817,,xwvqvtkd6-cj,33515,33516,67031
36818,,bheifpxfsrsj,33516,33517,67033
36819,,ywwumtxbdxmj,33517,33518,67035
36820,,_zt42a9bkjgj,33518,33519,67037
36821,,bttbcu4ilqmj,33519,33520,67039
36822,,elh7p-eugmaj,33520,33521,67041
36823,,fclkg3m1b2cj,33521,33522,67043
36824,,5irtrwl98ngj,33522,33523,67045
36825,,oluf0opjojoj,33523,33524,67047
36826,,f06tvq3d6yoj,33524,33525,67049
36827,,zxtvbjwoypmj,33525,33526,67051
36828,,cu-adnwny5wj,33526,33527,67053
36829,,jnhjcpjcu8kj,33527,33528,67055
36830,,fgimikpcljij,33528,33529,67057
36831,,gwpk8aongpmj,33529,33530,67059
36832,,fxaxcglm0o8j,33530,33531,67061
36833,,url:http://www.springerlink.com/index/l4h4h12200406465.pdf,33531,33532,67063
36834,,0f-iyjrggqkj,33532,33533,67065
36835,,bnuyehtdtcsj,33533,33534,67067
36836,,,33534,33535,67069
36837,,_ydvedvj_yqj,33535,33536,67071
36838,,xne9b0rix8oj,33536,33537,67073
36839,,zogurrkkreuj,33537,33538,67075
36840,,url:http://netserv.iet.unipi.it/saverio/pdf/011.pdf,33538,33539,67077
36841,,_7iqwl79lksj,33539,33540,67079
36842,,izkfwwnhyr8j,33540,33541,67081
36843,,ssynrxenhswj,33541,33542,67083
36844,,lvfwzlkxhq8j,33542,33543,67085
36845,,p6h31mpw0tyj,33543,33544,67087
36846,,craxfj71-agj,33544,33545,67089
36847,,url:http://doi.wiley.com/10.1002/tl.55,33545,33546,67091
36848,,vsotct1y5zuj,33546,33547,67093
36849,,buqeh5i2-4wj,33547,33548,67095
36850,,xr2yvlquffqj,33548,33549,67097
36851,,tesw3ebfe68j,33549,33550,67099
36852,,r4uyk-k3h8sj,33550,33551,67101
36853,,url:http://portal.acm.org/citation.cfm3fid3d335216,33551,33552,67103
36854,,y55zaq-l_1kj,33552,33553,67105
36855,,1d6af_fslesj,33553,33554,67107
36856,,nxz2znfuflij,33554,33555,67109
36857,,xbwtmy706loj,33555,33556,67111
36858,,cbohdik4icgj,33556,33557,67113
36859,,m4rc6nrz9f8j,33557,33558,67115
36860,,azs6wi3uqlmj,33558,33559,67117
36861,,url:http://doi.wiley.com/10.1002/anie.199005091,33559,33560,67119
36862,,xzkhtttuzvuj,33560,33561,67121
36863,,jaiu8btonisj,33561,33562,67123
36864,,,33562,33563,67125
36865,,dsurcngizusj,33563,33564,67127
36866,,bqoscckbfyuj,33564,33565,67129
36867,,wrc-hkz23ngj,33565,33566,67131
36868,,url:http://www.springerlink.com/index/589tqrppvbxq6ljn.pdf,33566,33567,67133
36869,,ou0kgc_hftuj,33567,33568,67135
36870,,bufnu10brt4j,33568,33569,67137
36871,,qgd7zwzazlej,33569,33570,67139
36872,,bvwpbkqrvpyj,33570,33571,67141
36873,,qexmcfyhpbgj,33572,33573,67145
36874,,5yqesx_uyaaj,33573,33574,67147
36875,,v305mot6sgaj,33574,33575,67149
36876,,y8w6duguyb4j,33575,33576,67151
36877,,sybrzbj2dbyj,33576,33577,67153
36878,,j9fyrwmewuij,33577,33578,67155
36879,,url:http://portal.acm.org/ft_gateway.cfm3fid3d109957926type3dpdf,33578,33579,67157
36880,,mr1qavmgm3kj,33579,33580,67159
36881,,8yzgkcfknukj,33580,33581,67161
36882,,o3uy_vtinwqj,33581,33582,67163
36883,,1sszwawwqlgj,33582,33583,67165
36884,,d-wovvsgh4cj,33583,33584,67167
36885,,ojpox6c0duqj,33584,33585,67169
36886,,putbuzfzey8j,33585,33586,67171
36887,,hnkvcql97vaj,33586,33587,67173
36888,,okfj293_5vgj,33587,33588,67175
36889,,aapoiitplioj,33588,33589,67177
36890,,7wczw_qk-maj,33589,33590,67179
36891,,ik_ta7ilhpkj,33590,33591,67181
36892,,w6t8uns2cfuj,33591,33592,67183
36893,,n9fw89tvoy4j,33592,33593,67185
36894,,mk6bmlwa2rgj,33593,33594,67187
36895,,vmeu18ccshgj,33594,33595,67189
36896,,quqz9tv1xvkj,33595,33596,67191
36897,,0ewnhcuwhy4j,33596,33597,67193
36898,,qps8osqsuauj,33597,33598,67195
36899,,ywhzt1f_excj,33598,33599,67197
36900,,glnt7w28ae8j,33599,33600,67199
36901,,9lfhqn-gqiuj,33600,33601,67201
36902,,ui-ch5qsce4j,33601,33602,67203
36903,,z-zpwoi0yqgj,33602,33603,67205
36904,,5989h0yiasgj,33603,33604,67207
36905,,4tewnlc17hoj,33604,33605,67209
36906,,nwd2_n23uiyj,33605,33606,67211
36907,,nlnwmrr7spij,33607,33608,67215
36908,,tomq6mxm5saj,33608,33609,67217
36909,,6x9v-mqe-roj,33609,33610,67219
36910,,mt81kiis--yj,33610,33611,67221
36911,,oqf4e4e3ad0j,33611,33612,67223
36912,,kayi60nog2aj,33612,33613,67225
36913,,qli_xo-fbp4j,33613,33614,67227
36914,,0ok-lz_koiaj,33614,33615,67229
36915,,qvf-exlryoej,33615,33616,67231
36916,,abe6etwwpggj,33616,33617,67233
36917,,7uum3wxul74j,33617,33618,67235
36918,,qz8hi9dlesgj,33618,33619,67237
36919,,pxrctvv6qquj,33619,33620,67239
36920,,nqyuojsbho8j,33620,33621,67241
36921,,odcjesaxekwj,33621,33622,67243
36922,,njlwj6gpdymj,33622,33623,67245
36923,,ts2vyw2vhpgj,33623,33624,67247
36924,,hafjr7wh9jsj,33624,33625,67249
36925,,kn5kh9pxcwqj,33625,33626,67251
36926,,9_oabfvkjyuj,33626,33627,67253
36927,,pbtruuoyfyqj,33627,33628,67255
36928,,rkh78q-rjlmj,33628,33629,67257
36929,,sanam0nnin0j,33629,33630,67259
36930,,wwm-pxn8jgej,33631,33632,67263
36931,,7qb2osncwf8j,33632,33633,67265
36932,,,33633,33634,67267
36933,,xcerogglg1aj,33634,33635,67269
36934,,g4g2oovcf2mj,33636,33637,67273
36935,,0pn9kdmv8-mj,33637,33638,67275
36936,,72s_xlm9cumj,33638,33639,67277
36937,,ryrwj_vpy6kj,33639,33640,67279
36938,,r4nlmqfv3wgj,33640,33641,67281
36939,,url:http://portal.acm.org/ft_gateway.cfm3fid3d110198926type3dpdf,33641,33642,67283
36940,,j9xz3s-vynaj,33642,33643,67285
36941,,okoc6obvamuj,33643,33644,67287
36942,,priaopxqjnkj,33644,33645,67289
36943,,q6xn0mkdnhaj,33645,33646,67291
36944,,url:http://portal.acm.org/citation.cfm3fid3d615172.615173,33646,33647,67293
36945,,fzivgpolcnwj,33647,33648,67295
36946,,shxkqn-jv3uj,33648,33649,67297
36947,,gzgkqkue8kkj,33649,33650,67299
36948,,8syzpkaetwqj,33650,33651,67301
36949,,33ekbbolg6cj,33651,33652,67303
36950,,ymdmkm9tfsmj,33652,33653,67305
36951,,1onkkvi7v8uj,33653,33654,67307
36952,,,33654,33655,67309
36953,,v1ox76a6vgej,33655,33656,67311
36954,,xb0bm5pezf8j,33656,33657,67313
36955,,ic5bd6xp_wgj,33657,33658,67315
36956,,me-ohdbrjrij,33660,33661,67321
36957,,l40qyqvjdxgj,33661,33662,67323
36958,,c2danrpzeduj,33662,33663,67325
36959,,f6nxzkgcxdej,33663,33664,67327
36960,,xen_nscybzaj,33664,33665,67329
36961,,avgkiumci0sj,33665,33666,67331
36962,,ahrxo47njtmj,33666,33667,67333
36963,,jxp_dqh9anmj,33667,33668,67335
36964,,4gyn95nwkmmj,33668,33669,67337
36965,,nhnzfdltgyoj,33671,33672,67343
36966,,1lrgfqystq8j,33672,33673,67345
36967,,p1heccvcmckj,33673,33674,67347
36968,,9tur4lts_u4j,33674,33675,67349
36969,,odb1plz8dwgj,33675,33676,67351
36970,,mdscqktbfnuj,33676,33677,67353
36971,,26rsvuw9oc4j,33677,33678,67355
36972,,k9l27vd79u4j,33678,33679,67357
36973,,_ug_07qa-mqj,33679,33680,67359
36974,,k84oazfimwgj,33680,33681,67361
36975,,url:http://portal.acm.org/ft_gateway.cfm3fid3d110751226type3dpdf,33681,33682,67363
36976,,4owq7mozhgaj,33682,33683,67365
36977,,inuicjk-wgej,33683,33684,67367
36978,,vn5zro9npdwj,33685,33686,67371
36979,,xxpgdrqhavij,33686,33687,67373
36980,,edbpykcbezuj,33687,33688,67375
36981,,decx9lknalej,33688,33689,67377
36982,,qme2v6wvenqj,33689,33690,67379
36983,,5pcm5wrqqpuj,33690,33691,67381
36984,,sbbfpzunr4sj,33691,33692,67383
36985,,hk2mahhl5oqj,33692,33693,67385
36986,,ufjsxlb6upgj,33693,33694,67387
36987,,pjinu_22a38j,33694,33695,67389
36988,,0e3bs1vfpvaj,33695,33696,67391
36989,,h3u3uxvxrquj,33696,33697,67393
36990,,9rq1je-mcxyj,33697,33698,67395
36991,,ve6ujscl5skj,33698,33699,67397
36992,,4uyvkcs3b9ij,33699,33700,67399
36993,,qmpkelhezroj,33700,33701,67401
36994,,,33701,33702,67403
36995,,gqpu-wudynij,33702,33703,67405
36996,,jlj0jex1kwkj,33703,33704,67407
36997,,2-rrmxd1mhsj,33704,33705,67409
36998,,fz2duhqvjdkj,33705,33706,67411
36999,,c2vrghmic0ij,33706,33707,67413
37000,,ldayujwgy0gj,33708,33709,67417
37001,,vceidv50kd8j,33709,33710,67419
37002,,2kt-4uedh5mj,33710,33711,67421
37003,,xwmyobtni0yj,33711,33712,67423
37004,,zccsghkhdayj,33713,33714,67427
37005,,url:http://portal.acm.org/ft_gateway.cfm3fid3d108623126type3dpdf,33714,33715,67429
37006,,url:http://pubs.acs.org/cgi-bin/abstract.cgi/achre4/2004/37/i12/abs/ar0401082b.html,33715,33716,67431
37007,,mbnpxmd1euoj,33716,33717,67433
37008,,a58ozgw7avuj,33718,33719,67437
37009,,2ejhvkyw8aoj,33719,33720,67439
37010,,qq6-sodrqayj,33720,33721,67441
37011,,be9ngykxdbaj,33721,33722,67443
37012,,3ytfyohyewyj,33722,33723,67445
37013,,d_-avsdebykj,33723,33724,67447
37014,,lnunauo0_lcj,33724,33725,67449
37015,,l1yr4ppc-wkj,33725,33726,67451
37016,,w-wybd0zoscj,33726,33727,67453
37017,,qhek4kcxbrcj,33727,33728,67455
37018,,heeweqnwrzoj,33728,33729,67457
37019,,fxdlomw8xzsj,33729,33730,67459
37020,,url:http://portal.acm.org/citation.cfm3fid3d192593.19269326dl3dportal26dl3dacm26type3dseries26idx3d19259326part3dproceedings26wanttype3dproceedings26title3dinternational2520multimedia2520conference26cfid3d1111111126cftoken3d2222222,33730,33731,67461
37021,,buvkrcjhep0j,33731,33732,67463
37022,,37be4odqhlgj,33732,33733,67465
37023,,ls5k0sq1jgqj,33733,33734,67467
37024,,jufiktthnzqj,33734,33735,67469
37025,,f90hjxodrnqj,33735,33736,67471
37026,,zq5ro0odlb8j,33736,33737,67473
37027,,eavumm_-wsij,33737,33738,67475
37028,,rr2esyq1zyij,33738,33739,67477
37029,,f8tissajvi8j,33739,33740,67479
37030,,0wwnkpca8haj,33740,33741,67481
37031,,vuq01btmx30j,33741,33742,67483
37032,,ykambu0osogj,33742,33743,67485
37033,,utpkd3ltfbaj,33743,33744,67487
37034,,dsstzunj1d0j,33744,33745,67489
37035,,ukau8ymhccij,33745,33746,67491
37036,,svlh2achp1qj,33746,33747,67493
37037,,dsg9vgubwduj,33748,33749,67497
37038,,-c2bfglx-dyj,33749,33750,67499
37039,,url:http://www.csa.com/partners/viewrecord.php3frequester3dgs26collection3dtrd26recid3dn9210561ah,33750,33751,67501
37040,,6i6k_4iptuoj,33751,33752,67503
37041,,wajziomfgjgj,33752,33753,67505
37042,,w8jxk_yfks8j,33753,33754,67507
37043,,depoi5d8efuj,33754,33755,67509
37044,,q7ahbhe7kgqj,33755,33756,67511
37045,,bkos6lfgv6wj,33756,33757,67513
37046,,thimcwyyl1gj,33757,33758,67515
37047,,szwhy7wtcpcj,33758,33759,67517
37048,,lrv3r58ctqij,33759,33760,67519
37049,,l_dorypqtjkj,33760,33761,67521
37050,,uuyuxildvjsj,33761,33762,67523
37051,,-1rdjz9ui5yj,33762,33763,67525
37052,,56aknoqlfb0j,33763,33764,67527
37053,,i3-f0um7nxqj,33764,33765,67529
37054,,rxfcjcleh6cj,33765,33766,67531
37055,,xmafdfyjdpuj,33766,33767,67533
37056,,orfs6ywrygsj,33767,33768,67535
37057,,9xihoyuyy7aj,33768,33769,67537
37058,,kq08ewsq9syj,33769,33770,67539
37059,,,33770,33771,67541
37060,,ht0mybrc9-yj,33771,33772,67543
37061,,rrz3wjpaaraj,33772,33773,67545
37062,,qqt64exlrp8j,33773,33774,67547
37063,,jjpvns45ufkj,33774,33775,67549
37064,,xg0binz0ke8j,33775,33776,67551
37065,,i31d1toxd48j,33776,33777,67553
37066,,ktc2cdkhmhkj,33777,33778,67555
37067,,tpdu98h5g9uj,33778,33779,67557
37068,,esxr7lccgdcj,33779,33780,67559
37069,,ho9c_kam9hgj,33780,33781,67561
37070,,nfgjnh4-xtmj,33781,33782,67563
37071,,rnfilqoqrbyj,33782,33783,67565
37072,,url:http://portal.acm.org/ft_gateway.cfm3fid3d102769526type3dpdf,33783,33784,67567
37073,,nenxxxlrvryj,33784,33785,67569
37074,,etmlqag8y3cj,33785,33786,67571
37075,,qqsyenlci58j,33787,33788,67575
37076,,l8xsmhrywvyj,33788,33789,67577
37077,,klxd0qnfyaoj,33789,33790,67579
37078,,ui5p8tqkkgqj,33790,33791,67581
37079,,kfli0ai9qmyj,33791,33792,67583
37080,,jbhfpuk6uy4j,33792,33793,67585
37081,,umlapdelw8sj,33793,33794,67587
37082,,url:http://www.springerlink.com/index/q64256l32386k822.pdf,33794,33795,67589
37083,,dqjjpopc3awj,33795,33796,67591
37084,,tjf85jywcukj,33796,33797,67593
37085,,gr0bduplm5sj,33797,33798,67595
37086,,88txlbbo0csj,33798,33799,67597
37087,,fydqohh2l-8j,33799,33800,67599
37088,,oysbx5nzxkkj,33800,33801,67601
37089,,5vaprro8xh0j,33801,33802,67603
37090,,huxoebsz-soj,33802,33803,67605
37091,,umwj4uv6ecij,33803,33804,67607
37092,,47bbglzpcuaj,33804,33805,67609
37093,,bpx-ad3gx5kj,33805,33806,67611
37094,,fbb94t6a5msj,33806,33807,67613
37095,,bgfovel4qqaj,33807,33808,67615
37096,,1r0rp_idwxyj,33808,33809,67617
37097,,mbce0fpsy7oj,33809,33810,67619
37098,,zrues6zqjkqj,33810,33811,67621
37099,,url:http://www.csa.com/partners/viewrecord.php3frequester3dgs26collection3dtrd26recid3d200111010667mt26recid3da0032570ah,33811,33812,67623
37100,,f-iqovjqj5ej,33812,33813,67625
37101,,5zmmi8xgug0j,33813,33814,67627
37102,,asupkywlbqgj,33814,33815,67629
37103,,aytzv-cjzi4j,33815,33816,67631
37104,,e34e5ebuftmj,33816,33817,67633
37105,,jzhf2fxd1coj,33817,33818,67635
37106,,xhfvbtp2yxqj,33818,33819,67637
37107,,ssdyihchqkmj,33819,33820,67639
37108,,ycf_6a62gxoj,33820,33821,67641
37109,,url:http://www.csa.com/partners/viewrecord.php3frequester3dgs26collection3dtrd26recid3d8902720088md26recid3d8901g2c0012ec,33821,33822,67643
37110,,5rv8gbz-kzaj,33822,33823,67645
37111,,_fvxxtqvo8qj,33823,33824,67647
37112,,cxykzp722daj,33824,33825,67649
37113,,bqyii8l0774j,33825,33826,67651
37114,,twwsi6qrvc8j,33826,33827,67653
37115,,vpnypcll-h4j,33827,33828,67655
37116,,o4vkdxkpelej,33828,33829,67657
37117,,zybtbwbejmgj,33829,33830,67659
37118,,psqepqzmrruj,33830,33831,67661
37119,,jcypw0qyb_ej,33831,33832,67663
37120,,s8t0wx-f3y8j,33832,33833,67665
37121,,ctxwdzydsrej,33833,33834,67667
37122,,ektqoytneb8j,33834,33835,67669
37123,,0qujcdx9qgaj,33835,33836,67671
37124,,yiqz0mr36gkj,33836,33837,67673
37125,,b0gcpdwufgaj,33837,33838,67675
37126,,2gsp0d2pgemj,33838,33839,67677
37127,,y-vrfzbi4syj,33839,33840,67679
37128,,url:http://links.jstor.org/sici3fsici3d0146-4949(196221252f22)3253a2253c5253atao2522b253e2.0.co253b2-0,33840,33841,67681
37129,,i-scery5ud4j,33841,33842,67683
37130,,m6ii0f95g7aj,33842,33843,67685
37131,,pygrz3lvd1aj,33843,33844,67687
37132,,ak4kujeduv0j,33844,33845,67689
37133,,dgsvfkcshqqj,33845,33846,67691
37134,,hjybadikcbcj,33846,33847,67693
37135,,-76gysmmojkj,33848,33849,67697
37136,,uxhdcfbliboj,33849,33850,67699
37137,,bcq34bavflcj,33850,33851,67701
37138,,agipwra_beyj,33851,33852,67703
37139,,ebdratcrra4j,33852,33853,67705
37140,,w-fjpl8zhsqj,33853,33854,67707
37141,,71rdcsehveqj,33854,33855,67709
37142,,0gfztntxc2ij,33855,33856,67711
37143,,url:http://www.csa.com/partners/viewrecord.php3frequester3dgs26collection3dtrd26recid3d0805026ci,33856,33857,67713
37144,,n65bpdm4vzyj,33857,33858,67715
37145,,lm6mcbabfrkj,33858,33859,67717
37146,,url:http://adsabs.harvard.edu/abs/1974mit..rept.....t,33859,33860,67719
37147,,_-1yasiblysj,33860,33861,67721
37148,,9qs-_p_gle8j,33861,33862,67723
37149,,eainzyb9iiyj,33862,33863,67725
37150,,rq-x0nqkvkqj,33863,33864,67727
37151,,url:http://doi.wiley.com/10.1002/tl.173,33864,33865,67729
37152,,615qrnoty4wj,33865,33866,67731
37153,,swpukdbssogj,33866,33867,67733
37154,,sntj9m8audmj,33867,33868,67735
37155,,kee-fesxgzwj,33868,33869,67737
37156,,url:http://portal.acm.org/ft_gateway.cfm3fid3d109956426type3dpdf,33869,33870,67739
37157,,9qtyoio67wsj,33870,33871,67741
37158,,nz6djhk9kgmj,33871,33872,67743
37159,,xr7mhgsktjmj,33872,33873,67745
37160,,xz58oj_mf8qj,33873,33874,67747
37161,,wgfjh7wvecsj,33874,33875,67749
37162,,qvhv1rk7pwej,33875,33876,67751
37163,,url:http://portal.acm.org/ft_gateway.cfm3fid3d98452026type3dpdf26dl3dguide26dl3dacm26cfid3d1111111126cftoken3d2222222,33876,33877,67753
37164,,kk8n-imhlhaj,33877,33878,67755
37165,,url:http://pubs.acs.org/cgi-bin/abstract.cgi/achre4/asap/abs/ar030281q.html,33878,33879,67757
37166,,pzivfscji7ij,33880,33881,67761
37167,,5hety4nfdumj,33881,33882,67763
37168,,mcnacbxgymuj,33882,33883,67765
37169,,adejijirbb8j,33883,33884,67767
37170,,ffvquwbfkzgj,33884,33885,67769
37171,,mjafj-4nbfwj,33885,33886,67771
37172,,cbk9peafr7oj,33886,33887,67773
37173,,4npyuf9c1n0j,33887,33888,67775
37174,,6an9ugypjzqj,33888,33889,67777
37175,,a5bumsuncmyj,33889,33890,67779
37176,,,33890,33891,67781
37177,,z9v7xwf-zd8j,33891,33892,67783
37178,,vvjugdt_dcqj,33892,33893,67785
37179,,ocmdogrnaaaj,33894,33895,67789
37180,,9kpwme4ysgej,33895,33896,67791
37181,,epr_2p68c7kj,33896,33897,67793
37182,,4gcycq6hsysj,33897,33898,67795
37183,,icwygrwojzkj,33898,33899,67797
37184,,xe0r1wlksooj,33899,33900,67799
37185,,url:http://www.ncbi.nlm.nih.gov/entrez/query.fcgi3fcmd3dretrieve26db3dpubmed26list_uids3d68270526dopt3dcitation,33900,33901,67801
37186,,zo_mmybhdjqj,33901,33902,67803
37187,,jyfsedgloxyj,33902,33903,67805
37188,,h6ze0vkvtsyj,33903,33904,67807
37189,,206iftm9czej,33905,33906,67811
37190,,tk_ldix4tsej,33906,33907,67813
37191,,hish-8hn4iwj,33907,33908,67815
37192,,3zcs91_rbpaj,33908,33909,67817
37193,,1wstxntfwjej,33909,33910,67819
37194,,idm62ywteruj,33910,33911,67821
37195,,byq8xzl02xij,33911,33912,67823
37196,,cawcd5i9pvgj,33912,33913,67825
37197,,4iqt4inby4yj,33913,33914,67827
37198,,3xb3apgaqv8j,33915,33916,67831
37199,,url:http://links.jstor.org/sici3fsici3d0146-4949(196224)3253a1253c5253a2522ildai253e2.0.co253b2-i,33916,33917,67833
37200,,nsoah2ys9rej,33917,33918,67835
37201,,iotfc4ztdpwj,33918,33919,67837
37202,,jolbfwjcowej,33919,33920,67839
37203,,prfaihy06smj,33920,33921,67841
37204,,hvuahuwkuf4j,33921,33922,67843
37205,,uum1c8pvop0j,33922,33923,67845
37206,,cu7q6lofejkj,33923,33924,67847
37207,,iblhpzl3pewj,33924,33925,67849
37208,,kpt8jirqlc8j,33925,33926,67851
37209,,a-8r_angx8sj,33926,33927,67853
37210,,c_myrdeeeq8j,33927,33928,67855
37211,,033degfotycj,33928,33929,67857
37212,,bkownmqfazuj,33929,33930,67859
37213,,5c0roiyu1_qj,33930,33931,67861
37214,,spmiqv2mrzmj,33931,33932,67863
37215,,_840-dpooaij,33932,33933,67865
37216,,jhbt0wonjm0j,33933,33934,67867
37217,,ao6pjz6qaw0j,33934,33935,67869
37218,,a-woeoqdthej,33935,33936,67871
37219,,8wsqrejxow8j,33936,33937,67873
37220,,rcrzvorobc0j,33937,33938,67875
37221,,a6vymzxfehij,33938,33939,67877
37222,,url:http://api.ingentaconnect.com/content/bpl/area/2001/00000033/00000002/art00025,33939,33940,67879
37223,,wjsvubea2wgj,33940,33941,67881
37224,,zsdfi1aozomj,33941,33942,67883
37225,,txg0fi1jy6ij,33942,33943,67885
37226,,7vx2oqvxdqij,33943,33944,67887
37227,,i6tbenjkojgj,33944,33945,67889
37228,,url:http://www.csa.com/partners/viewrecord.php3frequester3dgs26collection3dtrd26recid3dn9210528ah,33945,33946,67891
37229,,thbhvrxhanmj,33946,33947,67893
37230,,igp7regh2csj,33948,33949,67897
37231,,5vpaz5nncwsj,33949,33950,67899
37232,,0cq_o6t3e7mj,33950,33951,67901
37233,,knyp-i1edwwj,33951,33952,67903
37234,,3ksb_oos1cgj,33952,33953,67905
37235,,bmleojg1jc0j,33953,33954,67907
37236,,khnnlrhajo8j,33954,33955,67909
37237,,url:http://links.jstor.org/sici3fsici3d0146-4949(196722)8253a3253c392253alffpsa253e2.0.co253b2-i,33955,33956,67911
37238,,y4p8gk4tlrij,33957,33958,67915
37239,,rffnkfiyfkkj,33958,33959,67917
37240,,oupvpxir5e4j,33960,33961,67921
37241,,r5qzlns7mgoj,33961,33962,67923
37242,,m1svvt9b2nij,33962,33963,67925
37243,,vacsemt3szej,33963,33964,67927
37244,,peg4nzwoe-yj,33965,33966,67931
37245,,lqlkhqoy1baj,33966,33967,67933
37246,,i3dtj6nspcij,33967,33968,67935
37247,,vlyidupowx4j,33968,33969,67937
37248,,rww0ssx4uhuj,33969,33970,67939
37249,,vhy916imi4ej,33970,33971,67941
37250,,kobt-5e7dgqj,33971,33972,67943
37251,,_ngwnmnwsn8j,33972,33973,67945
37252,,0kxeqfxhytgj,33973,33974,67947
37253,,vztesirvgxsj,33974,33975,67949
37254,,uil1ljfwt9ij,33975,33976,67951
37255,,x-0wtaz_6gyj,33976,33977,67953
37256,,azqvbllj5w8j,33977,33978,67955
37257,,gwnsyevibzuj,33978,33979,67957
37258,,7x8w6lxc0wqj,33979,33980,67959
37259,,n3kf8hfd0q8j,33980,33981,67961
37260,,,33981,33982,67963
37261,,qmuhk41qx3kj,33982,33983,67965
37262,,-r9xl387038j,33983,33984,67967
37263,,fgaexpb9uz4j,33984,33985,67969
37264,,w9i7-c6-dzgj,33985,33986,67971
37265,,wf5ufon4t8aj,33986,33987,67973
37266,,url:http://www.ncbi.nlm.nih.gov/entrez/query.fcgi3fcmd3dretrieve26db3dpubmed26list_uids3d73911826dopt3dcitation,33987,33988,67975
37267,,brdmk77osgij,33988,33989,67977
37268,,0bzes_tssoaj,33989,33990,67979
37269,,a_upyibkvsqj,33990,33991,67981
37270,,enrllao58cmj,33991,33992,67983
37271,,n9z-b_0vgmqj,33992,33993,67985
37272,,mh23-wkfe70j,33993,33994,67987
37273,,hiab_9rgvquj,33994,33995,67989
37274,,hcuqhsubrpsj,33995,33996,67991
37275,,lqltdfqun5ij,33996,33997,67993
37276,,f75ii37jamaj,33997,33998,67995
37277,,2a4fkl3kghgj,33998,33999,67997
37278,,_mzllwokuhwj,33999,34000,67999
37279,,qigfucd1tgkj,34000,34001,68001
37280,,ahdmapplvgij,34001,34002,68003
37281,,w-u1qdu2kxej,34002,34003,68005
37282,,xd5ict_o4laj,34003,34004,68007
37283,,bwzgf3qjuscj,34004,34005,68009
37284,,islrjuo_fh0j,34005,34006,68011
37285,,qtpya6ovv2uj,34006,34007,68013
37286,,3faqv305qd0j,34007,34008,68015
37287,,u1jrw7ep4qgj,34008,34009,68017
37288,,qouo6p3xm40j,34009,34010,68019
37289,,url:http://doi.wiley.com/10.1002/he.129,34010,34011,68021
37290,,bp4zu0srgikj,34011,34012,68023
37291,,tdrv9etone0j,34012,34013,68025
37292,,jr1mnudhh9gj,34013,34014,68027
37293,,gq00hvkwgkkj,34014,34015,68029
37294,,inlglbbssbuj,34015,34016,68031
37295,,kcuw6tupfusj,34016,34017,68033
37296,,hjoadd3awsyj,34017,34018,68035
37297,,hdbzt9clvdyj,34018,34019,68037
37298,,0k2o56gzbruj,34019,34020,68039
37299,,e1qfopacc60j,34020,34021,68041
37300,,alk9d73xuwkj,34021,34022,68043
37301,,xxygdpd_peuj,34022,34023,68045
37302,,amh9ipuc6ssj,34023,34024,68047
37303,,ubp_-krs5w8j,34024,34025,68049
37304,,nzwsaroshhwj,34025,34026,68051
37305,,gnwc8ti6jlej,34026,34027,68053
37306,,pzgafkshw1mj,34027,34028,68055
37307,,jo8bdxhaen8j,34028,34029,68057
37308,,wp18rv-agkqj,34030,34031,68061
37309,,vdy9lkd8scoj,34031,34032,68063
37310,,tow-6zoqicaj,34032,34033,68065
37311,,z4cq4f5fkr8j,34035,34036,68071
37312,,obrr9a87dx0j,34037,34038,68075
37313,,awyjw4ciyuuj,34038,34039,68077
37314,,z7vjtopea0uj,34039,34040,68079
37315,,8bcxj1ujrqmj,34040,34041,68081
37316,,njgokkncxlsj,34041,34042,68083
37317,,i0kn3dzf4tgj,34042,34043,68085
37318,,sawn74iv8qcj,34044,34045,68089
37319,,n6aijtggepkj,34045,34046,68091
37320,,bf7ewyf06lyj,34046,34047,68093
37321,,0akvfdrcosij,34047,34048,68095
37322,,9w1idukft2yj,34048,34049,68097
37323,,ku5okyiaw-cj,34049,34050,68099
37324,,gpqk0cxaq3oj,34050,34051,68101
37325,,msz0xzjgb3uj,34051,34052,68103
37326,,qubhka6wmh8j,34052,34053,68105
37327,,hmvhq07qd9ej,34053,34054,68107
37328,,vghci7nrc2mj,34054,34055,68109
37329,,ug2p0v_2vvgj,34055,34056,68111
37330,,l6phd0syqdij,34056,34057,68113
37331,,ilppzcpzlmkj,34057,34058,68115
37332,,,34058,34059,68117
37333,,tq61nxhmezmj,34059,34060,68119
37334,,5ragbxrnq-kj,34060,34061,68121
37335,,eork_kilxdij,34061,34062,68123
37336,,pxf2irlthnuj,34062,34063,68125
37337,,3tuomf-qs4wj,34063,34064,68127
37338,,a4l-8wlsthsj,34064,34065,68129
37339,,dd906x3lv2gj,34065,34066,68131
37340,,xxd4nnsorqwj,34066,34067,68133
37341,,url:http://portal.acm.org/ft_gateway.cfm3fid3d6173626type3dpdf26coll3dguide26dl3dacm26cfid3d1111111126cftoken3d2222222,34067,34068,68135
37342,,p8k1ilvuakkj,34068,34069,68137
37343,,taspla7sbkuj,34069,34070,68139
37344,,gri0mymnukqj,34070,34071,68141
37345,,9-itlvviloej,34071,34072,68143
37346,,,34072,34073,68145
37347,,q-ugprmrhfaj,34073,34074,68147
37348,,g8_xxbzky6kj,34074,34075,68149
37349,,cqyfgx4-r_yj,34075,34076,68151
37350,,wfr_vdgs7jyj,34076,34077,68153
37351,,m_v17ivhb_ej,34077,34078,68155
37352,,5ymylkoxstkj,34078,34079,68157
37353,,kmk6o0xirrgj,34079,34080,68159
37354,,oeicxrxllh4j,34080,34081,68161
37355,,63zkhn6n19sj,34081,34082,68163
37356,,vumwnqqhtm0j,34082,34083,68165
37357,,9l4liuui9caj,34083,34084,68167
37358,,nuum6ndpmx0j,34084,34085,68169
37359,,spzliszxktqj,34085,34086,68171
37360,,uxr40i_s6qyj,34086,34087,68173
37361,,url:http://links.jstor.org/sici3fsici3d0146-4949(196021252f22)1253a2253c22253asbat2522r253e2.0.co253b2-h,34087,34088,68175
37362,,3gnlk4is7zoj,34088,34089,68177
37363,,mgxu1lnb_j8j,34089,34090,68179
37364,,,34090,34091,68181
37365,,yk7gbvd0wnyj,34091,34092,68183
37366,,t6ncv5bmz5aj,34092,34093,68185
37367,,lavs6oe0ygmj,34093,34094,68187
37368,,url:http://portal.acm.org/ft_gateway.cfm3fid3d106628226type3dpdf,34094,34095,68189
37369,,mutscqccwgij,34095,34096,68191
37370,,e0nilz4ifrcj,34096,34097,68193
37371,,am73zhkf_xwj,34097,34098,68195
37372,,dyplavaxwbwj,34098,34099,68197
37373,,banz4hx4uc4j,34099,34100,68199
37374,,h0jx6zbyeeej,34100,34101,68201
37375,,zaiuf5y911aj,34101,34102,68203
37376,,ivjpk_jmy5mj,34102,34103,68205
37377,,vbujb4dgeocj,34103,34104,68207
37378,,6mo9cszzouaj,34104,34105,68209
37379,,3mkhhdi-62yj,34105,34106,68211
37380,,yxywilntprcj,34106,34107,68213
37381,,mom7lhq4wb4j,34107,34108,68215
37382,,nyitgjax4kcj,34108,34109,68217
37383,,spm8twgogjgj,34109,34110,68219
37384,,nfmljutyhikj,34110,34111,68221
37385,,dbv2wpuyumej,34111,34112,68223
37386,,1ev8jhhhw_qj,34112,34113,68225
37387,,bbzk5dp1mbwj,34113,34114,68227
37388,,dem5ysf41xcj,34114,34115,68229
37389,,yhichcnv5tyj,34115,34116,68231
37390,,elbcjcky3hsj,34116,34117,68233
37391,,i8vxty7thvoj,34117,34118,68235
37392,,ebxncn6pwaej,34118,34119,68237
37393,,6adpfc-koe4j,34119,34120,68239
37394,,1i_ej4-r-_gj,34120,34121,68241
37395,,,34121,34122,68243
37396,,pdquejkotpej,34122,34123,68245
37397,,01c_hhrw15mj,34123,34124,68247
37398,,ooxab5xzbawj,34124,34125,68249
37399,,z46cgodok2qj,34125,34126,68251
37400,,__uz_kinodmj,34126,34127,68253
37401,,e6y3yutmsfgj,34127,34128,68255
37402,,r9lc0mwk_8ij,34128,34129,68257
37403,,0ehb_4wcbmwj,34129,34130,68259
37404,,9otgdtkdubkj,34130,34131,68261
37405,,ljhtwttcoxwj,34131,34132,68263
37406,,5jh2nja_888j,34132,34133,68265
37407,,e-xmu6ncei0j,34133,34134,68267
37408,,z2sxq-qlchaj,34134,34135,68269
37409,,rzc1tdwy6-0j,34135,34136,68271
37410,,df7lojne-9ij,34136,34137,68273
37411,,mrtx4mbtvsqj,34137,34138,68275
37412,,chvkxy1drluj,34138,34139,68277
37413,,ykjiaqnrjekj,34139,34140,68279
37414,,3ugcb7fdj6cj,34140,34141,68281
37415,,,34141,34142,68283
37416,,hnjh20ra6nqj,34142,34143,68285
37417,,b3ekxmgwwdmj,34143,34144,68287
37418,,av2mavx4iuwj,34144,34145,68289
37419,,1ahbmagc53wj,34145,34146,68291
37420,,bbws1xtbj9sj,34146,34147,68293
37421,,f628ljpdr_cj,34147,34148,68295
37422,,,34148,34149,68297
37423,,ayk_c6bxf5ej,34149,34150,68299
37424,,zvcs9bbyoi0j,34150,34151,68301
37425,,k0acqnxw-kaj,34151,34152,68303
37426,,zwrqd-2vvwgj,34152,34153,68305
37427,,fm-yipwgkqkj,34154,34155,68309
37428,,yiqccw0jn8gj,34155,34156,68311
37429,,qlmrgzchbrej,34156,34157,68313
37430,,jpnoy-099tej,34157,34158,68315
37431,,jxgmfqst6zoj,34158,34159,68317
37432,,7evlpeludxej,34159,34160,68319
37433,,4ip8ndv1l1cj,34160,34161,68321
37434,,e_6_numy_4sj,34162,34163,68325
37435,,url:http://doi.wiley.com/10.1002/he.153,34163,34164,68327
37436,,j5yjfxv0qayj,34164,34165,68329
37437,,yl4y7ouhuogj,34165,34166,68331
37438,,fo0ykyzkd4oj,34166,34167,68333
37439,,vyoq1m7v5gcj,34167,34168,68335
37440,,s7pvjkee0iqj,34168,34169,68337
37441,,wvwtnhcs_rwj,34169,34170,68339
37442,,cwgg3n2bj-aj,34170,34171,68341
37443,,_5rmtzashbsj,34171,34172,68343
37444,,anrnbjzqutcj,34172,34173,68345
37445,,mfn5jdnytkaj,34173,34174,68347
37446,,0pumhwohg4qj,34174,34175,68349
37447,,0r46la8z-iwj,34175,34176,68351
37448,,mn6xlaevvb8j,34176,34177,68353
37449,,url:http://pubs.acs.org/cgi-bin/abstract.cgi/achre4/2005/38/i11/abs/ar050055b.html,34177,34178,68355
37450,,_nprs7cpszoj,34178,34179,68357
37451,,dpjyrf9l89ij,34179,34180,68359
37452,,8sn4aiumlu4j,34180,34181,68361
37453,,q0caf6kzf_0j,34181,34182,68363
37454,,txgnzvl9z94j,34182,34183,68365
37455,,ubj7bx3cs5oj,34183,34184,68367
37456,,c-pcr4tiim4j,34184,34185,68369
37457,,t6a86cqcuhoj,34185,34186,68371
37458,,,34186,34187,68373
37459,,dnpkbok3erqj,34187,34188,68375
37460,,nu8m4xaaq_yj,34188,34189,68377
37461,,ysquq-xdd4gj,34189,34190,68379
37462,,zydijyhwgpej,34190,34191,68381
37463,,url:http://www.csa.com/partners/viewrecord.php3frequester3dgs26collection3dtrd26recid3dn9210363ah,34191,34192,68383
37464,,ehxtt9yo6twj,34192,34193,68385
37465,,66dwdpwjbbwj,34193,34194,68387
37466,,cxvdlkneig8j,34194,34195,68389
37467,,fidtobr8njmj,34195,34196,68391
37468,,sipzy2rkvvsj,34196,34197,68393
37469,,a5l9vhlovzcj,34197,34198,68395
37470,,p-yfoz4xxtuj,34198,34199,68397
37471,,ziqcvbdfylcj,34199,34200,68399
37472,,zwpc9nr0fd4j,34200,34201,68401
37473,,c2e-fbuv4x0j,34201,34202,68403
37474,,url:http://ieeexplore.ieee.org/iel3/3990/11481/00547833.pdf3farnumber3d547833,34202,34203,68405
37475,,csgd6l3ktd8j,34203,34204,68407
37476,,woafml8pi-qj,34204,34205,68409
37477,,ts9eamkvdhwj,34205,34206,68411
37478,,mzkeuiibp1uj,34206,34207,68413
37479,,v1cj4bp8qjgj,34207,34208,68415
37480,,ajey70u9gyyj,34208,34209,68417
37481,,cabbbwnbag4j,34209,34210,68419
37482,,pywn-8mq8s4j,34210,34211,68421
37483,,x5xwwe0ddgoj,34211,34212,68423
37484,,myev_2ohjicj,34212,34213,68425
37485,,,34213,34214,68427
37486,,i3oowyui3s0j,34214,34215,68429
37487,,ducfmohpc-cj,34215,34216,68431
37488,,ktqasmlkrksj,34216,34217,68433
37489,,u2cmoby3o_qj,34217,34218,68435
37490,,url:http://portal.acm.org/citation.cfm3fid3d382272.38241726dl3dguide26dl3dacm26idx3dj68926part3dperiodical26wanttype3dperiodical26title3dacm2520sigmod2520record26cfid3d1111111126cftoken3d2222222,34218,34219,68437
37491,,qrrzwoflwu4j,34219,34220,68439
37492,,ouz7ddzuflqj,34221,34222,68443
37493,,ujvpejcygbaj,34222,34223,68445
37494,,iecunjwaoqsj,34223,34224,68447
37495,,gf2po2dkgtwj,34224,34225,68449
37496,,obyaywreyuwj,34225,34226,68451
37497,,ylzdutuxje4j,34226,34227,68453
37498,,wncpq7wyxr0j,34227,34228,68455
37499,,gokx2zym1dkj,34228,34229,68457
37500,,ghot4k3qqfuj,34229,34230,68459
37501,,einrugzgvwaj,34230,34231,68461
37502,,hwvg35ywavsj,34231,34232,68463
37503,,6eqwqriughuj,34232,34233,68465
37504,,cxggddhphmij,34233,34234,68467
37505,,qqabk5zif5wj,34234,34235,68469
37506,,jwxigqqocnej,34235,34236,68471
37507,,-9m5ju5nohcj,34236,34237,68473
37508,,njcoamihvucj,34237,34238,68475
37509,,fhm46zpovxmj,34238,34239,68477
37510,,gukacxn-t58j,34239,34240,68479
37511,,jit7w3zfttoj,34240,34241,68481
37512,,xz5grfdnkdej,34241,34242,68483
37513,,tjrblxx-q4yj,34242,34243,68485
37514,,wryvnxspl_yj,34243,34244,68487
37515,,6y9oc4ee5kqj,34244,34245,68489
37516,,pl51p9ixizyj,34245,34246,68491
37517,,bmmdjb_plsqj,34246,34247,68493
37518,,i_bwhxl1kxej,34247,34248,68495
37519,,fhmc4zsqmx8j,34248,34249,68497
37520,,2dkex7erlqsj,34249,34250,68499
37521,,g5iiv4s_bruj,34250,34251,68501
37522,,edx9rmn-mo4j,34251,34252,68503
37523,,71mlbckrxowj,34252,34253,68505
37524,,qo3fwskhlg8j,34253,34254,68507
37525,,hojrfvvhfwqj,34254,34255,68509
37526,,1a2go5crpfkj,34255,34256,68511
37527,,fli0aokc85yj,34256,34257,68513
37528,,dmwtuwm462uj,34257,34258,68515
37529,,zuuloszyiyej,34258,34259,68517
37530,,a-o-7imlhjuj,34259,34260,68519
37531,,2wgzc4156ikj,34260,34261,68521
37532,,npkmlsic3jqj,34261,34262,68523
37533,,0uhcqsca9cwj,34262,34263,68525
37534,,latzi957gbij,34263,34264,68527
37535,,djte_7xhqr4j,34264,34265,68529
37536,,ldbc_bglcj8j,34265,34266,68531
37537,,1l_yweicutij,34266,34267,68533
37538,,bbquqfy5608j,34267,34268,68535
37539,,dnq2e_ttlmyj,34268,34269,68537
37540,,wgxcapsmhgij,34269,34270,68539
37541,,x-0rtnhdxxuj,34270,34271,68541
37542,,lr5cr2ltfl8j,34271,34272,68543
37543,,cmcuaze1wfqj,34272,34273,68545
37544,,uib-u3fi19gj,34273,34274,68547
37545,,ixlqb3dcvdgj,34274,34275,68549
37546,,on2gwaaxxc4j,34275,34276,68551
37547,,pprmsibjh5sj,34276,34277,68553
37548,,exjose4ld8uj,34277,34278,68555
37549,,gox9ci1w2xoj,34278,34279,68557
37550,,irs5qvotf-kj,34279,34280,68559
37551,,url:http://portal.acm.org/ft_gateway.cfm3fid3d109964226type3dpdf,34280,34281,68561
37552,,2hlsh8fx-umj,34281,34282,68563
37553,,dltfce9ubp8j,34282,34283,68565
37554,,ef7velnhx6ij,34283,34284,68567
37555,,hgcjwab-byaj,34284,34285,68569
37556,,deqadmst4jij,34285,34286,68571
37557,,-5ehghcel4wj,34286,34287,68573
37558,,kvgorcdc5bgj,34287,34288,68575
37559,,umpir9n5jloj,34288,34289,68577
37560,,fi9nd6yo0mgj,34289,34290,68579
37561,,o2tw8wxqtdij,34290,34291,68581
37562,,g-zpzyjvmi8j,34291,34292,68583
37563,,h_iloigbljqj,34292,34293,68585
37564,,sufsyirdq00j,34294,34295,68589
37565,,btqbcc5gtuuj,34295,34296,68591
37566,,,34296,34297,68593
37567,,nlhsifijdwaj,34297,34298,68595
37568,,wzx54ck0eigj,34298,34299,68597
37569,,uxlu_4y3zyij,34299,34300,68599
37570,,chhu-wfg8fwj,34300,34301,68601
37571,,bsl3y37jamoj,34301,34302,68603
37572,,fap2ddohxpmj,34302,34303,68605
37573,,hpzadsu5g2qj,34303,34304,68607
37574,,ojivohdh6cyj,34304,34305,68609
37575,,d0qewk37wnqj,34305,34306,68611
37576,,cr5gu350_faj,34306,34307,68613
37577,,pdrwntep3wkj,34307,34308,68615
37578,,nxjjb5fljbej,34308,34309,68617
37579,,r75znyjz-5uj,34309,34310,68619
37580,,dy5job0_xmoj,34310,34311,68621
37581,,heidmo8hun8j,34311,34312,68623
37582,,p8rcglf7txgj,34312,34313,68625
37583,,hosyew9s5sij,34313,34314,68627
37584,,u8wk0qos95ij,34314,34315,68629
37585,,5c86wbt5ohsj,34315,34316,68631
37586,,ffykdjrlw4wj,34316,34317,68633
37587,,url:http://portal.acm.org/citation.cfm3fid3d234286.1057841,34317,34318,68635
37588,,rh0hqaypia0j,34319,34320,68639
37589,,ilgiy73-ffej,34320,34321,68641
37590,,sdtsbtk1bsij,34321,34322,68643
37591,,mlxi5icg-ywj,34322,34323,68645
37592,,url:http://portal.acm.org/citation.cfm3fid3d255593,34323,34324,68647
37593,,v3knn-tgpo0j,34324,34325,68649
37594,,jhonn1wpvmqj,34325,34326,68651
37595,,xnfmzzemgsij,34326,34327,68653
37596,,c0rxf4clemcj,34327,34328,68655
37597,,kvyurvv4znqj,34328,34329,68657
37598,,ybuwadnodzuj,34329,34330,68659
37599,,3em6srh98n4j,34330,34331,68661
37600,,j9bngzw7m2aj,34331,34332,68663
37601,,rklibxmbtqij,34332,34333,68665
37602,,u8adxfuir3ej,34333,34334,68667
37603,,s7slke4qiaej,34334,34335,68669
37604,,t8vsgrteqbgj,34335,34336,68671
37605,,00zfkashbv4j,34336,34337,68673
37606,,hqpezxz7ojwj,34337,34338,68675
37607,,khsgd9gj6fej,34338,34339,68677
37608,,lqi3dllitioj,34339,34340,68679
37609,,uyhrqih_-moj,34340,34341,68681
37610,,vqenz5q5ry0j,34341,34342,68683
37611,,url:http://portal.acm.org/ft_gateway.cfm3fid3d38240026type3dpdf26coll3dguide26dl3dacm26cfid3d1111111126cftoken3d2222222,34342,34343,68685
37612,,hfpt6nrdzr0j,34343,34344,68687
37613,,izh8qf1zykuj,34344,34345,68689
37614,,vcbtvfq_xnuj,34345,34346,68691
37615,,9cuqohopsfgj,34346,34347,68693
37616,,sskzoyoow8ij,34347,34348,68695
37617,,jsl1pqioxfcj,34348,34349,68697
37618,,zodped9-qzej,34349,34350,68699
37619,,m8k7ngfg5k4j,34350,34351,68701
37620,,oilhf7jozq4j,34351,34352,68703
37621,,p0waj_7l2wyj,34352,34353,68705
37622,,i7jkyj8gop0j,34353,34354,68707
37623,,o2usrbrjehyj,34354,34355,68709
37624,,npc45ek-hywj,34355,34356,68711
37625,,m4v_bb2hphuj,34356,34357,68713
37626,,,34357,34358,68715
37627,,up5j0rmiptaj,34358,34359,68717
37628,,ix1k9dpzh9ej,34359,34360,68719
37629,,8qctgen-gfij,34360,34361,68721
37630,,6bmyly1nuv0j,34361,34362,68723
37631,,7okfw8fde60j,34362,34363,68725
37632,,6qo85klqywcj,34363,34364,68727
37633,,jk_yce1rk7sj,34364,34365,68729
37634,,kmcswdviycuj,34365,34366,68731
37635,,7n9spjc18ocj,34366,34367,68733
37636,,wazfdy2fxicj,34367,34368,68735
37637,,hpnloksuyegj,34368,34369,68737
37638,,ukw1xilxxesj,34370,34371,68741
37639,,jd7fziky62wj,34371,34372,68743
37640,,vkls2-y8u1gj,34372,34373,68745
37641,,url:http://www.csa.com/partners/viewrecord.php3frequester3dgs26collection3dtrd26recid3dn9210581ah,34373,34374,68747
37642,,awm4dkalwj4j,34374,34375,68749
37643,,ojudslfln44j,34375,34376,68751
37644,,dmgbkpaiygej,34376,34377,68753
37645,,l1xviewhqxcj,34377,34378,68755
37646,,e9jahlde-50j,34378,34379,68757
37647,,cvdbmyqs1z8j,34379,34380,68759
37648,,,34380,34381,68761
37649,,wsj1nllw0kaj,34382,34383,68765
37650,,culcd4fcibqj,34383,34384,68767
37651,,653nokwloosj,34384,34385,68769
37652,,cegmfbxz_n4j,34385,34386,68771
37653,,url:http://adsabs.harvard.edu/abs/1977phdt........51g,34386,34387,68773
37654,,qaly_bj4uosj,34387,34388,68775
37655,,bvxdb8yahouj,34388,34389,68777
37656,,url:http://www.ingentaconnect.com/content/els/08830355/2001/00000035/00000002/art00012,34389,34390,68779
37657,,jbshzidkdluj,34390,34391,68781
37658,,c63_glsimaaj,34391,34392,68783
37659,,jqxmu_k2uh4j,34392,34393,68785
37660,,v54w1by4kyyj,34393,34394,68787
37661,,oh5medqwzqkj,34394,34395,68789
37662,,wnhrjgnbnesj,34395,34396,68791
37663,,9lr3bh9upnoj,34396,34397,68793
37664,,m1uwguos_k8j,34397,34398,68795
37665,,k3uetujgqzwj,34398,34399,68797
37666,,a_ptcq0yvq0j,34399,34400,68799
37667,,wrg81vms-9ij,34400,34401,68801
37668,,i2pauvc4ye4j,34401,34402,68803
37669,,xecqzagt5g8j,34402,34403,68805
37670,,fvqo3jaj9tej,34403,34404,68807
37671,,li_yxvw-iuaj,34404,34405,68809
37672,,1hxhaqvwr5qj,34405,34406,68811
37673,,bgagdygvjxgj,34406,34407,68813
37674,,uumakaq7mogj,34408,34409,68817
37675,,uuyr5-hoxhij,34409,34410,68819
37676,,1fa9hkk7vp0j,34410,34411,68821
37677,,rqqxlsxgvtsj,34411,34412,68823
37678,,plelt_y87saj,34412,34413,68825
37679,,url:http://portal.acm.org/ft_gateway.cfm3fid3d102769726type3dpdf,34413,34414,68827
37680,,mque1cdfbfyj,34414,34415,68829
37681,,kuuho8vk6o4j,34415,34416,68831
37682,,url:http://portal.acm.org/citation.cfm3fid3d16856.1686926coll3dguide26dl3dacm26idx3dj68926part3dperiodical26wanttype3dperiodical26title3dacm2520sigmod2520record26cfid3d1111111126cftoken3d2222222,34416,34417,68833
37683,,maxr7lqvzl4j,34417,34418,68835
37684,,2r6xep6uxngj,34418,34419,68837
37685,,url:http://portal.acm.org/ft_gateway.cfm3fid3d30668426type3dpdf26dl3dguide26dl3dacm26cfid3d1111111126cftoken3d2222222,34419,34420,68839
37686,,kamyn8wjduwj,34420,34421,68841
37687,,0krhifzvqhoj,34421,34422,68843
37688,,qtidecnbwgyj,34422,34423,68845
37689,,gsh--gn6nqej,34423,34424,68847
37690,,29fu3abivaej,34424,34425,68849
37691,,e5iwbnmabayj,34425,34426,68851
37692,,0fpxce5umqcj,34426,34427,68853
37693,,wxtpxiihncij,34427,34428,68855
37694,,7edh53sux7kj,34428,34429,68857
37695,,_gg-tdtpqjaj,34429,34430,68859
37696,,axqcvkwb9okj,34430,34431,68861
37697,,url:http://www.im.tut.fi/cmc/pdf/pmnetwork.pdf,34431,34432,68863
37698,,v5a6ofgbr08j,34432,34433,68865
37699,,41-iknmayyej,34433,34434,68867
37700,,kvvb0uz_fyoj,34434,34435,68869
37701,,5leph-sjn-sj,34435,34436,68871
37702,,pknyzr0vwg0j,34436,34437,68873
37703,,zgvnf2jtaysj,34437,34438,68875
37704,,7qt7koeeltoj,34438,34439,68877
37705,,9jhejasszpoj,34439,34440,68879
37706,,miivxnpchimj,34440,34441,68881
37707,,gdoitiogubej,34441,34442,68883
37708,,tg8nuzsg10mj,34442,34443,68885
37709,,jnwbeu7dqwyj,34443,34444,68887
37710,,kct2lr2rocuj,34444,34445,68889
37711,,wm8umnxr8pwj,34445,34446,68891
37712,,mvz6hykpd9uj,34446,34447,68893
37713,,5dshn7wuu5cj,34447,34448,68895
37714,,wwvptpe5zvcj,34448,34449,68897
37715,,sn0tovkduegj,34449,34450,68899
37716,,cib46ylpwj8j,34450,34451,68901
37717,,by-drboce2gj,34451,34452,68903
37718,,lipg-xnffxwj,34452,34453,68905
37719,,f1zvca8-buaj,34453,34454,68907
37720,,4utuizo9cvqj,34454,34455,68909
37721,,ewjxswtquwij,34455,34456,68911
37722,,ephhniigul4j,34456,34457,68913
37723,,xjdrlk71qruj,34457,34458,68915
37724,,url:http://portal.acm.org/ft_gateway.cfm3fid3d109958326type3dpdf,34458,34459,68917
37725,,bpyfu0vz05qj,34459,34460,68919
37726,,9zdr_zb4fnsj,34460,34461,68921
37727,,vzxrd3leslaj,34461,34462,68923
37728,,x7cfkiupvzuj,34462,34463,68925
37729,,1hpm-viqijaj,34463,34464,68927
37730,,pgilk8a1hdsj,34464,34465,68929
37731,,teljren-7j4j,34465,34466,68931
37732,,tmzihxrzru4j,34466,34467,68933
37733,,oshqok3ivcuj,34467,34468,68935
37734,,hmzwzacrfwsj,34468,34469,68937
37735,,srvbsgkakyyj,34469,34470,68939
37736,,zisf-4kuuw4j,34470,34471,68941
37737,,o3ebn8zebeqj,34471,34472,68943
37738,,t5xtcthwxfkj,34472,34473,68945
37739,,wzblxgyxgyaj,34473,34474,68947
37740,,3isoplo_hi0j,34474,34475,68949
37741,,wfz3z1b79mkj,34475,34476,68951
37742,,femgxumee5wj,34476,34477,68953
37743,,_htx2ujjof0j,34477,34478,68955
37744,,2s6ao3rjkdej,34478,34479,68957
37745,,0rfqesgq914j,34479,34480,68959
37746,,wq1wlm533pwj,34480,34481,68961
37747,,4tggvdhtmgej,34481,34482,68963
37748,,dh9nd0jpp3sj,34482,34483,68965
37749,,vhjofby6kfcj,34483,34484,68967
37750,,zpjjbxzjmiyj,34484,34485,68969
37751,,g__t5t9i4zwj,34485,34486,68971
37752,,9ae-fszxyi8j,34486,34487,68973
37753,,3bgpowtw-88j,34487,34488,68975
37754,,4s4tzs9_wqej,34488,34489,68977
37755,,receuuswmbuj,34489,34490,68979
37756,,psbznwrtpfqj,34490,34491,68981
37757,,cwkn9lvcg8uj,34491,34492,68983
37758,,vht5fqzgwhoj,34492,34493,68985
37759,,gxm_fwdr1sij,34493,34494,68987
37760,,wlkcpyxbo3ej,34494,34495,68989
37761,,28j6cmuxloij,34495,34496,68991
37762,,taiqtrdvo4qj,34496,34497,68993
37763,,umk70lyfna4j,34497,34498,68995
37764,,d-qulje3qkej,34498,34499,68997
37765,,2qytjlcznlcj,34499,34500,68999
37766,,es1qcpfgbjwj,34500,34501,69001
37767,,j8sgekyqafcj,34501,34502,69003
37768,,2xfhgzakfz8j,34502,34503,69005
37769,,wwut1--c9d0j,34503,34504,69007
37770,,18a85hjffsqj,34504,34505,69009
37771,,vpebu2by_fsj,34505,34506,69011
37772,,cbsbow5h1bwj,34506,34507,69013
37773,,3nwpoxsc55ej,34507,34508,69015
37774,,url:http://portal.acm.org/ft_gateway.cfm3fid3d9362426type3dpdf26dl3dguide26dl3dacm26cfid3d1111111126cftoken3d2222222,34508,34509,69017
37775,,p_l6aorl6gsj,34509,34510,69019
37776,,efohyksd8luj,34511,34512,69023
37777,,_zqwzi72flcj,34512,34513,69025
37778,,npeho5w7pxwj,34513,34514,69027
37779,,4ni7fu-aonaj,34514,34515,69029
37780,,j2qysnlri68j,34515,34516,69031
37781,,dbp96_8brksj,34517,34518,69035
37782,,url:http://www.geography.org.uk/journals/journals.asp3farticleid3d74,34518,34519,69037
37783,,nsshkdj6fdkj,34519,34520,69039
37784,,wovvmr8_1z0j,34520,34521,69041
37785,,bnebn9kgy4ej,34521,34522,69043
37786,,to3ytn2saioj,34522,34523,69045
37787,,p0wbdi_jixmj,34523,34524,69047
37788,,fq3vm9wbt4yj,34524,34525,69049
37789,,eecp9rncjxoj,34525,34526,69051
37790,,hsrzrjwot7aj,34526,34527,69053
37791,,ue8imayrimmj,34527,34528,69055
37792,,url:http://www.springerlink.com/index/vq1584ju24143526.pdf,34528,34529,69057
37793,,5dfsvkhpvzej,34529,34530,69059
37794,,vfxmsdljni8j,34530,34531,69061
37795,,csow5v2tusqj,34531,34532,69063
37796,,goyqc1zpapkj,34532,34533,69065
37797,,sf_7ti8m2g8j,34533,34534,69067
37798,,io592v7d_awj,34534,34535,69069
37799,,o1udm3ttoa0j,34535,34536,69071
37800,,hli2xb5ijayj,34536,34537,69073
37801,,zc72x7ynjw4j,34537,34538,69075
37802,,xlyg-9qksbwj,34538,34539,69077
37803,,url:http://portal.acm.org/citation.cfm3fid3dseries10645.500801,34539,34540,69079
37804,,dyhfy9ldnxwj,34540,34541,69081
37805,,fmfk1ihxfpkj,34541,34542,69083
37806,,url:http://pubs.acs.org/cgi-bin/abstract.cgi/achre4/2005/38/i04/abs/ar0401653.html,34542,34543,69085
37807,,o1fhf_xbrz0j,34543,34544,69087
37808,,cj2dheg8w9mj,34544,34545,69089
37809,,kdevzeyqveuj,34545,34546,69091
37810,,wditwp644cmj,34546,34547,69093
37811,,tbpxgth9vaaj,34547,34548,69095
37812,,piu88authdgj,34548,34549,69097
37813,,cuccgdsiuzaj,34549,34550,69099
37814,,tgwsi0op6l0j,34550,34551,69101
37815,,url:http://ieeexplore.ieee.org/xpl/abs_free.jsp3farnumber3d1320096,34551,34552,69103
37816,,8izwaw87xrij,34552,34553,69105
37817,,mwxddhb-vh8j,34553,34554,69107
37818,,uzewhb2drg4j,34554,34555,69109
37819,,dayrbvnbqbej,34555,34556,69111
37820,,bqatcbjfzzwj,34556,34557,69113
37821,,vb0_dtzj9aaj,34557,34558,69115
37822,,yhmqdbcr4e4j,34558,34559,69117
37823,,4ceknjnyo-kj,34559,34560,69119
37824,,xsvorb8lrroj,34560,34561,69121
37825,,lwwsnwo36q8j,34561,34562,69123
37826,,quadwznirjwj,34562,34563,69125
37827,,r2vkn59zlosj,34563,34564,69127
37828,,uaxjkvwvp-sj,34564,34565,69129
37829,,hddasg0skkqj,34565,34566,69131
37830,,94_7c3d_ccoj,34566,34567,69133
37831,,z7_b_rginpsj,34567,34568,69135
37832,,avr1kll82fqj,34568,34569,69137
37833,,w2apyxb0x10j,34569,34570,69139
37834,,pl0kqaov5tqj,34570,34571,69141
37835,,0rgpc4u5s1aj,34571,34572,69143
37836,,lkkcccfjnpgj,34572,34573,69145
37837,,rt9ckbqggvej,34573,34574,69147
37838,,wdqesjjc93uj,34574,34575,69149
37839,,,34575,34576,69151
37840,,nivu7avv_6sj,34576,34577,69153
37841,,coqijpdfivkj,34577,34578,69155
37842,,4nkzi85v-iij,34578,34579,69157
37843,,,34579,34580,69159
37844,,gssl4mzcskwj,34580,34581,69161
37845,,url:http://portal.acm.org/ft_gateway.cfm3fid3d105816326type3dpdf,34581,34582,69163
37846,,u9sqemnnm6aj,34582,34583,69165
37847,,mulq-f6nhcgj,34583,34584,69167
37848,,ajfwp684-2ej,34584,34585,69169
37849,,vlg_ro7y718j,34585,34586,69171
37850,,if1ylcxlpkkj,34586,34587,69173
37851,,hblyxrejtxwj,34587,34588,69175
37852,,bc0fwbdrfpyj,34588,34589,69177
37853,,6n7cyabplpej,34589,34590,69179
37854,,yex7cqd-xluj,34590,34591,69181
37855,,wysprm5rjxsj,34591,34592,69183
37856,,on4lce_gceyj,34592,34593,69185
37857,,ndspzcoyo40j,34593,34594,69187
37858,,f3_bjc9cgioj,34594,34595,69189
37859,,bptdpgrq4raj,34595,34596,69191
37860,,1btjebvuhgej,34596,34597,69193
37861,,vfmthhp1z2ij,34597,34598,69195
37862,,16a8rd8og7qj,34598,34599,69197
37863,,zv1gparfu94j,34599,34600,69199
37864,,m32obfbe79sj,34600,34601,69201
37865,,mxye9g0hhewj,34601,34602,69203
37866,,h-6zbqb7nvuj,34602,34603,69205
37867,,5eaqnxm6djkj,34604,34605,69209
37868,,pc8mvoskdgoj,34605,34606,69211
37869,,ju7btbvbgksj,34606,34607,69213
37870,,nwfgdxpx-hyj,34607,34608,69215
37871,,62mtv5wqgf0j,34608,34609,69217
37872,,oggx0gzc_eyj,34609,34610,69219
37873,,ddsuspo4f2yj,34610,34611,69221
37874,,ektpai7vmjgj,34611,34612,69223
37875,,url:http://www.csa.com/partners/viewrecord.php3frequester3dgs26collection3dtrd26recid3d0835655ci,34612,34613,69225
37876,,vgqgd-ncbmsj,34613,34614,69227
37877,,e7zjaqcjo4ej,34614,34615,69229
37878,,v3ayjmfobzwj,34615,34616,69231
37879,,vw6ehgn7zb4j,34616,34617,69233
37880,,vqt66qj4jqcj,34617,34618,69235
37881,,url:http://ieeexplore.ieee.org/iel5/9217/29235/01320054.pdf3farnumber3d1320054,34618,34619,69237
37882,,xlffnlfuegej,34619,34620,69239
37883,,mxsyk3udxqyj,34620,34621,69241
37884,,ieqkzb3xbdgj,34621,34622,69243
37885,,pf8lqj7ck-4j,34622,34623,69245
37886,,9ys2z7wfcf0j,34623,34624,69247
37887,,9mdcp_a1rouj,34624,34625,69249
37888,,3-i3voohgz8j,34625,34626,69251
37889,,oaxk86f_gq0j,34626,34627,69253
37890,,h236vvi5li4j,34627,34628,69255
37891,,url:http://portal.acm.org/ft_gateway.cfm3fid3d108369326type3dpdf,34628,34629,69257
37892,,ja4cfnbneqgj,34629,34630,69259
37893,,l_r7ncsgvzwj,34631,34632,69263
37894,,fj3cscgikskj,34632,34633,69265
37895,,71gjvad7yiyj,34633,34634,69267
37896,,o8htucqqwbmj,34634,34635,69269
37897,,,34635,34636,69271
37898,,bqm9f-lgbjmj,34636,34637,69273
37899,,35ephn7rrwcj,34637,34638,69275
37900,,v9dxgims8zcj,34638,34639,69277
37901,,s_jh-ztvr08j,34639,34640,69279
37902,,ueq6dd5x8k4j,34640,34641,69281
37903,,9cpihur6bocj,34641,34642,69283
37904,,1vyonkku7wuj,34642,34643,69285
37905,,evocnwxiv-wj,34643,34644,69287
37906,,__qwbcjwaisj,34644,34645,69289
37907,,bilset6ldjgj,34645,34646,69291
37908,,url:http://www.csa.com/partners/viewrecord.php3frequester3dgs26collection3denv26recid3d7800015,34646,34647,69293
37909,,xfl-rmescnsj,34647,34648,69295
37910,,d2c287wvomuj,34648,34649,69297
37911,,mwbzcv_v4gsj,34649,34650,69299
37912,,_k7qe9gchyoj,34650,34651,69301
37913,,aodg3cq3uqij,34651,34652,69303
37914,,wg7levsel30j,34652,34653,69305
37915,,jcw2ir49nkcj,34653,34654,69307
37916,,url:http://portal.acm.org/ft_gateway.cfm3fid3d110132326type3dpdf,34654,34655,69309
37917,,hqp6i2gy-auj,34655,34656,69311
37918,,yadobjxtymmj,34656,34657,69313
37919,,wev8xxtoa_gj,34657,34658,69315
37920,,sflsl49yd9sj,34658,34659,69317
37921,,v-jeugmb5ucj,34659,34660,69319
37922,,qq7_ybehchmj,34660,34661,69321
37923,,olte1e-v-fsj,34661,34662,69323
37924,,mpwobk7wpwcj,34662,34663,69325
37925,,sp3co583dhmj,34663,34664,69327
37926,,url:http://portal.acm.org/ft_gateway.cfm3fid3d100768126type3dpdf,34664,34665,69329
37927,,sdmejjlr-aaj,34665,34666,69331
37928,,rjktvrgsvg4j,34666,34667,69333
37929,,mjwpubvyjoyj,34667,34668,69335
37930,,4fet8cudbbuj,34668,34669,69337
37931,,yfjqky1dqzcj,34669,34670,69339
37932,,8hn5j7gxjy0j,34670,34671,69341
37933,,bui-suavmzuj,34671,34672,69343
37934,,oggtgowdepwj,34672,34673,69345
37935,,xnvqcxmsnaij,34673,34674,69347
37936,,rpi2rpszfd0j,34674,34675,69349
37937,,xhic0cruascj,34675,34676,69351
37938,,nxex-le6ls4j,34676,34677,69353
37939,,iiddl7xsk-sj,34677,34678,69355
37940,,gb53jo2iaroj,34678,34679,69357
37941,,rlahwzj6fcuj,34679,34680,69359
37942,,c9y1kbdudpij,34680,34681,69361
37943,,pxirbmgdvi4j,34681,34682,69363
37944,,lgjlccc_ozkj,34682,34683,69365
37945,,lo1a73o0xbaj,34683,34684,69367
37946,,njfbrjwcnvuj,34684,34685,69369
37947,,gjknoaipm4qj,34685,34686,69371
37948,,l0ychk6kiqaj,34686,34687,69373
37949,,6pcxktoalfqj,34687,34688,69375
37950,,58yfrcsviwij,34688,34689,69377
37951,,l3dzzzqlauaj,34689,34690,69379
37952,,bi8ga9puq1oj,34690,34691,69381
37953,,mxlxa7zd1soj,34691,34692,69383
37954,,juhsuzgghrij,34692,34693,69385
37955,,jdjcuz5xekuj,34693,34694,69387
37956,,8ih77zcvmr4j,34694,34695,69389
37957,,n3kbwiuj5swj,34695,34696,69391
37958,,p2dgpefqpiej,34696,34697,69393
37959,,rzr9vm56-xgj,34697,34698,69395
37960,,wqosyfszg2aj,34699,34700,69399
37961,,pccbiemjvvyj,34700,34701,69401
37962,,ilkkvowanyyj,34701,34702,69403
37963,,cbyrhmmyqhwj,34702,34703,69405
37964,,url:http://www.csa.com/partners/viewrecord.php3frequester3dgs26collection3dtrd26recid3d200111010709mt26recid3da0032644ah,34703,34704,69407
37965,,q_esckylyi0j,34704,34705,69409
37966,,dpvbuf0a4z0j,34705,34706,69411
37967,,uypnc5gb9iij,34706,34707,69413
37968,,ici4bctogx4j,34707,34708,69415
37969,,tppc2ja5uxmj,34708,34709,69417
37970,,dyc6j_cnxqaj,34709,34710,69419
37971,,3eswrxf3-3sj,34710,34711,69421
37972,,url:http://portal.acm.org/citation.cfm3fid3d1083592.1083763,34711,34712,69423
37973,,xuoapynljwkj,34712,34713,69425
37974,,go47onufmduj,34713,34714,69427
37975,,xq0upuubnioj,34714,34715,69429
37976,,w3or6ec6c6aj,34715,34716,69431
37977,,zt8thg0qqe8j,34716,34717,69433
37978,,rce1nnil9loj,34717,34718,69435
37979,,9fyefbbmr3ej,34718,34719,69437
37980,,bqeicq-ygk8j,34719,34720,69439
37981,,url:http://portal.acm.org/ft_gateway.cfm3fid3d30444626type3dpdf26dl3dguide26dl3dacm26cfid3d1111111126cftoken3d2222222,34720,34721,69441
37982,,rwqvitfg4eej,34721,34722,69443
37983,,xskldlrsku0j,34722,34723,69445
37984,,347oyb_b7daj,34723,34724,69447
37985,,dtfwksdxn5mj,34724,34725,69449
37986,,be8bjzsdefgj,34725,34726,69451
37987,,tok56hjpqvuj,34726,34727,69453
37988,,url:http://portal.acm.org/ft_gateway.cfm3fid3d32012926type3dpdf26coll3dguide26dl3dacm26cfid3d1111111126cftoken3d2222222,34728,34729,69457
37989,,ujcu45ru094j,34729,34730,69459
37990,,w4_uwrrwrhwj,34730,34731,69461
37991,,xkfl6-y--cej,34731,34732,69463
37992,,vtr56kcbmq0j,34732,34733,69465
37993,,_cddvfjbwf0j,34733,34734,69467
37994,,ztq3jthczs8j,34735,34736,69471
37995,,ho5dnqievokj,34736,34737,69473
37996,,4rgdkq0itl4j,34737,34738,69475
37997,,w_4fvsmuitqj,34738,34739,69477
37998,,yrihpjbh-zgj,34739,34740,69479
37999,,fw9qqrhiil0j,34740,34741,69481
38000,,yoplfvwjjhgj,34741,34742,69483
38001,,,34742,34743,69485
38002,,f1rlyfgugd4j,34743,34744,69487
38003,,fd9casxdk9qj,34744,34745,69489
38004,,,34745,34746,69491
38005,,hu4u5d7z_wqj,34746,34747,69493
38006,,ewzcg8v36a0j,34747,34748,69495
38007,,4n6ua8wzjyuj,34748,34749,69497
38008,,i71mgng0yw8j,34749,34750,69499
38009,,2y9klchcfuoj,34750,34751,69501
38010,,8t4aa_dynuoj,34751,34752,69503
38011,,vvd-u4ty4p4j,34752,34753,69505
38012,,orkcxpcz_gkj,34753,34754,69507
38013,,url:http://www.springerlink.com/index/3887651358236g4l.pdf,34754,34755,69509
38014,,1s6bzsrtfe4j,34755,34756,69511
38015,,framp30btxoj,34756,34757,69513
38016,,szo8njream0j,34757,34758,69515
38017,,cxc8tcxg8hcj,34758,34759,69517
38018,,invsiqcrjwij,34759,34760,69519
38019,,url:http://portal.acm.org/citation.cfm3fid3d645927.672352,34760,34761,69521
38020,,ru7pwpnobgmj,34761,34762,69523
38021,,epnbar9fuqej,34762,34763,69525
38022,,xuep4x8k5soj,34763,34764,69527
38023,,m3ztoqgsumqj,34764,34765,69529
38024,,mgv0xn3_snaj,34765,34766,69531
38025,,bts3jbucdmwj,34766,34767,69533
38026,,s3ai7o_inaqj,34767,34768,69535
38027,,url:http://www.csa.com/partners/viewrecord.php3frequester3dgs26collection3dtrd26recid3d0249747ci,34768,34769,69537
38028,,z3iihw8jvscj,34769,34770,69539
38029,,url:http://www.geography.org.uk/journals/download.asp3farticleid3d154,34770,34771,69541
38030,,url:http://portal.acm.org/citation.cfm3fid3d1083592.1083734,34772,34773,69545
38031,,eh-tvn010zoj,34773,34774,69547
38032,,b1ndatbc1zuj,34774,34775,69549
38033,,cgptetr7t1sj,34775,34776,69551
38034,,s6mjk0jsldmj,34776,34777,69553
38035,,q3stvfaac1kj,34777,34778,69555
38036,,_dfbkzpcblqj,34778,34779,69557
38037,,gmrqgsmzlryj,34779,34780,69559
38038,,qtyxz5cybqyj,34780,34781,69561
38039,,aztyzfi0_o4j,34781,34782,69563
38040,,qsewmetzf8sj,34782,34783,69565
38041,,8-ibkuoxlzyj,34784,34785,69569
38042,,lub2_zos478j,34785,34786,69571
38043,,xby378t1nssj,34786,34787,69573
38044,,url:http://doi.wiley.com/10.1002/he.34.abs,34787,34788,69575
38045,,htxgbmktxdsj,34788,34789,69577
38046,,bvhj72aejdij,34789,34790,69579
38047,,tpiyac_buegj,34790,34791,69581
38048,,qsazvajuthgj,34791,34792,69583
38049,,kqnnuhidbqyj,34792,34793,69585
38050,,gddx8z6rrewj,34793,34794,69587
38051,,wzypyvzpcdoj,34794,34795,69589
38052,,0cl5blqvky0j,34795,34796,69591
38053,,s_cjd8qls4oj,34796,34797,69593
38054,,9zmh5mz0mxij,34797,34798,69595
38055,,irokbaaxi6qj,34798,34799,69597
38056,,odul4ojdfhmj,34799,34800,69599
38057,,oub6ph8mpdsj,34800,34801,69601
38058,,agyx_stchxoj,34801,34802,69603
38059,,rp5nqwlrzjgj,34802,34803,69605
38060,,hacgdtooefaj,34803,34804,69607
38061,,v5g64xtuv4qj,34804,34805,69609
38062,,kggjxov4hwyj,34805,34806,69611
38063,,caoct-nyddgj,34806,34807,69613
38064,,ohjnvncmqs4j,34807,34808,69615
38065,,ekdxwvyysoqj,34808,34809,69617
38066,,jj-l6qy9obkj,34809,34810,69619
38067,,f83ou6sdrjyj,34810,34811,69621
38068,,wckesjjl6_yj,34811,34812,69623
38069,,url:http://www.csa.com/partners/viewrecord.php3frequester3dgs26collection3dtrd26recid3d200111039713mt26recid3da8744328ah,34812,34813,69625
38070,,2jzxknchm74j,34813,34814,69627
38071,,hoibsimgt18j,34814,34815,69629
38072,,o0vnsbvzrqcj,34815,34816,69631
38073,,8zkkdoxwdqmj,34816,34817,69633
38074,,ztputs_mezmj,34817,34818,69635
38075,,zufaot5bs3kj,34818,34819,69637
38076,,5rk-xj3ip6sj,34819,34820,69639
38077,,a2kxl4qfzk0j,34820,34821,69641
38078,,yqnqgdlgo5oj,34821,34822,69643
38079,,mycuagkewpqj,34822,34823,69645
38080,,czwslu-dvscj,34823,34824,69647
38081,,plfyg8zrxlgj,34824,34825,69649
38082,,paqzht2emggj,34825,34826,69651
38083,,lz8c1d6vec0j,34826,34827,69653
38084,,7c0ugwqwrqoj,34827,34828,69655
38085,,bh8mq8atteuj,34828,34829,69657
38086,,igekfypywk8j,34829,34830,69659
38087,,url:http://www.csa.com/partners/viewrecord.php3frequester3dgs26collection3dtrd26recid3d1611560so,34830,34831,69661
38088,,es2op-ydrzyj,34831,34832,69663
38089,,pr6hxgbjmxoj,34832,34833,69665
38090,,imadir74kwij,34833,34834,69667
38091,,prq6b0rxfmmj,34834,34835,69669
38092,,9cd7sruip9gj,34835,34836,69671
38093,,hfnot1k-droj,34836,34837,69673
38094,,kaiouh6bwcej,34837,34838,69675
38095,,vagslidzaiaj,34838,34839,69677
38096,,dahszzjmftwj,34839,34840,69679
38097,,url:http://doi.wiley.com/10.1002/he.93,34840,34841,69681
38098,,t8w8va4vvpaj,34841,34842,69683
38099,,yk4tgmnbvt8j,34842,34843,69685
38100,,mgrrearu2aoj,34843,34844,69687
38101,,914zgbae6rgj,34844,34845,69689
38102,,q0c-5ant_gcj,34845,34846,69691
38103,,luhqn1tizykj,34846,34847,69693
38104,,url:http://doi.wiley.com/10.1002/tl.7902,34847,34848,69695
38105,,l30vwmdp7quj,34848,34849,69697
38106,,aofaowanqcyj,34849,34850,69699
38107,,fzhrtmzpncoj,34850,34851,69701
38108,,1rwkr2yzk3mj,34851,34852,69703
38109,,k_vvjfyiebkj,34852,34853,69705
38110,,q6ktksingwqj,34853,34854,69707
38111,,ht-j8dw6wjwj,34854,34855,69709
38112,,wmi8w6ipioyj,34856,34857,69713
38113,,sxn0nxsqhs0j,34857,34858,69715
38114,,5bt5do88llij,34858,34859,69717
38115,,dovw-bju3rgj,34859,34860,69719
38116,,y6ypetv0q74j,34860,34861,69721
38117,,1pkyteglm0wj,34862,34863,69725
38118,,xw_7jwce5jmj,34863,34864,69727
38119,,fq7hqbh_ne8j,34864,34865,69729
38120,,hhee3ov0thsj,34865,34866,69731
38121,,url:http://doi.wiley.com/10.1002/he.11201,34866,34867,69733
38122,,hwvcy3sr5lsj,34867,34868,69735
38123,,o81uxkxixxcj,34868,34869,69737
38124,,ruc9flmna2oj,34869,34870,69739
38125,,xu9ur-trwwuj,34870,34871,69741
38126,,zux8zmix8bgj,34871,34872,69743
38127,,kxcp6lkfyv4j,34872,34873,69745
38128,,fq5beyivatgj,34873,34874,69747
38129,,jfambjrjnaij,34874,34875,69749
38130,,url:http://www.springerlink.com/index/x87r5k61657u3187.pdf,34875,34876,69751
38131,,umgjamqs2vmj,34876,34877,69753
38132,,qbzlhqkbmzyj,34877,34878,69755
38133,,pdkq9oypcakj,34878,34879,69757
38134,,ihz0cepqnpkj,34879,34880,69759
38135,,wtp2e8neppcj,34880,34881,69761
38136,,jy3gznx3mbej,34881,34882,69763
38137,,epspsfakdl4j,34882,34883,69765
38138,,qblvixb3gjwj,34883,34884,69767
38139,,0-kk0b9hwiuj,34884,34885,69769
38140,,ulwosdc2gnsj,34885,34886,69771
38141,,srdaglumxp0j,34886,34887,69773
38142,,6al5nszzrnij,34887,34888,69775
38143,,l6vsl4qnj48j,34888,34889,69777
38144,,g9_nmpgdp3mj,34889,34890,69779
38145,,m523o6kymdsj,34890,34891,69781
38146,,lzu49skmbzsj,34891,34892,69783
38147,,u7hux5wshmij,34892,34893,69785
38148,,3whuswxi6lej,34893,34894,69787
38149,,a9ip6acklmcj,34894,34895,69789
38150,,yvci81vp9kaj,34895,34896,69791
38151,,fdsymryynq4j,34896,34897,69793
38152,,goatqv0ng0ej,34897,34898,69795
38153,,3uamyydao1ij,34898,34899,69797
38154,,3kl1huxstgqj,34899,34900,69799
38155,,5hlqsm9yqdaj,34900,34901,69801
38156,,gu3oyyavgzej,34901,34902,69803
38157,,url:http://www.csa.com/partners/viewrecord.php3frequester3dgs26collection3dtrd26recid3dn9210490ah,34904,34905,69809
38158,,ljl3fnaye40j,34905,34906,69811
38159,,aeslghylgjsj,34906,34907,69813
38160,,1uwjt9z9jsgj,34907,34908,69815
38161,,nwjkyxvr1saj,34908,34909,69817
38162,,avcc9nspiwij,34909,34910,69819
38163,,u6ne0etcsf0j,34911,34912,69823
38164,,r-aiwcwis1cj,34912,34913,69825
38165,,a__htalmxnuj,34913,34914,69827
38166,,jah8jz5l410j,34914,34915,69829
38167,,bsgni5tn55sj,34915,34916,69831
38168,,cwpzkcg1abuj,34916,34917,69833
38169,,qio0yn_fg-0j,34917,34918,69835
38170,,8qe_wch7daij,34918,34919,69837
38171,,ha2tabx6nyuj,34919,34920,69839
38172,,prxbsptvgaaj,34920,34921,69841
38173,,pjn0qadbblej,34921,34922,69843
38174,,btnkgb26ygaj,34922,34923,69845
38175,,c9je6w0c9fkj,34923,34924,69847
38176,,m_rmrr3tyr4j,34925,34926,69851
38177,,vm8tnb6toecj,34926,34927,69853
38178,,8vfaendje6ij,34927,34928,69855
38179,,7z7tdufdfngj,34928,34929,69857
38180,,lbs3bxlr8s4j,34929,34930,69859
38181,,qtwwyx7prcsj,34930,34931,69861
38182,,5fsg85hbuygj,34931,34932,69863
38183,,2cyasbpetrij,34932,34933,69865
38184,,lhnimvymmogj,34933,34934,69867
38185,,ie-xxj0u5bej,34934,34935,69869
38186,,wvyjh3kie8sj,34935,34936,69871
38187,,76safvdtaeej,34936,34937,69873
38188,,9fz3kosarekj,34937,34938,69875
38189,,7antohnspeyj,34938,34939,69877
38190,,gattmoeazg0j,34940,34941,69881
38191,,url:http://portal.acm.org/citation.cfm3fid3d264335,34941,34942,69883
38192,,xniwozrrciwj,34942,34943,69885
38193,,wuyqrwe6wcaj,34943,34944,69887
38194,,j-zxzlooaugj,34944,34945,69889
38195,,cai0gefw0t8j,34945,34946,69891
38196,,rljlttfm36ij,34946,34947,69893
38197,,url:http://portal.acm.org/citation.cfm3fid3d604275,34947,34948,69895
38198,,url:http://portal.acm.org/citation.cfm3fid3d192593.19745626dl3dguide26dl3dacm26type3dseries26idx3d19259326part3dproceedings26wanttype3dproceedings26title3dinternational2520multimedia2520conference26cfid3d1111111126cftoken3d2222222,34948,34949,69897
38199,,ajefgjiggcoj,34949,34950,69899
38200,,nez5xab-iqgj,34950,34951,69901
38201,,iu1sydyae6qj,34951,34952,69903
38202,,kec_bjxvdkij,34952,34953,69905
38203,,ec1nc0mfm3oj,34953,34954,69907
38204,,95jdsgsh9rqj,34954,34955,69909
38205,,kcvbkwv7ceoj,34955,34956,69911
38206,,uoca-qynvk8j,34956,34957,69913
38207,,url:http://adsabs.harvard.edu/abs/1979phdt........37t,34957,34958,69915
38208,,1-j0gtb37nqj,34958,34959,69917
38209,,yzdshqwyryaj,34959,34960,69919
38210,,d0j5fdlmunej,34960,34961,69921
38211,,nufdrxg4ufij,34961,34962,69923
38212,,fy2irxigj_sj,34962,34963,69925
38213,,k5bprmtxyu8j,34963,34964,69927
38214,,unnosnicxwij,34964,34965,69929
38215,,url:http://portal.acm.org/citation.cfm3fid3d66926,34965,34966,69931
38216,,atkmqzxhc2ij,34966,34967,69933
38217,,cgh11b4zepgj,34967,34968,69935
38218,,5_7gmrwegdqj,34968,34969,69937
38219,,isiz41kakvgj,34969,34970,69939
38220,,hbkgn8qfgsoj,34970,34971,69941
38221,,url:http://adsabs.harvard.edu/abs/1980mit..reptq....s,34971,34972,69943
38222,,xjbpxqnsd8qj,34972,34973,69945
38223,,zva6c7owbaij,34973,34974,69947
38224,,uaajl906vyoj,34974,34975,69949
38225,,lktp2hahztsj,34975,34976,69951
38226,,ik785vjyftwj,34976,34977,69953
38227,,gicd8lkrfdsj,34977,34978,69955
38228,,2kxhx32gezij,34978,34979,69957
38229,,owvyluiy9jwj,34979,34980,69959
38230,,5iode8dgfqyj,34980,34981,69961
38231,,0onmptmwa3cj,34981,34982,69963
38232,,ybapuo6io5aj,34982,34983,69965
38233,,az0rsxxqh8gj,34983,34984,69967
38234,,si3vad3u7p8j,34984,34985,69969
38235,,5vuvsmrrea4j,34985,34986,69971
38236,,0q2mmlh-6z0j,34986,34987,69973
38237,,zs1hnx8rcimj,34987,34988,69975
38238,,tlirbm97epqj,34988,34989,69977
38239,,xv3mx9vwltyj,34989,34990,69979
38240,,muh0rkm4xaij,34990,34991,69981
38241,,1wavr-ztvxaj,34991,34992,69983
38242,,sgm14sh3hgmj,34992,34993,69985
38243,,url:http://www.kluweronline.com/article.asp3fpips3d525477826pdf3d1,34993,34994,69987
38244,,gnzvsgt2mryj,34994,34995,69989
38245,,kij2saahgl4j,34995,34996,69991
38246,,url:http://www.springerlink.com/index/e204fftefg3cfth1.pdf,34996,34997,69993
38247,,ayng2rkdyj4j,34997,34998,69995
38248,,i-2f3z8ijoyj,34998,34999,69997
38249,,,34999,35000,69999
38250,,yqm_uffel7cj,35000,35001,70001
38251,,cnjwd2x87i0j,35001,35002,70003
38252,,-7pp3rsp1ucj,35002,35003,70005
38253,,_af4sn-clmmj,35003,35004,70007
38254,,fvbtledsj0aj,35004,35005,70009
38255,,ho33ksgkvlyj,35005,35006,70011
38256,,jofet_ml93ij,35006,35007,70013
38257,,pfar-t-ux-gj,35007,35008,70015
38258,,url:http://www.csa.com/partners/viewrecord.php3frequester3dgs26collection3dtrd26recid3d155929ws26recid3d199301550063md,35008,35009,70017
38259,,mc4qoxrruoej,35009,35010,70019
38260,,qqccsajz3pwj,35010,35011,70021
38261,,me7boarmq-sj,35011,35012,70023
38262,,lha8g9lzi_0j,35012,35013,70025
38263,,wwdhzheub2cj,35013,35014,70027
38264,,e1lywhgwzl4j,35014,35015,70029
38265,,idp6cl47-3ej,35015,35016,70031
38266,,7mwtqerobhwj,35016,35017,70033
38267,,jqqbdnr9fxyj,35017,35018,70035
38268,,p0yhojdarfej,35018,35019,70037
38269,,qjrhc8oknrqj,35019,35020,70039
38270,,xh5dvjprhgoj,35020,35021,70041
38271,,2nirv30mdssj,35021,35022,70043
38272,,url:http://portal.acm.org/ft_gateway.cfm3fid3d102764826type3dpdf,35022,35023,70045
38273,,7dj7oks9f2gj,35023,35024,70047
38274,,evnk3ewphwuj,35024,35025,70049
38275,,_xx0a6nnwquj,35025,35026,70051
38276,,dx9x2eupfhmj,35026,35027,70053
38277,,8b_m-etz2o4j,35027,35028,70055
38278,,url:http://portal.acm.org/ft_gateway.cfm3fid3d110116326type3dpdf,35028,35029,70057
38279,,i7nwv7ehcsaj,35029,35030,70059
38280,,n0uet6ugsdwj,35030,35031,70061
38281,,awhjypz6yzaj,35031,35032,70063
38282,,pg_634bybfoj,35032,35033,70065
38283,,ajh-xfd0zxsj,35033,35034,70067
38284,,9xdnhvtrsduj,35034,35035,70069
38285,,hlu7mvwb5rmj,35035,35036,70071
38286,,20a-7ec92oyj,35036,35037,70073
38287,,zpofyhxgatmj,35037,35038,70075
38288,,1ziqj6pooc4j,35038,35039,70077
38289,,pfvdk4imu3mj,35039,35040,70079
38290,,63qglkmev70j,35040,35041,70081
38291,,dxk_jg7p27ij,35041,35042,70083
38292,,gvf5sqryssij,35042,35043,70085
38293,,ca-babwlsqaj,35043,35044,70087
38294,,q4yydwkhozwj,35044,35045,70089
38295,,0xsvborvb6cj,35045,35046,70091
38296,,e3fk6gen2a4j,35046,35047,70093
38297,,qfn1qw5zzywj,35047,35048,70095
38298,,lzqz9g966ikj,35048,35049,70097
38299,,n1-twp5lezij,35049,35050,70099
38300,,jml6fldou7qj,35050,35051,70101
38301,,bxu3vyi4us0j,35051,35052,70103
38302,,arp0u3sap_wj,35052,35053,70105
38303,,9hhtac4jpe4j,35053,35054,70107
38304,,irzjh5j7fgsj,35054,35055,70109
38305,,zjqo1roxwd4j,35055,35056,70111
38306,,qfddycl0d5uj,35056,35057,70113
38307,,ygcfoj9vqwmj,35057,35058,70115
38308,,d1z6goxdt2mj,35058,35059,70117
38309,,zgicmgjl67gj,35059,35060,70119
38310,,env_l859tvoj,35060,35061,70121
38311,,rcq7jia3rhkj,35061,35062,70123
38312,,yj3o1lkvxhwj,35062,35063,70125
38313,,wxuuqe5p5l0j,35063,35064,70127
38314,,auvmrp30sryj,35064,35065,70129
38315,,puutmo_qzbkj,35065,35066,70131
38316,,zowv-tyk7wyj,35066,35067,70133
38317,,rn_tybgasnqj,35067,35068,70135
38318,,b3mo9t_dloqj,35068,35069,70137
38319,,2wtzbxrkfnij,35069,35070,70139
38320,,1lkrkmn025aj,35070,35071,70141
38321,,xvac7qjd_8yj,35071,35072,70143
38322,,9uydycim2zmj,35073,35074,70147
38323,,eslkq0ue8coj,35074,35075,70149
38324,,lkdaw7_pdyoj,35075,35076,70151
38325,,lrqfa3zxneaj,35076,35077,70153
38326,,ke6wo5obeygj,35077,35078,70155
38327,,rea_hxnwgz4j,35078,35079,70157
38328,,i7dlyb6nnw0j,35079,35080,70159
38329,,yy7uxjdlto8j,35080,35081,70161
38330,,mdzxiqvjqasj,35081,35082,70163
38331,,pj-5nxe3mn8j,35082,35083,70165
38332,,t137algaf-qj,35083,35084,70167
38333,,5iwmt22ilryj,35084,35085,70169
38334,,h_ekr1nrxv0j,35085,35086,70171
38335,,dr-rpqt3pouj,35086,35087,70173
38336,,ipsta_aqkjyj,35087,35088,70175
38337,,_hno8qzjgruj,35088,35089,70177
38338,,x4_xeivay0oj,35089,35090,70179
38339,,pk-vt8ziio0j,35090,35091,70181
38340,,ds02fkn-y80j,35091,35092,70183
38341,,rjnjrvnqi_ej,35094,35095,70189
38342,,tt1vlpfuijgj,35095,35096,70191
38343,,kzrx0guvj2kj,35096,35097,70193
38344,,emklnpdqf1uj,35097,35098,70195
38345,,qn0rejsdzdqj,35098,35099,70197
38346,,y_2fmkxeohmj,35099,35100,70199
38347,,r7s58b9ovyoj,35100,35101,70201
38348,,_i2pmflzc0qj,35101,35102,70203
38349,,pp0pl6ljp9gj,35102,35103,70205
38350,,vayvxdoquwwj,35103,35104,70207
38351,,e09sxl9w5gij,35104,35105,70209
38352,,kvn46kkzizcj,35105,35106,70211
38353,,ycdte6ckfsyj,35106,35107,70213
38354,,8j_5z-cwnnmj,35107,35108,70215
38355,,wvnljg_dpw4j,35108,35109,70217
38356,,3zrevocei0wj,35109,35110,70219
38357,,url:http://www.geography.org.uk/journals/journals.asp3farticleid3d44,35110,35111,70221
38358,,jinjotzkbpij,35111,35112,70223
38359,,sr-83hrlkdij,35112,35113,70225
38360,,utx4nflz6eij,35113,35114,70227
38361,,ad92qkuci_kj,35114,35115,70229
38362,,crrabel1llaj,35115,35116,70231
38363,,k6wnzdqvt5ej,35116,35117,70233
38364,,gstvuq-wt74j,35117,35118,70235
38365,,m00bnek5gj8j,35118,35119,70237
38366,,cno_c3b2bzqj,35119,35120,70239
38367,,xo4kxwq9xicj,35120,35121,70241
38368,,url:http://www.springerlink.com/index/q672v0240r4033q1.pdf,35121,35122,70243
38369,,rdl5lvxsma0j,35123,35124,70247
38370,,xp05b8klbyej,35124,35125,70249
38371,,x79ymh_j8zkj,35125,35126,70251
38372,,jcg4xrjxyfyj,35126,35127,70253
38373,,kkk4xijfq70j,35127,35128,70255
38374,,ekwfivpjztoj,35128,35129,70257
38375,,url:http://portal.acm.org/ft_gateway.cfm3fid3d36929126type3dpdf26dl3dguide26dl3dacm26cfid3d1111111126cftoken3d2222222,35129,35130,70259
38376,,ntnfr7dtgigj,35130,35131,70261
38377,,pusj4wix8hgj,35131,35132,70263
38378,,yxv3e5ouymsj,35132,35133,70265
38379,,uezhzgp9brej,35133,35134,70267
38380,,ffviv1gfgzuj,35135,35136,70271
38381,,xi1wcl3cuuaj,35136,35137,70273
38382,,uzqkmyx8y0ej,35137,35138,70275
38383,,trx6o8fzrqoj,35138,35139,70277
38384,,znx4vcyuad8j,35139,35140,70279
38385,,s5qzuoo4af8j,35140,35141,70281
38386,,oae6hwl15z4j,35141,35142,70283
38387,,da2j18ry5pij,35142,35143,70285
38388,,xxhyvbfen2aj,35143,35144,70287
38389,,pirau6xcqrmj,35144,35145,70289
38390,,cu9dxtjef24j,35145,35146,70291
38391,,o4dh9kivye4j,35146,35147,70293
38392,,e_poclayrk0j,35147,35148,70295
38393,,p626pmxqzhcj,35148,35149,70297
38394,,z-bfyonfckaj,35149,35150,70299
38395,,rnvb29afuhej,35150,35151,70301
38396,,url:http://links.jstor.org/sici3fsici3d0146-4949(196724)8253a1253c60253atiowsa253e2.0.co253b2-r,35151,35152,70303
38397,,url:http://portal.acm.org/citation.cfm3fid3d237301,35152,35153,70305
38398,,rw3an13jxluj,35153,35154,70307
38399,,jugwx-5dluwj,35154,35155,70309
38400,,zfebtn3aoiaj,35155,35156,70311
38401,,z36obxdx-dgj,35156,35157,70313
38402,,03vmwhjpvsyj,35157,35158,70315
38403,,w_b-eo5vaogj,35158,35159,70317
38404,,a3xtqdi1j5uj,35159,35160,70319
38405,,3fpj26ryagqj,35160,35161,70321
38406,,j8c_xwgjvrkj,35161,35162,70323
38407,,gywgsfl7_ygj,35162,35163,70325
38408,,cmdb816fl7mj,35163,35164,70327
38409,,grukhohmdjqj,35164,35165,70329
38410,,f39sc2ajgykj,35165,35166,70331
38411,,vgoyklrrabsj,35166,35167,70333
38412,,02duv_2w7e4j,35167,35168,70335
38413,,url:http://portal.acm.org/citation.cfm3fid3d171926.171959,35168,35169,70337
38414,,zjnhndsxlpuj,35169,35170,70339
38415,,xbphgz5zfwaj,35170,35171,70341
38416,,gw74wxbfgykj,35171,35172,70343
38417,,uuj1rkhlfpyj,35172,35173,70345
38418,,url:http://www.csa.com/partners/viewrecord.php3frequester3dgs26collection3dtrd26recid3da8012645ah,35173,35174,70347
38419,,u-adwoagtnej,35174,35175,70349
38420,,d3fzecltiuej,35175,35176,70351
38421,,h0h8wwsxeoyj,35176,35177,70353
38422,,ddjanysecuej,35177,35178,70355
38423,,w_j2gn_prnij,35178,35179,70357
38424,,c2bqlsk-gmuj,35179,35180,70359
38425,,qi_fphbfr4wj,35180,35181,70361
38426,,i1njg59d69ij,35181,35182,70363
38427,,6yug31fgk6mj,35182,35183,70365
38428,,,35183,35184,70367
38429,,9awwi9dekymj,35184,35185,70369
38430,,98gd-x4i6y4j,35185,35186,70371
38431,,url:http://portal.acm.org/citation.cfm3fid3d82148.82171,35186,35187,70373
38432,,sifuolp3gyej,35187,35188,70375
38433,,rdydzgifz6oj,35188,35189,70377
38434,,ifunbvhyu5ij,35189,35190,70379
38435,,j_txd3-zyesj,35190,35191,70381
38436,,eorf8hnqzb0j,35191,35192,70383
38437,,prl0iagoquqj,35192,35193,70385
38438,,osvaygdj8wkj,35193,35194,70387
38439,,fyixuigl7f4j,35194,35195,70389
38440,,lhttkja429qj,35195,35196,70391
38441,,zxeqlrp8ns4j,35196,35197,70393
38442,,rwdx5slla7ij,35197,35198,70395
38443,,ciq01lhglkaj,35198,35199,70397
38444,,58qs16d0pskj,35199,35200,70399
38445,,mz1gonxdj1mj,35200,35201,70401
38446,,ysxiqxsa1tcj,35201,35202,70403
38447,,dxfi4zv8tkij,35202,35203,70405
38448,,0pf3n9t34lyj,35203,35204,70407
38449,,url:http://portal.acm.org/citation.cfm3fid3d1085028.1085034,35204,35205,70409
38450,,url:http://portal.acm.org/citation.cfm3fid3d1099554.1099626,35205,35206,70411
38451,,ko3lpor4g1mj,35206,35207,70413
38452,,iip0ppgndl0j,35207,35208,70415
38453,,68blzxluevuj,35208,35209,70417
38454,,oowmdmqid44j,35209,35210,70419
38455,,gq0uwrtq5wej,35210,35211,70421
38456,,mye6ojtux-qj,35211,35212,70423
38457,,myj_hmoxjiqj,35212,35213,70425
38458,,xtvdl1lsljcj,35213,35214,70427
38459,,evczcysesqcj,35214,35215,70429
38460,,dxqrzbqruvwj,35215,35216,70431
38461,,bhv77x8snakj,35216,35217,70433
38462,,znxnonuh18ej,35217,35218,70435
38463,,a7k9pgmnausj,35218,35219,70437
38464,,8d48zeediqqj,35219,35220,70439
38465,,9wq6rwwchrij,35220,35221,70441
38466,,6ojj1u4eyowj,35221,35222,70443
38467,,707rpzhab8yj,35223,35224,70447
38468,,zn5rvepdjfgj,35225,35226,70451
38469,,taphzimnv-gj,35226,35227,70453
38470,,qldipuwvvuqj,35227,35228,70455
38471,,nqjmbnjkfkaj,35228,35229,70457
38472,,kjybuqz-gnoj,35229,35230,70459
38473,,dpd2zhl1fdsj,35230,35231,70461
38474,,wkxr7ny3tcaj,35231,35232,70463
38475,,azykamoaen8j,35232,35233,70465
38476,,xcf5kbq2rr4j,35233,35234,70467
38477,,pjeu7tvbd2cj,35234,35235,70469
38478,,nyvz_hn8c7kj,35235,35236,70471
38479,,fttzmqun3ksj,35236,35237,70473
38480,,fv-abnwwv7ij,35237,35238,70475
38481,,0llajmhcwqqj,35238,35239,70477
38482,,bza49-1loaij,35239,35240,70479
38483,,2h-6vxfqmbqj,35240,35241,70481
38484,,tx0hbhc5_uqj,35241,35242,70483
38485,,q9yggecb16sj,35242,35243,70485
38486,,pzkvflukaruj,35243,35244,70487
38487,,ha9gk8lq6ycj,35244,35245,70489
38488,,kjwgqq4kz4yj,35245,35246,70491
38489,,emi2h0ihniuj,35246,35247,70493
38490,,mvbpzi_e3eaj,35247,35248,70495
38491,,url:http://doi.wiley.com/10.1002/ev.1620,35248,35249,70497
38492,,wqirfmswsewj,35249,35250,70499
38493,,zt3t9rs38ugj,35250,35251,70501
38494,,4wjgmyokj1kj,35251,35252,70503
38495,,9tubosd6c4kj,35252,35253,70505
38496,,kxc2-vdzojuj,35253,35254,70507
38497,,rles3ok5di0j,35254,35255,70509
38498,,lshdf9g7ykwj,35255,35256,70511
38499,,oeheo3bap-8j,35256,35257,70513
38500,,x14g4few97qj,35257,35258,70515
38501,,url:http://www.csa.com/partners/viewrecord.php3frequester3dgs26collection3dtrd26recid3d2005092515519ci,35258,35259,70517
38502,,8znxzqdpiaoj,35259,35260,70519
38503,,9xec0yqcklsj,35260,35261,70521
38504,,aeauk6id924j,35261,35262,70523
38505,,6tikucc2krij,35262,35263,70525
38506,,cug3o_9qmzsj,35263,35264,70527
38507,,e8aydf-bmn4j,35264,35265,70529
38508,,qmwcuiwz1wuj,35265,35266,70531
38509,,url:http://portal.acm.org/citation.cfm3fid3d1085028.1085033,35266,35267,70533
38510,,fwlptthldbkj,35267,35268,70535
38511,,j6f6xmby05qj,35268,35269,70537
38512,,a-bgckurqz0j,35269,35270,70539
38513,,lbgzjfyu6yqj,35270,35271,70541
38514,,d6z8krfsctij,35271,35272,70543
38515,,hzy2yc4nhbij,35272,35273,70545
38516,,yt_bs_k6jmij,35273,35274,70547
38517,,8xz8rmtkdjoj,35274,35275,70549
38518,,q6vyy9b9ydgj,35275,35276,70551
38519,,exz7h3my-ysj,35276,35277,70553
38520,,ts-akltfvsmj,35277,35278,70555
38521,,bix0omwwfnwj,35278,35279,70557
38522,,5_e5p-thavwj,35279,35280,70559
38523,,edehrtc9hd4j,35280,35281,70561
38524,,shgequk9jrij,35281,35282,70563
38525,,url:http://portal.acm.org/ft_gateway.cfm3fid3d106630326type3dpdf,35282,35283,70565
38526,,toojcmal5uij,35283,35284,70567
38527,,tby-bcy9icyj,35285,35286,70571
38528,,modvzknhygkj,35286,35287,70573
38529,,cdqooa7wxiij,35287,35288,70575
38530,,jvrjbiaq8l8j,35288,35289,70577
38531,,uizazucapeyj,35289,35290,70579
38532,,rmkz2x-fcrsj,35290,35291,70581
38533,,g9x7rqmmcxij,35291,35292,70583
38534,,burtoc88p-ej,35292,35293,70585
38535,,ollwfyebtmoj,35294,35295,70589
38536,,87qpf4btpesj,35295,35296,70591
38537,,eluktffxthaj,35296,35297,70593
38538,,p7wkychyrfqj,35297,35298,70595
38539,,oo__y15ehlsj,35298,35299,70597
38540,,da0_fagwuruj,35299,35300,70599
38541,,tzgqhxpvkrcj,35300,35301,70601
38542,,855tudohjl4j,35301,35302,70603
38543,,2eytqpymei4j,35302,35303,70605
38544,,ggggopghro0j,35303,35304,70607
38545,,gln2_fipywsj,35304,35305,70609
38546,,zb2sexjnfkmj,35305,35306,70611
38547,,zajzifbzfdyj,35306,35307,70613
38548,,linqqsapeeij,35307,35308,70615
38549,,tayzmok2cwoj,35308,35309,70617
38550,,nwkpe4dio6kj,35309,35310,70619
38551,,orolucu6eakj,35310,35311,70621
38552,,fl66io1nytkj,35311,35312,70623
38553,,dsb7elxexaoj,35312,35313,70625
38554,,iwbrb5lsukqj,35313,35314,70627
38555,,nkrze409lx8j,35314,35315,70629
38556,,url:http://www.csa.com/partners/viewrecord.php3frequester3dgs26collection3dtrd26recid3dn9210397ah,35315,35316,70631
38557,,g8tad9ma2mmj,35316,35317,70633
38558,,dody1oykzkwj,35317,35318,70635
38559,,uiacgnx3hf4j,35318,35319,70637
38560,,rplth0lfov0j,35319,35320,70639
38561,,tdi5rotz6gqj,35320,35321,70641
38562,,jemxqqpeq-oj,35321,35322,70643
38563,,url:http://portal.acm.org/ft_gateway.cfm3fid3d30668126type3dpdf26coll3dguide26dl3dacm26cfid3d1111111126cftoken3d2222222,35322,35323,70645
38564,,j3a2ltq9cpij,35323,35324,70647
38565,,ononcsnvv3yj,35324,35325,70649
38566,,ltmekkb_c4ej,35325,35326,70651
38567,,fxefnqz1mlgj,35326,35327,70653
38568,,6ybkphnmmw4j,35328,35329,70657
38569,,,35329,35330,70659
38570,,ax35ykhxt5qj,35330,35331,70661
38571,,jnuy569uloej,35331,35332,70663
38572,,ihct1cn4jmqj,35332,35333,70665
38573,,lwtcei__yu8j,35333,35334,70667
38574,,vvdiaj-ngquj,35334,35335,70669
38575,,svnh8efxaj4j,35335,35336,70671
38576,,bjaakjngdwsj,35336,35337,70673
38577,,aaut2ug42eoj,35337,35338,70675
38578,,rlu8xm2-o_oj,35338,35339,70677
38579,,idjxyhsfo_ej,35339,35340,70679
38580,,,35340,35341,70681
38581,,tjsqmcz1iicj,35341,35342,70683
38582,,7dtkcezdkwej,35342,35343,70685
38583,,kfwvkq5g394j,35343,35344,70687
38584,,ae2n9nwjby8j,35344,35345,70689
38585,,nyu72y-j0oyj,35345,35346,70691
38586,,qkjffehclhmj,35346,35347,70693
38587,,s_jrcji_whcj,35347,35348,70695
38588,,w4xl3r1kzs0j,35348,35349,70697
38589,,url:http://doi.wiley.com/10.1002/ace.129,35349,35350,70699
38590,,porh9rvc56cj,35350,35351,70701
38591,,tdl7ge0qstcj,35351,35352,70703
38592,,x17914enbcuj,35352,35353,70705
38593,,3o8b0fmv8dej,35353,35354,70707
38594,,r3gi5ly9cuij,35354,35355,70709
38595,,k21pe7xeitoj,35355,35356,70711
38596,,5xl6vfajb_sj,35356,35357,70713
38597,,rgp-vv42famj,35357,35358,70715
38598,,rj9e8uoo3lwj,35358,35359,70717
38599,,qnuaou3crc8j,35359,35360,70719
38600,,q6mgqfysdqwj,35360,35361,70721
38601,,bu3dpya4unwj,35361,35362,70723
38602,,ivhr6rjemrwj,35362,35363,70725
38603,,7ugnnprlhloj,35363,35364,70727
38604,,ycgwqikudkaj,35364,35365,70729
38605,,f77jm4o8bckj,35365,35366,70731
38606,,i3kh2a-z2duj,35366,35367,70733
38607,,7eoakvvmmtwj,35367,35368,70735
38608,,dyaiw_mk79aj,35368,35369,70737
38609,,7pvqmvbotw4j,35369,35370,70739
38610,,4yx2pudv6hkj,35370,35371,70741
38611,,7wknkjj67lmj,35371,35372,70743
38612,,mx3iuzrqoyej,35372,35373,70745
38613,,rjizt8tqupwj,35373,35374,70747
38614,,goptuchyh04j,35374,35375,70749
38615,,asqf3isy65wj,35375,35376,70751
38616,,2k3lsxsgqjij,35376,35377,70753
38617,,fooij5nrs-gj,35377,35378,70755
38618,,mx9bekg6cd4j,35379,35380,70759
38619,,z06kxswcflaj,35380,35381,70761
38620,,gkf7dxs5nrqj,35381,35382,70763
38621,,isgzntexaoej,35382,35383,70765
38622,,plncyff6n-sj,35383,35384,70767
38623,,iv5wuvdl1j0j,35384,35385,70769
38624,,url:http://josaa.osa.org/viewmedia.cfm3fid3d6185526seq3d0,35385,35386,70771
38625,,url:http://portal.acm.org/ft_gateway.cfm3fid3d106625426type3dpdf,35386,35387,70773
38626,,wbai_elrxkuj,35387,35388,70775
38627,,lx6uniki94kj,35388,35389,70777
38628,,oumumdgaaq8j,35389,35390,70779
38629,,rahloi1k1qgj,35390,35391,70781
38630,,ii1eqdmpef0j,35391,35392,70783
38631,,47ou5eupcwuj,35392,35393,70785
38632,,kufgvs_i83ej,35393,35394,70787
38633,,saaviey9zvgj,35394,35395,70789
38634,,xqvhojocot4j,35395,35396,70791
38635,,5ysvyr5o_dcj,35396,35397,70793
38636,,4ucphzy3itgj,35397,35398,70795
38637,,trvotgxoscuj,35398,35399,70797
38638,,pjfbtuelnmaj,35399,35400,70799
38639,,9s5-mgdkewwj,35400,35401,70801
38640,,_exuzq1bkekj,35401,35402,70803
38641,,ckelcddzfjaj,35402,35403,70805
38642,,3wsixrcgqbsj,35403,35404,70807
38643,,6tarntfaiqej,35404,35405,70809
38644,,1vrd_ocnzx0j,35405,35406,70811
38645,,vttt5_wdbt4j,35406,35407,70813
38646,,glopipo73qij,35408,35409,70817
38647,,url:http://www.csa.com/partners/viewrecord.php3frequester3dgs26collection3dtrd26recid3dn9210567ah,35409,35410,70819
38648,,qc4k45civcwj,35410,35411,70821
38649,,ydkvzqhysaij,35411,35412,70823
38650,,wgprown0gskj,35412,35413,70825
38651,,9a4eqcypxw0j,35413,35414,70827
38652,,c0a3kbzb978j,35414,35415,70829
38653,,hnag1qblnbwj,35415,35416,70831
38654,,sn5q-q71ucmj,35416,35417,70833
38655,,ntav0zf9_7cj,35417,35418,70835
38656,,dsx5rxavldij,35418,35419,70837
38657,,sq5m89saluuj,35419,35420,70839
38658,,6bh-egskreaj,35420,35421,70841
38659,,80gkhajiw_cj,35421,35422,70843
38660,,m-2fxucg0jmj,35422,35423,70845
38661,,r8uyvagt6swj,35423,35424,70847
38662,,url:http://portal.acm.org/ft_gateway.cfm3fid3d13030226type3dpdf26dl3dguide26dl3dacm26cfid3d1111111126cftoken3d2222222,35424,35425,70849
38663,,zb4qjvfdk6sj,35425,35426,70851
38664,,oqltfl2lqnqj,35426,35427,70853
38665,,0c0h4mqp2fyj,35427,35428,70855
38666,,sfbuvcc2rr8j,35428,35429,70857
38667,,upxh9ubkdfej,35429,35430,70859
38668,,i2xvjlbwtaij,35430,35431,70861
38669,,ntex5vf9i7gj,35431,35432,70863
38670,,sgzwg88x-9mj,35432,35433,70865
38671,,apuuc3ilu34j,35433,35434,70867
38672,,cjrxxra1geoj,35434,35435,70869
38673,,qd94fqs0rkkj,35435,35436,70871
38674,,30ztkxzwp24j,35436,35437,70873
38675,,seireymxaiaj,35437,35438,70875
38676,,agk-mqwh1yij,35438,35439,70877
38677,,url:http://adsabs.harvard.edu/abs/1980mit..reptr....h,35439,35440,70879
38678,,lufcow16gcwj,35440,35441,70881
38679,,miiilcrlrnij,35441,35442,70883
38680,,osj_th-_hwuj,35442,35443,70885
38681,,knnuack5dzqj,35443,35444,70887
38682,,u8izdpo4h_gj,35444,35445,70889
38683,,uk8me4-25dyj,35445,35446,70891
38684,,uwejtsfqjvaj,35446,35447,70893
38685,,3jc3ntwekjyj,35447,35448,70895
38686,,p-wlp2m9yvcj,35448,35449,70897
38687,,e4s7pmzj8uaj,35449,35450,70899
38688,,zdo2acim9maj,35450,35451,70901
38689,,jl8ubl4nit0j,35451,35452,70903
38690,,bfdsn7h7rwsj,35453,35454,70907
38691,,wscygorzatmj,35454,35455,70909
38692,,2pjfiwlfuu0j,35455,35456,70911
38693,,3oy8h2p4muaj,35456,35457,70913
38694,,qhmg7reewxmj,35457,35458,70915
38695,,yce8hyzis_0j,35458,35459,70917
38696,,vnsrizs6m3wj,35459,35460,70919
38697,,wscqvendjjuj,35460,35461,70921
38698,,ykrwqrmwgwwj,35461,35462,70923
38699,,h2z51qpxcskj,35462,35463,70925
38700,,ztzeypzxcw8j,35463,35464,70927
38701,,1qlwxrrpg9wj,35464,35465,70929
38702,,bc0uowpvuasj,35465,35466,70931
38703,,tiy7vitjhs0j,35466,35467,70933
38704,,exrpbvncdjmj,35467,35468,70935
38705,,ipm6bspgsqsj,35468,35469,70937
38706,,di9_rttd3smj,35469,35470,70939
38707,,y35llzuorpwj,35470,35471,70941
38708,,owyhy5_wqg0j,35471,35472,70943
38709,,5t0ck6fxof4j,35472,35473,70945
38710,,3cwqbjptvk0j,35473,35474,70947
38711,,j1_6u4jgt1uj,35474,35475,70949
38712,,ajgjah68ha4j,35475,35476,70951
38713,,viqeqpv3jsuj,35476,35477,70953
38714,,ktzvumx1f2mj,35477,35478,70955
38715,,ekwdhqfg7-cj,35478,35479,70957
38716,,lnjyltzcxfmj,35479,35480,70959
38717,,uvhpd4e3kzej,35480,35481,70961
38718,,v7kpgmhgjekj,35481,35482,70963
38719,,zdyv7fphadqj,35482,35483,70965
38720,,do041bhhax0j,35483,35484,70967
38721,,iqjfuz3apl0j,35484,35485,70969
38722,,3qk_1kbypdkj,35485,35486,70971
38723,,3uvembjq3qmj,35486,35487,70973
38724,,qripmcjc-6wj,35487,35488,70975
38725,,zmkip_bwnuij,35488,35489,70977
38726,,p5fngft4kfkj,35489,35490,70979
38727,,mf7p4qqvddcj,35490,35491,70981
38728,,url:http://www.csa.com/partners/viewrecord.php3frequester3dgs26collection3dtrd26recid3dn9210586ah,35491,35492,70983
38729,,gfkxwbt-_zoj,35492,35493,70985
38730,,lmcmoehiockj,35493,35494,70987
38731,,url:http://doi.wiley.com/10.1002/tl.32,35494,35495,70989
38732,,url:http://www.csa.com/partners/viewrecord.php3frequester3dgs26collection3dtrd26recid3d200404210602mt,35495,35496,70991
38733,,uvsulycckmcj,35496,35497,70993
38734,,dqooub7__zsj,35497,35498,70995
38735,,omgpy28dsfkj,35499,35500,70999
38736,,_9d3liabanwj,35500,35501,71001
38737,,s2qdmxobbicj,35501,35502,71003
38738,,wvbmkndfkisj,35502,35503,71005
38739,,epvfh0mxvxmj,35503,35504,71007
38740,,url:http://www.csa.com/partners/viewrecord.php3frequester3dgs26collection3dtrd26recid3d200111010662mt26recid3da0032563ah,35504,35505,71009
38741,,tnl-tvyxq1qj,35505,35506,71011
38742,,m6idwug6chgj,35506,35507,71013
38743,,apkmpftuidyj,35507,35508,71015
38744,,9tawb9z5alaj,35508,35509,71017
38745,,ekdalcup3b0j,35509,35510,71019
38746,,ku4sjzlhfq0j,35510,35511,71021
38747,,9omu4chajn8j,35511,35512,71023
38748,,gmljesb8p2kj,35512,35513,71025
38749,,jiwkzwyvt7sj,35514,35515,71029
38750,,e6sbznkkwhcj,35515,35516,71031
38751,,kb5z_xs5ydgj,35516,35517,71033
38752,,xzyp7rtznsoj,35517,35518,71035
38753,,wd915vrny9oj,35518,35519,71037
38754,,oqi_4bqqysaj,35519,35520,71039
38755,,mf_hxhonsmoj,35520,35521,71041
38756,,url:http://www.ingentaconnect.com/search/expand3fpub3dinfobike://els/13891286/2004/00000044/00000002/art0037526unc3d,35521,35522,71043
38757,,vvscggjeleej,35522,35523,71045
38758,,qdjjive2hmqj,35523,35524,71047
38759,,knrtxrrr6ksj,35524,35525,71049
38760,,awp_v-1dasmj,35525,35526,71051
38761,,fqgo7rkex58j,35526,35527,71053
38762,,b855ccghbu4j,35527,35528,71055
38763,,rvbnhkca2-yj,35528,35529,71057
38764,,qrst4qit27ij,35529,35530,71059
38765,,j3bicqmnikkj,35530,35531,71061
38766,,zth7ogw9fogj,35531,35532,71063
38767,,x466fazjy3wj,35532,35533,71065
38768,,mobycd3jw0ej,35533,35534,71067
38769,,3coj4f517qej,35534,35535,71069
38770,,qpiaphl2lvyj,35535,35536,71071
38771,,njpcyccjskmj,35536,35537,71073
38772,,2hhw3xrxq40j,35537,35538,71075
38773,,okbp-fu9weuj,35538,35539,71077
38774,,du7sd_ixwssj,35539,35540,71079
38775,,huvgqlu7zdqj,35540,35541,71081
38776,,yyydzt9kc2wj,35541,35542,71083
38777,,b_y2gxusrnqj,35542,35543,71085
38778,,xgqgslehn6gj,35543,35544,71087
38779,,wrdd4h0gakyj,35544,35545,71089
38780,,axbnwc3ppkgj,35546,35547,71093
38781,,dap6p0nstl0j,35547,35548,71095
38782,,ytksddib5e8j,35548,35549,71097
38783,,url:http://ieeexplore.ieee.org/xpl/abs_free.jsp3farnumber3d1277817,35549,35550,71099
38784,,eh4zevyxzfsj,35550,35551,71101
38785,,qztfoeo0jqqj,35552,35553,71105
38786,,df9oqluj6amj,35553,35554,71107
38787,,vqyvzfrg5csj,35554,35555,71109
38788,,8ysjd5tuv3qj,35555,35556,71111
38789,,apffdllr-qqj,35557,35558,71115
38790,,froky4brkk8j,35558,35559,71117
38791,,fmw_vzqceloj,35559,35560,71119
38792,,zaysvkmo2eyj,35561,35562,71123
38793,,xu6gy3etrk0j,35562,35563,71125
38794,,zkifzm0i5smj,35563,35564,71127
38795,,klkefqjqrbmj,35564,35565,71129
38796,,6i7tlfcqu_qj,35565,35566,71131
38797,,2flgdplum2yj,35566,35567,71133
38798,,vwdsfl2p33qj,35567,35568,71135
38799,,g00ha7hgl9uj,35568,35569,71137
38800,,h10fxblw6zaj,35569,35570,71139
38801,,yfra7vdel-kj,35570,35571,71141
38802,,jqpibcuxzmyj,35571,35572,71143
38803,,grnp3whvibmj,35572,35573,71145
38804,,azvya5hruv4j,35573,35574,71147
38805,,vwvz65wqktoj,35574,35575,71149
38806,,url:http://www.csa.com/partners/viewrecord.php3frequester3dgs26collection3dtrd26recid3d0014623en,35575,35576,71151
38807,,4wg9ka_9eyij,35577,35578,71155
38808,,ca-r3uw1kzkj,35578,35579,71157
38809,,eh4t5kurz1yj,35579,35580,71159
38810,,xhbkwqqvuiuj,35580,35581,71161
38811,,pb5rahmh904j,35581,35582,71163
38812,,u1rcqav05m0j,35583,35584,71167
38813,,tn3id3ymx08j,35584,35585,71169
38814,,ghvw20tcymaj,35585,35586,71171
38815,,z3xkc23ovcej,35586,35587,71173
38816,,j0qhwazwpncj,35587,35588,71175
38817,,00pppmapmxyj,35588,35589,71177
38818,,a8l92dx2pkgj,35589,35590,71179
38819,,8wij6ab-upcj,35590,35591,71181
38820,,utaxrz8hblcj,35591,35592,71183
38821,,6iqxtaijac0j,35592,35593,71185
38822,,gbm-ag7hdzej,35593,35594,71187
38823,,w7ayr3jptuaj,35594,35595,71189
38824,,tvteszffdpij,35595,35596,71191
38825,,c1kag91hqwoj,35596,35597,71193
38826,,ekf1zvnkp0gj,35597,35598,71195
38827,,wt2w1fpudfij,35598,35599,71197
38828,,tjxys021ifqj,35599,35600,71199
38829,,slbb8npxoxyj,35600,35601,71201
38830,,vvln9cnusxuj,35601,35602,71203
38831,,oazvwoi68yij,35602,35603,71205
38832,,8eoaxly9psgj,35603,35604,71207
38833,,afdifr7f2jkj,35604,35605,71209
38834,,xkm04n5ikiqj,35605,35606,71211
38835,,url:http://portal.acm.org/ft_gateway.cfm3fid3d106626726type3dpdf,35606,35607,71213
38836,,pa3oj-rpmaaj,35607,35608,71215
38837,,zqu15myjpfyj,35608,35609,71217
38838,,cuufat8i7jmj,35609,35610,71219
38839,,yp82aryegxij,35610,35611,71221
38840,,pttiy8vsvogj,35611,35612,71223
38841,,w2qbmi6nhfyj,35612,35613,71225
38842,,0dwq5huuncyj,35613,35614,71227
38843,,ur4cad8knq4j,35614,35615,71229
38844,,qjzrsg0web0j,35615,35616,71231
38845,,sqrhqmlrc18j,35616,35617,71233
38846,,staul26tq_cj,35618,35619,71237
38847,,8xnep7tc5wsj,35619,35620,71239
38848,,k3xgt2zhoxoj,35620,35621,71241
38849,,blez2hrmqe4j,35621,35622,71243
38850,,,35622,35623,71245
38851,,_pligkgpzdyj,35623,35624,71247
38852,,zpdjbbfbeq8j,35624,35625,71249
38853,,_vwuzgowmtaj,35625,35626,71251
38854,,0cbmcxnsdboj,35626,35627,71253
38855,,7yugfbsj1hoj,35627,35628,71255
38856,,gsyrvipblhcj,35628,35629,71257
38857,,guxvtt9itikj,35629,35630,71259
38858,,qp2lid7yxbej,35630,35631,71261
38859,,url:http://doi.wiley.com/10.1002/tl.121,35631,35632,71263
38860,,dndkkhv7esij,35632,35633,71265
38861,,url:http://links.jstor.org/sici3fsici3d0146-4949(196524252f21)6253a1253c27253ahtatsb253e2.0.co253b2-8,35633,35634,71267
38862,,kxg6e8iyop4j,35634,35635,71269
38863,,ne5dhadfek8j,35635,35636,71271
38864,,6vyqsmrfozmj,35636,35637,71273
38865,,b5tvirfzvjgj,35638,35639,71277
38866,,_2xxohpni7kj,35639,35640,71279
38867,,ygytza-hqbaj,35640,35641,71281
38868,,b_cauzcjoh8j,35641,35642,71283
38869,,01lncjhtoksj,35642,35643,71285
38870,,i9wvub94vkij,35643,35644,71287
38871,,_uaomchyt7kj,35644,35645,71289
38872,,xwt2e451nhoj,35645,35646,71291
38873,,ib_-hoil74aj,35646,35647,71293
38874,,poo6wxik_hkj,35647,35648,71295
38875,,l4lkqrssb5wj,35648,35649,71297
38876,,q2qdnrwk9kqj,35649,35650,71299
38877,,bau_kuuygb8j,35650,35651,71301
38878,,6g9u9jxdfpkj,35651,35652,71303
38879,,url:http://www.csa.com/partners/viewrecord.php3frequester3dgs26collection3dtrd26recid3d20021212023589mt26recid3da7642842ah,35652,35653,71305
38880,,tbaspc0dvoej,35653,35654,71307
38881,,czaxfqngoayj,35654,35655,71309
38882,,sp982xq0nu4j,35655,35656,71311
38883,,sswr2rhkjk0j,35656,35657,71313
38884,,ufunxlcotkkj,35657,35658,71315
38885,,lxm6p7nqakqj,35658,35659,71317
38886,,url:http://doi.wiley.com/10.1002/he.10509,35659,35660,71319
38887,,k944fc425y0j,35660,35661,71321
38888,,url:http://www.csa.com/partners/viewrecord.php3frequester3dgs26collection3dtrd26recid3d0972113ci,35661,35662,71323
38889,,ini08px7jd4j,35662,35663,71325
38890,,z_vrxmoktygj,35663,35664,71327
38891,,bc68ctgaahgj,35664,35665,71329
38892,,apqefk_y24cj,35665,35666,71331
38893,,gqsmy3n2lysj,35666,35667,71333
38894,,ly3_rju358sj,35667,35668,71335
38895,,6rdpwmto8n0j,35668,35669,71337
38896,,pdhfb0v9jm8j,35670,35671,71341
38897,,cdqghe6axksj,35671,35672,71343
38898,,fc1ljhwmpiyj,35672,35673,71345
38899,,ypz09q3c0oij,35673,35674,71347
38900,,5htjdo0doz8j,35674,35675,71349
38901,,rqr7opg0ydwj,35675,35676,71351
38902,,yyj1okhcni0j,35676,35677,71353
38903,,tf42xf2c44sj,35677,35678,71355
38904,,rplwbjeoktcj,35678,35679,71357
38905,,d2qdkahdrsmj,35679,35680,71359
38906,,ids7km4vojqj,35680,35681,71361
38907,,sskmjyauymij,35681,35682,71363
38908,,9zpabw7jupoj,35682,35683,71365
38909,,_x2hkd6jcssj,35683,35684,71367
38910,,ykqbook9494j,35684,35685,71369
38911,,g6st2nen3-aj,35685,35686,71371
38912,,qfw7pu1wvcij,35686,35687,71373
38913,,url:http://www.springerlink.com/index/g203770mu67l0526.pdf,35687,35688,71375
38914,,tftfk6qwkjcj,35688,35689,71377
38915,,hhtp7i7oo6uj,35689,35690,71379
38916,,ducog-emimaj,35690,35691,71381
38917,,gwzikdftfcmj,35691,35692,71383
38918,,hsgg85g1j98j,35692,35693,71385
38919,,qzeu5gq_2p0j,35693,35694,71387
38920,,t8-9dlk71baj,35694,35695,71389
38921,,itsghv1zfkkj,35695,35696,71391
38922,,enoyysmfyqkj,35696,35697,71393
38923,,nw8rqv5nec8j,35697,35698,71395
38924,,ca9a0mivswij,35698,35699,71397
38925,,imau2dyn2saj,35699,35700,71399
38926,,hsgzdqtxw-ij,35700,35701,71401
38927,,ckfqagfhwxej,35701,35702,71403
38928,,31w6zbov2cqj,35702,35703,71405
38929,,8s9q4xeisl0j,35703,35704,71407
38930,,qw3yroa38saj,35704,35705,71409
38931,,w-kpvuoybvuj,35705,35706,71411
38932,,ld002ecgsekj,35706,35707,71413
38933,,4iwyfnpvb2mj,35707,35708,71415
38934,,jlfdo5f4iqaj,35708,35709,71417
38935,,vkraglmstumj,35709,35710,71419
38936,,ecntclfwvpcj,35710,35711,71421
38937,,ockojiivpmaj,35711,35712,71423
38938,,kg4pzskmshkj,35712,35713,71425
38939,,walee-pgwmmj,35713,35714,71427
38940,,ziyanwccfekj,35714,35715,71429
38941,,0d6ztag3ptcj,35715,35716,71431
38942,,lhmo07oxrdij,35716,35717,71433
38943,,tkegalc3ufmj,35717,35718,71435
38944,,mhmuhomblokj,35718,35719,71437
38945,,w6utxj3a93ej,35719,35720,71439
38946,,url:http://www.ingentaconnect.com/search/expand3fpub3dinfobike://els/13891286/2001/00000036/00000005/art0018926unc3d,35720,35721,71441
38947,,rkj5a1nrvsyj,35721,35722,71443
38948,,z-7da2t_2bmj,35722,35723,71445
38949,,1emlstkap5yj,35723,35724,71447
38950,,url:http://doi.wiley.com/10.1002/ace.171,35724,35725,71449
38951,,otrnsqumhu0j,35725,35726,71451
38952,,emud8zykfpij,35726,35727,71453
38953,,rokontp8vxsj,35727,35728,71455
38954,,8fy6yt12yigj,35728,35729,71457
38955,,8jr6bperf6oj,35729,35730,71459
38956,,mgvoe58kcjmj,35730,35731,71461
38957,,0o0eb4yuxmcj,35731,35732,71463
38958,,8oxvujwn1r8j,35732,35733,71465
38959,,3i6lso9hy4sj,35733,35734,71467
38960,,bvoui13lnuyj,35734,35735,71469
38961,,fwxxiemo524j,35735,35736,71471
38962,,ksnjik-brxuj,35736,35737,71473
38963,,punj-9oqr_4j,35737,35738,71475
38964,,fn0hpmq6cvyj,35738,35739,71477
38965,,ymcjxhjooxij,35739,35740,71479
38966,,url:http://portal.acm.org/ft_gateway.cfm3fid3d110127126type3dpdf,35740,35741,71481
38967,,7xinvpwq80kj,35741,35742,71483
38968,,jt7ivpiroewj,35742,35743,71485
38969,,tizotmf2wp4j,35743,35744,71487
38970,,tchhjbc2o8aj,35744,35745,71489
38971,,2knfbw6knn0j,35745,35746,71491
38972,,s36esjyvh_wj,35746,35747,71493
38973,,wciyiz6x4jkj,35747,35748,71495
38974,,1tfs0boukxij,35748,35749,71497
38975,,url:http://ieeexplore.ieee.org/iel5/69/28220/01307300.pdf3farnumber3d1307300,35749,35750,71499
38976,,hgmhg5v-kdaj,35750,35751,71501
38977,,qsds0fi9zckj,35751,35752,71503
38978,,pkuc-6_jvjij,35752,35753,71505
38979,,url:http://www.csa.com/partners/viewrecord.php3frequester3dgs26collection3dtrd26recid3dn9210423ah,35753,35754,71507
38980,,jdll3xfcv74j,35754,35755,71509
38981,,znhh1qwsrtcj,35755,35756,71511
38982,,afqvhtetq0ej,35756,35757,71513
38983,,wltbyae2sgyj,35758,35759,71517
38984,,rdekkswgx7gj,35759,35760,71519
38985,,llqftaexvwaj,35760,35761,71521
38986,,f1zw_86pu3mj,35761,35762,71523
38987,,lwbu_ngswmaj,35762,35763,71525
38988,,rdkbzql5kaaj,35763,35764,71527
38989,,h_ph8chxhtoj,35764,35765,71529
38990,,absusqabwmmj,35765,35766,71531
38991,,da60jinzi-ij,35766,35767,71533
38992,,9uyo0m1rv7oj,35767,35768,71535
38993,,1fdhkwtvoqij,35768,35769,71537
38994,,y637vqfdczej,35769,35770,71539
38995,,k7mgorcrfnkj,35770,35771,71541
38996,,4nwy7bdd8lmj,35771,35772,71543
38997,,prijrfmu4goj,35772,35773,71545
38998,,ps7cnkuustmj,35773,35774,71547
38999,,zjdrzvkk49qj,35775,35776,71551
39000,,url:http://links.jstor.org/sici3fsici3d0146-4949(196524252f21)6253a1253c15253amhai253e2.0.co253b2-r,35776,35777,71553
39001,,rbefmvyunsqj,35777,35778,71555
39002,,_01bligvntsj,35778,35779,71557
39003,,a-ruks0_fb4j,35779,35780,71559
39004,,vp-8_6pwsgwj,35781,35782,71563
39005,,ohuisryckdgj,35782,35783,71565
39006,,z8smcv3vzp8j,35783,35784,71567
39007,,07wfaar_hqyj,35784,35785,71569
39008,,url:http://portal.acm.org/citation.cfm3fid3d170035.170089,35785,35786,71571
39009,,,35786,35787,71573
39010,,rawecunemq0j,35787,35788,71575
39011,,uedeqdgif_sj,35788,35789,71577
39012,,5oxhncixc4kj,35789,35790,71579
39013,,q-x_alsyfvej,35790,35791,71581
39014,,uvltz3_wccwj,35792,35793,71585
39015,,e078bw9a0eoj,35793,35794,71587
39016,,iw6l0ndtl5aj,35794,35795,71589
39017,,cy95o3edbogj,35795,35796,71591
39018,,ry96qxfuk3mj,35796,35797,71593
39019,,cgznb6hoxfyj,35797,35798,71595
39020,,rhxzvpqfaocj,35798,35799,71597
39021,,7ic5w29crskj,35799,35800,71599
39022,,6ull6f-8vhaj,35800,35801,71601
39023,,f4mnjtaqtzyj,35801,35802,71603
39024,,epdszht8lusj,35802,35803,71605
39025,,xjrorofbsxoj,35803,35804,71607
39026,,rhzlqismdaqj,35804,35805,71609
39027,,ydqwz3sbmb4j,35805,35806,71611
39028,,mzxyo-dkvsej,35806,35807,71613
39029,,wfgqvxvbifgj,35807,35808,71615
39030,,mn3tuh03fgkj,35808,35809,71617
39031,,2ex0vmfj3kyj,35809,35810,71619
39032,,92x4xkyulnuj,35810,35811,71621
39033,,au4srxvqcwwj,35811,35812,71623
39034,,lwdydncdetwj,35812,35813,71625
39035,,afmum3pcfd8j,35813,35814,71627
39036,,xlcryyd8v00j,35814,35815,71629
39037,,gwheizpnlycj,35815,35816,71631
39038,,rgzt2qoav4ej,35816,35817,71633
39039,,egzhyb1b7gqj,35817,35818,71635
39040,,gznf5vwqjfoj,35818,35819,71637
39041,,kevnvzevbiwj,35819,35820,71639
39042,,fpulfut8p-kj,35820,35821,71641
39043,,4sf7xobwso4j,35821,35822,71643
39044,,ctf68umb8bkj,35822,35823,71645
39045,,9a1z48m-fdej,35823,35824,71647
39046,,pp5pwwc0uxcj,35824,35825,71649
39047,,bzile3ohezgj,35825,35826,71651
39048,,djkidy9dswmj,35826,35827,71653
39049,,vhk-n5bguvgj,35827,35828,71655
39050,,hwdeszqmohcj,35828,35829,71657
39051,,hnh7lhhaw44j,35829,35830,71659
39052,,pabwyotjkfuj,35830,35831,71661
39053,,jf80k03x9eyj,35832,35833,71665
39054,,ppj5gdlaaikj,35833,35834,71667
39055,,wymwbzh9na0j,35834,35835,71669
39056,,0fmx6k5-6jkj,35835,35836,71671
39057,,url:http://www.csa.com/partners/viewrecord.php3frequester3dgs26collection3dtrd26recid3d0277424ci,35836,35837,71673
39058,,kfbwm-inkjmj,35837,35838,71675
39059,,jquapb2bpfij,35838,35839,71677
39060,,xvx5wmstw7yj,35839,35840,71679
39061,,ayqlwt5xlugj,35840,35841,71681
39062,,c5jsgig1b3ij,35841,35842,71683
39063,,ytsmcivsnruj,35842,35843,71685
39064,,67glcizbhzsj,35843,35844,71687
39065,,lribvg5epo4j,35844,35845,71689
39066,,oks-zhsk8vmj,35845,35846,71691
39067,,mm4dwanim-ej,35846,35847,71693
39068,,q0h0sdthlqyj,35847,35848,71695
39069,,n7ohymyxk_ij,35848,35849,71697
39070,,ul005j4_lw0j,35849,35850,71699
39071,,ogvypodq2myj,35850,35851,71701
39072,,7equ__lh6ygj,35852,35853,71705
39073,,kk7pdmqch6qj,35853,35854,71707
39074,,url:http://portal.acm.org/ft_gateway.cfm3fid3d110190926type3dpdf,35854,35855,71709
39075,,9dilcgdxrwcj,35855,35856,71711
39076,,usinmdlnq-mj,35856,35857,71713
39077,,ojpxnlcmbxaj,35857,35858,71715
39078,,ryeflyha0ewj,35858,35859,71717
39079,,cu55tr09osuj,35859,35860,71719
39080,,zmyz3dh0e-aj,35860,35861,71721
39081,,bpnogxnlwq4j,35861,35862,71723
39082,,url:http://portal.acm.org/citation.cfm3fid3d47153.47159,35862,35863,71725
39083,,2wqglz6_arwj,35863,35864,71727
39084,,ggp8dgcb618j,35865,35866,71731
39085,,3jvkdumoosij,35866,35867,71733
39086,,c2iojlgww9cj,35867,35868,71735
39087,,ylln5x12o_oj,35868,35869,71737
39088,,zqcqbblmvi4j,35869,35870,71739
39089,,zssy35gxktsj,35870,35871,71741
39090,,tbjpfxfh_x4j,35871,35872,71743
39091,,2kdqh_xzqysj,35872,35873,71745
39092,,,35873,35874,71747
39093,,2l_tyyhc7uuj,35874,35875,71749
39094,,url:http://www.csa.com/partners/viewrecord.php3frequester3dgs26collection3dtrd26recid3da8622920ah,35875,35876,71751
39095,,qurx85bowi0j,35876,35877,71753
39096,,ka-fezhtazwj,35877,35878,71755
39097,,9cl40ru9z78j,35878,35879,71757
39098,,nu_am8ckzwaj,35879,35880,71759
39099,,pzznibhz2mwj,35880,35881,71761
39100,,url:http://www.csa.com/partners/viewrecord.php3frequester3dgs26collection3dtrd26recid3d0151624ci,35881,35882,71763
39101,,zo0dfwhqxkuj,35882,35883,71765
39102,,rlkwpgsxs_sj,35883,35884,71767
39103,,nicvzevlvdmj,35884,35885,71769
39104,,zywgddoapzej,35885,35886,71771
39105,,deelfpz3550j,35886,35887,71773
39106,,8kfblaz3jfkj,35887,35888,71775
39107,,xqwto0xuyr4j,35888,35889,71777
39108,,z87giqj_wg0j,35889,35890,71779
39109,,7fimmqbyyogj,35890,35891,71781
39110,,lqowvatjmdyj,35891,35892,71783
39111,,t1td16djwnmj,35892,35893,71785
39112,,z9q7irebq0kj,35893,35894,71787
39113,,e-tsiujhzfqj,35894,35895,71789
39114,,jjqgcrn8tqmj,35895,35896,71791
39115,,fkktyoualduj,35896,35897,71793
39116,,5djricb6mo8j,35897,35898,71795
39117,,cippezen0esj,35898,35899,71797
39118,,oy0xd5zkbe8j,35899,35900,71799
39119,,gunnmaqk1rcj,35900,35901,71801
39120,,upgoyjvnikcj,35901,35902,71803
39121,,okaaip4gcgsj,35902,35903,71805
39122,,url:http://portal.acm.org/citation.cfm3fid3d48338,35903,35904,71807
39123,,h07a59foeryj,35904,35905,71809
39124,,bmlt78vm_imj,35905,35906,71811
39125,,ekczmmj9h44j,35906,35907,71813
39126,,zlu0t6tyhkqj,35907,35908,71815
39127,,zbft5gyycguj,35908,35909,71817
39128,,0b1ts-kjrd0j,35909,35910,71819
39129,,e0mv0w1pu0gj,35910,35911,71821
39130,,mujf3dbvt8uj,35911,35912,71823
39131,,csibsvppgpij,35913,35914,71827
39132,,loekpxlbm9yj,35914,35915,71829
39133,,frh7wtjbgacj,35915,35916,71831
39134,,r69wfe4omvcj,35916,35917,71833
39135,,pg4abvmswk8j,35917,35918,71835
39136,,s-r5akh_kioj,35918,35919,71837
39137,,dntoutscmrcj,35919,35920,71839
39138,,,35920,35921,71841
39139,,qjmrnviw_dcj,35921,35922,71843
39140,,w1iuo3efdj8j,35922,35923,71845
39141,,q2bx8soo6vwj,35923,35924,71847
39142,,h8xgas5ffeij,35924,35925,71849
39143,,pkk2ak_izrgj,35925,35926,71851
39144,,url:http://www.csa.com/partners/viewrecord.php3frequester3dgs26collection3dtrd26recid3d0116701ci,35926,35927,71853
39145,,2ndrynpmo0aj,35927,35928,71855
39146,,url:http://www.csa.com/partners/viewrecord.php3frequester3dgs26collection3dtrd26recid3d20021212029381mt26recid3da7340051ah,35928,35929,71857
39147,,jenc1dydf1uj,35929,35930,71859
39148,,equvzw4poxmj,35930,35931,71861
39149,,fvneupibx-0j,35931,35932,71863
39150,,qnrp4gdhwiij,35932,35933,71865
39151,,1wdh0gxvhwcj,35933,35934,71867
39152,,y86uitvoligj,35934,35935,71869
39153,,vwostq6dcf8j,35935,35936,71871
39154,,zvgrpg1rgauj,35936,35937,71873
39155,,gjux3dwo5lcj,35937,35938,71875
39156,,cw0s6atlorej,35938,35939,71877
39157,,mdgekbs5wsoj,35939,35940,71879
39158,,s23kdospdooj,35940,35941,71881
39159,,ihihi_giqduj,35941,35942,71883
39160,,ao5_lmhk8foj,35942,35943,71885
39161,,o6_rqvm0hzaj,35943,35944,71887
39162,,lv5qggkzrecj,35944,35945,71889
39163,,1e-r4xloi4gj,35945,35946,71891
39164,,f0xacoyml_sj,35946,35947,71893
39165,,c-haiuprm2ej,35947,35948,71895
39166,,1ywwzj1zwzuj,35948,35949,71897
39167,,ivdnvd8sjysj,35949,35950,71899
39168,,01enar-fib0j,35950,35951,71901
39169,,v0cj_apposmj,35952,35953,71905
39170,,k17ensji5xwj,35953,35954,71907
39171,,sswdohigec0j,35954,35955,71909
39172,,url:http://www.csa.com/partners/viewrecord.php3frequester3dgs26collection3dtrd26recid3da8028862ah,35955,35956,71911
39173,,crbce_-bju0j,35956,35957,71913
39174,,aka3b_hbugwj,35957,35958,71915
39175,,aklz3hy4xtsj,35958,35959,71917
39176,,ht5fmkba2e0j,35959,35960,71919
39177,,9cvawywiiqmj,35960,35961,71921
39178,,gljho3kl15oj,35961,35962,71923
39179,,jksndyiu1nsj,35962,35963,71925
39180,,1gcw4rqduv4j,35963,35964,71927
39181,,kjpf8qqgop4j,35964,35965,71929
39182,,mdd5upg-basj,35965,35966,71931
39183,,unfmytrxe_mj,35966,35967,71933
39184,,4txdo0tjf9gj,35967,35968,71935
39185,,reib_cnujy8j,35968,35969,71937
39186,,wysbgo-zyoej,35969,35970,71939
39187,,148exz3ukpkj,35970,35971,71941
39188,,f0m4gzpwoiaj,35971,35972,71943
39189,,4xzv7sihucsj,35972,35973,71945
39190,,t9_dp4hrfqgj,35973,35974,71947
39191,,uhw7bhc3e2ej,35974,35975,71949
39192,,n-wq3nildhyj,35975,35976,71951
39193,,w1kaltbn5coj,35976,35977,71953
39194,,xm3tg_hr6agj,35978,35979,71957
39195,,jjb-usgojyoj,35980,35981,71961
39196,,cdhhaevhrcoj,35981,35982,71963
39197,,xp0sg1hmbdwj,35982,35983,71965
39198,,sm6zqkrhxssj,35983,35984,71967
39199,,rhokqx11w_ij,35984,35985,71969
39200,,pad50exhd9wj,35985,35986,71971
39201,,zbbe_3cfarsj,35986,35987,71973
39202,,wauoqpt_0wmj,35987,35988,71975
39203,,,35988,35989,71977
39204,,vsen6wd5cluj,35989,35990,71979
39205,,9odhziqnrhkj,35990,35991,71981
39206,,a8gdqpkojhcj,35991,35992,71983
39207,,i6iijoxuj5wj,35992,35993,71985
39208,,tsyunhleaoqj,35993,35994,71987
39209,,nxb0ojbnrr0j,35994,35995,71989
39210,,oejfjewrcgoj,35995,35996,71991
39211,,zwdip8mdm2ej,35996,35997,71993
39212,,tz__ebqp8nuj,35997,35998,71995
39213,,i-p1_4vphs4j,35998,35999,71997
39214,,xugajw6k-1uj,35999,36000,71999
39215,,vdjmo7fauwej,36000,36001,72001
39216,,rnb0rlhsn1ej,36001,36002,72003
39217,,eohb8ltdqnkj,36002,36003,72005
39218,,f3y0bqzbv8sj,36003,36004,72007
39219,,qz_r_eocqowj,36004,36005,72009
39220,,pu1kpnrzyguj,36005,36006,72011
39221,,hztnllqmd1wj,36006,36007,72013
39222,,weoggxmstkyj,36007,36008,72015
39223,,9tgsaxh2gimj,36008,36009,72017
39224,,ngzrvq9mrbej,36009,36010,72019
39225,,umsl8ms8pokj,36010,36011,72021
39226,,2lyutaphcgaj,36011,36012,72023
39227,,shpvaovpuhyj,36012,36013,72025
39228,,ibei8puancej,36013,36014,72027
39229,,xbv-t4xb4lkj,36014,36015,72029
39230,,pgscfwmmkyuj,36015,36016,72031
39231,,2opey9_6blej,36016,36017,72033
39232,,cvl2mutxgwwj,36017,36018,72035
39233,,9ki7gyhiwoij,36018,36019,72037
39234,,guydi-lk7huj,36019,36020,72039
39235,,ddx7y0wvbrmj,36020,36021,72041
39236,,r0-4sjfuplej,36021,36022,72043
39237,,fcpkxvqxmogj,36022,36023,72045
39238,,qdi_iymwg0mj,36023,36024,72047
39239,,uhf2upetwc8j,36024,36025,72049
39240,,nzzq-t-ta7oj,36025,36026,72051
39241,,vxs-ut5x7xaj,36026,36027,72053
39242,,xh95zakdv34j,36027,36028,72055
39243,,q10y8llexekj,36028,36029,72057
39244,,hzyjwkg-viij,36029,36030,72059
39245,,sxu81nxez0wj,36030,36031,72061
39246,,vcq-wtizfzuj,36031,36032,72063
39247,,wh86c-1cgqgj,36032,36033,72065
39248,,l4pqjqswnccj,36033,36034,72067
39249,,lvsrv29k8_oj,36034,36035,72069
39250,,nufyqa8h71oj,36035,36036,72071
39251,,6h9orvyg7m0j,36036,36037,72073
39252,,ihsorvqxpfaj,36037,36038,72075
39253,,yc9sw13udzwj,36038,36039,72077
39254,,xtifjc-mdsmj,36039,36040,72079
39255,,hlzzyehvuxwj,36040,36041,72081
39256,,bko6gkbceyqj,36041,36042,72083
39257,,qdkqgdpyi-4j,36042,36043,72085
39258,,ebnt7lhv2lwj,36043,36044,72087
39259,,r04xyro2cggj,36044,36045,72089
39260,,ht1_umssmlwj,36045,36046,72091
39261,,gri9bkybx0gj,36046,36047,72093
39262,,sojkylu47x0j,36047,36048,72095
39263,,kmijcg2ywrmj,36048,36049,72097
39264,,re4ewftgbquj,36049,36050,72099
39265,,6nts7qjnfdcj,36050,36051,72101
39266,,u65yhyn20tij,36051,36052,72103
39267,,awukqctylvqj,36052,36053,72105
39268,,nalojilqh34j,36053,36054,72107
39269,,6horchefkfkj,36054,36055,72109
39270,,bzq27sanorij,36055,36056,72111
39271,,zjsuswru5twj,36056,36057,72113
39272,,yc9p0rd9xuwj,36057,36058,72115
39273,,dpwvhvytw_gj,36058,36059,72117
39274,,kf_jllm_63ij,36059,36060,72119
39275,,i-z5lr7ifqaj,36060,36061,72121
39276,,egvucxszqrwj,36061,36062,72123
39277,,url:http://www.csa.com/partners/viewrecord.php3frequester3dgs26collection3dtrd26recid3d0293907ci,36062,36063,72125
39278,,tdmrgxm-xvkj,36063,36064,72127
39279,,mrxg9my5ba4j,36064,36065,72129
39280,,ebjsnjbyvgoj,36065,36066,72131
39281,,emphybqskmkj,36066,36067,72133
39282,,tl5js-a_72ej,36067,36068,72135
39283,,zw8rg-hezzuj,36068,36069,72137
39284,,5sss-tdoqnyj,36069,36070,72139
39285,,kmgve9do92ej,36070,36071,72141
39286,,8ncwdcmfzxoj,36071,36072,72143
39287,,btzotybkdjsj,36072,36073,72145
39288,,unimacqiou0j,36073,36074,72147
39289,,y63glokehmsj,36074,36075,72149
39290,,snfcezbo5z8j,36075,36076,72151
39291,,c0zp-qfbweoj,36076,36077,72153
39292,,lpqmfzimm70j,36077,36078,72155
39293,,4euby5cowc4j,36078,36079,72157
39294,,aa53podeg4ij,36079,36080,72159
39295,,b_v-xj5h0wej,36080,36081,72161
39296,,ygrqhw-jrgyj,36081,36082,72163
39297,,xqo8qahjsn0j,36082,36083,72165
39298,,tbnhqpi6yjoj,36083,36084,72167
39299,,iqvokq3opk4j,36084,36085,72169
39300,,url:http://portal.acm.org/citation.cfm3fid3d615164.615169,36085,36086,72171
39301,,kxpbw3iazjcj,36086,36087,72173
39302,,mpjlvss6m8wj,36087,36088,72175
39303,,qjsyp7u1dzij,36088,36089,72177
39304,,o73dzlugcu4j,36089,36090,72179
39305,,m1i4e7gcxhaj,36090,36091,72181
39306,,url:http://doi.wiley.com/10.1002/he.91,36091,36092,72183
39307,,o9nphgzn_suj,36092,36093,72185
39308,,9gynrtdkuqyj,36093,36094,72187
39309,,g3os3vr7y7kj,36094,36095,72189
39310,,fxmshdd1liyj,36095,36096,72191
39311,,d7hdjjxzlnaj,36096,36097,72193
39312,,u6uhx2avwa0j,36097,36098,72195
39313,,iqanivdnbxwj,36098,36099,72197
39314,,evn-z5qkqb0j,36099,36100,72199
39315,,gmx98mn4suej,36100,36101,72201
39316,,rijybadvqruj,36101,36102,72203
39317,,lw1j0jn9bl4j,36102,36103,72205
39318,,v8mjz448z3ij,36103,36104,72207
39319,,wxpcpy0yjk4j,36104,36105,72209
39320,,csgp-tx6xkuj,36105,36106,72211
39321,,mk8rynsqz4qj,36106,36107,72213
39322,,z8krr4t21jyj,36107,36108,72215
39323,,url:http://www.csa.com/partners/viewrecord.php3frequester3dgs26collection3dtrd26recid3dn9210548ah,36108,36109,72217
39324,,prmelznindgj,36109,36110,72219
39325,,87pqurhhjomj,36110,36111,72221
39326,,r6nkafyh-z8j,36111,36112,72223
39327,,9g_j2cwcfioj,36112,36113,72225
39328,,k4kprbrnpdej,36113,36114,72227
39329,,xkk5smfddeuj,36114,36115,72229
39330,,a3oz0iectqcj,36115,36116,72231
39331,,5v6g0kagzhkj,36116,36117,72233
39332,,j4mxoq9dd-kj,36117,36118,72235
39333,,oipyjhtc8qoj,36118,36119,72237
39334,,9-3trtlpq3sj,36119,36120,72239
39335,,523oxip99aoj,36120,36121,72241
39336,,0hqtsg3fcr8j,36121,36122,72243
39337,,url:http://www.csa.com/partners/viewrecord.php3frequester3dgs26collection3dtrd26recid3dn9210405ah,36122,36123,72245
39338,,uwph2iljjwej,36123,36124,72247
39339,,u3ked5k834gj,36124,36125,72249
39340,,tflw0ned-swj,36125,36126,72251
39341,,lbct8gz3nccj,36126,36127,72253
39342,,y3tbgombvpmj,36127,36128,72255
39343,,__jk6grs-x4j,36128,36129,72257
39344,,xgtxogg998mj,36129,36130,72259
39345,,s9gb_7kliusj,36130,36131,72261
39346,,nbflyxhobdyj,36131,36132,72263
39347,,iffui3ya2xaj,36132,36133,72265
39348,,dv_fnjzrchwj,36133,36134,72267
39349,,nz2fm_s7t7aj,36134,36135,72269
39350,,vrkwe4gajjsj,36135,36136,72271
39351,,7sn25wgcks0j,36136,36137,72273
39352,,2ulcmlax--mj,36137,36138,72275
39353,,url:http://ieeexplore.ieee.org/iel5/69/28220/01262191.pdf3farnumber3d1262191,36138,36139,72277
39354,,ngrsd42mcsoj,36139,36140,72279
39355,,ofauidfbzlwj,36140,36141,72281
39356,,yakynvq7zm8j,36141,36142,72283
39357,,rwmr2dtzq2aj,36142,36143,72285
39358,,amkj88yjtr0j,36143,36144,72287
39359,,8vy9i26m8iaj,36144,36145,72289
39360,,lgxfzqaq9yaj,36145,36146,72291
39361,,ba_vchcqnemj,36146,36147,72293
39362,,fy7zl3f6s8mj,36147,36148,72295
39363,,qc-dmcm27saj,36148,36149,72297
39364,,fozoueyf1kgj,36149,36150,72299
39365,,p5udmp62f6wj,36150,36151,72301
39366,,uo3cq-w3pe8j,36151,36152,72303
39367,,ozj8vbpxluyj,36152,36153,72305
39368,,url:http://ieeexplore.ieee.org/iel5/2193/3608/00129235.pdf3farnumber3d129235,36153,36154,72307
39369,,eujfadqyhpqj,36154,36155,72309
39370,,cxa0j-kijvgj,36155,36156,72311
39371,,hiw2ukcasakj,36156,36157,72313
39372,,rtwnq3or_zoj,36157,36158,72315
39373,,djgjhmosbkij,36158,36159,72317
39374,,srrwxw8sdioj,36159,36160,72319
39375,,0rgjoanfwbmj,36160,36161,72321
39376,,sjgmhpyrgvej,36161,36162,72323
39377,,i9eiyjulalyj,36162,36163,72325
39378,,aj3zc7_n78uj,36163,36164,72327
39379,,sj0oqrjbsaqj,36164,36165,72329
39380,,vr8fctdtn3gj,36166,36167,72333
39381,,w84whcpjongj,36167,36168,72335
39382,,8mgvc0fhwyej,36168,36169,72337
39383,,gyqdmee0zwmj,36169,36170,72339
39384,,hy1udjx_4wwj,36170,36171,72341
39385,,rijlcixyinwj,36171,36172,72343
39386,,clgex8sr7-gj,36172,36173,72345
39387,,jtm-rkjwbuoj,36173,36174,72347
39388,,jsd1itypc10j,36174,36175,72349
39389,,p2vv7xopgbyj,36176,36177,72353
39390,,4yxvto7nxeqj,36177,36178,72355
39391,,e3rrshkw_s4j,36178,36179,72357
39392,,lbruv56gnkyj,36179,36180,72359
39393,,r2aswsdjjumj,36180,36181,72361
39394,,ntocihgiemwj,36181,36182,72363
39395,,gmbcisplx2qj,36182,36183,72365
39396,,o3-3-w_w6bkj,36183,36184,72367
39397,,pv4v_q5wlakj,36184,36185,72369
39398,,yuvcuqnexx4j,36185,36186,72371
39399,,5xix3fwp1suj,36186,36187,72373
39400,,bk86zno7we0j,36187,36188,72375
39401,,ukk7wvcharqj,36188,36189,72377
39402,,ex3rdgkdsqwj,36189,36190,72379
39403,,_asc1v9wssuj,36190,36191,72381
39404,,lz9czkhy2uyj,36191,36192,72383
39405,,12gjvbkq1_ij,36192,36193,72385
39406,,bzqyjpkm1vkj,36193,36194,72387
39407,,zx-5iqrovpqj,36194,36195,72389
39408,,uh4-uo36sicj,36195,36196,72391
39409,,h1jrdbbbuhej,36196,36197,72393
39410,,pkzp0e-5brcj,36197,36198,72395
39411,,fotivs8wm8qj,36198,36199,72397
39412,,z3xkiretu40j,36199,36200,72399
39413,,zd9ql77uk2gj,36200,36201,72401
39414,,i2vfoizhh2ej,36201,36202,72403
39415,,bfc1qxbcdlmj,36202,36203,72405
39416,,eswjvscvvw4j,36203,36204,72407
39417,,ejzknbr98ngj,36204,36205,72409
39418,,qpxdicaio5kj,36205,36206,72411
39419,,aavmwqwzzq8j,36206,36207,72413
39420,,soj8o3qyl_wj,36207,36208,72415
39421,,l2pl6ljtriej,36208,36209,72417
39422,,s9b_jphietgj,36210,36211,72421
39423,,oc3ton7hgvwj,36211,36212,72423
39424,,t3zm8wkd_fyj,36212,36213,72425
39425,,url:http://portal.acm.org/ft_gateway.cfm3fid3d95709826type3dpdf26dl3dacm26dl3dacm26cfid3d1111111126cftoken3d2222222,36213,36214,72427
39426,,iwtopm74jxwj,36214,36215,72429
39427,,jyoe9zskrugj,36215,36216,72431
39428,,vh4hrks2wlkj,36216,36217,72433
39429,,s7xf0jnftegj,36217,36218,72435
39430,,g2zq4_qy228j,36218,36219,72437
39431,,4a0xkzfhmr0j,36219,36220,72439
39432,,1xvepl2ebhuj,36220,36221,72441
39433,,1varcrxo9c0j,36221,36222,72443
39434,,cxamh0onwcaj,36222,36223,72445
39435,,url:http://www.springerlink.com/index/k1366tg454t0652x.pdf,36223,36224,72447
39436,,xa288yfh_e8j,36224,36225,72449
39437,,subewka5dnyj,36225,36226,72451
39438,,jt5b21niugaj,36226,36227,72453
39439,,g4hp8thlehuj,36227,36228,72455
39440,,7q1qrcjniiaj,36228,36229,72457
39441,,url:http://doi.ieeecomputersociety.org/10.1109/tkde.2004.65,36229,36230,72459
39442,,l-m2kfc_b3gj,36230,36231,72461
39443,,ztc5e-dql84j,36231,36232,72463
39444,,_ghut2dtkvgj,36232,36233,72465
39445,,y7bqo1l72eaj,36233,36234,72467
39446,,lv4xv6hoydqj,36234,36235,72469
39447,,h1afe0aabvgj,36235,36236,72471
39448,,hmnts6afflqj,36236,36237,72473
39449,,rehw-ezfvvyj,36238,36239,72477
39450,,xr6mhpswqr8j,36239,36240,72479
39451,,_a4rhvwrvwsj,36240,36241,72481
39452,,qmdydwwbttcj,36241,36242,72483
39453,,d-injbaeswoj,36242,36243,72485
39454,,wntc9blq93cj,36243,36244,72487
39455,,5dof3pbj_p8j,36244,36245,72489
39456,,4o1glkwtugcj,36245,36246,72491
39457,,url:http://www.csa.com/partners/viewrecord.php3frequester3dgs26collection3dtrd26recid3d200111010681mt26recid3da0032591ah,36246,36247,72493
39458,,s4pm7spj2gwj,36247,36248,72495
39459,,lsbry0gggwmj,36248,36249,72497
39460,,0stw-w2cu90j,36249,36250,72499
39461,,d1-f3y13jlgj,36250,36251,72501
39462,,9aln-tngkbsj,36251,36252,72503
39463,,rzodqy32aeaj,36252,36253,72505
39464,,ohvt5z2aq1mj,36253,36254,72507
39465,,6ahyyaf1zs0j,36254,36255,72509
39466,,ntiart90kdaj,36255,36256,72511
39467,,y7_ajj89daej,36256,36257,72513
39468,,dvzrmzjxlokj,36257,36258,72515
39469,,ms_xx6_7tpaj,36258,36259,72517
39470,,ea-njkbywiyj,36259,36260,72519
39471,,ejsc52mdsdcj,36260,36261,72521
39472,,fl-fegkxdvoj,36261,36262,72523
39473,,fe6cgg1wbp0j,36262,36263,72525
39474,,tytrdkftmpsj,36263,36264,72527
39475,,url:http://www.csa.com/partners/viewrecord.php3frequester3dgs26collection3dtrd26recid3da8622970ah,36264,36265,72529
39476,,qmo3tvyig70j,36265,36266,72531
39477,,url:http://portal.acm.org/citation.cfm3fid3d11344126dl3dacm,36266,36267,72533
39478,,wksgt37rpnmj,36267,36268,72535
39479,,wwas0byxddkj,36268,36269,72537
39480,,fuitkuyy3l8j,36269,36270,72539
39481,,sk8qsgw6bqij,36270,36271,72541
39482,,unnqmzl0kcgj,36271,36272,72543
39483,,r8yvktqj9kkj,36272,36273,72545
39484,,7nwm2vppjsqj,36273,36274,72547
39485,,0vwlneoyjbaj,36274,36275,72549
39486,,fjw1unfffrwj,36275,36276,72551
39487,,djqoi4ougk0j,36276,36277,72553
39488,,rnvevkiw_o4j,36277,36278,72555
39489,,qzo-nm0pbbkj,36278,36279,72557
39490,,1us3bmyomcaj,36279,36280,72559
39491,,ljvuwtybivkj,36280,36281,72561
39492,,xmdsz1fktsuj,36281,36282,72563
39493,,ir4fn5cgz7uj,36282,36283,72565
39494,,url:http://portal.acm.org/ft_gateway.cfm3fid3d108360226type3dpdf,36283,36284,72567
39495,,jqyqd4tfrnej,36285,36286,72571
39496,,8fyixamqyhuj,36286,36287,72573
39497,,xkztot-wokcj,36287,36288,72575
39498,,ua-smk1cjmyj,36288,36289,72577
39499,,vx4x2xlw-4qj,36289,36290,72579
39500,,rplujjlwdmgj,36290,36291,72581
39501,,qg7hjk7qcpyj,36291,36292,72583
39502,,b7ekrb6sicqj,36292,36293,72585
39503,,cs3lmo6klfcj,36294,36295,72589
39504,,2cc2lo_7obaj,36295,36296,72591
39505,,6rb2ytbytg4j,36296,36297,72593
39506,,xurou0mlbxgj,36297,36298,72595
39507,,keysuo_j5roj,36298,36299,72597
39508,,cth39oyh-2ij,36299,36300,72599
39509,,brkmkolouhqj,36300,36301,72601
39510,,hauedelsa2mj,36301,36302,72603
39511,,takwcfi7amyj,36302,36303,72605
39512,,6tgdgvunzcqj,36303,36304,72607
39513,,c2j6g-7mtxoj,36304,36305,72609
39514,,pzlsbmv_nb4j,36305,36306,72611
39515,,kpsslmapa1oj,36306,36307,72613
39516,,yu8d1p_mmr0j,36307,36308,72615
39517,,s9tkethc7y8j,36308,36309,72617
39518,,w205jejndmgj,36310,36311,72621
39519,,gvogvdxdgmcj,36311,36312,72623
39520,,o0ymmwc2ttsj,36312,36313,72625
39521,,jt1dicytay4j,36313,36314,72627
39522,,lgqrma3f4aij,36314,36315,72629
39523,,p4o2waxxrdoj,36315,36316,72631
39524,,url:http://links.jstor.org/sici3fsici3d0146-4949(196722)8253a3253c463253acif253e2.0.co253b2-u,36316,36317,72633
39525,,4bg0kv1yloyj,36317,36318,72635
39526,,a0srqblu-sqj,36318,36319,72637
39527,,url:http://adsabs.harvard.edu/abs/1976scom.nasa..322l,36319,36320,72639
39528,,6wuen1s-wluj,36320,36321,72641
39529,,m4adpyn98_qj,36321,36322,72643
39530,,07fhcqgpje0j,36322,36323,72645
39531,,6mwentwfhhej,36323,36324,72647
39532,,oqdtfitvxnij,36324,36325,72649
39533,,m9freatug5ej,36325,36326,72651
39534,,wk2ji3wn7o8j,36326,36327,72653
39535,,lmdwqphisnwj,36327,36328,72655
39536,,_tbbfyxbiraj,36328,36329,72657
39537,,zd7itecsq9wj,36329,36330,72659
39538,,nfhgrhareg4j,36330,36331,72661
39539,,qhioma1pk0gj,36331,36332,72663
39540,,crzuoopefkoj,36332,36333,72665
39541,,gucm2yvzfpuj,36333,36334,72667
39542,,6gis7vhggnkj,36334,36335,72669
39543,,5hv8kccloz4j,36335,36336,72671
39544,,kptb-60rb3ej,36336,36337,72673
39545,,wk4gnuqyfvsj,36337,36338,72675
39546,,u36ximtqatyj,36338,36339,72677
39547,,vpuorkt6w3ej,36339,36340,72679
39548,,oy95u2mujywj,36342,36343,72685
39549,,_isfet_xlrkj,36343,36344,72687
39550,,p5tshvoqo8uj,36344,36345,72689
39551,,iydh-8veeuuj,36345,36346,72691
39552,,iqt8edrcdiqj,36346,36347,72693
39553,,2lxbjttig_aj,36347,36348,72695
39554,,mpyjmgne6mwj,36348,36349,72697
39555,,4-ir4y7jfnkj,36349,36350,72699
39556,,9ryu7t7djp0j,36350,36351,72701
39557,,xgnidg2kbnsj,36351,36352,72703
39558,,klh7nu-g4-ij,36352,36353,72705
39559,,noc9itfy3imj,36353,36354,72707
39560,,qei_6usgpwmj,36354,36355,72709
39561,,jic71upeuvsj,36355,36356,72711
39562,,5xbdowpe5mwj,36356,36357,72713
39563,,prbp69get18j,36357,36358,72715
39564,,t2i-adronqej,36358,36359,72717
39565,,xrcbzdu2nskj,36359,36360,72719
39566,,ak_dsc7id0yj,36360,36361,72721
39567,,xoc7qhp-qkgj,36361,36362,72723
39568,,gokddtuzgxkj,36362,36363,72725
39569,,bpoygxoad1gj,36364,36365,72729
39570,,5c2yfbipwdsj,36366,36367,72733
39571,,abd5_spgqpgj,36367,36368,72735
39572,,jmoa_wsoe9sj,36368,36369,72737
39573,,thf2sxrgwcaj,36369,36370,72739
39574,,giog0t2opmij,36370,36371,72741
39575,,--3zzsmfda0j,36371,36372,72743
39576,,url:http://ieeexplore.ieee.org/iel5/9217/29235/01320077.pdf3farnumber3d1320077,36372,36373,72745
39577,,zr7paiddtogj,36373,36374,72747
39578,,o2v2hsiwexij,36374,36375,72749
39579,,y42ly4s3k_uj,36375,36376,72751
39580,,xn11hea-ghkj,36376,36377,72753
39581,,2d4ks1zxygaj,36377,36378,72755
39582,,nkarqt3c-y8j,36378,36379,72757
39583,,ruwn7e6-hcoj,36379,36380,72759
39584,,url:http://portal.acm.org/citation.cfm3fid3d1065850.1065869,36380,36381,72761
39585,,url:http://portal.acm.org/ft_gateway.cfm3fid3d110127526type3dpdf,36381,36382,72763
39586,,leo7hxbbsjwj,36382,36383,72765
39587,,i0zkqvykflmj,36383,36384,72767
39588,,jndsz5lhhyoj,36384,36385,72769
39589,,ux4nsdbrubwj,36385,36386,72771
39590,,exgthayejkwj,36386,36387,72773
39591,,0vmhp990scmj,36387,36388,72775
39592,,url:http://www.springerlink.com/index/v015v5407r697647.pdf,36388,36389,72777
39593,,wrfvtx7hdgaj,36389,36390,72779
39594,,vvbnsdhocnij,36390,36391,72781
39595,,jo1plgb5m2uj,36391,36392,72783
39596,,yu4tvuy_wiaj,36392,36393,72785
39597,,v14syvkk5iwj,36393,36394,72787
39598,,lh8lw1fikyqj,36394,36395,72789
39599,,10-5uogvuvij,36395,36396,72791
39600,,2xqevyls6bqj,36396,36397,72793
39601,,3ujvu2iirmoj,36397,36398,72795
39602,,ulwlpm5jkysj,36398,36399,72797
39603,,url:http://www.csa.com/partners/viewrecord.php3frequester3dgs26collection3dtrd26recid3da8622988ah,36399,36400,72799
39604,,v7g4aog8xfqj,36400,36401,72801
39605,,oxar64aijlij,36401,36402,72803
39606,,k3yxwblxp9yj,36402,36403,72805
39607,,rsgewwilhl8j,36403,36404,72807
39608,,gmlfe1qysosj,36404,36405,72809
39609,,zcere-v5xaej,36405,36406,72811
39610,,rl0c2tfqwsyj,36406,36407,72813
39611,,a_hdemfn9rmj,36407,36408,72815
39612,,smuf_rmdrwwj,36408,36409,72817
39613,,vjnvzcqnufwj,36409,36410,72819
39614,,p3tjfxbq_qoj,36410,36411,72821
39615,,url:http://www.csa.com/partners/viewrecord.php3frequester3dgs26collection3dtrd26recid3d0177739so,36411,36412,72823
39616,,exv3o2mbcuwj,36412,36413,72825
39617,,abofgsfn4q0j,36413,36414,72827
39618,,mio7rwwgbpij,36414,36415,72829
39619,,ukj6ept_uo8j,36415,36416,72831
39620,,gb1thzdpd-aj,36416,36417,72833
39621,,zb7zadz3dm0j,36417,36418,72835
39622,,k8onis9zwyqj,36418,36419,72837
39623,,rdaovogstxqj,36419,36420,72839
39624,,d-knmrk3dpaj,36420,36421,72841
39625,,jo4zj6x1zoaj,36421,36422,72843
39626,,wc6kksblw5mj,36422,36423,72845
39627,,lsqojqbroowj,36423,36424,72847
39628,,hf7kj0hv9gwj,36424,36425,72849
39629,,fnwvaigc1syj,36425,36426,72851
39630,,ghjyyylddt0j,36427,36428,72855
39631,,ttozhsbmvh4j,36428,36429,72857
39632,,url:http://www.csa.com/partners/viewrecord.php3frequester3dgs26collection3dtrd26recid3d0168673ci,36429,36430,72859
39633,,cjfui5gi-b4j,36430,36431,72861
39634,,wlq4cqrenwmj,36431,36432,72863
39635,,knlsjlnggvij,36432,36433,72865
39636,,v7afodlj-k8j,36433,36434,72867
39637,,tvduywbqjacj,36434,36435,72869
39638,,netwpta0c5cj,36435,36436,72871
39639,,k4yntkci8uyj,36436,36437,72873
39640,,shopf844dk4j,36437,36438,72875
39641,,2gjjb_a68haj,36438,36439,72877
39642,,4ecifmjwuhyj,36439,36440,72879
39643,,zapvjm4wbcwj,36440,36441,72881
39644,,av5xvux4wccj,36441,36442,72883
39645,,vo0sqs-rk90j,36442,36443,72885
39646,,uuw9srtx7ymj,36444,36445,72889
39647,,efh2acvu6faj,36445,36446,72891
39648,,t1i_dq0a1uij,36446,36447,72893
39649,,jfun3qdzxzqj,36447,36448,72895
39650,,ktdirnws1l0j,36448,36449,72897
39651,,mwo2ehelipsj,36449,36450,72899
39652,,fohmicwctlej,36450,36451,72901
39653,,pxkgenknnbcj,36451,36452,72903
39654,,tdtkex9m4bqj,36453,36454,72907
39655,,,36454,36455,72909
39656,,b-jinisu_pqj,36455,36456,72911
39657,,ybhvmjqguu4j,36456,36457,72913
39658,,_7apaitvbtmj,36457,36458,72915
39659,,kmsepjsqqusj,36458,36459,72917
39660,,4h7qgauropkj,36459,36460,72919
39661,,5glijkb5vhij,36460,36461,72921
39662,,o6gc24u3rkoj,36461,36462,72923
39663,,uzu3r7uw_rkj,36462,36463,72925
39664,,l3oejhujecwj,36463,36464,72927
39665,,8wrrqofpaacj,36464,36465,72929
39666,,jqhrw-vsm7wj,36465,36466,72931
39667,,wb0tru43yewj,36466,36467,72933
39668,,jwlfs59o_zyj,36468,36469,72937
39669,,5telvzjbrrgj,36469,36470,72939
39670,,6rldzjiqlbej,36470,36471,72941
39671,,id6ppxf5sx4j,36471,36472,72943
39672,,tk6muta48lej,36472,36473,72945
39673,,bbntkoyx4myj,36473,36474,72947
39674,,j8zmor4iwdoj,36474,36475,72949
39675,,uttqpsoh_ygj,36475,36476,72951
39676,,q-xwtd90hbqj,36476,36477,72953
39677,,yybsjtivf8gj,36477,36478,72955
39678,,kvrdixc5zfej,36478,36479,72957
39679,,m8lqd0voa70j,36479,36480,72959
39680,,k1-qo65s-akj,36480,36481,72961
39681,,vgqq9duaiv4j,36481,36482,72963
39682,,jscvamycsmoj,36482,36483,72965
39683,,url:http://portal.acm.org/citation.cfm3fid3d637411.63742326dl3dportal26dl3dacm26type3dissue26idx3d63741126part3dperiodical26wanttype3dperiodical26title3dacm2520sigmod2520record26cfid3d1111111126cftoken3d2222222,36483,36484,72967
39684,,lxhj0q0wwssj,36484,36485,72969
39685,,qnk5x4ymjzej,36485,36486,72971
39686,,pifg2tgqvxoj,36486,36487,72973
39687,,7idooycf5mqj,36487,36488,72975
39688,,dvgc30eswz0j,36488,36489,72977
39689,,w5sknzgju0yj,36489,36490,72979
39690,,fowg5bztqtij,36490,36491,72981
39691,,_ouqpdhhlomj,36491,36492,72983
39692,,yp311brlip8j,36492,36493,72985
39693,,ekocazb1hfuj,36493,36494,72987
39694,,h7m9l9vjoxaj,36494,36495,72989
39695,,hzmysa645jqj,36495,36496,72991
39696,,tp46s2wuc6cj,36496,36497,72993
39697,,lnoi5c435a4j,36497,36498,72995
39698,,rigxi-jzvyyj,36498,36499,72997
39699,,izsrdvjkmxcj,36499,36500,72999
39700,,lh_n19yvmwgj,36500,36501,73001
39701,,a1ehix2vxssj,36501,36502,73003
39702,,leqktloxisej,36502,36503,73005
39703,,rv_scgsokkmj,36503,36504,73007
39704,,n_yur_a82pgj,36505,36506,73011
39705,,2avwwpwiuvcj,36506,36507,73013
39706,,f5xpl6mnxbuj,36507,36508,73015
39707,,q91dbywch54j,36508,36509,73017
39708,,u8vumwnvmzuj,36509,36510,73019
39709,,epewol4-veuj,36511,36512,73023
39710,,lbijdclicncj,36512,36513,73025
39711,,k9bviuh6j5mj,36513,36514,73027
39712,,rr_ozb4ilwaj,36514,36515,73029
39713,,v1cvereahuuj,36515,36516,73031
39714,,url:http://doi.wiley.com/10.1002/he.9802,36516,36517,73033
39715,,url:http://www.csa.com/partners/viewrecord.php3frequester3dgs26collection3dtrd26recid3d200111010674mt26recid3da0032577ah,36517,36518,73035
39716,,ewdpecqbt1aj,36518,36519,73037
39717,,8qlmryxp3bsj,36519,36520,73039
39718,,a3brhyvfk_ij,36520,36521,73041
39719,,url:http://doi.wiley.com/10.1002/tl.166,36521,36522,73043
39720,,url:http://doi.wiley.com/10.1002/he.103,36522,36523,73045
39721,,z2mk4a-ktdgj,36523,36524,73047
39722,,npky15s4hw8j,36524,36525,73049
39723,,sgytgpry3cej,36525,36526,73051
39724,,m8wiivrg_3uj,36526,36527,73053
39725,,8ktyf_8pswoj,36527,36528,73055
39726,,anrmqbzk70sj,36528,36529,73057
39727,,3ya-c6zsfcgj,36529,36530,73059
39728,,fif3vwin7duj,36530,36531,73061
39729,,uksadhhuurwj,36531,36532,73063
39730,,ufiivn61kocj,36532,36533,73065
39731,,zmymropbww0j,36533,36534,73067
39732,,fehxmwiwsj0j,36534,36535,73069
39733,,k68r_gjbo9mj,36535,36536,73071
39734,,mgpam-dklcej,36536,36537,73073
39735,,jz2-txqb_msj,36538,36539,73077
39736,,ifwqjztau5kj,36539,36540,73079
39737,,url:http://www.csa.com/partners/viewrecord.php3frequester3dgs26collection3dtrd26recid3d0294143ci,36540,36541,73081
39738,,luvypdk_zkwj,36541,36542,73083
39739,,url:http://ieeexplore.ieee.org/iel5/35/23752/01090579.pdf3farnumber3d1090579,36542,36543,73085
39740,,mj-bxttmh-kj,36543,36544,73087
39741,,,36544,36545,73089
39742,,twb-kriari0j,36545,36546,73091
39743,,_vjmet9jwnkj,36546,36547,73093
39744,,ddst2izavvej,36547,36548,73095
39745,,url:http://portal.acm.org/ft_gateway.cfm3fid3d110192326type3dpdf,36548,36549,73097
39746,,url:http://portal.acm.org/citation.cfm3fid3d1083784.1083802,36549,36550,73099
39747,,jwvedxqapukj,36550,36551,73101
39748,,d3siuhnrgsuj,36551,36552,73103
39749,,vr00sl3jutej,36552,36553,73105
39750,,srogvte759ej,36553,36554,73107
39751,,cliodwkc9jcj,36554,36555,73109
39752,,uz5yb9bxyeqj,36555,36556,73111
39753,,cli-yotfssgj,36556,36557,73113
39754,,ciumyr8q4wcj,36557,36558,73115
39755,,rpd20setu2cj,36558,36559,73117
39756,,ypnxndzgnvwj,36559,36560,73119
39757,,lzflsqekdhoj,36560,36561,73121
39758,,2i7ouzcuvdqj,36561,36562,73123
39759,,ts6ge7q5laoj,36562,36563,73125
39760,,selrfxbb2omj,36563,36564,73127
39761,,zd_qz4db_ekj,36564,36565,73129
39762,,qaucc8gn2vij,36565,36566,73131
39763,,url:http://www.springerlink.com/index/l29217h47xl84011.pdf,36566,36567,73133
39764,,r0p7nmrhofqj,36567,36568,73135
39765,,arl7wdzkid8j,36568,36569,73137
39766,,url:http://www.ingentaconnect.com/search/expand3fpub3dinfobike://els/13891286/1999/00000031/00000020/art0006526unc3d,36569,36570,73139
39767,,yawe__az8igj,36570,36571,73141
39768,,4n_c-q2kwcgj,36571,36572,73143
39769,,0x5igmcid0ej,36572,36573,73145
39770,,9rn0eyqjgmaj,36573,36574,73147
39771,,vxswsbfjkugj,36574,36575,73149
39772,,pq7wctj-wocj,36575,36576,73151
39773,,ropbwx4wb_0j,36576,36577,73153
39774,,14xusnb5xu4j,36577,36578,73155
39775,,xixyrnbtby4j,36578,36579,73157
39776,,wnob9yvvnmgj,36579,36580,73159
39777,,vrqmj_kjxgcj,36580,36581,73161
39778,,url:http://portal.acm.org/ft_gateway.cfm3fid3d109974526type3dpdf,36581,36582,73163
39779,,bulvakeuodkj,36582,36583,73165
39780,,j03ibjchbmmj,36583,36584,73167
39781,,h8fa79ks_3wj,36584,36585,73169
39782,,azkcoryj_b8j,36585,36586,73171
39783,,9qtnpc83rnaj,36586,36587,73173
39784,,gmi5mhnrf9wj,36587,36588,73175
39785,,duj6itryxg4j,36588,36589,73177
39786,,ntsge-h66qij,36589,36590,73179
39787,,igzsbfigdcsj,36590,36591,73181
39788,,url:http://portal.acm.org/citation.cfm3fid3d171926.171988,36591,36592,73183
39789,,5e9kizznk30j,36592,36593,73185
39790,,sqmw5_eml7oj,36593,36594,73187
39791,,nv1fgnuzjvwj,36594,36595,73189
39792,,pboqxyl4w-mj,36595,36596,73191
39793,,gsntlqu93iyj,36596,36597,73193
39794,,gucstrmaj0oj,36597,36598,73195
39795,,wqzh2ccydtaj,36598,36599,73197
39796,,jfpqveo56d8j,36599,36600,73199
39797,,7iorzbtlficj,36600,36601,73201
39798,,4s4gb63ms9wj,36601,36602,73203
39799,,qlqchfejvgkj,36602,36603,73205
39800,,cddx1r5btx0j,36603,36604,73207
39801,,yux3ihfksswj,36604,36605,73209
39802,,drrtxn2klfwj,36605,36606,73211
39803,,btf7csc_5x4j,36606,36607,73213
39804,,cojzttwkbxyj,36607,36608,73215
39805,,fj4qighuwwej,36608,36609,73217
39806,,3qmq4l-96pyj,36609,36610,73219
39807,,ase9qcio2saj,36610,36611,73221
39808,,uvnw4ionk-qj,36612,36613,73225
39809,,m0am85mrsqcj,36613,36614,73227
39810,,szgjnnzj5qgj,36614,36615,73229
39811,,qknonjohqc8j,36615,36616,73231
39812,,shi1-8otrwyj,36616,36617,73233
39813,,0emg_2spkosj,36617,36618,73235
39814,,5xdaczsqj7wj,36618,36619,73237
39815,,wvvy_ao19maj,36619,36620,73239
39816,,2kyj0j_fihej,36620,36621,73241
39817,,_f5d4qmbz0sj,36621,36622,73243
39818,,eygpnkfprf8j,36622,36623,73245
39819,,tsk4badtzmij,36623,36624,73247
39820,,dh3u05jbr-qj,36624,36625,73249
39821,,pixuq---hduj,36625,36626,73251
39822,,uysilf8cziuj,36626,36627,73253
39823,,sws7b2k0vcij,36627,36628,73255
39824,,z9yegkzly8mj,36628,36629,73257
39825,,xmwjxdntshcj,36629,36630,73259
39826,,fsrdlbgbyh4j,36630,36631,73261
39827,,kdayxxy7smoj,36631,36632,73263
39828,,mrmjoega1ukj,36632,36633,73265
39829,,zyzkgl4_urmj,36633,36634,73267
39830,,xly2iqgrtaaj,36634,36635,73269
39831,,17qyrryewiqj,36635,36636,73271
39832,,n3prdpeh1taj,36637,36638,73275
39833,,fjdsmhsk36oj,36638,36639,73277
39834,,7ftvkd78pxyj,36639,36640,73279
39835,,url:http://doi.wiley.com/10.1002/ace.8207,36640,36641,73281
39836,,zqspyvh7mw4j,36641,36642,73283
39837,,vwflrqytbu4j,36642,36643,73285
39838,,2odwnqbtbasj,36643,36644,73287
39839,,j5hqj5rh5icj,36644,36645,73289
39840,,u2br_nghzogj,36645,36646,73291
39841,,ur_m2wl8xguj,36646,36647,73293
39842,,pi2j_lwqp6qj,36647,36648,73295
39843,,g3owlbgrlh4j,36648,36649,73297
39844,,uvlvm-e5y2mj,36649,36650,73299
39845,,rftxwf3e7pkj,36650,36651,73301
39846,,stcncfaqlfgj,36651,36652,73303
39847,,9ljdg2bmaayj,36652,36653,73305
39848,,wyd_clw1hgwj,36653,36654,73307
39849,,ub3kun7ptsoj,36654,36655,73309
39850,,at9iayjk6kij,36655,36656,73311
39851,,5aymnob1ktgj,36656,36657,73313
39852,,ksqp5x9ayugj,36657,36658,73315
39853,,ih3wsuueqtuj,36658,36659,73317
39854,,pnytslkecuyj,36659,36660,73319
39855,,url:http://portal.acm.org/citation.cfm3fid3dseries9729.156041,36660,36661,73321
39856,,05ifwrhkzxoj,36661,36662,73323
39857,,lrobfb81fqkj,36662,36663,73325
39858,,a1jaxg-hkuwj,36663,36664,73327
39859,,7srievzrhvcj,36664,36665,73329
39860,,27tslo5yxfoj,36665,36666,73331
39861,,ra4rtxa6nroj,36666,36667,73333
39862,,yr7oql-d4fgj,36667,36668,73335
39863,,s7ezhxmlaf0j,36668,36669,73337
39864,,kz9z0b-bwmqj,36669,36670,73339
39865,,xu5hvtktmzmj,36670,36671,73341
39866,,dgfgcgwzvqgj,36671,36672,73343
39867,,iizi1ed7p_oj,36672,36673,73345
39868,,s4a1ndjkmccj,36673,36674,73347
39869,,gj6axbnp6qij,36674,36675,73349
39870,,hmgf1q_uqvqj,36675,36676,73351
39871,,ft56dae8w1ij,36676,36677,73353
39872,,to_ejikwfsaj,36677,36678,73355
39873,,axtmpulqx20j,36678,36679,73357
39874,,nl-302gx3twj,36679,36680,73359
39875,,2oagl7bkfrqj,36680,36681,73361
39876,,,36681,36682,73363
39877,,s15aqbenommj,36682,36683,73365
39878,,uvip738scu4j,36683,36684,73367
39879,,ztxaijei8yuj,36684,36685,73369
39880,,ynm0arsuskij,36686,36687,73373
39881,,rtmuk3d5ny4j,36687,36688,73375
39882,,by5qcfxlpjqj,36688,36689,73377
39883,,i0y9qjsajxsj,36689,36690,73379
39884,,url:http://portal.acm.org/ft_gateway.cfm3fid3d110127326type3dpdf,36690,36691,73381
39885,,ekii_rsl5duj,36691,36692,73383
39886,,bgddyh8bpc4j,36692,36693,73385
39887,,ej5xcu4kmb4j,36693,36694,73387
39888,,3-evdt60fr8j,36694,36695,73389
39889,,ivmeo631nrij,36695,36696,73391
39890,,udo5xymazwwj,36696,36697,73393
39891,,3vxl-omcbvcj,36697,36698,73395
39892,,idzyoxh_li4j,36698,36699,73397
39893,,u0o-mm0emwmj,36699,36700,73399
39894,,c9y8cctkjdaj,36700,36701,73401
39895,,ajz-kh0mqaoj,36701,36702,73403
39896,,url:http://adsabs.harvard.edu/abs/1980geaer...3..107r,36702,36703,73405
39897,,_vn4nsui5umj,36703,36704,73407
39898,,c_zevfmuvucj,36704,36705,73409
39899,,52x78w6qgcwj,36705,36706,73411
39900,,7dnzrilma24j,36706,36707,73413
39901,,url:http://portal.acm.org/ft_gateway.cfm3fid3d110126826type3dpdf,36707,36708,73415
39902,,url:http://portal.acm.org/citation.cfm3fid3d146022.146034,36708,36709,73417
39903,,kqnid64sffuj,36709,36710,73419
39904,,v499qeldrk0j,36710,36711,73421
39905,,pdtivsjq3paj,36711,36712,73423
39906,,1r3dikuxnuej,36712,36713,73425
39907,,-prcloc-z-4j,36713,36714,73427
39908,,qqwitb2fo1mj,36714,36715,73429
39909,,wvqvhjsirisj,36715,36716,73431
39910,,rgpx4sx-f50j,36716,36717,73433
39911,,h7ygcdwqbcaj,36717,36718,73435
39912,,rg6e0jsctvmj,36719,36720,73439
39913,,wtxyvlnpzuej,36720,36721,73441
39914,,x5u94xvpyoej,36721,36722,73443
39915,,v1jkxrosxfaj,36722,36723,73445
39916,,url:http://doi.wiley.com/10.1002/tl.91,36723,36724,73447
39917,,r1vb09flxgyj,36724,36725,73449
39918,,url:http://www.ingentaconnect.com/content/els/09505849/2001/00000043/00000012/art00179,36725,36726,73451
39919,,v7vg8eegnrij,36726,36727,73453
39920,,29d_5uq6zbwj,36727,36728,73455
39921,,lh-qyykutryj,36728,36729,73457
39922,,ma9je1n6ccuj,36729,36730,73459
39923,,venk429chbmj,36730,36731,73461
39924,,ymo-pf35nicj,36731,36732,73463
39925,,tp3ayzrhuewj,36732,36733,73465
39926,,p-rdxnktpckj,36733,36734,73467
39927,,zfxd9vnwssij,36734,36735,73469
39928,,ar8xj6cxbhyj,36735,36736,73471
39929,,knbdoees5xuj,36736,36737,73473
39930,,pc6y77bvvqcj,36737,36738,73475
39931,,w9hbbprnlm0j,36738,36739,73477
39932,,pol1tqjl1bqj,36739,36740,73479
39933,,l6l7robdgnij,36740,36741,73481
39934,,n11hysouxmwj,36741,36742,73483
39935,,v-a9q61fyy4j,36742,36743,73485
39936,,fnra-wxrlkkj,36743,36744,73487
39937,,mkjmfizcqcoj,36744,36745,73489
39938,,wadxjvnb0g0j,36745,36746,73491
39939,,77hnyp9ky9ij,36746,36747,73493
39940,,43v9fsxyxvgj,36747,36748,73495
39941,,zb7y3huwyqqj,36748,36749,73497
39942,,giwjdl5zwuwj,36749,36750,73499
39943,,0ccgphx7ntij,36750,36751,73501
39944,,t_-hpnraab0j,36751,36752,73503
39945,,sdu3pt2atkoj,36752,36753,73505
39946,,e2jx72_05dgj,36753,36754,73507
39947,,kr4vhnjbgk8j,36754,36755,73509
39948,,i_bfecjxp6mj,36755,36756,73511
39949,,1-d-h8stju4j,36756,36757,73513
39950,,ug2u-c6kqtoj,36757,36758,73515
39951,,zucdyqgysrwj,36758,36759,73517
39952,,gq58nojn5aaj,36759,36760,73519
39953,,uth-ntwhfuqj,36760,36761,73521
39954,,2s5rodtar8wj,36761,36762,73523
39955,,gmkqxuejb_0j,36762,36763,73525
39956,,ukvocx9trkcj,36763,36764,73527
39957,,0avtezjwe4sj,36764,36765,73529
39958,,bja2sammhqij,36765,36766,73531
39959,,qtwec37_bnwj,36766,36767,73533
39960,,zjderfl1vlwj,36767,36768,73535
39961,,1qc4cnzidfcj,36768,36769,73537
39962,,1gdj3icvbdej,36769,36770,73539
39963,,khoxzoabvm0j,36770,36771,73541
39964,,lpfu9chxdrwj,36771,36772,73543
39965,,oxhbgsk1gpgj,36772,36773,73545
39966,,url:http://doi.wiley.com/10.1002/ev.1289,36773,36774,73547
39967,,w39-xqr9dmmj,36774,36775,73549
39968,,neqfdn-6lvej,36775,36776,73551
39969,,zo87lhglwkgj,36776,36777,73553
39970,,mjfyf9m2nw4j,36777,36778,73555
39971,,sspwr_fshr8j,36778,36779,73557
39972,,n8xhyf9em1wj,36779,36780,73559
39973,,0akpsvfc0dyj,36780,36781,73561
39974,,wjcvky9wmyqj,36781,36782,73563
39975,,60dzekxnvjij,36782,36783,73565
39976,,mum9jho-5loj,36783,36784,73567
39977,,9jq-4xhvc0kj,36784,36785,73569
39978,,na3wrpyew08j,36785,36786,73571
39979,,z6roax5gooej,36786,36787,73573
39980,,rznzwtnbqzij,36787,36788,73575
39981,,cbkhtpuul2kj,36788,36789,73577
39982,,dpkggqpocqyj,36789,36790,73579
39983,,u5quqjepktyj,36790,36791,73581
39984,,nrkhpvmbllgj,36791,36792,73583
39985,,bcuzsve1x5ej,36792,36793,73585
39986,,4e9imkukx9cj,36793,36794,73587
39987,,s5gfplgempyj,36794,36795,73589
39988,,hidey-va1vqj,36795,36796,73591
39989,,fazwbrnvglkj,36796,36797,73593
39990,,seejwmu23goj,36797,36798,73595
39991,,qnmztw_lpzqj,36798,36799,73597
39992,,bw5wkl5nnjgj,36799,36800,73599
39993,,dpfc-dxt58ej,36800,36801,73601
39994,,xfv1vk3-pgcj,36801,36802,73603
39995,,w7o5c612jgaj,36802,36803,73605
39996,,_mql5joxbscj,36803,36804,73607
39997,,ns8neiq0-2yj,36804,36805,73609
39998,,gm9ist67njqj,36805,36806,73611
39999,,fjfqvdl22imj,36806,36807,73613
40000,,snmduq2ssraj,36807,36808,73615
40001,,imwzdydgk8kj,36808,36809,73617
40002,,ri03ckum82kj,36809,36810,73619
40003,,,36810,36811,73621
40004,,prwtqepex4sj,36811,36812,73623
40005,,tgjdw3o61zgj,36812,36813,73625
40006,,r1pehhizku0j,36813,36814,73627
40007,,ngzndkgomhsj,36814,36815,73629
40008,,ymyi8qoi77mj,36815,36816,73631
40009,,vsi1nw6rrduj,36816,36817,73633
40010,,brgma4ieihyj,36817,36818,73635
40011,,xvypnql14x8j,36818,36819,73637
40012,,yoci7sjwx3mj,36819,36820,73639
40013,,hicobk1knckj,36820,36821,73641
40014,,xv8ffjndztqj,36821,36822,73643
40015,,wlbjbex98-4j,36822,36823,73645
40016,,kerr6jki7sij,36823,36824,73647
40017,,k1pma60ia7oj,36824,36825,73649
40018,,yhaj5sttq0sj,36825,36826,73651
40019,,ooh0lhw2ctkj,36826,36827,73653
40020,,p8kflquk9mqj,36827,36828,73655
40021,,bclr5pnzmvaj,36828,36829,73657
40022,,ovkgpiavcpcj,36829,36830,73659
40023,,9slew6hrcs4j,36830,36831,73661
40024,,k76rrxnewdej,36831,36832,73663
40025,,6e9xrj9hopcj,36832,36833,73665
40026,,_ej75amgilwj,36833,36834,73667
40027,,url:http://www.ingentaconnect.com/content/els/09505849/2001/00000043/00000010/art00167,36834,36835,73669
40028,,kixtozbhftgj,36835,36836,73671
40029,,mr8xdkq7adaj,36836,36837,73673
40030,,9lu58bvvu8gj,36837,36838,73675
40031,,wtkel2ibrtuj,36838,36839,73677
40032,,pbgwudupk3wj,36839,36840,73679
40033,,url:http://doi.wiley.com/10.1002/ace.7601,36840,36841,73681
40034,,xefug6xv9iej,36841,36842,73683
40035,,cwytvaxjurwj,36842,36843,73685
40036,,ejxcxeo53o4j,36843,36844,73687
40037,,oah_2kmthtej,36844,36845,73689
40038,,w855syqma9kj,36845,36846,73691
40039,,2gikhiyy10gj,36846,36847,73693
40040,,qwgtn_ruug0j,36847,36848,73695
40041,,u2yvprttdngj,36848,36849,73697
40042,,all_0vgkfmqj,36849,36850,73699
40043,,mkvkap65ifkj,36850,36851,73701
40044,,tpruurkprwgj,36851,36852,73703
40045,,sh6qs5j_g-ej,36852,36853,73705
40046,,nb3rsmm2ndkj,36854,36855,73709
40047,,rg9aob0lexej,36855,36856,73711
40048,,9hrcw6gsxokj,36856,36857,73713
40049,,url:http://doi.wiley.com/10.1002/ev.1261,36857,36858,73715
40050,,ws-tgr_lupij,36858,36859,73717
40051,,2j-iheruid8j,36859,36860,73719
40052,,corrizswgdej,36860,36861,73721
40053,,ztxnaoeaqgsj,36861,36862,73723
40054,,3owag7egzqqj,36862,36863,73725
40055,,xakiz5s-cquj,36863,36864,73727
40056,,45yisxcsycij,36864,36865,73729
40057,,b-qjb8hpovsj,36865,36866,73731
40058,,lcyjuho0jlyj,36866,36867,73733
40059,,aa2o8zxmzv4j,36867,36868,73735
40060,,7vye8hfsidaj,36868,36869,73737
40061,,459ncslnfcgj,36869,36870,73739
40062,,dx3fat100cyj,36870,36871,73741
40063,,y4gl00kwt_uj,36871,36872,73743
40064,,za4prfsmcsmj,36872,36873,73745
40065,,easyup9dbxaj,36873,36874,73747
40066,,jd64xvdnrpyj,36874,36875,73749
40067,,url:http://doi.wiley.com/10.1002/ace.8005,36875,36876,73751
40068,,nupbkztyonyj,36876,36877,73753
40069,,c6iqlpkcbiij,36877,36878,73755
40070,,cmn1sa3rhagj,36878,36879,73757
40071,,qu7b1oxgvrej,36879,36880,73759
40072,,2fti8ovo5cij,36880,36881,73761
40073,,r8xb5lmsatij,36881,36882,73763
40074,,vl6rer51ed0j,36882,36883,73765
40075,,j8hqtssymw0j,36883,36884,73767
40076,,m3toxsbrx-wj,36884,36885,73769
40077,,vbcsji9fh5oj,36885,36886,73771
40078,,url:http://www.csa.com/partners/viewrecord.php3frequester3dgs26collection3dtrd26recid3d200111010685mt26recid3da0032599ah,36886,36887,73773
40079,,sw8rvycxqamj,36887,36888,73775
40080,,anyli6svnigj,36888,36889,73777
40081,,k-lnzr15jhqj,36889,36890,73779
40082,,addbemg7oyyj,36890,36891,73781
40083,,evrwf0wcsfqj,36892,36893,73785
40084,,jrnpfxol4nsj,36893,36894,73787
40085,,yef-g0a1bsaj,36894,36895,73789
40086,,0l0yclrf4pyj,36895,36896,73791
40087,,8hc_3z__zjmj,36896,36897,73793
40088,,rtargqmne9ij,36897,36898,73795
40089,,6zgi-apfngqj,36898,36899,73797
40090,,url:http://portal.acm.org/citation.cfm3fid3d14148426dl3dguide26dl3dacm26type3dissue26idx3d14148426part3dperiodical26wanttype3dperiodical26title3dacm2520sigmod2520record26cfid3d1111111126cftoken3d2222222,36899,36900,73799
40091,,url:http://portal.acm.org/citation.cfm3fid3d234286.1057813,36900,36901,73801
40092,,url:http://www.ingentaconnect.com/content/els/08830355/2001/00000035/00000002/art00015,36901,36902,73803
40093,,plt0eogpcrgj,36902,36903,73805
40094,,c05be8uuczsj,36903,36904,73807
40095,,f2q4mfevyrcj,36904,36905,73809
40096,,fx2exsneb6gj,36905,36906,73811
40097,,url:http://doi.ieeecomputersociety.org/10.1109/tkde.2004.46,36906,36907,73813
40098,,juoqfsvo8bmj,36908,36909,73817
40099,,abmtc3hbtfuj,36909,36910,73819
40100,,qrycu4kyfvmj,36910,36911,73821
40101,,atidmqn5j-ej,36911,36912,73823
40102,,8sktr0yma8ij,36912,36913,73825
40103,,url:http://portal.acm.org/ft_gateway.cfm3fid3d18155526type3dpdf26coll3dguide26dl3dacm26cfid3d1111111126cftoken3d2222222,36913,36914,73827
40104,,ppidyofhd0ij,36914,36915,73829
40105,,yseyznx0afcj,36915,36916,73831
40106,,neb3vcdkrfoj,36916,36917,73833
40107,,jaujjgbpruaj,36917,36918,73835
40108,,1ckuoid-zq4j,36918,36919,73837
40109,,fgarb8elzkkj,36919,36920,73839
40110,,7vvn0arse6ej,36920,36921,73841
40111,,907lcnulb8oj,36921,36922,73843
40112,,1ufcsl6qjumj,36922,36923,73845
40113,,qtpuwmxdllej,36923,36924,73847
40114,,omp03p90kh8j,36924,36925,73849
40115,,flpzluxy5cgj,36925,36926,73851
40116,,kv5pvq9b9vwj,36926,36927,73853
40117,,rxmz_xacwauj,36927,36928,73855
40118,,g241kquryxwj,36929,36930,73859
40119,,ii09o1cxjwcj,36930,36931,73861
40120,,myhjfkzto0qj,36931,36932,73863
40121,,s21yqsruwowj,36932,36933,73865
40122,,hszejcpemxuj,36934,36935,73869
40123,,mbrizc7lr-8j,36935,36936,73871
40124,,qlbbhghkut0j,36936,36937,73873
40125,,_inulg9vrzoj,36937,36938,73875
40126,,ksqkdhhzkumj,36938,36939,73877
40127,,k5ruxm0vxqmj,36939,36940,73879
40128,,nft9poxbymmj,36940,36941,73881
40129,,6frocfbcwcgj,36941,36942,73883
40130,,usapcfocwxsj,36942,36943,73885
40131,,2r-2i60g4msj,36943,36944,73887
40132,,uaoopa1724yj,36944,36945,73889
40133,,itgobi_h4j0j,36945,36946,73891
40134,,62kkd4os98wj,36946,36947,73893
40135,,url:http://www.ingentaconnect.com/content/els/09505849/2000/00000042/00000007/art00103,36947,36948,73895
40136,,wyu8qn_wgm4j,36948,36949,73897
40137,,l_ploxf_owoj,36949,36950,73899
40138,,9-_c2xvdc3ij,36950,36951,73901
40139,,_xh2pa55toij,36951,36952,73903
40140,,url:http://www.eastwestcenter.org/stored/pdfs/nfhsbull011.pdf,36952,36953,73905
40141,,mdjitmvln0sj,36953,36954,73907
40142,,sz3nifetw1qj,36954,36955,73909
40143,,d5ay0p6ofp8j,36955,36956,73911
40144,,iepzefcmctsj,36956,36957,73913
40145,,r-nedv2thg8j,36957,36958,73915
40146,,xkzhb4zfqe8j,36958,36959,73917
40147,,xmrmwsjtipcj,36959,36960,73919
40148,,3nulika1kgqj,36960,36961,73921
40149,,zibfdzrwsfej,36962,36963,73925
40150,,url:http://www.csa.com/partners/viewrecord.php3frequester3dgs26collection3dtrd26recid3d20021211038651mt26recid3da7423785ah,36963,36964,73927
40151,,a5piu9h6nxwj,36964,36965,73929
40152,,ooazos5rf9gj,36965,36966,73931
40153,,tnavqtiakh0j,36966,36967,73933
40154,,r73wcjmziegj,36967,36968,73935
40155,,p1zps-eeo9uj,36968,36969,73937
40156,,jpqwxxkcvjaj,36969,36970,73939
40157,,jirgrll_d1mj,36970,36971,73941
40158,,xwzds8e3ugkj,36971,36972,73943
40159,,eblgiaaukh0j,36972,36973,73945
40160,,qgagr6fhjyyj,36973,36974,73947
40161,,k97qwdwyktqj,36974,36975,73949
40162,,ekvcaxfgb-aj,36976,36977,73953
40163,,ivb63yjxgj0j,36977,36978,73955
40164,,h0u-oqv03wuj,36978,36979,73957
40165,,h1dtqk0_3tsj,36979,36980,73959
40166,,url:http://portal.acm.org/citation.cfm3fid3d637411.63742626dl3dguide26dl3dacm26idx3d63741126part3dperiodical26wanttype3dperiodical26title3dacm2520sigmod2520record26cfid3d1111111126cftoken3d2222222,36980,36981,73961
40167,,kk6zyd0bkhsj,36981,36982,73963
40168,,jsjfmalvahuj,36982,36983,73965
40169,,hmpeihmxyqij,36983,36984,73967
40170,,url:http://www.csa.com/partners/viewrecord.php3frequester3dgs26collection3denv26recid3d3594872,36984,36985,73969
40171,,v7u-6eapl48j,36985,36986,73971
40172,,lnqefxdzvicj,36986,36987,73973
40173,,1rw7ao6gk-qj,36987,36988,73975
40174,,r08vybtwnxwj,36988,36989,73977
40175,,uwzed8qlt6qj,36989,36990,73979
40176,,tlfcarzmj1cj,36990,36991,73981
40177,,hrdg_-ecnp8j,36991,36992,73983
40178,,5y0oysigpisj,36992,36993,73985
40179,,nztn7ghd7yoj,36993,36994,73987
40180,,24hcnozoa30j,36994,36995,73989
40181,,gftu2pvky_gj,36995,36996,73991
40182,,j-wcx3qr5ugj,36996,36997,73993
40183,,wo65i6bsypyj,36998,36999,73997
40184,,xqchx17hx8gj,36999,37000,73999
40185,,url:http://www.ingentaconnect.com/search/expand3fpub3dinfobike://els/13891286/2001/00000036/00000004/art0016426unc3d,37000,37001,74001
40186,,bme47wjnv3yj,37001,37002,74003
40187,,nxa1w2peti4j,37002,37003,74005
40188,,xrik_nc9rkkj,37003,37004,74007
40189,,yk4valoqjlgj,37004,37005,74009
40190,,n6ctiqpgc7cj,37005,37006,74011
40191,,lherpzrvv64j,37006,37007,74013
40192,,url:http://www.csa.com/partners/viewrecord.php3frequester3dgs26collection3dtrd26recid3da8622977ah,37007,37008,74015
40193,,wd4c-qvpwguj,37008,37009,74017
40194,,xjsdgko2i28j,37009,37010,74019
40195,,h9uulrghkwkj,37010,37011,74021
40196,,yngvbzmneuij,37011,37012,74023
40197,,j--gh3yrotuj,37012,37013,74025
40198,,frxajqbmciej,37013,37014,74027
40199,,v5xsasjaonmj,37014,37015,74029
40200,,hdtsm52hpxyj,37015,37016,74031
40201,,w3kytjvd9haj,37016,37017,74033
40202,,nkc8busdlqwj,37017,37018,74035
40203,,w6osnqbtul0j,37018,37019,74037
40204,,otegbke7qyqj,37019,37020,74039
40205,,rr-bblpfx1ij,37020,37021,74041
40206,,9tphm8fzio8j,37021,37022,74043
40207,,evx1zjbjhkmj,37022,37023,74045
40208,,ruenddvwzzij,37023,37024,74047
40209,,feps1shdvmkj,37024,37025,74049
40210,,nzg3d6r0bmcj,37025,37026,74051
40211,,kk-_x6m8v3gj,37026,37027,74053
40212,,fvkzrqjsa5ij,37027,37028,74055
40213,,25re7-aq9waj,37028,37029,74057
40214,,url:http://www.csa.com/partners/viewrecord.php3frequester3dgs26collection3dtrd26recid3d9109g2p0232ep,37029,37030,74059
40215,,1pkdxuhmasij,37030,37031,74061
40216,,-3mp1r-2ogyj,37031,37032,74063
40217,,dng63id3l0gj,37032,37033,74065
40218,,ajilpfjfruyj,37033,37034,74067
40219,,kocuy-pwxtsj,37034,37035,74069
40220,,1y-pkwumdnkj,37035,37036,74071
40221,,ytouxklnaooj,37036,37037,74073
40222,,coznzle5u7sj,37037,37038,74075
40223,,url:http://www.csa.com/partners/viewrecord.php3frequester3dgs26collection3dtrd26recid3d0250656ci,37038,37039,74077
40224,,2dgc2z5xblwj,37039,37040,74079
40225,,uk_ecxw5j4wj,37040,37041,74081
40226,,vdiiqik-f6uj,37041,37042,74083
40227,,ue24twi-1wmj,37042,37043,74085
40228,,wsc-whj5py4j,37043,37044,74087
40229,,2tdmgcorixej,37044,37045,74089
40230,,sg2_lfhds3cj,37045,37046,74091
40231,,zy5rxeunnpkj,37046,37047,74093
40232,,z5nbebapaa8j,37047,37048,74095
40233,,url:http://portal.acm.org/ft_gateway.cfm3fid3d98453026type3dpdf26dl3dguide26dl3dacm26cfid3d1111111126cftoken3d2222222,37048,37049,74097
40234,,url:http://www.springerlink.com/index/j37h37477t333335.pdf,37049,37050,74099
40235,,ms-yg5hpdfkj,37050,37051,74101
40236,,1tpakjmmsrwj,37051,37052,74103
40237,,vfwvakxevl0j,37052,37053,74105
40238,,url:http://www.springerlink.com/index/ut66751872u203g0.pdf,37053,37054,74107
40239,,befvab2twhqj,37054,37055,74109
40240,,rpg83udhxkoj,37055,37056,74111
40241,,utxoxrgvgiuj,37056,37057,74113
40242,,url:http://portal.acm.org/ft_gateway.cfm3fid3d110121426type3dpdf,37057,37058,74115
40243,,ld-fchcnzuqj,37059,37060,74119
40244,,b20omyu0nfyj,37060,37061,74121
40245,,vn4voappdwyj,37061,37062,74123
40246,,k_svcm_n6nqj,37062,37063,74125
40247,,iylieubeyhwj,37063,37064,74127
40248,,3wpf6pfgudwj,37064,37065,74129
40249,,oebedpx7b9kj,37065,37066,74131
40250,,nwhrxbiu8qmj,37066,37067,74133
40251,,z0lle6fjwsmj,37067,37068,74135
40252,,mrwq9idcsm4j,37068,37069,74137
40253,,wio2pxrx3mij,37069,37070,74139
40254,,bk4up5onwu8j,37070,37071,74141
40255,,1sgr4qmscemj,37071,37072,74143
40256,,cdrw29kx4fij,37072,37073,74145
40257,,wylax6x3xhmj,37073,37074,74147
40258,,9rv5sccc__uj,37074,37075,74149
40259,,100pfcyhqigj,37075,37076,74151
40260,,12mqfumgbyyj,37076,37077,74153
40261,,seylqcn5bpgj,37077,37078,74155
40262,,6aj3zawdkygj,37078,37079,74157
40263,,acv0_tybvaaj,37079,37080,74159
40264,,r2gt4i2nsj0j,37080,37081,74161
40265,,url:http://www.springerlink.com/index/rl754360p552t76l.pdf,37081,37082,74163
40266,,qmrmn_ff5r4j,37083,37084,74167
40267,,zbxsamf4qy8j,37084,37085,74169
40268,,ia2aelgfb2oj,37085,37086,74171
40269,,vzfzfhow3rwj,37086,37087,74173
40270,,gyq5tkhw5cuj,37087,37088,74175
40271,,iawavdg4a3gj,37088,37089,74177
40272,,url:http://www.springerlink.com/index/77820u7x105l87g4.pdf,37089,37090,74179
40273,,1tmlx24gezwj,37090,37091,74181
40274,,rhoy5iohsjwj,37091,37092,74183
40275,,8ofwbn5stmsj,37092,37093,74185
40276,,og5f8rb6z3ej,37095,37096,74191
40277,,url:http://www.csa.com/partners/viewrecord.php3frequester3dgs26collection3dtrd26recid3d0879335ci,37096,37097,74193
40278,,ryzx99ep9raj,37097,37098,74195
40279,,pierhl-0ec4j,37098,37099,74197
40280,,0ytohf51qi8j,37099,37100,74199
40281,,fw_vddd_ikwj,37100,37101,74201
40282,,3dgczpyja_gj,37102,37103,74205
40283,,-7ikbmfrmrkj,37103,37104,74207
40284,,qm5freasfsuj,37104,37105,74209
40285,,w-6_y5sf1suj,37106,37107,74213
40286,,ctddbksvthyj,37107,37108,74215
40287,,ez0kgvqelesj,37108,37109,74217
40288,,zrqe5qx9jh0j,37109,37110,74219
40289,,0corb6rupw0j,37110,37111,74221
40290,,url:http://ieeexplore.ieee.org/iel1/2206/2685/00081883.pdf3farnumber3d81883,37111,37112,74223
40291,,i0wkc_no3akj,37112,37113,74225
40292,,qdqmb9tkhqaj,37113,37114,74227
40293,,y0wuvzqutbej,37114,37115,74229
40294,,0tukdzrziqqj,37115,37116,74231
40295,,mlfilgvrjx0j,37116,37117,74233
40296,,nhmkpk7la7uj,37117,37118,74235
40297,,7crzhn3fj0qj,37118,37119,74237
40298,,aiabzjduw5oj,37119,37120,74239
40299,,csefaal--rij,37120,37121,74241
40300,,url:http://portal.acm.org/ft_gateway.cfm3fid3d109962926type3dpdf,37121,37122,74243
40301,,ma5sxa8jub4j,37122,37123,74245
40302,,4wayls_1y6ij,37123,37124,74247
40303,,0jf0qh_qcgij,37124,37125,74249
40304,,friu_dzv95yj,37125,37126,74251
40305,,iqbufsnofbsj,37126,37127,74253
40306,,rljlqbvdn7aj,37127,37128,74255
40307,,qbvbvembf8uj,37128,37129,74257
40308,,0hqa98rop5cj,37129,37130,74259
40309,,oyy4qijdl4yj,37131,37132,74263
40310,,wcuinocujc4j,37132,37133,74265
40311,,lnp1rvszinej,37133,37134,74267
40312,,z_uwcwi-atgj,37134,37135,74269
40313,,dwoz9hpnrt4j,37135,37136,74271
40314,,xjcno8sejjqj,37136,37137,74273
40315,,url:http://www.springerlink.com/index/p13qgw28761t2060.pdf,37137,37138,74275
40316,,rikfx0skx6gj,37138,37139,74277
40317,,obpyy2ska8aj,37139,37140,74279
40318,,dai3rwkz3aij,37140,37141,74281
40319,,ru2l8lgn12cj,37141,37142,74283
40320,,byhlna5ybbwj,37142,37143,74285
40321,,bw70e09cvo8j,37143,37144,74287
40322,,lcxsm4acdmkj,37144,37145,74289
40323,,jftxbhgb0zej,37145,37146,74291
40324,,vqy3gypo-4wj,37146,37147,74293
40325,,ycwn_sn8m94j,37147,37148,74295
40326,,pmg7yod9ojaj,37148,37149,74297
40327,,izvcavqglm0j,37149,37150,74299
40328,,qx8k2b10r-gj,37150,37151,74301
40329,,rtywyrjbumej,37151,37152,74303
40330,,url:http://www.csa.com/partners/viewrecord.php3frequester3dgs26collection3dtrd26recid3dn9210484ah,37152,37153,74305
40331,,wmkznuih5a0j,37153,37154,74307
40332,,url:http://www.geography.org.uk/journals/journals.asp3farticleid3d10,37154,37155,74309
40333,,3xzoxvjt8jsj,37155,37156,74311
40334,,yy3av9cpcjwj,37156,37157,74313
40335,,xls_uumsg84j,37157,37158,74315
40336,,j5g6ukaymyaj,37158,37159,74317
40337,,iq_mbfjgh0kj,37159,37160,74319
40338,,xt7dv_athaej,37160,37161,74321
40339,,am7xs83hqiuj,37161,37162,74323
40340,,ioqpoq2msvqj,37162,37163,74325
40341,,7waf_qxnbpqj,37163,37164,74327
40342,,54ytpeslqkgj,37164,37165,74329
40343,,wyf3ehsufqgj,37165,37166,74331
40344,,8ualmnrheeyj,37166,37167,74333
40345,,ygoqbrkq5cgj,37167,37168,74335
40346,,bhzkryfupauj,37168,37169,74337
40347,,f8m4mu4nyz4j,37169,37170,74339
40348,,,37170,37171,74341
40349,,h0yozblymkuj,37171,37172,74343
40350,,tga6ekvb-iqj,37172,37173,74345
40351,,zxmmesrotf0j,37173,37174,74347
40352,,phoibf_rilaj,37174,37175,74349
40353,,dz-nrusgicoj,37175,37176,74351
40354,,wyzvvenmar0j,37176,37177,74353
40355,,olnfvec68psj,37177,37178,74355
40356,,irz0bjx-vaij,37178,37179,74357
40357,,rdduqvcmtyoj,37179,37180,74359
40358,,nqs9oxuzecej,37180,37181,74361
40359,,v0sqsy7eytgj,37181,37182,74363
40360,,7lzwg9sfjgij,37182,37183,74365
40361,,jwtmqnmefnuj,37183,37184,74367
40362,,zcefhybn-hyj,37184,37185,74369
40363,,rsledy5b4qmj,37185,37186,74371
40364,,pfhztou9dzsj,37186,37187,74373
40365,,fjskdretgxcj,37187,37188,74375
40366,,5uzho1mhjmej,37188,37189,74377
40367,,waprtci_acaj,37189,37190,74379
40368,,url:http://portal.acm.org/ft_gateway.cfm3fid3d109961926type3dpdf,37190,37191,74381
40369,,icyh5nnwx7aj,37191,37192,74383
40370,,h1vy63wvvsij,37192,37193,74385
40371,,byclbuqqcwcj,37193,37194,74387
40372,,oqyeufy2pbwj,37194,37195,74389
40373,,_4u8mzmydy4j,37196,37197,74393
40374,,a0p0ao13d-0j,37197,37198,74395
40375,,qa0wmcnlr3mj,37198,37199,74397
40376,,asbp_fje6x0j,37199,37200,74399
40377,,ssdqeoz4o44j,37200,37201,74401
40378,,znvsx6hygg4j,37201,37202,74403
40379,,vbdp5ajk0umj,37202,37203,74405
40380,,3wy8_ljylt0j,37203,37204,74407
40381,,0762aco9vtgj,37204,37205,74409
40382,,wl8-pjbfi_cj,37205,37206,74411
40383,,m08qlw9n1qoj,37206,37207,74413
40384,,zcaak0b2g9uj,37207,37208,74415
40385,,ltzwlnojavwj,37208,37209,74417
40386,,4ss84k8dtpcj,37209,37210,74419
40387,,e1atmeqbmccj,37210,37211,74421
40388,,prlawgdmk6kj,37211,37212,74423
40389,,cb2wdzxn-d8j,37212,37213,74425
40390,,4vjbdu-ofrcj,37213,37214,74427
40391,,efczbs13yhij,37214,37215,74429
40392,,elcvoen4fn0j,37215,37216,74431
40393,,zoyp4aygqbsj,37216,37217,74433
40394,,45fbwj-hqicj,37217,37218,74435
40395,,rikvmmia8e0j,37218,37219,74437
40396,,li_7t59sxi4j,37219,37220,74439
40397,,yqgp7fsb874j,37220,37221,74441
40398,,wfevzqabmbwj,37221,37222,74443
40399,,mz9rfleoirsj,37222,37223,74445
40400,,fy36f1pourej,37223,37224,74447
40401,,l3qwhdxf8rsj,37224,37225,74449
40402,,ry8yftwbvmej,37225,37226,74451
40403,,awhi2veg1noj,37226,37227,74453
40404,,664jmna6ekuj,37227,37228,74455
40405,,ls3b2fwi_jyj,37228,37229,74457
40406,,qkn6xl6dgckj,37229,37230,74459
40407,,m3ao2eagbhcj,37230,37231,74461
40408,,zuzxtkq34iej,37231,37232,74463
40409,,dwooadl5qykj,37232,37233,74465
40410,,zih7thtoetmj,37233,37234,74467
40411,,utxg-kmwnx0j,37234,37235,74469
40412,,gy449ropuqwj,37235,37236,74471
40413,,3ktvasn28noj,37236,37237,74473
40414,,edyrc2qrvsmj,37237,37238,74475
40415,,lu57fbiqnqqj,37238,37239,74477
40416,,hjiqnip-mgij,37239,37240,74479
40417,,6pah--3rhi0j,37240,37241,74481
40418,,txlts625isqj,37241,37242,74483
40419,,url:http://www.ingentaconnect.com/search/expand3fpub3dinfobike://els/08830355/2001/00000035/00000004/art0003526unc3d,37242,37243,74485
40420,,flb3hzht-ryj,37243,37244,74487
40421,,cycdesl6w3kj,37244,37245,74489
40422,,ykzzxa_8s8cj,37245,37246,74491
40423,,v24ryk38p9mj,37246,37247,74493
40424,,loxphnr8kg4j,37247,37248,74495
40425,,qmvmov7v96yj,37248,37249,74497
40426,,5al17rdqqgkj,37249,37250,74499
40427,,s1gcbh1pkicj,37250,37251,74501
40428,,gvroti4fkqwj,37251,37252,74503
40429,,mj5xfzb2rt8j,37252,37253,74505
40430,,gg0h1ocxzogj,37253,37254,74507
40431,,qhr0upslzsuj,37254,37255,74509
40432,,zhpo6fv5yc0j,37255,37256,74511
40433,,xfwpvwpanf8j,37256,37257,74513
40434,,mtkdm03u8vgj,37257,37258,74515
40435,,w3wkgk0-dp8j,37258,37259,74517
40436,,kikj9dgkjqgj,37259,37260,74519
40437,,hmk49svkmrej,37260,37261,74521
40438,,zkxzhrwwdn4j,37261,37262,74523
40439,,g6aowxu20kkj,37262,37263,74525
40440,,7lakg2cqcwgj,37263,37264,74527
40441,,5lp9ojmigguj,37265,37266,74531
40442,,uymvgv3dr1aj,37266,37267,74533
40443,,rt4wbioc2rej,37267,37268,74535
40444,,fhx-cooz2n0j,37268,37269,74537
40445,,ft3wfwcenmgj,37269,37270,74539
40446,,z95mbmpkj64j,37270,37271,74541
40447,,br4jmzwomuyj,37271,37272,74543
40448,,s37nwzvgpcmj,37272,37273,74545
40449,,6_xufqwsgb8j,37273,37274,74547
40450,,scmuaa4gnsmj,37274,37275,74549
40451,,oxdldeexmj0j,37275,37276,74551
40452,,gdoq7l19qh8j,37276,37277,74553
40453,,dobox3k1zryj,37277,37278,74555
40454,,v-scopfqtk8j,37278,37279,74557
40455,,q6k057kdh6cj,37279,37280,74559
40456,,wst60sxh0ccj,37280,37281,74561
40457,,uvbtmyv8x8kj,37281,37282,74563
40458,,k3fx2tcmx9aj,37283,37284,74567
40459,,i00lgxesagij,37284,37285,74569
40460,,3k4f1pdvdugj,37285,37286,74571
40461,,eethjsaqcycj,37286,37287,74573
40462,,4ymavlvi7faj,37287,37288,74575
40463,,rb-vrzhvpx8j,37288,37289,74577
40464,,te3mu7ttnquj,37289,37290,74579
40465,,5fw03imttpuj,37290,37291,74581
40466,,9fdqruod4amj,37291,37292,74583
40467,,qdlbwgirnvgj,37292,37293,74585
40468,,ro2tzuvctxej,37293,37294,74587
40469,,a0lvkdfyhmij,37294,37295,74589
40470,,vh3v0uq86ogj,37295,37296,74591
40471,,yzckrtd03dwj,37296,37297,74593
40472,,tt-7rpnjjjcj,37298,37299,74597
40473,,u7ulxce8knqj,37299,37300,74599
40474,,liawakbbeacj,37300,37301,74601
40475,,kwpvkwymk-ij,37301,37302,74603
40476,,7cvshwnqtmoj,37302,37303,74605
40477,,bsqajeobskij,37303,37304,74607
40478,,anyz3bj8xjoj,37304,37305,74609
40479,,ggsos49brzsj,37305,37306,74611
40480,,p-6-zhiz9dyj,37306,37307,74613
40481,,seggjbmgfqsj,37307,37308,74615
40482,,eqivieo2ne8j,37308,37309,74617
40483,,ilq_ehmhwmmj,37309,37310,74619
40484,,,37310,37311,74621
40485,,ytgdjenlja0j,37312,37313,74625
40486,,bxymcnpvjpqj,37313,37314,74627
40487,,bppxs-pmhv8j,37314,37315,74629
40488,,kcv6mg5sihej,37315,37316,74631
40489,,vs0ujbmikzgj,37316,37317,74633
40490,,6qe7xpbeaksj,37317,37318,74635
40491,,wxmco0p6nl0j,37318,37319,74637
40492,,mljvu-cdb4yj,37319,37320,74639
40493,,ktbrp8oopa8j,37320,37321,74641
40494,,pxx6z7nlhjaj,37321,37322,74643
40495,,ayeklo1q83wj,37322,37323,74645
40496,,v8ttmctefiqj,37323,37324,74647
40497,,l-wynmuh_lyj,37324,37325,74649
40498,,2tw4hil58goj,37325,37326,74651
40499,,cz-st0xvm0uj,37326,37327,74653
40500,,md2gljl2hxyj,37327,37328,74655
40501,,jfjr1sxi4eqj,37328,37329,74657
40502,,fbhet-4akgmj,37329,37330,74659
40503,,ejmelkq8onyj,37330,37331,74661
40504,,l_zxsydpgu8j,37331,37332,74663
40505,,zmweff8wb6kj,37332,37333,74665
40506,,1g0gvpunu-sj,37333,37334,74667
40507,,99r10ljb_baj,37334,37335,74669
40508,,jic8lsoqlboj,37335,37336,74671
40509,,evmdkcb-67kj,37336,37337,74673
40510,,aroiq_2neycj,37337,37338,74675
40511,,znwmw4ii7bij,37338,37339,74677
40512,,4n-s1zgd8fmj,37339,37340,74679
40513,,4ji-jdvyy4yj,37340,37341,74681
40514,,2cjnr7zmqocj,37341,37342,74683
40515,,tv9chtwnoeyj,37342,37343,74685
40516,,pet9jwgihvkj,37343,37344,74687
40517,,4xb2cxlv6ruj,37345,37346,74691
40518,,iifwdy26qguj,37346,37347,74693
40519,,jtsicqfi0qmj,37347,37348,74695
40520,,qkg8i5bgtvcj,37348,37349,74697
40521,,x02_xqk_fgmj,37349,37350,74699
40522,,zhjyb2-udbkj,37350,37351,74701
40523,,tdv4afwg3vyj,37351,37352,74703
40524,,y7cxoamfjoaj,37352,37353,74705
40525,,mvr3nhkcvfwj,37354,37355,74709
40526,,dmpikn9lciyj,37355,37356,74711
40527,,l6wspjnjao4j,37356,37357,74713
40528,,3jngz4sm9a8j,37357,37358,74715
40529,,xkykhzlbsscj,37358,37359,74717
40530,,kgl_hv2o2iyj,37359,37360,74719
40531,,dylaaanuohkj,37360,37361,74721
40532,,c4s9gazildwj,37361,37362,74723
40533,,ys0rltwdbrwj,37362,37363,74725
40534,,ob6mp-uwvvmj,37363,37364,74727
40535,,obohtaykhqij,37364,37365,74729
40536,,ohipucfjdxaj,37365,37366,74731
40537,,j3h5hc-53hij,37366,37367,74733
40538,,odbjoi1brv4j,37367,37368,74735
40539,,j6kblqimd9ej,37368,37369,74737
40540,,os4_l9vmxxqj,37369,37370,74739
40541,,nh6irofama8j,37370,37371,74741
40542,,url:http://www.geography.org.uk/journals/journals.asp3farticleid3d7,37371,37372,74743
40543,,pkgxc-nvz_8j,37372,37373,74745
40544,,a0xatpqfomsj,37373,37374,74747
40545,,sk7smlbnf0yj,37374,37375,74749
40546,,url:http://www.csa.com/partners/viewrecord.php3frequester3dgs26collection3dtrd26recid3dn9210398ah,37375,37376,74751
40547,,uun-ecx8bisj,37376,37377,74753
40548,,url:http://www.csa.com/partners/viewrecord.php3frequester3dgs26collection3dtrd26recid3dn9210510ah,37377,37378,74755
40549,,wlnxlwfrhy4j,37378,37379,74757
40550,,i2zgxbf_cgcj,37379,37380,74759
40551,,hse1kadzbmqj,37380,37381,74761
40552,,coubnkv6qemj,37381,37382,74763
40553,,_dpspmw0luwj,37383,37384,74767
40554,,h063fqnj3kqj,37384,37385,74769
40555,,jwl9zkwheoaj,37385,37386,74771
40556,,tmea42njrgqj,37386,37387,74773
40557,,moi9rowo9nqj,37387,37388,74775
40558,,nrotye0r-agj,37388,37389,74777
40559,,,37389,37390,74779
40560,,4xi3rvjl9uqj,37390,37391,74781
40561,,boctb-vz6jsj,37391,37392,74783
40562,,w_bgiobenowj,37392,37393,74785
40563,,ymzu_tyxk7gj,37393,37394,74787
40564,,jz7lkh_miaaj,37394,37395,74789
40565,,vcv6tg6f8uij,37395,37396,74791
40566,,171ajtsoxuaj,37396,37397,74793
40567,,ptddachkrtsj,37397,37398,74795
40568,,3bacp3ey8aij,37398,37399,74797
40569,,lf5zxw3picej,37399,37400,74799
40570,,pr3fuvhoj4aj,37400,37401,74801
40571,,url:http://www.ncbi.nlm.nih.gov/entrez/query.fcgi3fcmd3dretrieve26db3dpubmed26list_uids3d1610468326dopt3dcitation,37401,37402,74803
40572,,t3xhb1cuouqj,37402,37403,74805
40573,,46paacxev-ej,37403,37404,74807
40574,,umfl2udeyjcj,37405,37406,74811
40575,,phgeniy-trmj,37406,37407,74813
40576,,kjbqoid6jrsj,37407,37408,74815
40577,,k_24ah3jbosj,37408,37409,74817
40578,,url:http://doi.wiley.com/10.1002/ev.1476,37409,37410,74819
40579,,wzfzepxgwfij,37410,37411,74821
40580,,ckoxmufhsqaj,37411,37412,74823
40581,,biiwgfjnisoj,37412,37413,74825
40582,,h8-qn7g_w0gj,37413,37414,74827
40583,,istad_mjrhaj,37414,37415,74829
40584,,g3imjxppceoj,37415,37416,74831
40585,,sfzljqx_ppmj,37416,37417,74833
40586,,iqzzmpppekaj,37417,37418,74835
40587,,yg3m_axznxej,37418,37419,74837
40588,,url:http://www.csa.com/partners/viewrecord.php3frequester3dgs26collection3dtrd26recid3d0791278ci,37419,37420,74839
40589,,jxtnooqurvij,37420,37421,74841
40590,,,37421,37422,74843
40591,,olgvyevqecwj,37422,37423,74845
40592,,kh2ptu9malgj,37423,37424,74847
40593,,kg4gwvf3s1qj,37424,37425,74849
40594,,va4zeo_az44j,37426,37427,74853
40595,,ewghmhz9dtwj,37427,37428,74855
40596,,x1o8pu6h2qij,37428,37429,74857
40597,,62i9xi01u_8j,37429,37430,74859
40598,,spxepxfqfs8j,37430,37431,74861
40599,,2k9b6pgwbqij,37431,37432,74863
40600,,mnowj87clz8j,37433,37434,74867
40601,,yqony5gyfx8j,37434,37435,74869
40602,,uusn0erljeqj,37435,37436,74871
40603,,otpjaiorgxsj,37436,37437,74873
40604,,u8sbogdjpw0j,37437,37438,74875
40605,,toumgdmkbxgj,37438,37439,74877
40606,,vdn8bn3cuw8j,37439,37440,74879
40607,,ajb03z_ksfwj,37440,37441,74881
40608,,d0myalesxmuj,37441,37442,74883
40609,,aik49yzz3aoj,37442,37443,74885
40610,,qawz3ouc5pyj,37443,37444,74887
40611,,yxu7xnigenqj,37444,37445,74889
40612,,kb4khypv-v0j,37445,37446,74891
40613,,n6kynxkdfykj,37446,37447,74893
40614,,qvwdjwsy-faj,37447,37448,74895
40615,,vwnycpodb_wj,37448,37449,74897
40616,,jnjxe59zolaj,37449,37450,74899
40617,,tt5fmfgtcx4j,37450,37451,74901
40618,,url:http://www.csa.com/partners/viewrecord.php3frequester3dgs26collection3dtrd26recid3dn9210417ah,37451,37452,74903
40619,,lzjnqp5fonaj,37452,37453,74905
40620,,rwqbcqq8t-4j,37453,37454,74907
40621,,ejq4ojw7ugej,37454,37455,74909
40622,,fwycwb3aao4j,37455,37456,74911
40623,,ngdj6abrgeuj,37457,37458,74915
40624,,mmoibxqck_mj,37458,37459,74917
40625,,svcwgtzvknsj,37459,37460,74919
40626,,bq1iwe14ohqj,37460,37461,74921
40627,,url:http://portal.acm.org/ft_gateway.cfm3fid3d110122926type3dpdf,37461,37462,74923
40628,,ijwehmf6ao8j,37462,37463,74925
40629,,6708xyuwgigj,37463,37464,74927
40630,,qjva3wpasugj,37464,37465,74929
40631,,5ybi8vnb_aij,37465,37466,74931
40632,,sx-gm3rgwhkj,37466,37467,74933
40633,,tkekh9zwdw0j,37467,37468,74935
40634,,gqdllq0gszaj,37468,37469,74937
40635,,loehpyte2boj,37469,37470,74939
40636,,lwapspshvloj,37470,37471,74941
40637,,py5otnocc8cj,37471,37472,74943
40638,,eputxehwdauj,37472,37473,74945
40639,,url:http://portal.acm.org/ft_gateway.cfm3fid3d109958026type3dpdf,37473,37474,74947
40640,,eynrthdtbpcj,37474,37475,74949
40641,,kimcgcwratgj,37475,37476,74951
40642,,kmtet1fgn8sj,37476,37477,74953
40643,,sxao0ycmrtaj,37477,37478,74955
40644,,ggdq2hkf0oqj,37478,37479,74957
40645,,url:http://portal.acm.org/citation.cfm3fid3d17003526dl3dguide26dl3dguide26type3dproceeding26idx3d17003526part3dproceedings26wanttype3dproceedings26title3dinternational2520conference2520on2520management2520of2520data2520and2520symposium2520on2520principles2520of2520database2520systems26cfid3d1111111126cftoken3d2222222,37479,37480,74959
40646,,w-zq1aytt9kj,37480,37481,74961
40647,,url:http://portal.acm.org/citation.cfm3fid3d582353.58235826dl3dguide26dl3dacm26type3dseries26idx3dseries47326part3dproceedings26wanttype3dproceedings26title3dinternational2520conference2520on2520management2520of2520data2520and2520symposium2520on2520principles2520of2520database2520systems26cfid3d1111111126cftoken3d2222222,37481,37482,74963
40648,,yragvvtfwhaj,37482,37483,74965
40649,,url:http://portal.acm.org/citation.cfm3fid3d5020226dl3dguide26dl3dguide26type3dproceeding26idx3d5020226part3dproceedings26wanttype3dproceedings26title3dinternational2520conference2520on2520management2520of2520data26cfid3d1111111126cftoken3d2222222,37483,37484,74967
40650,,n4-jcj85-rmj,37484,37485,74969
40651,,url:http://portal.acm.org/citation.cfm3fid3d582353.58239326dl3dguide26dl3dacm26type3dseries26idx3dseries47326part3dproceedings26wanttype3dproceedings26title3dinternational2520conference2520on2520management2520of2520data2520and2520symposium2520on2520principles2520of2520database2520systems26cfid3d1111111126cftoken3d2222222,37485,37486,74971
40652,,urteaexg15ej,37486,37487,74973
40653,,dqyw5jhvoauj,37487,37488,74975
40654,,url:http://portal.acm.org/citation.cfm3fid3d1689426dl3dguide26dl3dguide26type3dproceeding26idx3d1689426part3dproceedings26wanttype3dproceedings26title3dinternational2520conference2520on2520management2520of2520data2520and2520symposium2520on2520principles2520of2520database2520systems26cfid3d1111111126cftoken3d2222222,37488,37489,74977
40655,,dizdldhjncej,37489,37490,74979
40656,,xsxt8vtsdzoj,37490,37491,74981
40657,,hknlimkinsuj,37491,37492,74983
40658,,pzhesry84fqj,37492,37493,74985
40659,,zru-br836soj,37493,37494,74987
40660,,9wngw1hlqbkj,37494,37495,74989
40661,,yfqh5xs5xwkj,37495,37496,74991
40662,,9zjmtqiweuaj,37496,37497,74993
40663,,exsmvyj5j7yj,37497,37498,74995
40664,,esn2phrqaxkj,37498,37499,74997
40665,,sg2weyn34w4j,37499,37500,74999
40666,,7j97fowbmn0j,37500,37501,75001
40667,,z72iwttij8sj,37501,37502,75003
40668,,url:http://portal.acm.org/citation.cfm3fid3d984392,37502,37503,75005
40669,,1lfkwyyxzvej,37503,37504,75007
40670,,url:http://www.csa.com/partners/viewrecord.php3frequester3dgs26collection3dtrd26recid3d1611658so,37504,37505,75009
40671,,kudk1cdymhqj,37505,37506,75011
40672,,url:http://www.csa.com/partners/viewrecord.php3frequester3dgs26collection3dtrd26recid3dn9210515ah,37506,37507,75013
40673,,d6e-9r3lhxuj,37507,37508,75015
40674,,j9am7gsxp4ij,37508,37509,75017
40675,,url:http://www.csa.com/partners/viewrecord.php3frequester3dgs26collection3dtrd26recid3dn9210392ah,37509,37510,75019
40676,,omnrftlvltaj,37510,37511,75021
40677,,thiyx7u9vtuj,37511,37512,75023
40678,,oeywsxd3clij,37512,37513,75025
40679,,t4s4oq3ev00j,37513,37514,75027
40680,,igbgxtjmpfij,37514,37515,75029
40681,,eiuow5hjixmj,37515,37516,75031
40682,,rspmu6wtybmj,37516,37517,75033
40683,,0c5th_b-g4qj,37517,37518,75035
40684,,vrtdlnijnqoj,37518,37519,75037
40685,,94mo-renbtaj,37519,37520,75039
40686,,lcxfjyjcc3wj,37520,37521,75041
40687,,se3uixcryayj,37521,37522,75043
40688,,4bf1bkouunaj,37522,37523,75045
40689,,ymbtwfyecc4j,37523,37524,75047
40690,,al1psokgyu8j,37524,37525,75049
40691,,vqmdtj6ajbsj,37525,37526,75051
40692,,j9a176pc6bgj,37526,37527,75053
40693,,,37527,37528,75055
40694,,_htfkl5dnhgj,37528,37529,75057
40695,,9sbezfhlsooj,37529,37530,75059
40696,,url:http://portal.acm.org/ft_gateway.cfm3fid3d110750726type3dpdf,37530,37531,75061
40697,,umfzjix2sngj,37531,37532,75063
40698,,kzh_qgzhobyj,37532,37533,75065
40699,,c6eoml0zulsj,37533,37534,75067
40700,,o44o74jovvuj,37535,37536,75071
40701,,url:http://portal.acm.org/citation.cfm3fid3d1073204.1073300,37536,37537,75073
40702,,6rutv7ct0baj,37537,37538,75075
40703,,znget_nu6lsj,37538,37539,75077
40704,,xhyrandyc3ij,37539,37540,75079
40705,,9ix-gxrkyucj,37540,37541,75081
40706,,twij4zubgj8j,37541,37542,75083
40707,,m4jbpwiffl4j,37542,37543,75085
40708,,url:http://doi.wiley.com/10.1002/ace.85,37543,37544,75087
40709,,4gvshuhkwp0j,37544,37545,75089
40710,,4hpcn-tkgz0j,37545,37546,75091
40711,,_n1bqelfuk0j,37546,37547,75093
40712,,cr-yiv77-hkj,37547,37548,75095
40713,,e7_p4qbjdbcj,37548,37549,75097
40714,,3zxfownbojej,37549,37550,75099
40715,,3fu4x29khwuj,37550,37551,75101
40716,,ldiseoi15lqj,37551,37552,75103
40717,,uv8ukrqpg1oj,37552,37553,75105
40718,,xxweiilofvuj,37553,37554,75107
40719,,5zkowdj-dhkj,37554,37555,75109
40720,,5awqcpwfbrcj,37555,37556,75111
40721,,url:http://portal.acm.org/ft_gateway.cfm3fid3d35321226type3dpdf26dl3dportal26dl3dacm26cfid3d1111111126cftoken3d2222222,37556,37557,75113
40722,,avv-1wzxn0cj,37557,37558,75115
40723,,k1-falvoy2cj,37558,37559,75117
40724,,japzazeefukj,37559,37560,75119
40725,,zxfydvzulx8j,37560,37561,75121
40726,,obisnxtv_kmj,37561,37562,75123
40727,,s0cupw3gymsj,37562,37563,75125
40728,,vf-kpoq9tdij,37563,37564,75127
40729,,r-elbrloxdkj,37564,37565,75129
40730,,g-isjxebbouj,37565,37566,75131
40731,,tyuygx3als4j,37566,37567,75133
40732,,nazozwlow5uj,37567,37568,75135
40733,,ceuejdhlo6uj,37568,37569,75137
40734,,1tpih8ishrej,37569,37570,75139
40735,,2ebmcirmimsj,37570,37571,75141
40736,,7pef2k_hy5oj,37571,37572,75143
40737,,url:http://www.springerlink.com/index/y96q2b3w63hu36ny.pdf,37572,37573,75145
40738,,fvcsnthvbeaj,37573,37574,75147
40739,,frsnntpwqv8j,37574,37575,75149
40740,,iivlnw9-npwj,37575,37576,75151
40741,,qhdu-acurpcj,37576,37577,75153
40742,,cwzozjuz0i8j,37577,37578,75155
40743,,url:http://portal.acm.org/ft_gateway.cfm3fid3d110121226type3dpdf,37578,37579,75157
40744,,da9xiau1izaj,37579,37580,75159
40745,,x5jemyauzwgj,37580,37581,75161
40746,,spt-kfetheqj,37581,37582,75163
40747,,grlh3aenrzoj,37582,37583,75165
40748,,ox115mhmxgkj,37583,37584,75167
40749,,ws1tz-pdljkj,37584,37585,75169
40750,,nvo41rzzzzcj,37585,37586,75171
40751,,y3zbs4_uknoj,37586,37587,75173
40752,,rq3kcbz3llkj,37587,37588,75175
40753,,wuldysdo_fqj,37588,37589,75177
40754,,ftgacfzsceej,37589,37590,75179
40755,,qjpel7spsq4j,37590,37591,75181
40756,,werzftfzofgj,37591,37592,75183
40757,,4iq1ixm7gqcj,37592,37593,75185
40758,,dobhbcaeyzej,37593,37594,75187
40759,,drzjifsvb0yj,37594,37595,75189
40760,,sxu1dfpobvej,37595,37596,75191
40761,,gq-pe6kwicsj,37596,37597,75193
40762,,vqatsr6hqxkj,37598,37599,75197
40763,,9uw98trqfsqj,37599,37600,75199
40764,,trjfpemrtyqj,37601,37602,75203
40765,,rv3yym2s9q0j,37602,37603,75205
40766,,ht64d4ewpagj,37603,37604,75207
40767,,url:http://portal.acm.org/ft_gateway.cfm3fid3d110120726type3dpdf,37604,37605,75209
40768,,0ilhy66wftuj,37605,37606,75211
40769,,uui1hvl0znsj,37606,37607,75213
40770,,ss0rzgqpx04j,37607,37608,75215
40771,,3bbftjvsieij,37608,37609,75217
40772,,35q21anzbeoj,37609,37610,75219
40773,,8jbgyqvx_wcj,37610,37611,75221
40774,,pjfaoxjz3vej,37611,37612,75223
40775,,cmafjgjowu8j,37612,37613,75225
40776,,url:http://www.ingentaconnect.com/content/els/08830355/2001/00000035/00000002/art00017,37613,37614,75227
40777,,l3x_nyilmgoj,37614,37615,75229
40778,,jlayugjbyluj,37615,37616,75231
40779,,1cnxem4bcssj,37616,37617,75233
40780,,ubfvqfsssqyj,37617,37618,75235
40781,,bchvluef_q8j,37618,37619,75237
40782,,clu4bwdixmsj,37619,37620,75239
40783,,o1v7_xwoh1kj,37621,37622,75243
40784,,bk8wq3h6zo0j,37622,37623,75245
40785,,xoaeyear-yaj,37623,37624,75247
40786,,caucdhwrrmij,37624,37625,75249
40787,,3fag9muyn68j,37625,37626,75251
40788,,ofxauhs-0dgj,37626,37627,75253
40789,,reg6f-br_fqj,37627,37628,75255
40790,,qetiaopls1ij,37628,37629,75257
40791,,ty2ffmkajswj,37629,37630,75259
40792,,32tbaxbbthqj,37630,37631,75261
40793,,zoxmm5zzc04j,37631,37632,75263
40794,,url:http://doi.wiley.com/10.1002/he.9806,37632,37633,75265
40795,,qdbbt3zu2a8j,37633,37634,75267
40796,,sgyrtvja6fsj,37634,37635,75269
40797,,vyua4ff1mh4j,37635,37636,75271
40798,,rbst5ncwhsqj,37636,37637,75273
40799,,ylah1vd1fksj,37637,37638,75275
40800,,hgpfbetfuvqj,37638,37639,75277
40801,,lospslics7mj,37640,37641,75281
40802,,6l7t1l9aomqj,37641,37642,75283
40803,,wu0var7zlkej,37642,37643,75285
40804,,76idckfrotwj,37643,37644,75287
40805,,myrpuviwaaqj,37644,37645,75289
40806,,tm8qhi512zwj,37645,37646,75291
40807,,xeifxke3vm8j,37646,37647,75293
40808,,40m6vt-s33aj,37647,37648,75295
40809,,rt3nryf7unaj,37648,37649,75297
40810,,cjvzzao1jgkj,37649,37650,75299
40811,,3qe91fezr9sj,37650,37651,75301
40812,,u7mx0347zcaj,37651,37652,75303
40813,,qlrcutgzgrmj,37652,37653,75305
40814,,n0q3jafl1bej,37653,37654,75307
40815,,eu5d5dgpeagj,37654,37655,75309
40816,,p2qpravg-s4j,37655,37656,75311
40817,,irarfqv5up8j,37656,37657,75313
40818,,kskna04u11ej,37657,37658,75315
40819,,sqp92uimx3gj,37658,37659,75317
40820,,jukbwdantqej,37659,37660,75319
40821,,p5diiwqbafej,37660,37661,75321
40822,,url:http://portal.acm.org/ft_gateway.cfm3fid3d108629226type3dpdf,37661,37662,75323
40823,,iqs_aktlpoij,37662,37663,75325
40824,,0losbv0o7uwj,37663,37664,75327
40825,,url:http://portal.acm.org/ft_gateway.cfm3fid3d110194926type3dpdf,37664,37665,75329
40826,,yn4hrxncgvyj,37665,37666,75331
40827,,sl1qwnhln14j,37666,37667,75333
40828,,p279iur7e3wj,37667,37668,75335
40829,,ngbqsl18mosj,37668,37669,75337
40830,,ryrz5njevxaj,37669,37670,75339
40831,,xr6w2wp0u18j,37670,37671,75341
40832,,8yueubzx_cej,37671,37672,75343
40833,,zjlytxn3fecj,37672,37673,75345
40834,,t_pdgscdvi0j,37673,37674,75347
40835,,nje4kv-m3cej,37674,37675,75349
40836,,b6yvdp4pafgj,37675,37676,75351
40837,,gc32fajxs5aj,37676,37677,75353
40838,,hqo7c5e4bqwj,37677,37678,75355
40839,,oeyl3izeoaoj,37678,37679,75357
40840,,itlrwrchsm0j,37679,37680,75359
40841,,l1phqr9u06ej,37680,37681,75361
40842,,f-bfm88f6iej,37681,37682,75363
40843,,tr6qs6qwcwej,37682,37683,75365
40844,,smacmpakfjoj,37683,37684,75367
40845,,azwghb9q6ugj,37684,37685,75369
40846,,t9lqranj9jmj,37685,37686,75371
40847,,uknrl8fhts8j,37686,37687,75373
40848,,brftdqe9i9ij,37687,37688,75375
40849,,url:http://portal.acm.org/ft_gateway.cfm3fid3d95713826type3dpdf26dl3dguide26dl3dacm26cfid3d1111111126cftoken3d2222222,37688,37689,75377
40850,,ceoiyg3ba-4j,37689,37690,75379
40851,,tnvkp-4ms_sj,37690,37691,75381
40852,,49e1fevoqb8j,37691,37692,75383
40853,,fyp9xbqrzjyj,37692,37693,75385
40854,,qnbqswz4ezyj,37693,37694,75387
40855,,rqs9afjfblsj,37695,37696,75391
40856,,8tdtfm-rgnij,37696,37697,75393
40857,,lqftpkfqev0j,37697,37698,75395
40858,,mpvuukyjxooj,37698,37699,75397
40859,,rfi8az4xq4sj,37699,37700,75399
40860,,yxqd3urood8j,37700,37701,75401
40861,,eoobhtvhdlaj,37701,37702,75403
40862,,8iih0kkh47cj,37702,37703,75405
40863,,590ffo6qs-uj,37703,37704,75407
40864,,tbngmneugauj,37704,37705,75409
40865,,ujcme7yfulyj,37705,37706,75411
40866,,ltvqkcxkpm8j,37706,37707,75413
40867,,digrpvpin28j,37707,37708,75415
40868,,s5b5mtmcwrij,37708,37709,75417
40869,,rzs5taonhcij,37709,37710,75419
40870,,svakfuymbayj,37710,37711,75421
40871,,ho_md2hwhvwj,37711,37712,75423
40872,,exum6eh6gbij,37712,37713,75425
40873,,fsusuilokruj,37713,37714,75427
40874,,ns0lw4chgsmj,37714,37715,75429
40875,,rfviho1y8yij,37715,37716,75431
40876,,uzidnemadr0j,37716,37717,75433
40877,,jdfve4hyaeyj,37717,37718,75435
40878,,qgt7qverfv4j,37719,37720,75439
40879,,1pywhoymqagj,37720,37721,75441
40880,,jyhyv_cegiij,37721,37722,75443
40881,,ae-y0licgtkj,37722,37723,75445
40882,,ob1ygewfcnmj,37723,37724,75447
40883,,gxq0xdvzmcmj,37724,37725,75449
40884,,54j8karfqokj,37725,37726,75451
40885,,nzh8giwrpa0j,37726,37727,75453
40886,,kqfbdkva2pej,37727,37728,75455
40887,,vrf1chv0hoij,37728,37729,75457
40888,,,37729,37730,75459
40889,,gk6nu5grjy8j,37730,37731,75461
40890,,ypm1nyoefjmj,37731,37732,75463
40891,,_02j4z65ijqj,37732,37733,75465
40892,,9_ccll-9dlcj,37733,37734,75467
40893,,yjfwtiadx0oj,37734,37735,75469
40894,,leqfdyaj-94j,37735,37736,75471
40895,,hp_e9j_t3uej,37736,37737,75473
40896,,url:http://www.springerlink.com/index/j54183r57106852k.pdf,37737,37738,75475
40897,,6s7zi16ntnwj,37738,37739,75477
40898,,pu0pidh33daj,37739,37740,75479
40899,,df1xrtdooiaj,37740,37741,75481
40900,,80gly_gbghej,37741,37742,75483
40901,,url:http://portal.acm.org/ft_gateway.cfm3fid3d109957726type3dpdf,37742,37743,75485
40902,,9mkfatnhk-gj,37743,37744,75487
40903,,qmqvip8l7w8j,37744,37745,75489
40904,,lijye8v-mm0j,37745,37746,75491
40905,,fvfyicywjloj,37746,37747,75493
40906,,t73xvjwzx2oj,37747,37748,75495
40907,,smqzgeicnr8j,37748,37749,75497
40908,,ydyarf4ezomj,37749,37750,75499
40909,,g_ip0gagfr0j,37750,37751,75501
40910,,qjem-syil2gj,37751,37752,75503
40911,,url:http://portal.acm.org/citation.cfm3fid3d233013.233054,37752,37753,75505
40912,,myvw9qtoinoj,37753,37754,75507
40913,,_cc9he1wkbij,37754,37755,75509
40914,,dnmqdzusdgej,37755,37756,75511
40915,,9n6hk1a0b1oj,37756,37757,75513
40916,,_sbapssupl8j,37757,37758,75515
40917,,url:http://www.ingentaconnect.com/content/els/09505849/1996/00000038/00000002/art01050,37758,37759,75517
40918,,fmzmmpuohoyj,37759,37760,75519
40919,,onisy6bp-c8j,37760,37761,75521
40920,,8lxal3mv2hyj,37761,37762,75523
40921,,vl247mu2uquj,37762,37763,75525
40922,,1xbd4sssjjuj,37763,37764,75527
40923,,dtycolo7ux4j,37764,37765,75529
40924,,1np1ijghovgj,37765,37766,75531
40925,,peojocau-goj,37766,37767,75533
40926,,yduk7ms0zauj,37767,37768,75535
40927,,yx5cbgejyj4j,37768,37769,75537
40928,,00rfk-_f61mj,37769,37770,75539
40929,,c1umecz_3qwj,37771,37772,75543
40930,,v8l93qhwmoqj,37772,37773,75545
40931,,dlsoji25xsaj,37773,37774,75547
40932,,b8xttfwrohij,37774,37775,75549
40933,,3xb-lrde7zmj,37775,37776,75551
40934,,h-fw-k-0wvsj,37776,37777,75553
40935,,ysv4pj6czgwj,37777,37778,75555
40936,,56vuiaqiopej,37778,37779,75557
40937,,url:http://www.ingentaconnect.com/content/els/09505849/1999/00000041/00000007/art00012,37779,37780,75559
40938,,fm43pcxcu2kj,37781,37782,75563
40939,,zr3gcwmpqwij,37782,37783,75565
40940,,glhksynpjtyj,37783,37784,75567
40941,,trdqul1sie4j,37784,37785,75569
40942,,maxttez_p4ej,37785,37786,75571
40943,,bjcqhvppy3oj,37786,37787,75573
40944,,8m3v0fyhjhwj,37787,37788,75575
40945,,mk1edda_sn0j,37788,37789,75577
40946,,bvd0ee0p1tqj,37789,37790,75579
40947,,u475eeewkfqj,37790,37791,75581
40948,,ll5ylodrfwyj,37791,37792,75583
40949,,lxbsgkpnisuj,37792,37793,75585
40950,,cwml7txrq44j,37793,37794,75587
40951,,url:http://portal.acm.org/citation.cfm3fid3d171926.171976,37794,37795,75589
40952,,2prxsvt3w-qj,37795,37796,75591
40953,,9x3jwybsrbwj,37796,37797,75593
40954,,5yojpuxqmx8j,37797,37798,75595
40955,,vwpduheimhgj,37798,37799,75597
40956,,bcfdf9-m494j,37799,37800,75599
40957,,pmpshuchntoj,37800,37801,75601
40958,,x_fbiczkragj,37801,37802,75603
40959,,ljhrrod-db0j,37802,37803,75605
40960,,lk-dueikdgsj,37803,37804,75607
40961,,4b-3uxribakj,37804,37805,75609
40962,,zwcxkkw07pgj,37805,37806,75611
40963,,qk61dduq-dwj,37806,37807,75613
40964,,onpupsuqassj,37807,37808,75615
40965,,url:http://www.csa.com/partners/viewrecord.php3frequester3dgs26collection3dtrd26recid3da8622987ah,37808,37809,75617
40966,,heemq37_mpcj,37809,37810,75619
40967,,lrtzqx-mzicj,37811,37812,75623
40968,,4xbmnnjmhtkj,37812,37813,75625
40969,,pfhrd6kap6gj,37813,37814,75627
40970,,,37814,37815,75629
40971,,57n4_du4t2qj,37815,37816,75631
40972,,ifxrd9a6syqj,37816,37817,75633
40973,,wnaejnndj6qj,37817,37818,75635
40974,,ecrspubbaiej,37818,37819,75637
40975,,of4l0pcbxjcj,37819,37820,75639
40976,,url:http://portal.acm.org/ft_gateway.cfm3fid3d110123026type3dpdf,37820,37821,75641
40977,,t4p7tzuwdx4j,37821,37822,75643
40978,,vukkfb7zks8j,37822,37823,75645
40979,,myoyc0fgmvqj,37823,37824,75647
40980,,wxmxuq3mui8j,37824,37825,75649
40981,,qljhg6rz2t0j,37825,37826,75651
40982,,2v4vyd5iltaj,37826,37827,75653
40983,,-0mjbvezt_wj,37827,37828,75655
40984,,lvnugtotndoj,37828,37829,75657
40985,,lknsirn3wlyj,37829,37830,75659
40986,,2yrd4ewi-jyj,37830,37831,75661
40987,,xbmulzoyzzuj,37831,37832,75663
40988,,yzzbsiarvsmj,37833,37834,75667
40989,,qn2sqe7n_a8j,37834,37835,75669
40990,,hlevymtlo4uj,37835,37836,75671
40991,,ckisbmtemm0j,37836,37837,75673
40992,,cgzuhkk-sa4j,37837,37838,75675
40993,,ykwcbq5igumj,37838,37839,75677
40994,,1rggnomvjukj,37839,37840,75679
40995,,3_dhbrqsctgj,37840,37841,75681
40996,,hondwkcrewcj,37841,37842,75683
40997,,cnd06laxg4wj,37842,37843,75685
40998,,7dfulf0dyq4j,37843,37844,75687
40999,,u2csskxthg4j,37844,37845,75689
41000,,9f9fijs0qdoj,37845,37846,75691
41001,,ukxkuwe3kigj,37846,37847,75693
41002,,ptg__3xt_7cj,37847,37848,75695
41003,,rwg8wf1idpoj,37848,37849,75697
41004,,qa4uurx5u74j,37849,37850,75699
41005,,lriswgnjntij,37850,37851,75701
41006,,fcqz3w3pvbmj,37851,37852,75703
41007,,kgxqgmul738j,37852,37853,75705
41008,,fjgqsdbgcx0j,37853,37854,75707
41009,,grojrztwjs4j,37854,37855,75709
41010,,pkpkhthhjrej,37855,37856,75711
41011,,jq7r6bado4cj,37856,37857,75713
41012,,bao8keberbwj,37857,37858,75715
41013,,_v9xj8g_r-0j,37858,37859,75717
41014,,b7polz5jk90j,37859,37860,75719
41015,,ei1c30ai60sj,37860,37861,75721
41016,,5g44lshucdcj,37861,37862,75723
41017,,uuhaarzorpkj,37862,37863,75725
41018,,xhtegsh9p3mj,37863,37864,75727
41019,,3zooesn5g00j,37864,37865,75729
41020,,exceb1smqe4j,37865,37866,75731
41021,,ndi4o0kajm0j,37866,37867,75733
41022,,ahgutqrzomaj,37867,37868,75735
41023,,co1ehwzjta0j,37868,37869,75737
41024,,krs39ezvouqj,37869,37870,75739
41025,,yog4wrrawkkj,37871,37872,75743
41026,,2cvkpinvzusj,37872,37873,75745
41027,,cmtkrre3m2ij,37873,37874,75747
41028,,url:http://www.springerlink.com/index/g72653p706gk5557.pdf,37874,37875,75749
41029,,ipcihissoouj,37875,37876,75751
41030,,_6hdrqhhsv0j,37876,37877,75753
41031,,casx2njlbdij,37877,37878,75755
41032,,,37878,37879,75757
41033,,dhtvw7s5smmj,37879,37880,75759
41034,,ww3mp4nbmbqj,37880,37881,75761
41035,,aetpv37ana0j,37881,37882,75763
41036,,mzoqzmznrwaj,37882,37883,75765
41037,,b4pumlylc7oj,37883,37884,75767
41038,,nt8r8vhi5ywj,37884,37885,75769
41039,,lwkkzfi_mpuj,37885,37886,75771
41040,,cppvsrz-7xcj,37886,37887,75773
41041,,nqoapgnjbdej,37888,37889,75777
41042,,93i5xtpt6j4j,37889,37890,75779
41043,,tgdrf1ubid0j,37890,37891,75781
41044,,snp7robn0xmj,37892,37893,75785
41045,,1puqnue1shcj,37893,37894,75787
41046,,7eph6qgt-6gj,37894,37895,75789
41047,,nt6xgwotgbqj,37895,37896,75791
41048,,7fpxyof3poej,37896,37897,75793
41049,,ty9r2qeyjkwj,37897,37898,75795
41050,,,37898,37899,75797
41051,,i2xtw1ipeaij,37899,37900,75799
41052,,zhvz3f23su4j,37900,37901,75801
41053,,c0zlqkt6jnsj,37901,37902,75803
41054,,lmspuwrzahyj,37902,37903,75805
41055,,yi3kwyogx-wj,37903,37904,75807
41056,,scgbzxfyiomj,37904,37905,75809
41057,,95xzkm2ht54j,37905,37906,75811
41058,,j_c9sv2qhooj,37906,37907,75813
41059,,jagthmyxxzoj,37907,37908,75815
41060,,url:http://www.springerlink.com/index/cwancl0vwn1mkl0m.pdf,37908,37909,75817
41061,,xnevejqob8gj,37909,37910,75819
41062,,ldv4my6gwjqj,37910,37911,75821
41063,,owsdpojisj8j,37912,37913,75825
41064,,7povnz32rc4j,37913,37914,75827
41065,,url:http://www.csa.com/partners/viewrecord.php3frequester3dgs26collection3denv26recid3d3936356,37914,37915,75829
41066,,jmmkn8g36lej,37915,37916,75831
41067,,q_xa40bc5mij,37916,37917,75833
41068,,url:http://www.csa.com/partners/viewrecord.php3frequester3dgs26collection3denv26recid3d7711941,37917,37918,75835
41069,,u7d1djm_fiwj,37918,37919,75837
41070,,muywfdyqdhoj,37919,37920,75839
41071,,iuy3ggxr1akj,37920,37921,75841
41072,,j8j8ehiqmbmj,37921,37922,75843
41073,,k6eu4iwee2sj,37922,37923,75845
41074,,5iysd_s1rhkj,37923,37924,75847
41075,,xi5qdrht0eaj,37924,37925,75849
41076,,2fqmfpmlmowj,37925,37926,75851
41077,,or0k16685qmj,37926,37927,75853
41078,,jrzydc75o68j,37927,37928,75855
41079,,jxxjb08qstsj,37928,37929,75857
41080,,xg4mykwafpoj,37929,37930,75859
41081,,8evxgvablzij,37930,37931,75861
41082,,i-q_xtogkqoj,37931,37932,75863
41083,,hykgr0lvmtyj,37933,37934,75867
41084,,url:http://portal.acm.org/ft_gateway.cfm3fid3d105348226type3dpdf,37934,37935,75869
41085,,txprjky_-90j,37935,37936,75871
41086,,letueshtivcj,37936,37937,75873
41087,,7caa45tlpr0j,37937,37938,75875
41088,,ztmywqhvussj,37938,37939,75877
41089,,rt68wm6j4m8j,37939,37940,75879
41090,,mut_nlwd8igj,37940,37941,75881
41091,,3tillfpjos0j,37941,37942,75883
41092,,anamxss-xs4j,37942,37943,75885
41093,,9dykafck0maj,37943,37944,75887
41094,,1u1sw9no0s0j,37944,37945,75889
41095,,dc6epiwmqqqj,37945,37946,75891
41096,,seaehxu4nmaj,37946,37947,75893
41097,,xc71kldvjpyj,37947,37948,75895
41098,,9drealwdseij,37948,37949,75897
41099,,a30ybz7x5igj,37949,37950,75899
41100,,url:http://www.csa.com/partners/viewrecord.php3frequester3dgs26collection3dtrd26recid3d1107238ci,37950,37951,75901
41101,,eyfvwdqut-uj,37951,37952,75903
41102,,yamqgczwjcsj,37953,37954,75907
41103,,ws4va2j2mwsj,37954,37955,75909
41104,,jt11ofwjwf4j,37955,37956,75911
41105,,jdakjepmyiaj,37956,37957,75913
41106,,d36kzbbqcduj,37957,37958,75915
41107,,jghtb_0tq98j,37958,37959,75917
41108,,ygz8blxbppcj,37959,37960,75919
41109,,url:http://portal.acm.org/citation.cfm3fid3d354393,37960,37961,75921
41110,,wbnvzsa4kmwj,37961,37962,75923
41111,,url:http://www.csa.com/partners/viewrecord.php3frequester3dgs26collection3dtrd26recid3dn9210460ah,37962,37963,75925
41112,,kygak17l3ccj,37963,37964,75927
41113,,lpeuszu0izmj,37964,37965,75929
41114,,h4suceswdj0j,37965,37966,75931
41115,,_wmpyk2c4esj,37966,37967,75933
41116,,s-pa7wyg6kcj,37967,37968,75935
41117,,url:http://portal.acm.org/citation.cfm3fid3d74120.7412526dl3dguide26dl3dacm26idx3dj68926part3dperiodical26wanttype3dperiodical26title3dacm2520sigmod2520record26cfid3d1111111126cftoken3d2222222,37968,37969,75937
41118,,crjzeeya3fmj,37969,37970,75939
41119,,u1w_pdrq1vuj,37970,37971,75941
41120,,x4qaymt3jzej,37971,37972,75943
41121,,23qa1gaub3aj,37972,37973,75945
41122,,hmmrlmhfdfqj,37973,37974,75947
41123,,zm0o4fokrxij,37974,37975,75949
41124,,8gla9eeh7-cj,37975,37976,75951
41125,,vxmarpzwtzqj,37976,37977,75953
41126,,7h-2_dab9-ij,37977,37978,75955
41127,,qmmcllrfn88j,37978,37979,75957
41128,,9javzlsee8oj,37979,37980,75959
41129,,uit8d6gvdnij,37980,37981,75961
41130,,cxv1xm6jidwj,37981,37982,75963
41131,,url:http://ieeexplore.ieee.org/iel5/69/29697/01350759.pdf3farnumber3d1350759,37982,37983,75965
41132,,url:http://portal.acm.org/ft_gateway.cfm3fid3d1634326type3dpdf26coll3dguide26dl3dacm26cfid3d1111111126cftoken3d2222222,37983,37984,75967
41133,,url:http://www.csa.com/partners/viewrecord.php3frequester3dgs26collection3dtrd26recid3dn9210503ah,37984,37985,75969
41134,,ov19qxs3jbuj,37985,37986,75971
41135,,z_9yawppyymj,37987,37988,75975
41136,,owxhg-6d6mqj,37988,37989,75977
41137,,ssnmpv-i79wj,37989,37990,75979
41138,,ik7hbdpuixmj,37990,37991,75981
41139,,zlssuzft_4qj,37991,37992,75983
41140,,ymqtxqupv4kj,37992,37993,75985
41141,,zkk-ilu3ty0j,37993,37994,75987
41142,,qit-5begax4j,37994,37995,75989
41143,,6ihzgkvildoj,37995,37996,75991
41144,,rd2cyhvlqimj,37996,37997,75993
41145,,e0nhpx8pysqj,37997,37998,75995
41146,,,37998,37999,75997
41147,,v-lo20klzsyj,37999,38000,75999
41148,,znbeliacsjej,38000,38001,76001
41149,,t5bioe-4vj8j,38001,38002,76003
41150,,ekusyj-5__qj,38002,38003,76005
41151,,brf-t827je0j,38003,38004,76007
41152,,ecmnqqrzppej,38004,38005,76009
41153,,5wk-cevek-qj,38005,38006,76011
41154,,czkxjomfqmij,38006,38007,76013
41155,,hh1zuqtvr3oj,38007,38008,76015
41156,,jsl1ulhf-eyj,38008,38009,76017
41157,,kbgnrx6eipqj,38009,38010,76019
41158,,2zg2a7g8hbuj,38010,38011,76021
41159,,bbvcrg_asvkj,38011,38012,76023
41160,,3t_uznn_uscj,38012,38013,76025
41161,,rjjwjb_k1iwj,38013,38014,76027
41162,,kylx11sv4rqj,38014,38015,76029
41163,,zcxwytxuiduj,38015,38016,76031
41164,,tyq2kktmxwoj,38016,38017,76033
41165,,ofjcfkwpb7qj,38017,38018,76035
41166,,nbzdruakieuj,38018,38019,76037
41167,,nhfuctdht2wj,38019,38020,76039
41168,,url:http://portal.acm.org/citation.cfm3fid3d983076.98308026coll3dguide26dl3dacm26idx3dj68926part3dperiodical26wanttype3dperiodical26title3dacm2520sigmod2520record26cfid3d1111111126cftoken3d2222222,38020,38021,76041
41169,,,38021,38022,76043
41170,,uqa6wpxvkegj,38022,38023,76045
41171,,dppvmcfovkcj,38024,38025,76049
41172,,a4afaz2fs2sj,38025,38026,76051
41173,,j_3ik8j1hzgj,38026,38027,76053
41174,,nt84bvdytucj,38027,38028,76055
41175,,leuha2se-wsj,38028,38029,76057
41176,,a_cutwh-u2mj,38029,38030,76059
41177,,url:http://links.jstor.org/sici3fsici3d0146-4949(196724)8253a1253c19253aaanig2522253e2.0.co253b2-g,38030,38031,76061
41178,,fb50eco-otgj,38031,38032,76063
41179,,ho1ejjj1b2oj,38032,38033,76065
41180,,oh5ragiavzcj,38033,38034,76067
41181,,bndyxizo6eej,38034,38035,76069
41182,,y1ocqrjysiqj,38035,38036,76071
41183,,qftxnxcjcbkj,38036,38037,76073
41184,,i0nvk0272fej,38037,38038,76075
41185,,gtcdpeq5es4j,38039,38040,76079
41186,,azmhfnf2o5aj,38040,38041,76081
41187,,riri8yktcwuj,38041,38042,76083
41188,,eyabdtrkxayj,38042,38043,76085
41189,,dzjzwem8-duj,38043,38044,76087
41190,,z4btknix1xkj,38044,38045,76089
41191,,rtzvoy7xb5qj,38045,38046,76091
41192,,tfwlqqobawoj,38047,38048,76095
41193,,ak8vmuagspkj,38048,38049,76097
41194,,vcpb8hw_55ej,38049,38050,76099
41195,,ntkzmxgjdnwj,38050,38051,76101
41196,,2bujhcix8cwj,38052,38053,76105
41197,,tf1ekpy3_fij,38053,38054,76107
41198,,_xuzal5fzuyj,38054,38055,76109
41199,,vj-ethbgdeuj,38055,38056,76111
41200,,boa8lvz_qiuj,38056,38057,76113
41201,,nguyl5fjzv0j,38057,38058,76115
41202,,ubwpyapriqmj,38058,38059,76117
41203,,9tfq9o3thasj,38059,38060,76119
41204,,it9fvj8a-4yj,38060,38061,76121
41205,,igousfchwokj,38061,38062,76123
41206,,aphtm4d56qyj,38062,38063,76125
41207,,yl9emmxmwz0j,38063,38064,76127
41208,,lg8vusbpwz4j,38064,38065,76129
41209,,evihduumkiaj,38065,38066,76131
41210,,qw5r3rjbms0j,38066,38067,76133
41211,,aq1dxzoygiqj,38067,38068,76135
41212,,8-uvtgp6emij,38069,38070,76139
41213,,z28ra__te_yj,38070,38071,76141
41214,,sd2hounthpqj,38071,38072,76143
41215,,dyox5eq_q3cj,38072,38073,76145
41216,,fdruey_xiigj,38074,38075,76149
41217,,us37xnong24j,38075,38076,76151
41218,,url:http://www.csa.com/partners/viewrecord.php3frequester3dgs26collection3denv26recid3d8913248,38076,38077,76153
41219,,benfd4nxyj4j,38077,38078,76155
41220,,ckkeruoa-kqj,38078,38079,76157
41221,,rjr-vyaf77wj,38079,38080,76159
41222,,mkqqqc9ctdij,38080,38081,76161
41223,,pupzloqfcpij,38081,38082,76163
41224,,ecim1hyult4j,38082,38083,76165
41225,,,38083,38084,76167
41226,,zzyycnfhd98j,38084,38085,76169
41227,,vgom95ggcvcj,38085,38086,76171
41228,,5gtqngfnpjuj,38086,38087,76173
41229,,k7awz4fzydgj,38087,38088,76175
41230,,url:http://www.ingentaconnect.com/search/expand3fpub3dinfobike://els/13891286/1999/00000031/00000007/art0029226unc3d,38088,38089,76177
41231,,e1k8frdftrcj,38089,38090,76179
41232,,x2k6n7blydcj,38090,38091,76181
41233,,taai7zm5858j,38091,38092,76183
41234,,lnl57ohzhz8j,38092,38093,76185
41235,,okdgq1pb6x8j,38093,38094,76187
41236,,h1at1pd_jvcj,38094,38095,76189
41237,,lwi-tpbeklmj,38095,38096,76191
41238,,jcznrv6e26qj,38096,38097,76193
41239,,ute8b9iicluj,38097,38098,76195
41240,,tpr6u1euclaj,38098,38099,76197
41241,,opp3whmruv0j,38099,38100,76199
41242,,zudm-9aggnaj,38100,38101,76201
41243,,m7i-reweojqj,38101,38102,76203
41244,,ogtqrxbkmjej,38102,38103,76205
41245,,3m7klymq42uj,38103,38104,76207
41246,,sxi2zgbjqdoj,38104,38105,76209
41247,,url:http://portal.acm.org/citation.cfm3fid3d19743126coll3dportal26dl3dacm,38105,38106,76211
41248,,url:http://doi.wiley.com/10.1002/he.78,38106,38107,76213
41249,,acz8dgx5te4j,38108,38109,76217
41250,,s-lhmgwnvfmj,38109,38110,76219
41251,,r4fvvmv_yvoj,38110,38111,76221
41252,,twmrulrfmauj,38111,38112,76223
41253,,n11b8vv9qikj,38112,38113,76225
41254,,fqoykfsazscj,38113,38114,76227
41255,,tmr7gupvu0aj,38114,38115,76229
41256,,tcliqbceohmj,38115,38116,76231
41257,,_a85ol3yhicj,38116,38117,76233
41258,,joopbw-doeyj,38117,38118,76235
41259,,whp-izim5ncj,38118,38119,76237
41260,,url:http://portal.acm.org/ft_gateway.cfm3fid3d102775626type3dpdf,38119,38120,76239
41261,,glnatewrengj,38120,38121,76241
41262,,rdxzpxuoyuqj,38121,38122,76243
41263,,gz8ddfss5h0j,38122,38123,76245
41264,,7qibwjtef_uj,38123,38124,76247
41265,,s6tpl9bsnrcj,38124,38125,76249
41266,,jzq4wb0kkgsj,38125,38126,76251
41267,,iccdkyrrmeij,38126,38127,76253
41268,,0i1azs-wswyj,38127,38128,76255
41269,,o6noitaughyj,38128,38129,76257
41270,,d48ssn95h34j,38129,38130,76259
41271,,i7spk7i9qosj,38130,38131,76261
41272,,x0t9g2qsqmuj,38131,38132,76263
41273,,lzpxc3b7xqwj,38132,38133,76265
41274,,hw2jnmwfyiaj,38133,38134,76267
41275,,ncye0pgymukj,38134,38135,76269
41276,,oos3txs6engj,38135,38136,76271
41277,,mhb6_lclvfyj,38136,38137,76273
41278,,alxd3pi24rgj,38137,38138,76275
41279,,qisf-fbue8qj,38138,38139,76277
41280,,ga66owjhdouj,38139,38140,76279
41281,,lgrshn5tv8ij,38140,38141,76281
41282,,ppe6__we9_yj,38141,38142,76283
41283,,7sk9r2e0yngj,38142,38143,76285
41284,,_sk87bsdkyij,38143,38144,76287
41285,,skcaiehuc9sj,38144,38145,76289
41286,,bhrepnd1qfuj,38145,38146,76291
41287,,f3eaxrjsdgaj,38146,38147,76293
41288,,szyrvvlxet0j,38147,38148,76295
41289,,3ctzqeeyxlcj,38148,38149,76297
41290,,xo0ni8ispbgj,38149,38150,76299
41291,,url:http://www.csa.com/partners/viewrecord.php3frequester3dgs26collection3dtrd26recid3dn9210442ah,38150,38151,76301
41292,,jdrdxdhrqpij,38151,38152,76303
41293,,mvzlnt3lkwej,38152,38153,76305
41294,,hwmwvdmagbaj,38153,38154,76307
41295,,euwuptgk8usj,38154,38155,76309
41296,,ks2fkbkpdzoj,38155,38156,76311
41297,,xsepj3wpacqj,38156,38157,76313
41298,,frmfg2g1xjuj,38157,38158,76315
41299,,kwqgxt2fkkwj,38159,38160,76319
41300,,tm0ip-cyptej,38160,38161,76321
41301,,r-hmvdd_bw4j,38161,38162,76323
41302,,7p_6jpetzksj,38162,38163,76325
41303,,slso4zjlebwj,38163,38164,76327
41304,,j0sm-0kig74j,38164,38165,76329
41305,,url:http://portal.acm.org/ft_gateway.cfm3fid3d13087226type3dpdf26coll3dguide26dl3dacm26cfid3d1111111126cftoken3d2222222,38165,38166,76331
41306,,url:http://links.jstor.org/sici3fsici3d0146-4949(196524252f21)6253a1253c73253atmvo2522s253e2.0.co253b2-f,38166,38167,76333
41307,,2u1fnxv5eegj,38167,38168,76335
41308,,ltwgmtrptt4j,38168,38169,76337
41309,,k0akoyfpeqsj,38169,38170,76339
41310,,nwt43pa8idaj,38170,38171,76341
41311,,oh_xfqi8wigj,38171,38172,76343
41312,,bb5zrpquzf0j,38172,38173,76345
41313,,aho524r_xpqj,38173,38174,76347
41314,,,38174,38175,76349
41315,,iyq_tzdmrhuj,38175,38176,76351
41316,,bjwby4hjcqcj,38176,38177,76353
41317,,isbdw7xgng4j,38177,38178,76355
41318,,pneptoilzb0j,38178,38179,76357
41319,,bvrwadvsco4j,38179,38180,76359
41320,,ntcpqsysm08j,38180,38181,76361
41321,,url:http://doi.wiley.com/10.1002/he.132,38181,38182,76363
41322,,f1b7i2jyeqaj,38182,38183,76365
41323,,nhefhoxenmkj,38183,38184,76367
41324,,y8hbdyuwgqoj,38184,38185,76369
41325,,,38185,38186,76371
41326,,qi1h450r984j,38186,38187,76373
41327,,pbrhawjn1yoj,38187,38188,76375
41328,,neue3-ulqh4j,38188,38189,76377
41329,,4u_bgookeiej,38189,38190,76379
41330,,kf-lfdx-sekj,38190,38191,76381
41331,,csigmqdu58qj,38191,38192,76383
41332,,e9mzvpjte34j,38192,38193,76385
41333,,cz8ticxfsxsj,38193,38194,76387
41334,,nj-qtwj_qf8j,38194,38195,76389
41335,,2pyspwxcpzqj,38195,38196,76391
41336,,hiiyjs1ymrmj,38196,38197,76393
41337,,erhegm4x-p8j,38197,38198,76395
41338,,bbf2ej9f3xwj,38198,38199,76397
41339,,wt-wjvi5vacj,38199,38200,76399
41340,,2r-oivcvvegj,38200,38201,76401
41341,,7fqteumiohoj,38201,38202,76403
41342,,j5kikcuqb3cj,38202,38203,76405
41343,,8y3usv_mrwyj,38203,38204,76407
41344,,thzhcbq9iz0j,38204,38205,76409
41345,,url:http://adsabs.harvard.edu/abs/1979ge26ae..19q.439m,38205,38206,76411
41346,,9llodvfhqacj,38206,38207,76413
41347,,2djipxynj5wj,38207,38208,76415
41348,,6bdfcr4xrfej,38208,38209,76417
41349,,dv7jnoq8u7ej,38209,38210,76419
41350,,z_kvjgrmo5qj,38211,38212,76423
41351,,f2bawr51pbgj,38213,38214,76427
41352,,1qwt9qdoo3uj,38214,38215,76429
41353,,ida9ueflh-mj,38215,38216,76431
41354,,_ifzwjs6rjkj,38216,38217,76433
41355,,rcqrhu6kqu0j,38217,38218,76435
41356,,odotect31fij,38218,38219,76437
41357,,url:http://www.csa.com/partners/viewrecord.php3frequester3dgs26collection3dtrd26recid3d199402720181md26recid3d199402g2c0052ec26recid3d199402g2d0052ed26recid3d199402g2p0052ep,38219,38220,76439
41358,,z_swstehvoaj,38220,38221,76441
41359,,rrle6lrdhsgj,38221,38222,76443
41360,,url:http://www.ingentaconnect.com/search/expand3fpub3dinfobike://els/09505849/2003/00000045/00000009/art0004826unc3d,38222,38223,76445
41361,,url:http://portal.acm.org/ft_gateway.cfm3fid3d101777126type3dpdf,38223,38224,76447
41362,,nyk7o8mxfssj,38224,38225,76449
41363,,mtssr3dh6k0j,38225,38226,76451
41364,,1lw7ihpysmkj,38226,38227,76453
41365,,ggng_c5hpn4j,38227,38228,76455
41366,,xygwipvpoxmj,38228,38229,76457
41367,,_s-pn9mkexkj,38229,38230,76459
41368,,ssirfdfkxz4j,38231,38232,76463
41369,,ttcis5t_ucgj,38232,38233,76465
41370,,jec4dc4ghacj,38233,38234,76467
41371,,wblzgkuy8faj,38234,38235,76469
41372,,8fczkb7_y4wj,38235,38236,76471
41373,,hvlu2repd4uj,38236,38237,76473
41374,,bfwrvo_wqngj,38237,38238,76475
41375,,gauezkm-hayj,38238,38239,76477
41376,,rotufjtnahyj,38239,38240,76479
41377,,a4uz89icj9qj,38240,38241,76481
41378,,fy5mnwj8n2qj,38241,38242,76483
41379,,4692sthnstuj,38242,38243,76485
41380,,t6mc5hx2w9wj,38243,38244,76487
41381,,3xqmo1erpj0j,38244,38245,76489
41382,,qpgzqh0bcdsj,38245,38246,76491
41383,,swvp_rrso64j,38246,38247,76493
41384,,tlwzee9imfyj,38248,38249,76497
41385,,hdlnc2gtv1ej,38249,38250,76499
41386,,_dv6feni9vcj,38250,38251,76501
41387,,hzbbmsrkjxej,38251,38252,76503
41388,,b87rz7o7r94j,38252,38253,76505
41389,,zpppdku9z_wj,38253,38254,76507
41390,,hzfzo1gdpk4j,38254,38255,76509
41391,,ioa7mjph2xmj,38255,38256,76511
41392,,pqadhpcpybaj,38256,38257,76513
41393,,ncxbmhj4isoj,38257,38258,76515
41394,,v5619ztwi8ej,38258,38259,76517
41395,,vwwvqvcirbej,38259,38260,76519
41396,,jtcwn2krs-sj,38260,38261,76521
41397,,url:http://www.csa.com/partners/viewrecord.php3frequester3dgs26collection3dtrd26recid3d0971836ci,38261,38262,76523
41398,,ykutufveqqkj,38262,38263,76525
41399,,lkph_adpiyqj,38263,38264,76527
41400,,rdvoxbkya_kj,38264,38265,76529
41401,,bfcz9xezfy0j,38265,38266,76531
41402,,ea8gnvxhrj4j,38266,38267,76533
41403,,liwpzlx4hn4j,38267,38268,76535
41404,,gyraygwgqyyj,38268,38269,76537
41405,,eudccuhaxagj,38269,38270,76539
41406,,mpmmofish1sj,38270,38271,76541
41407,,nscsha925mmj,38272,38273,76545
41408,,ljmtxd7lc3sj,38273,38274,76547
41409,,url:http://portal.acm.org/ft_gateway.cfm3fid3d110131326type3dpdf,38274,38275,76549
41410,,vpqlif_r5n4j,38275,38276,76551
41411,,q7_vyaqvszkj,38276,38277,76553
41412,,jveuzth8kncj,38277,38278,76555
41413,,bz83dynj02ej,38278,38279,76557
41414,,url:http://pubs.acs.org/cgi-bin/abstract.cgi/achre4/2005/38/i07/abs/ar0401294.html,38279,38280,76559
41415,,vfixi2t6twgj,38280,38281,76561
41416,,c7qqmsgvp60j,38281,38282,76563
41417,,qujis-2sjkkj,38282,38283,76565
41418,,cnrddxjv7mkj,38283,38284,76567
41419,,x8yr9bw8rwaj,38284,38285,76569
41420,,oabgxqlfgkcj,38285,38286,76571
41421,,lvhq_vibbt4j,38286,38287,76573
41422,,umg68hkf8ecj,38287,38288,76575
41423,,k9ga7hqsoqqj,38288,38289,76577
41424,,kidwjkwd3quj,38289,38290,76579
41425,,gtjvo_osuecj,38290,38291,76581
41426,,pjm2eaewpg4j,38291,38292,76583
41427,,pcusk8bkmjyj,38292,38293,76585
41428,,y3zhjk2m3ikj,38293,38294,76587
41429,,xq63g-3bpboj,38294,38295,76589
41430,,wr4fnqwwchmj,38295,38296,76591
41431,,ipkav8tamngj,38296,38297,76593
41432,,ciqgdmpce1mj,38297,38298,76595
41433,,vgdj7x2icjuj,38298,38299,76597
41434,,8tyznh5vbxuj,38299,38300,76599
41435,,cfg7mxsjncgj,38300,38301,76601
41436,,kfbyzty7pnoj,38301,38302,76603
41437,,bobje9_6k0qj,38302,38303,76605
41438,,snpujbqtf8gj,38303,38304,76607
41439,,mgtkafp1woyj,38304,38305,76609
41440,,yepfmydfup8j,38305,38306,76611
41441,,url:http://www.geography.org.uk/journals/journals.asp3farticleid3d12,38306,38307,76613
41442,,lah2jjwsjcgj,38307,38308,76615
41443,,jm-i8-clbpuj,38308,38309,76617
41444,,les-p-whyd4j,38309,38310,76619
41445,,a21ttzqnclej,38310,38311,76621
41446,,zxmd8wn2hmyj,38311,38312,76623
41447,,zbjgcfs0a70j,38312,38313,76625
41448,,zulqhkbuogsj,38313,38314,76627
41449,,kylt5cm5phej,38314,38315,76629
41450,,bb0rsk0ovdgj,38315,38316,76631
41451,,url:http://www.springerlink.com/index/t58x8308h4761g3u.pdf,38316,38317,76633
41452,,zepvi2iu9mij,38317,38318,76635
41453,,1mkoosl3b2sj,38318,38319,76637
41454,,ljar0ieyucgj,38319,38320,76639
41455,,3ixdhej1ahij,38320,38321,76641
41456,,oszwidx3mxgj,38321,38322,76643
41457,,qqmkcplx4dwj,38322,38323,76645
41458,,oy8skf4t5ccj,38323,38324,76647
41459,,tksfgndukf0j,38324,38325,76649
41460,,gzdfjkf1xgej,38325,38326,76651
41461,,0oe1syzxuxcj,38326,38327,76653
41462,,fjlfxajt2vgj,38327,38328,76655
41463,,gbnddmhcl94j,38328,38329,76657
41464,,nouewqwfyaej,38330,38331,76661
41465,,wqdcittoyxuj,38331,38332,76663
41466,,uxpzafc2i4qj,38332,38333,76665
41467,,z6x8i7jhtncj,38333,38334,76667
41468,,url:http://www.csa.com/partners/viewrecord.php3frequester3dgs26collection3dtrd26recid3d2470496ci,38334,38335,76669
41469,,d_yooz8re00j,38335,38336,76671
41470,,bdcqsdrwcvoj,38336,38337,76673
41471,,ty6mugnryimj,38337,38338,76675
41472,,zf3qzonp5paj,38338,38339,76677
41473,,rvfh4whfxouj,38339,38340,76679
41474,,p-o_xlwolgmj,38340,38341,76681
41475,,q1beta9mqogj,38342,38343,76685
41476,,739veq4f8lmj,38343,38344,76687
41477,,zpfttx9dtzsj,38346,38347,76693
41478,,xidcirzmsacj,38348,38349,76697
41479,,rguzkoadvj0j,38349,38350,76699
41480,,7lc-glqkgdgj,38350,38351,76701
41481,,_k7npzvy6xyj,38351,38352,76703
41482,,2krirykjypuj,38352,38353,76705
41483,,ihakmrjktxij,38353,38354,76707
41484,,ffdq9mypaz0j,38354,38355,76709
41485,,yaxyfqfkuf4j,38355,38356,76711
41486,,f4ktxrnem3kj,38356,38357,76713
41487,,w7pzjlyutzcj,38357,38358,76715
41488,,vg9oyfnifzwj,38358,38359,76717
41489,,mdymk7dhecij,38359,38360,76719
41490,,txbefhkeyrmj,38360,38361,76721
41491,,ay3ti7qo81kj,38361,38362,76723
41492,,93f1ntfniyej,38362,38363,76725
41493,,fbj5iyp1nxkj,38363,38364,76727
41494,,94r3iw70arwj,38364,38365,76729
41495,,j_1hjd8gijej,38365,38366,76731
41496,,dwttiyhqj04j,38366,38367,76733
41497,,b_s6ymdtz8yj,38367,38368,76735
41498,,ooknnz3rbfwj,38368,38369,76737
41499,,dozr24fcjeqj,38369,38370,76739
41500,,xhshstflcg0j,38370,38371,76741
41501,,sopa4xr1sdyj,38371,38372,76743
41502,,g6ffcix6gtmj,38372,38373,76745
41503,,fn0gz-m-r8sj,38373,38374,76747
41504,,url:http://links.jstor.org/sici3fsici3d0146-4949(196522)6253a2253c228253aatitno253e2.0.co253b2-u,38374,38375,76749
41505,,beton9cnscuj,38375,38376,76751
41506,,upxw77eqqggj,38376,38377,76753
41507,,g1uozez98iqj,38377,38378,76755
41508,,9hedn3a13bqj,38378,38379,76757
41509,,exefaukbycsj,38379,38380,76759
41510,,biwcmruptsmj,38380,38381,76761
41511,,-1wosb2ab4aj,38382,38383,76765
41512,,ducgixk2-l4j,38383,38384,76767
41513,,lx2jh4eecq0j,38384,38385,76769
41514,,nyw0aiapknuj,38385,38386,76771
41515,,fetne4a8weej,38386,38387,76773
41516,,phpusfqom1oj,38387,38388,76775
41517,,uyaff23svhoj,38388,38389,76777
41518,,ihc1gwio3xaj,38389,38390,76779
41519,,sxlrc8xotcgj,38390,38391,76781
41520,,,38391,38392,76783
41521,,lfpv9rpvxxwj,38393,38394,76787
41522,,53flgmwgm5qj,38394,38395,76789
41523,,url:http://doi.wiley.com/10.1002/he.130,38395,38396,76791
41524,,url:http://www.springerlink.com/index/l677n83321264g44.pdf,38396,38397,76793
41525,,92xgzkibrywj,38397,38398,76795
41526,,yoslnsuffbsj,38398,38399,76797
41527,,namnqu4_bmaj,38399,38400,76799
41528,,aytgczywvnyj,38400,38401,76801
41529,,okpu9ajj99wj,38401,38402,76803
41530,,vn0hk5bcpvmj,38402,38403,76805
41531,,rnakkc_m9-kj,38403,38404,76807
41532,,uhv-kjv6nuuj,38404,38405,76809
41533,,twoeqyfga_oj,38405,38406,76811
41534,,mxf-99wlhxsj,38406,38407,76813
41535,,,38407,38408,76815
41536,,url:http://doi.wiley.com/10.1002/tl.116,38408,38409,76817
41537,,ssjy-vtett4j,38409,38410,76819
41538,,vsiaz2ctflcj,38410,38411,76821
41539,,url:http://portal.acm.org/ft_gateway.cfm3fid3d110124326type3dpdf,38411,38412,76823
41540,,y1ovp2laaqwj,38412,38413,76825
41541,,fcoitsry8i4j,38413,38414,76827
41542,,url:http://www.csa.com/partners/viewrecord.php3frequester3dgs26collection3dtrd26recid3da8622919ah,38414,38415,76829
41543,,_ezqgzrkm9sj,38415,38416,76831
41544,,gcnan6jp6bgj,38416,38417,76833
41545,,2iqz3ksx-twj,38418,38419,76837
41546,,nxm1oa1ejdqj,38419,38420,76839
41547,,0jze7toeunej,38420,38421,76841
41548,,nvuicvngapej,38421,38422,76843
41549,,b_o9vn5jrbcj,38422,38423,76845
41550,,1zrdyrvsyoqj,38423,38424,76847
41551,,dt2i37brvrkj,38424,38425,76849
41552,,zxb1xi2h-hkj,38425,38426,76851
41553,,w-sg4dhdvtmj,38426,38427,76853
41554,,aqdccivxxbkj,38427,38428,76855
41555,,zxgagksga5gj,38428,38429,76857
41556,,dc2r2mlfl1ij,38429,38430,76859
41557,,0j-lkcllkoqj,38430,38431,76861
41558,,rmzgkzewmlqj,38431,38432,76863
41559,,knxmvtirmtij,38432,38433,76865
41560,,la4jkxln23cj,38433,38434,76867
41561,,s2yafidqm4sj,38434,38435,76869
41562,,sq02nle587yj,38435,38436,76871
41563,,lntlyp8h1cgj,38436,38437,76873
41564,,urcatrxsqroj,38437,38438,76875
41565,,ujoo5olcvyyj,38438,38439,76877
41566,,rr5lyove680j,38439,38440,76879
41567,,ypvxutjpi7aj,38440,38441,76881
41568,,g_-aizohiqyj,38441,38442,76883
41569,,vv2rozp4ei8j,38442,38443,76885
41570,,gyleuelzz9gj,38443,38444,76887
41571,,n-52zxv1zhsj,38444,38445,76889
41572,,8ns6plyfoi8j,38445,38446,76891
41573,,2sdlotbrtpij,38446,38447,76893
41574,,fowjyejoaxgj,38447,38448,76895
41575,,uhwpnbs8ffwj,38448,38449,76897
41576,,mq7ed5avivgj,38449,38450,76899
41577,,zixpccxvcwcj,38450,38451,76901
41578,,url:http://www.csa.com/partners/viewrecord.php3frequester3dgs26collection3dtrd26recid3da8622912ah,38451,38452,76903
41579,,e7l7jzlxfluj,38452,38453,76905
41580,,t4hslkatfbyj,38453,38454,76907
41581,,,38454,38455,76909
41582,,i2athk9aom4j,38455,38456,76911
41583,,bqjeio4lhc8j,38456,38457,76913
41584,,hqt4gv-pzfmj,38457,38458,76915
41585,,8mmr2_m3rj8j,38458,38459,76917
41586,,grzp1cufibqj,38459,38460,76919
41587,,bn92qi_l7lsj,38460,38461,76921
41588,,url:http://portal.acm.org/ft_gateway.cfm3fid3d110130526type3dpdf,38461,38462,76923
41589,,meyor-dhouqj,38462,38463,76925
41590,,yfmekfzgzmwj,38464,38465,76929
41591,,5qfhf2nhpcmj,38465,38466,76931
41592,,fskvyqc3zguj,38466,38467,76933
41593,,w_t-c23z7v4j,38467,38468,76935
41594,,ckijrdrb1yoj,38468,38469,76937
41595,,j8x8pvtslnej,38469,38470,76939
41596,,hshhy8lzrr8j,38470,38471,76941
41597,,ebvxcqxod_sj,38471,38472,76943
41598,,3a_lxqqv_fgj,38472,38473,76945
41599,,m80uyofy-0wj,38473,38474,76947
41600,,url:http://portal.acm.org/citation.cfm3fid3d171926.171969,38474,38475,76949
41601,,qzswsxgpttyj,38475,38476,76951
41602,,x8x-u7a7rjcj,38476,38477,76953
41603,,url:http://www.ingentaconnect.com/search/expand3fpub3dinfobike://pep/jae/2001/00000215/00000006/art0000726unc3d,38478,38479,76957
41604,,umldnfhypsoj,38479,38480,76959
41605,,qwq2t5hxmfej,38480,38481,76961
41606,,6u7dzzzypdqj,38481,38482,76963
41607,,bfqw6ylljiij,38482,38483,76965
41608,,r_9ygc3kteqj,38484,38485,76969
41609,,bn0oa3zd5kcj,38485,38486,76971
41610,,lyjic_xwquej,38486,38487,76973
41611,,zh9caewevisj,38487,38488,76975
41612,,rcxagmy4ptej,38488,38489,76977
41613,,cdgcx9fvb4uj,38489,38490,76979
41614,,vkiqkjddbnsj,38490,38491,76981
41615,,ukrfqewl4-4j,38491,38492,76983
41616,,l593mwzuxikj,38492,38493,76985
41617,,p9wtksnp59cj,38493,38494,76987
41618,,kvczhiyqdl8j,38494,38495,76989
41619,,66z4l2pza2ej,38495,38496,76991
41620,,vyr5q3cydy8j,38496,38497,76993
41621,,lx0hi5lfdt8j,38497,38498,76995
41622,,txohsiimnywj,38498,38499,76997
41623,,w0zgy7f_pduj,38499,38500,76999
41624,,8xkikba3ezsj,38500,38501,77001
41625,,45i3dy_zwwsj,38501,38502,77003
41626,,io2j_lt8ei0j,38502,38503,77005
41627,,hsbw_wrmvusj,38503,38504,77007
41628,,rndqcokl4gij,38504,38505,77009
41629,,rbpwlhvtyioj,38505,38506,77011
41630,,_-_f8g6rb7oj,38506,38507,77013
41631,,yq56ira1dlqj,38507,38508,77015
41632,,r3cb3e4rp7kj,38509,38510,77019
41633,,ufkefxpffr0j,38510,38511,77021
41634,,jryxg23orawj,38511,38512,77023
41635,,url:http://www.csa.com/partners/viewrecord.php3frequester3dgs26collection3dtrd26recid3dn9210558ah,38512,38513,77025
41636,,p3t0lwdpqmij,38513,38514,77027
41637,,obrouvcpmkmj,38514,38515,77029
41638,,vy_bf4hz9jqj,38515,38516,77031
41639,,yt5whyav_jkj,38516,38517,77033
41640,,lpsqxcsdjh0j,38517,38518,77035
41641,,gpl3xxu5wtyj,38518,38519,77037
41642,,rhg_zjkiuqmj,38519,38520,77039
41643,,j_1bgxrrweij,38520,38521,77041
41644,,wy-gzgdckl4j,38521,38522,77043
41645,,dz_arsy5cmej,38522,38523,77045
41646,,zb5ttpslltcj,38523,38524,77047
41647,,3fzy6zfuqdoj,38524,38525,77049
41648,,xzs0wjjnf-uj,38525,38526,77051
41649,,ckwxqn7o2luj,38526,38527,77053
41650,,jcswiftlnuej,38527,38528,77055
41651,,arfj3t6izjij,38528,38529,77057
41652,,,38529,38530,77059
41653,,gxn8pz9enoij,38530,38531,77061
41654,,3gmctuqxb7kj,38531,38532,77063
41655,,0f3sigkg79ej,38532,38533,77065
41656,,_mk2vcql2kwj,38534,38535,77069
41657,,f0fva5swckaj,38536,38537,77073
41658,,lgqtqtqgtyej,38537,38538,77075
41659,,lpj_g5xtutej,38538,38539,77077
41660,,vgds1iqz1uqj,38539,38540,77079
41661,,n_oayay2g40j,38540,38541,77081
41662,,2yqjwjoavl0j,38541,38542,77083
41663,,9reanbx2i-ij,38542,38543,77085
41664,,nygxuwsuwlwj,38543,38544,77087
41665,,qjv7ard3yskj,38544,38545,77089
41666,,url:http://portal.acm.org/ft_gateway.cfm3fid3d31977526type3dpdf26coll3dguide26dl3dacm26cfid3d1111111126cftoken3d2222222,38545,38546,77091
41667,,lizeoj5cqemj,38546,38547,77093
41668,,py30qkhyic4j,38547,38548,77095
41669,,z57bxi3fltej,38548,38549,77097
41670,,1pzgzisytroj,38549,38550,77099
41671,,47y5_6ccqdkj,38550,38551,77101
41672,,ozfzwsfb0tkj,38553,38554,77107
41673,,k_pdl1_2brsj,38554,38555,77109
41674,,vrtkybx9xcmj,38555,38556,77111
41675,,36r9fbv4wjoj,38556,38557,77113
41676,,0sx_giegnlmj,38557,38558,77115
41677,,w0x5djzfelgj,38558,38559,77117
41678,,dnfgxbwirc0j,38559,38560,77119
41679,,4ne_r_4cmvej,38560,38561,77121
41680,,bunqp82xz5yj,38561,38562,77123
41681,,pg6if68y-faj,38562,38563,77125
41682,,cw-qg237dhaj,38563,38564,77127
41683,,hta3edy2druj,38564,38565,77129
41684,,sxzx_evn1lej,38565,38566,77131
41685,,qrl7qbcdojij,38566,38567,77133
41686,,mbfxaqrwxbyj,38567,38568,77135
41687,,zqzksu10jeuj,38568,38569,77137
41688,,,38569,38570,77139
41689,,cim5kswpjgoj,38570,38571,77141
41690,,_wygsrl30puj,38571,38572,77143
41691,,vtlng6xwrowj,38572,38573,77145
41692,,nm9rcu6yvnwj,38573,38574,77147
41693,,8kcwcqfclrmj,38574,38575,77149
41694,,jrccmzuhulqj,38575,38576,77151
41695,,url:http://portal.acm.org/citation.cfm3fid3d141818.14182926dl3dguide26dl3dacm26idx3dj68926part3dperiodical26wanttype3dperiodical26title3dacm2520sigmod2520record26cfid3d1111111126cftoken3d2222222,38576,38577,77153
41696,,e6juiwl9cskj,38577,38578,77155
41697,,oqmts7hmfq8j,38578,38579,77157
41698,,dzfcuiypnkej,38579,38580,77159
41699,,oo0fc3wck18j,38580,38581,77161
41700,,d6aryeugux4j,38581,38582,77163
41701,,vahwzuk_d7cj,38582,38583,77165
41702,,036parht3csj,38583,38584,77167
41703,,thnzguqwnbmj,38585,38586,77171
41704,,herrtm--hbkj,38586,38587,77173
41705,,zooauey-evqj,38587,38588,77175
41706,,y9mefvbjbg0j,38588,38589,77177
41707,,fhxdipxzpk4j,38589,38590,77179
41708,,6-tze7f-njej,38590,38591,77181
41709,,qzyutlmyn1uj,38591,38592,77183
41710,,djjllfifpyyj,38592,38593,77185
41711,,yy4mpel_2-sj,38593,38594,77187
41712,,wahxkla4pg8j,38594,38595,77189
41713,,kuj0x5r9utqj,38595,38596,77191
41714,,yk8d1pitsowj,38596,38597,77193
41715,,k34nllyyihsj,38597,38598,77195
41716,,dby6jthneowj,38598,38599,77197
41717,,url:http://portal.acm.org/citation.cfm3fid3d6754426dl3dacm26coll3dguide26cfid3d1111111126cftoken3d2222222,38599,38600,77199
41718,,ggcd6aa81rcj,38600,38601,77201
41719,,jtxql6frabwj,38601,38602,77203
41720,,fpr5tkffemij,38602,38603,77205
41721,,j-wijdljqlyj,38603,38604,77207
41722,,huqsrjv9omej,38604,38605,77209
41723,,uumkoupnfswj,38605,38606,77211
41724,,-9o7oskaslqj,38607,38608,77215
41725,,acle6vwinxgj,38608,38609,77217
41726,,m9nxigor-j4j,38609,38610,77219
41727,,b3qgnzccnw8j,38610,38611,77221
41728,,najug7ujprqj,38611,38612,77223
41729,,tooi_kd4dfej,38612,38613,77225
41730,,apj7cbo1vfyj,38613,38614,77227
41731,,tgejpogfe1yj,38614,38615,77229
41732,,lst4fcui3ywj,38615,38616,77231
41733,,ay9h1i7bs8mj,38616,38617,77233
41734,,yb7ndyjmjhkj,38617,38618,77235
41735,,url:http://portal.acm.org/citation.cfm3fid3d1041410.1041433,38618,38619,77237
41736,,nnenzixaee8j,38619,38620,77239
41737,,cyo3tu5dek8j,38620,38621,77241
41738,,ggspso3lucuj,38621,38622,77243
41739,,wenli6f74wsj,38622,38623,77245
41740,,kj6e1fb2rr8j,38623,38624,77247
41741,,url:http://www.springerlink.com/index/g84477l715278156.pdf,38624,38625,77249
41742,,dz9a81fbugoj,38625,38626,77251
41743,,lvg0fwoqceuj,38626,38627,77253
41744,,url:http://www.csa.com/partners/viewrecord.php3frequester3dgs26collection3dtrd26recid3dn9210390ah,38627,38628,77255
41745,,y5zncyc9dqsj,38628,38629,77257
41746,,3kfnls-dnx0j,38629,38630,77259
41747,,1ryzhi11nkuj,38630,38631,77261
41748,,url:http://portal.acm.org/ft_gateway.cfm3fid3d94574126type3dpdf26dl3dguide26dl3dacm26cfid3d1111111126cftoken3d2222222,38631,38632,77263
41749,,5zj4ekux9umj,38632,38633,77265
41750,,olcbypgxkzyj,38633,38634,77267
41751,,1yepg0qeq48j,38634,38635,77269
41752,,0cyixdmpwr4j,38635,38636,77271
41753,,ch46mv7bljuj,38636,38637,77273
41754,,rfbnyloj09kj,38637,38638,77275
41755,,hrjwqzxg9zsj,38638,38639,77277
41756,,14unlhczyq0j,38639,38640,77279
41757,,zfpckn6wvccj,38640,38641,77281
41758,,8egg5qjzybmj,38641,38642,77283
41759,,fzwyo_yhxf4j,38642,38643,77285
41760,,go3qx2qnlowj,38643,38644,77287
41761,,nk7edholatqj,38644,38645,77289
41762,,rwuo9g3id6aj,38645,38646,77291
41763,,dki-ev_laa4j,38647,38648,77295
41764,,h4yboz0tuh0j,38648,38649,77297
41765,,0m5dtw0ehskj,38649,38650,77299
41766,,cvgf0jn9q6mj,38650,38651,77301
41767,,xvaw7wqgenoj,38651,38652,77303
41768,,4npo8ixgyraj,38652,38653,77305
41769,,mm0fiullgy0j,38653,38654,77307
41770,,3qqvwswtsc8j,38654,38655,77309
41771,,yb5jkhbm3wkj,38655,38656,77311
41772,,c-7qcqygr_4j,38656,38657,77313
41773,,v3snxnz2_ckj,38657,38658,77315
41774,,1zxdq0otm4gj,38658,38659,77317
41775,,z4071j-_zq0j,38659,38660,77319
41776,,y-dygh7k4o4j,38660,38661,77321
41777,,g3pyyodntdwj,38661,38662,77323
41778,,gc3p-9eyxzcj,38662,38663,77325
41779,,gkflignzcnkj,38663,38664,77327
41780,,v8gpzclwkzuj,38664,38665,77329
41781,,iez3oz8wxn8j,38665,38666,77331
41782,,kmta85cbmeyj,38668,38669,77337
41783,,qy3fingzhhcj,38669,38670,77339
41784,,1uynwxminjsj,38670,38671,77341
41785,,jsdhi0rmj40j,38671,38672,77343
41786,,46w_dbzb6yij,38672,38673,77345
41787,,ijb5yucckksj,38673,38674,77347
41788,,yxvhsbouczsj,38674,38675,77349
41789,,url:http://pubs.acs.org/cgi-bin/abstract.cgi/achre4/2005/38/i09/abs/ar0500012.html,38675,38676,77351
41790,,grek6j6bpawj,38676,38677,77353
41791,,k-s57os_ov8j,38677,38678,77355
41792,,t6zozxqzpjij,38678,38679,77357
41793,,equzaiuv0cwj,38679,38680,77359
41794,,taaxqzajjqoj,38680,38681,77361
41795,,ugxry7xmoiyj,38681,38682,77363
41796,,b2mrsaz4iiej,38682,38683,77365
41797,,itjinn099dgj,38683,38684,77367
41798,,jrlxod3yjwcj,38684,38685,77369
41799,,oi8jvvxjumkj,38685,38686,77371
41800,,zv0vmt0rzroj,38686,38687,77373
41801,,gjq4cz8qxw0j,38687,38688,77375
41802,,hgqs1gzmejkj,38688,38689,77377
41803,,mqzbr7pyj9uj,38689,38690,77379
41804,,zkqtzgd_7ikj,38690,38691,77381
41805,,yunpe4lsor8j,38691,38692,77383
41806,,3sk5nxr8du0j,38692,38693,77385
41807,,uoob0o9rjhqj,38693,38694,77387
41808,,kwaajwj1epej,38695,38696,77391
41809,,odpcv8c3ih8j,38696,38697,77393
41810,,ykrnpccobdqj,38697,38698,77395
41811,,2th4oozmmumj,38698,38699,77397
41812,,tayfhcuksxgj,38699,38700,77399
41813,,i5avkiu7q78j,38700,38701,77401
41814,,url:http://portal.acm.org/ft_gateway.cfm3fid3d77699926type3dpdf26dl3dguide26dl3dacm26cfid3d1111111126cftoken3d2222222,38701,38702,77403
41815,,ra73wxbkrr8j,38702,38703,77405
41816,,awfoczrwth8j,38703,38704,77407
41817,,nbgfm52uklqj,38704,38705,77409
41818,,url:http://www.ingentaconnect.com/search/expand3fpub3dinfobike://pep/jae/2004/00000218/00000007/art0000826unc3d,38705,38706,77411
41819,,8wetzuvsodej,38706,38707,77413
41820,,,38707,38708,77415
41821,,vankk7y8e74j,38708,38709,77417
41822,,odr4dzb-ammj,38709,38710,77419
41823,,fgk6k_1kwzuj,38710,38711,77421
41824,,evfmcuvq9f8j,38711,38712,77423
41825,,rjwzp8x5sjcj,38712,38713,77425
41826,,rajkim8jacyj,38713,38714,77427
41827,,qhyavsekjqaj,38714,38715,77429
41828,,tffczhhffocj,38715,38716,77431
41829,,zqwqsipzxnej,38716,38717,77433
41830,,xk2nsspmuxyj,38717,38718,77435
41831,,4fn55wgzw-qj,38718,38719,77437
41832,,0taeopwwsxcj,38719,38720,77439
41833,,8unn-h9kxjej,38720,38721,77441
41834,,u0kkitcpp-8j,38721,38722,77443
41835,,uu8wmyb2ilkj,38722,38723,77445
41836,,o9xwmjevucej,38723,38724,77447
41837,,mph54kjmnh8j,38724,38725,77449
41838,,omafwkqrldkj,38725,38726,77451
41839,,ip5zp0fgkvyj,38726,38727,77453
41840,,rme_pr6sli0j,38727,38728,77455
41841,,xffrxkhxuh8j,38728,38729,77457
41842,,dd0y1dbid3aj,38729,38730,77459
41843,,xtnydtf-hosj,38730,38731,77461
41844,,3cjxaak3lgsj,38731,38732,77463
41845,,oxl4dvamiemj,38732,38733,77465
41846,,hassyw-atx0j,38733,38734,77467
41847,,p-vncxvqmauj,38734,38735,77469
41848,,_acglw5c-o4j,38735,38736,77471
41849,,l_cznjmeeauj,38736,38737,77473
41850,,wzae2lo15u8j,38737,38738,77475
41851,,8chxzdtnvzuj,38738,38739,77477
41852,,mdwphcbe_juj,38739,38740,77479
41853,,xki8vm3o9ksj,38740,38741,77481
41854,,yosywe9ly4ij,38741,38742,77483
41855,,tt2en36wfiej,38742,38743,77485
41856,,fz1taoqcibmj,38743,38744,77487
41857,,7uxygdisutsj,38744,38745,77489
41858,,zasifvpceo8j,38745,38746,77491
41859,,gxfemdaz7iwj,38746,38747,77493
41860,,kxrluksxlqoj,38748,38749,77497
41861,,ygpadrgw6muj,38749,38750,77499
41862,,60bdtk58sqoj,38750,38751,77501
41863,,ewbsr4wu9ymj,38751,38752,77503
41864,,eq63hkjrbbyj,38752,38753,77505
41865,,kpbctldvta0j,38753,38754,77507
41866,,url:http://portal.acm.org/ft_gateway.cfm3fid3d110122126type3dpdf,38754,38755,77509
41867,,0se-tfgmmscj,38756,38757,77513
41868,,trdwponue3cj,38757,38758,77515
41869,,rtjenhuruhkj,38758,38759,77517
41870,,bps-qnjrck8j,38759,38760,77519
41871,,lnimptw3uzej,38760,38761,77521
41872,,ri7twedqsa4j,38762,38763,77525
41873,,u61_xclki7gj,38763,38764,77527
41874,,oamkge_oiraj,38764,38765,77529
41875,,onsmq_468fgj,38765,38766,77531
41876,,ytz5s2fu5xqj,38766,38767,77533
41877,,ph6_p9x6fv0j,38767,38768,77535
41878,,xcbrh53ji4mj,38769,38770,77539
41879,,xgxl_p6jm7yj,38770,38771,77541
41880,,px4jslmpzwcj,38771,38772,77543
41881,,ywknrsgsticj,38772,38773,77545
41882,,yhndbk12aj4j,38773,38774,77547
41883,,url:http://doi.wiley.com/10.1002/he.133,38774,38775,77549
41884,,82bicol7kk8j,38775,38776,77551
41885,,0vj1hqme91yj,38776,38777,77553
41886,,jnrab3c7pgwj,38777,38778,77555
41887,,fu9ra1az2joj,38778,38779,77557
41888,,aj5ky4j_socj,38779,38780,77559
41889,,4sqx_req8akj,38780,38781,77561
41890,,cocvgpnhg_aj,38781,38782,77563
41891,,q5qvn7t5wxaj,38782,38783,77565
41892,,g97fwc89nacj,38783,38784,77567
41893,,url:http://doi.ieeecomputersociety.org/10.1109/tkde.2004.26,38784,38785,77569
41894,,ew4ftlr_hisj,38785,38786,77571
41895,,d9wmrvy8xzaj,38786,38787,77573
41896,,url:http://www.csa.com/partners/viewrecord.php3frequester3dgs26collection3dtrd26recid3d8608720304md26recid3d8607g2c0119ec26recid3d8607g2d0119ed26recid3d8607g2p0119ep,38787,38788,77575
41897,,0zhsxblz6t4j,38788,38789,77577
41898,,cg3xcirfk8cj,38789,38790,77579
41899,,y-l6axlaafij,38790,38791,77581
41900,,wpofqabbgu0j,38791,38792,77583
41901,,_mn9hsjos0aj,38792,38793,77585
41902,,j4cfis8fwbyj,38793,38794,77587
41903,,swilrirlb8wj,38794,38795,77589
41904,,l-jclckfjrej,38795,38796,77591
41905,,20sfbifhpeqj,38796,38797,77593
41906,,e08r_of0avcj,38797,38798,77595
41907,,5hjldgmxizej,38798,38799,77597
41908,,soji6iizsa8j,38799,38800,77599
41909,,rw6p_z3auzcj,38800,38801,77601
41910,,ewfhfobl2mqj,38801,38802,77603
41911,,qcc3ihupfpaj,38802,38803,77605
41912,,y205ene_jmqj,38804,38805,77609
41913,,yhamnbz8icyj,38805,38806,77611
41914,,url:http://portal.acm.org/ft_gateway.cfm3fid3d109971726type3dpdf,38806,38807,77613
41915,,xg4y1ub1rhaj,38807,38808,77615
41916,,ze6ilhzdbqij,38808,38809,77617
41917,,3qhmsj3hjjgj,38809,38810,77619
41918,,h_z4wrbaubkj,38810,38811,77621
41919,,wkcfg_bokuoj,38811,38812,77623
41920,,jatmhzq_ceij,38812,38813,77625
41921,,tvcplsbuq2uj,38813,38814,77627
41922,,m04o27eifzwj,38814,38815,77629
41923,,txa_ycb6h-gj,38815,38816,77631
41924,,dbqp-p741dcj,38816,38817,77633
41925,,sjerxhayjaaj,38817,38818,77635
41926,,ztmxoixankcj,38818,38819,77637
41927,,hnxh3ozxzlgj,38819,38820,77639
41928,,eezvksy3w5yj,38820,38821,77641
41929,,knfbb_mkyewj,38821,38822,77643
41930,,6wvsowzhkoaj,38822,38823,77645
41931,,h_gjzl8dsqej,38823,38824,77647
41932,,ll0df1sat10j,38824,38825,77649
41933,,8-i-cnspzrij,38825,38826,77651
41934,,viijvkmvgngj,38826,38827,77653
41935,,tod1u4b1d4kj,38827,38828,77655
41936,,lnjkngzxkp4j,38828,38829,77657
41937,,hiti8s6jmvaj,38829,38830,77659
41938,,url:http://portal.acm.org/citation.cfm3fid3d601858.60186726dl3dguide26dl3dacm26idx3dj68926part3dperiodical26wanttype3dperiodical26title3dacm2520sigmod2520record26cfid3d1111111126cftoken3d2222222,38830,38831,77661
41939,,sbgoukuotguj,38831,38832,77663
41940,,lr82sbcmzkgj,38832,38833,77665
41941,,_q7tmdlyukmj,38833,38834,77667
41942,,vumppr6k95aj,38834,38835,77669
41943,,2jdgivlyxsuj,38835,38836,77671
41944,,5qnjjb8uthgj,38836,38837,77673
41945,,_f5xtsv_mz8j,38837,38838,77675
41946,,ombwwgkjzsuj,38838,38839,77677
41947,,0kcwov729asj,38839,38840,77679
41948,,3kigwvdkkjuj,38840,38841,77681
41949,,c_neihimfjmj,38841,38842,77683
41950,,ikeqv3bhor4j,38842,38843,77685
41951,,exzzqyjjuqaj,38843,38844,77687
41952,,url:http://www.csa.com/partners/viewrecord.php3frequester3dgs26collection3dtrd26recid3d0116698ci,38844,38845,77689
41953,,koo3549ny2kj,38845,38846,77691
41954,,ghao2se95cyj,38846,38847,77693
41955,,url:http://doi.wiley.com/10.1002/ev.1501,38847,38848,77695
41956,,wt9fk_vo6ykj,38848,38849,77697
41957,,nczkki9taomj,38849,38850,77699
41958,,jhkbzps0yuqj,38850,38851,77701
41959,,_sud4auz5aaj,38851,38852,77703
41960,,lqyrzqangmgj,38852,38853,77705
41961,,st1ty3lp55wj,38853,38854,77707
41962,,6fzm2r7gybmj,38854,38855,77709
41963,,vwd-ublptgij,38856,38857,77713
41964,,arymv7hebswj,38857,38858,77715
41965,,qqshhipfqigj,38858,38859,77717
41966,,eoj2py_7l0ej,38859,38860,77719
41967,,7c-grus6ubsj,38860,38861,77721
41968,,tnjwctw60x0j,38861,38862,77723
41969,,micls7evaguj,38862,38863,77725
41970,,bh5ql4rbp9mj,38863,38864,77727
41971,,hk0njr_ohh4j,38864,38865,77729
41972,,q49jrr3bzboj,38865,38866,77731
41973,,w2u7rb_58pkj,38866,38867,77733
41974,,3qsbud0sdioj,38867,38868,77735
41975,,p69u-5lwoguj,38868,38869,77737
41976,,iem1-sepnlij,38869,38870,77739
41977,,hwfvhoxf7q8j,38870,38871,77741
41978,,u6on5bccb44j,38871,38872,77743
41979,,wa5b_zmozg0j,38873,38874,77747
41980,,ofnljs1frn0j,38874,38875,77749
41981,,8do04xiwzvyj,38876,38877,77753
41982,,g-sa8xmajkaj,38877,38878,77755
41983,,ffewtxdskzgj,38878,38879,77757
41984,,io4ompida94j,38879,38880,77759
41985,,url:http://portal.acm.org/citation.cfm3fid3d14181826dl3dguide26dl3dacm26type3dissue26idx3dj68926part3dperiodical26wanttype3dperiodical26title3dacm2520sigmod2520record26cfid3d1111111126cftoken3d2222222,38880,38881,77761
41986,,wrwksjaj_58j,38881,38882,77763
41987,,4iskr5poapej,38882,38883,77765
41988,,s3z71lld5amj,38883,38884,77767
41989,,fafzacrlbhqj,38884,38885,77769
41990,,gfvntjadvvyj,38885,38886,77771
41991,,18lzogy5eaaj,38886,38887,77773
41992,,rygj2zgrmtqj,38887,38888,77775
41993,,bb5hjwtokkej,38888,38889,77777
41994,,_5yoobsa62uj,38889,38890,77779
41995,,s5xkzyaqiaqj,38890,38891,77781
41996,,ek-uyjzmwsyj,38891,38892,77783
41997,,url:http://ieeexplore.ieee.org/iel1/2206/2029/00056133.pdf3farnumber3d56133,38892,38893,77785
41998,,zwnvlwvtip0j,38893,38894,77787
41999,,5cu67guyeyyj,38894,38895,77789
42000,,url:http://www.springerlink.com/index/p8735323712t2281.pdf,38895,38896,77791
42001,,omgtigmkhckj,38896,38897,77793
42002,,v3yjj1dbcyaj,38897,38898,77795
42003,,xalxv809jskj,38898,38899,77797
42004,,puvemcynffgj,38899,38900,77799
42005,,v1uqzf3l9a8j,38900,38901,77801
42006,,kibwqoukcwyj,38901,38902,77803
42007,,3hzz4xrhh5oj,38902,38903,77805
42008,,xwffmiadh_mj,38903,38904,77807
42009,,v1fswcspn2mj,38904,38905,77809
42010,,fioyfpsrgqej,38905,38906,77811
42011,,g-xed7zslyuj,38906,38907,77813
42012,,cjklb_mbpmaj,38907,38908,77815
42013,,_1slurmfzdoj,38908,38909,77817
42014,,url:http://portal.acm.org/ft_gateway.cfm3fid3d7412226type3dpdf26coll3dguide26dl3dacm26cfid3d1111111126cftoken3d2222222,38909,38910,77819
42015,,url:http://portal.acm.org/ft_gateway.cfm3fid3d106626426type3dpdf,38910,38911,77821
42016,,f3j6kkkpmk0j,38911,38912,77823
42017,,ml1rm9tqatej,38912,38913,77825
42018,,dzuxvdwm6swj,38913,38914,77827
42019,,r3lx4nz_udyj,38914,38915,77829
42020,,6jvslncl6isj,38915,38916,77831
42021,,mkgchvzkpkkj,38916,38917,77833
42022,,url:http://portal.acm.org/citation.cfm3fid3d50927426dl3dacm26coll3dportal26cfid3d1111111126cftoken3d2222222,38917,38918,77835
42023,,atzkip1faloj,38918,38919,77837
42024,,vykmpm-vhimj,38919,38920,77839
42025,,url:http://portal.acm.org/ft_gateway.cfm3fid3d56511926type3dpdf26dl3dguide26dl3dacm26cfid3d1111111126cftoken3d2222222,38920,38921,77841
42026,,qh1kkemlnccj,38921,38922,77843
42027,,rajyeutwu6yj,38922,38923,77845
42028,,2dslkcihzjuj,38923,38924,77847
42029,,f7fnmrl7n1aj,38924,38925,77849
42030,,sqva0l86yqaj,38925,38926,77851
42031,,jejuwpfapm0j,38926,38927,77853
42032,,rq15xkzapymj,38927,38928,77855
42033,,mefttkdu6soj,38928,38929,77857
42034,,cvv3__b_vlej,38929,38930,77859
42035,,xj4atbplur4j,38930,38931,77861
42036,,yuuvni-o4fqj,38931,38932,77863
42037,,sbmfrkmcik8j,38932,38933,77865
42038,,b4xxizovvy0j,38933,38934,77867
42039,,fq3hcyputnwj,38934,38935,77869
42040,,dukhsts-mc8j,38935,38936,77871
42041,,pbsd0pm83i8j,38936,38937,77873
42042,,ghoyilbaczqj,38937,38938,77875
42043,,1fijq6zhuuqj,38938,38939,77877
42044,,a61jjvgyl_ej,38939,38940,77879
42045,,hohveok9bjuj,38940,38941,77881
42046,,fqjvtetvarkj,38941,38942,77883
42047,,nvm9s-2vljgj,38942,38943,77885
42048,,ruyyq5xdgnyj,38943,38944,77887
42049,,jmfmxrtkzgsj,38944,38945,77889
42050,,plfghb5vzwcj,38945,38946,77891
42051,,t14qqfsglxmj,38946,38947,77893
42052,,nxv_bm6lpkoj,38947,38948,77895
42053,,url:http://portal.acm.org/citation.cfm3fid3d1077961.1077973,38948,38949,77897
42054,,8ieutknsex4j,38949,38950,77899
42055,,am9zrb5azuqj,38950,38951,77901
42056,,uljo4td7b64j,38951,38952,77903
42057,,gmyyg63ltcuj,38952,38953,77905
42058,,,38953,38954,77907
42059,,vyq1maebkmij,38954,38955,77909
42060,,pmcq4jkp3vij,38955,38956,77911
42061,,9ohsb-ckynyj,38956,38957,77913
42062,,zt-gmae2rfaj,38957,38958,77915
42063,,ksv7sglz-jkj,38958,38959,77917
42064,,url:http://doi.wiley.com/10.1002/dc.10097,38959,38960,77919
42065,,ulsgbxicj7mj,38960,38961,77921
42066,,137tklgo17kj,38961,38962,77923
42067,,j8yz0k_cd4cj,38962,38963,77925
42068,,10jkfdju1zqj,38963,38964,77927
42069,,u0apwnsae5kj,38964,38965,77929
42070,,rz6pqqvikdyj,38965,38966,77931
42071,,pgftmyv6j-aj,38966,38967,77933
42072,,e6pirenjajuj,38967,38968,77935
42073,,944kualmgrkj,38969,38970,77939
42074,,aa9pufkp5hej,38970,38971,77941
42075,,8wjwmcxvlcqj,38971,38972,77943
42076,,url:http://www.geography.org.uk/journals/download.asp3farticleid3d156,38972,38973,77945
42077,,3sbiyrl-o74j,38974,38975,77949
42078,,zmuarae81b8j,38975,38976,77951
42079,,gd98006cb9gj,38976,38977,77953
42080,,0qvuaukvoucj,38977,38978,77955
42081,,83miv81wkkgj,38978,38979,77957
42082,,9u5xniajpmej,38979,38980,77959
42083,,url:http://adsabs.harvard.edu/abs/1980phdt........27a,38981,38982,77963
42084,,pkjslpqxjxgj,38982,38983,77965
42085,,gmxmsinjv1kj,38984,38985,77969
42086,,lxvuvi-q20ij,38985,38986,77971
42087,,qhu_3bzsglqj,38986,38987,77973
42088,,drll3v5n3foj,38987,38988,77975
42089,,dt7dzog4h4qj,38989,38990,77979
42090,,em8_5n1i2mkj,38991,38992,77983
42091,,url:http://portal.acm.org/ft_gateway.cfm3fid3d101779926type3dpdf,38992,38993,77985
42092,,yasocpxlhlqj,38993,38994,77987
42093,,7xvvu-8mkjgj,38994,38995,77989
42094,,5qapql9qtrij,38995,38996,77991
42095,,url:http://links.jstor.org/sici3fsici3d0146-4949(196424252f21)5253a1253c54253a2522cjc2522253e2.0.co253b2-k,38996,38997,77993
42096,,fnmhjw12fruj,38997,38998,77995
42097,,3fbj1mzctgkj,38998,38999,77997
42098,,uj3icjmotakj,38999,39000,77999
42099,,url:http://www.ingentaconnect.com/content/els/09505849/1995/00000037/00000002/art93486,39000,39001,78001
42100,,3ciutseuovcj,39001,39002,78003
42101,,ilkwvlgwut4j,39002,39003,78005
42102,,e66kxitmar4j,39003,39004,78007
42103,,6skosevxqlkj,39004,39005,78009
42104,,nkocrynnqukj,39005,39006,78011
42105,,7v9lpaiq4kej,39006,39007,78013
42106,,kwds5fdtt98j,39007,39008,78015
42107,,xkzhyaf44aaj,39008,39009,78017
42108,,cvxsxae9cxoj,39009,39010,78019
42109,,k1jblbjbn00j,39010,39011,78021
42110,,wpoa6kxpunaj,39011,39012,78023
42111,,url:http://books.google.com/books3fhl3den26lr3d26id3dd21pdfet1bac26oi3dfnd26pg3dpa126sig3dvvuwvbaxjptp75ydftuyouqfxck26prev3dhttp://scholar.google.com/scholar253fstart253d2002526num253d1002526hl253den2526lr253d2526sa253dn,39012,39013,78025
42112,,dexdgfwyxhoj,39013,39014,78027
42113,,xuvhvybwesgj,39014,39015,78029
42114,,rnl0mgkppdsj,39015,39016,78031
42115,,bt16gyo-hx8j,39016,39017,78033
42116,,nzusgwxjy7gj,39017,39018,78035
42117,,whg9egny49gj,39018,39019,78037
42118,,ajlgeyziy8qj,39019,39020,78039
42119,,p8xputpsidij,39020,39021,78041
42120,,uieswfitmpij,39021,39022,78043
42121,,opuaxvhfln8j,39022,39023,78045
42122,,0jkpw72mjn0j,39023,39024,78047
42123,,u_1rdxvuziaj,39024,39025,78049
42124,,wr9npixka04j,39025,39026,78051
42125,,swyctkxofgyj,39026,39027,78053
42126,,3fqbks2g-bmj,39027,39028,78055
42127,,emhqtm102-gj,39028,39029,78057
42128,,ivm9fhl3g4qj,39029,39030,78059
42129,,h7wrdjhwqxij,39030,39031,78061
42130,,url:http://www.csa.com/partners/viewrecord.php3frequester3dgs26collection3dtrd26recid3d20021214044998mt26recid3da7212143ah,39031,39032,78063
42131,,url:http://portal.acm.org/ft_gateway.cfm3fid3d106629226type3dpdf,39032,39033,78065
42132,,hmjq6xlqg2ij,39033,39034,78067
42133,,jv0r5aowmsuj,39034,39035,78069
42134,,yetl7r2xzqyj,39035,39036,78071
42135,,pyfvtseeeumj,39036,39037,78073
42136,,dgc6ejltxwij,39037,39038,78075
42137,,zorcb_spxbgj,39038,39039,78077
42138,,llrqgbman0mj,39039,39040,78079
42139,,i3n7sjoy3i4j,39040,39041,78081
42140,,krpjaldhgdcj,39041,39042,78083
42141,,,39042,39043,78085
42142,,mdwpqv0nxewj,39043,39044,78087
42143,,bwq_agrktnij,39044,39045,78089
42144,,9idz13mwkbyj,39045,39046,78091
42145,,lli7mysraikj,39046,39047,78093
42146,,qydz787agnqj,39047,39048,78095
42147,,udto8zasuuej,39048,39049,78097
42148,,vepxrcjsg2aj,39049,39050,78099
42149,,2ibg4uipy8wj,39050,39051,78101
42150,,z4d2flsd7kcj,39051,39052,78103
42151,,eyskfznsnbmj,39052,39053,78105
42152,,url:http://doi.wiley.com/10.1002/ace.110,39053,39054,78107
42153,,glnt2qvqi1wj,39054,39055,78109
42154,,m7nqypp7sx0j,39055,39056,78111
42155,,paahjo-pxsij,39056,39057,78113
42156,,vdzfjyidjuyj,39057,39058,78115
42157,,qdvs2zfwuhij,39059,39060,78119
42158,,vnjv7cvabvmj,39060,39061,78121
42159,,w1wrigtcucqj,39061,39062,78123
42160,,f21orurautmj,39062,39063,78125
42161,,fi4uoq_jpkmj,39063,39064,78127
42162,,sriarvpualmj,39064,39065,78129
42163,,qygzjvmvjs8j,39065,39066,78131
42164,,dniylpo4y3ej,39066,39067,78133
42165,,zwqt3hbam_mj,39067,39068,78135
42166,,fsz4rps_2x0j,39068,39069,78137
42167,,youo5xeyg5uj,39069,39070,78139
42168,,oqy6ybwcrnyj,39070,39071,78141
42169,,zr0y_bxkw8sj,39071,39072,78143
42170,,qxhdy9ingmoj,39072,39073,78145
42171,,oxpsdmmfi2sj,39073,39074,78147
42172,,scvi9cgaq_yj,39074,39075,78149
42173,,qg-ve5xgnccj,39075,39076,78151
42174,,bkhgcjv3l6sj,39076,39077,78153
42175,,ywoivet15zej,39077,39078,78155
42176,,fisbz3xhpe0j,39078,39079,78157
42177,,arke9ua6xduj,39079,39080,78159
42178,,m0oiippizd0j,39080,39081,78161
42179,,dkzny8cotuaj,39081,39082,78163
42180,,qd7hvb7r0c0j,39083,39084,78167
42181,,tnoqkngahpij,39084,39085,78169
42182,,hi3krcuwkdmj,39085,39086,78171
42183,,rnlof5nyjpcj,39087,39088,78175
42184,,5fxuspqfyl0j,39088,39089,78177
42185,,url:http://links.jstor.org/sici3fsici3d0146-4949(196424252f21)5253a1253c5253atwata253e2.0.co253b2-p,39089,39090,78179
42186,,cxergcdwv4ij,39090,39091,78181
42187,,p9xh6der33sj,39091,39092,78183
42188,,_etk9nthhu0j,39092,39093,78185
42189,,xijw9synx7mj,39093,39094,78187
42190,,url:http://doi.wiley.com/10.1002/ace.8707,39094,39095,78189
42191,,url:http://www.ingentaconnect.com/content/els/13891286/2000/00000032/00000005/art00016,39095,39096,78191
42192,,s6nn60la4eqj,39096,39097,78193
42193,,kgrxqxtba5ej,39097,39098,78195
42194,,r693jhz8jmaj,39098,39099,78197
42195,,he-_jryc-f8j,39099,39100,78199
42196,,_zyvpwgbbbcj,39100,39101,78201
42197,,er8571wxl6ej,39101,39102,78203
42198,,sgv_qs5vuoej,39102,39103,78205
42199,,h74o8pcbwq8j,39103,39104,78207
42200,,v7zqofbe8u4j,39104,39105,78209
42201,,khyieoofxvkj,39106,39107,78213
42202,,q8ubgvwm2pgj,39107,39108,78215
42203,,bksfj4lhbqcj,39108,39109,78217
42204,,awtqfl-ck_kj,39109,39110,78219
42205,,pp9nsnx5mckj,39110,39111,78221
42206,,2wnzydfj3xoj,39111,39112,78223
42207,,io2ynka57a8j,39112,39113,78225
42208,,gpw4kvq333sj,39113,39114,78227
42209,,s_oaab8wbmaj,39114,39115,78229
42210,,nbgdthlrqiej,39115,39116,78231
42211,,lzgzszkyjj8j,39116,39117,78233
42212,,ogr0qv6w1bmj,39117,39118,78235
42213,,hoi0t_8so4gj,39118,39119,78237
42214,,nzx2fgmpneij,39119,39120,78239
42215,,pkl4dzhrm6kj,39120,39121,78241
42216,,hmcth-tl3ckj,39121,39122,78243
42217,,gisca-hlmsij,39122,39123,78245
42218,,3w8t8o8xy5uj,39123,39124,78247
42219,,ln7gwalbwnqj,39124,39125,78249
42220,,j9dkekey4akj,39125,39126,78251
42221,,oq69sjtu-voj,39126,39127,78253
42222,,yhk3brevkbej,39127,39128,78255
42223,,9jkwd0ps1vyj,39128,39129,78257
42224,,sjsjwwkg9y8j,39129,39130,78259
42225,,_lrmfn44imuj,39130,39131,78261
42226,,ckiy3t8yfa4j,39131,39132,78263
42227,,7jux10sutngj,39132,39133,78265
42228,,fuo3prjlzwaj,39133,39134,78267
42229,,w0hl-_rldgqj,39134,39135,78269
42230,,tbyf0suvidkj,39135,39136,78271
42231,,p3tzajfxisij,39136,39137,78273
42232,,ktp1qlyald4j,39137,39138,78275
42233,,bbfpaub_hoqj,39138,39139,78277
42234,,6hsenecu8ryj,39139,39140,78279
42235,,vlzb0dn2o3ij,39140,39141,78281
42236,,8aocsexrpoyj,39141,39142,78283
42237,,6wmj9nf8h_4j,39142,39143,78285
42238,,52d6vbtpohgj,39144,39145,78289
42239,,4sfzbiv8xnyj,39145,39146,78291
42240,,rffkoplaruqj,39146,39147,78293
42241,,vonqrs25cv8j,39147,39148,78295
42242,,s5e3sukud6kj,39148,39149,78297
42243,,xnmxr70fnwij,39149,39150,78299
42244,,i7lvqgqkfx0j,39150,39151,78301
42245,,kbhupthcq-qj,39151,39152,78303
42246,,pk-h1htfzqmj,39152,39153,78305
42247,,kek7p1e69ykj,39153,39154,78307
42248,,hz3hotdwuxqj,39154,39155,78309
42249,,dajx72iecbmj,39155,39156,78311
42250,,29ezmavjbuwj,39156,39157,78313
42251,,l5kjgtdbet4j,39157,39158,78315
42252,,m4tfdzhfpjij,39158,39159,78317
42253,,w18sd-jehvcj,39159,39160,78319
42254,,bprpyuqdvwwj,39160,39161,78321
42255,,vlpwh5gra90j,39161,39162,78323
42256,,a356hg96ky8j,39162,39163,78325
42257,,jnyuhsksnduj,39163,39164,78327
42258,,qlqxncstphij,39164,39165,78329
42259,,4qgley15vq4j,39166,39167,78333
42260,,6u8chqf6ia8j,39167,39168,78335
42261,,6ihlzi7prnaj,39168,39169,78337
42262,,v8pcvqfph68j,39169,39170,78339
42263,,9blowo4-wnmj,39170,39171,78341
42264,,nrhdwlsfut4j,39171,39172,78343
42265,,i5tangbwwomj,39172,39173,78345
42266,,z0l7zr67jb0j,39173,39174,78347
42267,,s-b_mkc6g98j,39174,39175,78349
42268,,w5ch7v5nieej,39175,39176,78351
42269,,hi85hedc0xij,39176,39177,78353
42270,,ak4ztcdp-xcj,39177,39178,78355
42271,,iyttzte5qpyj,39178,39179,78357
42272,,b-t6mun-xd8j,39179,39180,78359
42273,,j4j8nltp8rwj,39180,39181,78361
42274,,sesel2gscjoj,39181,39182,78363
42275,,f-3zs1wmstcj,39182,39183,78365
42276,,winigpoa4koj,39183,39184,78367
42277,,dnmlzjsxogcj,39184,39185,78369
42278,,ibjojunobioj,39185,39186,78371
42279,,qjwy38hcamgj,39186,39187,78373
42280,,gcbixi_bl1kj,39187,39188,78375
42281,,f5fc1calg5ej,39188,39189,78377
42282,,d5fgx1lputcj,39189,39190,78379
42283,,,39190,39191,78381
42284,,at7awp67qq4j,39191,39192,78383
42285,,gc4sddwxe9qj,39192,39193,78385
42286,,znxii0vbnr0j,39193,39194,78387
42287,,5ohxszoj_i0j,39194,39195,78389
42288,,scvfqbnprvij,39195,39196,78391
42289,,,39196,39197,78393
42290,,xrkzkj-rhjaj,39197,39198,78395
42291,,ilr-ulem1c0j,39198,39199,78397
42292,,usafmlhbqlgj,39199,39200,78399
42293,,dnqj3ns0uzwj,39200,39201,78401
42294,,nrbtagxscxoj,39201,39202,78403
42295,,r6re-z7hrwoj,39202,39203,78405
42296,,6jzyh2hyymsj,39203,39204,78407
42297,,vryloqgibdcj,39204,39205,78409
42298,,jd64rodslwsj,39205,39206,78411
42299,,nmcnw9xmgc0j,39206,39207,78413
42300,,map0dbsck4wj,39207,39208,78415
42301,,lnuwyoiu_n0j,39208,39209,78417
42302,,ea4g2pb6y0uj,39209,39210,78419
42303,,eor6elh3cokj,39210,39211,78421
42304,,ys4wxup7mquj,39211,39212,78423
42305,,okva3xfn5fyj,39212,39213,78425
42306,,amgq0q2i8tij,39213,39214,78427
42307,,q8mxrleflz8j,39214,39215,78429
42308,,1gpjn9h1xwej,39215,39216,78431
42309,,drs5zyhonn8j,39217,39218,78435
42310,,0w3wfoqp1dsj,39218,39219,78437
42311,,o1w4aenxlnsj,39219,39220,78439
42312,,9cco3dmh9syj,39220,39221,78441
42313,,_rpelir-gu8j,39221,39222,78443
42314,,5utmpabm9h0j,39223,39224,78447
42315,,4penbzlkndwj,39224,39225,78449
42316,,i3x5jsvpwkuj,39225,39226,78451
42317,,ifjm9j5e9ekj,39226,39227,78453
42318,,itqn_tcxr-gj,39227,39228,78455
42319,,2h1ed5lzq2uj,39228,39229,78457
42320,,due5v8ivr4ij,39229,39230,78459
42321,,pgzponyzp3gj,39230,39231,78461
42322,,nvdorgqkhycj,39231,39232,78463
42323,,lyrcmubwibmj,39232,39233,78465
42324,,tabwqafri-yj,39233,39234,78467
42325,,fzpwzkvcotwj,39234,39235,78469
42326,,kwesuruqqdgj,39235,39236,78471
42327,,t9litixgdjsj,39236,39237,78473
42328,,eav6_jog5zaj,39237,39238,78475
42329,,,39238,39239,78477
42330,,mnjsype2s6sj,39239,39240,78479
42331,,2t6l7vmwnvaj,39240,39241,78481
42332,,n7ifc7gnpn4j,39241,39242,78483
42333,,nz3layjiyeej,39242,39243,78485
42334,,q4ehitotezuj,39243,39244,78487
42335,,nc3_-usgnxaj,39244,39245,78489
42336,,fxzrwg60xaej,39245,39246,78491
42337,,cgjqflo5kgyj,39246,39247,78493
42338,,cfkf-x7wmr0j,39247,39248,78495
42339,,6kivpg9ol-gj,39248,39249,78497
42340,,url:http://portal.acm.org/citation.cfm3fid3d144111.144132,39249,39250,78499
42341,,85p7equhwksj,39250,39251,78501
42342,,url:http://www.csa.com/partners/viewrecord.php3frequester3dgs26collection3dtrd26recid3dn9210440ah,39251,39252,78503
42343,,fgb5jo7eicsj,39252,39253,78505
42344,,cnpvh8izqcyj,39253,39254,78507
42345,,lpl1qa3j78oj,39254,39255,78509
42346,,wyehciw83-wj,39255,39256,78511
42347,,oick-ibculaj,39256,39257,78513
42348,,ssvinwapc1yj,39257,39258,78515
42349,,6fxebwnm78ej,39258,39259,78517
42350,,vc8epxlvi-wj,39259,39260,78519
42351,,s149nattdwyj,39260,39261,78521
42352,,,39261,39262,78523
42353,,hhl5zufk8kuj,39262,39263,78525
42354,,wds-mevyugoj,39263,39264,78527
42355,,segxz-dfwnwj,39264,39265,78529
42356,,ctbursu4d1gj,39265,39266,78531
42357,,s-jblja5sxkj,39266,39267,78533
42358,,3pa-k4xflb0j,39267,39268,78535
42359,,cme9gl4qao0j,39268,39269,78537
42360,,u5hmk5ta9gcj,39269,39270,78539
42361,,nhjempfe13ej,39270,39271,78541
42362,,bzwr3ewmjvoj,39271,39272,78543
42363,,zyl9nwj1gi4j,39272,39273,78545
42364,,url:http://www.csa.com/partners/viewrecord.php3frequester3dgs26collection3dtrd26recid3dn9210585ah,39273,39274,78547
42365,,oti_coaph9ij,39274,39275,78549
42366,,dtpv0fpqzaij,39275,39276,78551
42367,,aca2cigq2maj,39276,39277,78553
42368,,ynqj76bsulwj,39277,39278,78555
42369,,etehlbprebuj,39278,39279,78557
42370,,2utrt45tmxcj,39279,39280,78559
42371,,e-4nqkbjergj,39280,39281,78561
42372,,091hexuiwxwj,39281,39282,78563
42373,,5h5ivf5kmdyj,39282,39283,78565
42374,,ox8cgyfstpsj,39283,39284,78567
42375,,z4a6mo1itg4j,39284,39285,78569
42376,,g9fxunddxoij,39285,39286,78571
42377,,f1jts6bsj4gj,39286,39287,78573
42378,,oe6v2h7qgv8j,39287,39288,78575
42379,,q6kw29ega98j,39288,39289,78577
42380,,duhxctyd-vuj,39289,39290,78579
42381,,d5vsp1fgbc4j,39290,39291,78581
42382,,url:http://portal.acm.org/citation.cfm3fid3d171926.171951,39291,39292,78583
42383,,4ed5mc2lgt4j,39292,39293,78585
42384,,k-nzmymrxoij,39293,39294,78587
42385,,r7t2evhc8kej,39294,39295,78589
42386,,tpwbozpz2gmj,39295,39296,78591
42387,,z84rsob6hyaj,39296,39297,78593
42388,,32__lz4kmwwj,39297,39298,78595
42389,,dxwn_0cdvrcj,39299,39300,78599
42390,,ulskbf2f_dej,39300,39301,78601
42391,,myfeprxeikoj,39301,39302,78603
42392,,c_jhjg3sbuwj,39302,39303,78605
42393,,apypsze7axgj,39303,39304,78607
42394,,ft5azz3lpymj,39304,39305,78609
42395,,gpedva0ij6mj,39305,39306,78611
42396,,milnlvl0q1yj,39306,39307,78613
42397,,j2niqh4d-9aj,39307,39308,78615
42398,,8z0jhkuy2j0j,39308,39309,78617
42399,,jleihu2auqyj,39309,39310,78619
42400,,fesq7jccqvaj,39310,39311,78621
42401,,9j4sjwqglyoj,39311,39312,78623
42402,,ndhrxjpaanej,39312,39313,78625
42403,,q1p6pl_zjacj,39313,39314,78627
42404,,ijqftks5dbgj,39314,39315,78629
42405,,qjgokzyqwegj,39315,39316,78631
42406,,bp9vf7z9-yoj,39316,39317,78633
42407,,zc-krcn-gt8j,39317,39318,78635
42408,,url:http://portal.acm.org/citation.cfm3fid3d263666,39318,39319,78637
42409,,1yv3it6jem0j,39319,39320,78639
42410,,ngubprizi4ij,39320,39321,78641
42411,,pdon9atlqtaj,39321,39322,78643
42412,,j09k7pshj1kj,39322,39323,78645
42413,,2usdpiapv64j,39323,39324,78647
42414,,vlabkwuawqgj,39324,39325,78649
42415,,r0h-dngfveqj,39325,39326,78651
42416,,mhdfvsc3oewj,39326,39327,78653
42417,,nridtl0qcqyj,39327,39328,78655
42418,,wjnmy2nig10j,39328,39329,78657
42419,,yxih2ug2qvgj,39329,39330,78659
42420,,jmo985qd6esj,39330,39331,78661
42421,,qnhy5iwyjtmj,39331,39332,78663
42422,,kgci8unjcdgj,39333,39334,78667
42423,,akwmwp7qcuej,39334,39335,78669
42424,,bangbt11f7mj,39336,39337,78673
42425,,uuq2vexlea4j,39337,39338,78675
42426,,8rcoy9ma_54j,39338,39339,78677
42427,,n-urkef9l8kj,39339,39340,78679
42428,,wsqzzj42akej,39340,39341,78681
42429,,01qqehymjeyj,39341,39342,78683
42430,,_odfc1ar4caj,39342,39343,78685
42431,,0dxvhl2l2skj,39343,39344,78687
42432,,94bkxnwj-gij,39344,39345,78689
42433,,on_0bnz5smoj,39345,39346,78691
42434,,gom7ja-re1qj,39346,39347,78693
42435,,f1wg59h_qxaj,39347,39348,78695
42436,,hf4wfcitzeij,39348,39349,78697
42437,,-0irogrnfx4j,39349,39350,78699
42438,,4k6_edw6ymaj,39350,39351,78701
42439,,dmcss-miyhij,39351,39352,78703
42440,,lrp0iajaocmj,39352,39353,78705
42441,,7j-ongmswssj,39353,39354,78707
42442,,url:http://portal.acm.org/ft_gateway.cfm3fid3d109971526type3dpdf,39354,39355,78709
42443,,habvc8qxpu8j,39355,39356,78711
42444,,16tlmwhi2ewj,39356,39357,78713
42445,,4rb6qq2fz0ij,39357,39358,78715
42446,,sbyugusfttyj,39358,39359,78717
42447,,jtcyx4vdt-mj,39359,39360,78719
42448,,t_et-5_blcyj,39360,39361,78721
42449,,xcgceil9qxuj,39361,39362,78723
42450,,v3qx8m90vl4j,39362,39363,78725
42451,,vzumhh_mfgaj,39363,39364,78727
42452,,igy5cos2xtwj,39364,39365,78729
42453,,olbpla3ajlqj,39365,39366,78731
42454,,ebcpbhvdikyj,39366,39367,78733
42455,,x9n24ouqlwej,39367,39368,78735
42456,,rnvdf1c6b5kj,39368,39369,78737
42457,,hfged6ksij4j,39369,39370,78739
42458,,niizpqld3haj,39370,39371,78741
42459,,iml8ksnxnvoj,39371,39372,78743
42460,,mus7faujemcj,39372,39373,78745
42461,,6tzbs2n2c_ej,39373,39374,78747
42462,,ohagghwialej,39375,39376,78751
42463,,nntx4cxmv_aj,39376,39377,78753
42464,,ex5ktvyjad0j,39378,39379,78757
42465,,wt_hvsl9pwqj,39379,39380,78759
42466,,qjwzysvmpiaj,39380,39381,78761
42467,,yrq-cuz4rfoj,39381,39382,78763
42468,,wyceljzgm5qj,39382,39383,78765
42469,,200kdkjzelwj,39383,39384,78767
42470,,ud12vkbzm8uj,39384,39385,78769
42471,,bkz0qljeitoj,39385,39386,78771
42472,,1r4jjbbvmq0j,39386,39387,78773
42473,,aupyr9bhnimj,39388,39389,78777
42474,,3pzvlugth-qj,39389,39390,78779
42475,,n-ixc1bxu08j,39390,39391,78781
42476,,h2ubipi5w-ij,39391,39392,78783
42477,,j6bj_ubjxiij,39392,39393,78785
42478,,qtggdxifufij,39393,39394,78787
42479,,crbrx6pjoboj,39394,39395,78789
42480,,url:http://portal.acm.org/ft_gateway.cfm3fid3d105816626type3dpdf,39395,39396,78791
42481,,_vbyw092kpgj,39396,39397,78793
42482,,e2rqcgflltyj,39397,39398,78795
42483,,zfveggxhtbyj,39398,39399,78797
42484,,lck0bmr_g5ej,39399,39400,78799
42485,,rf5riomxyaoj,39400,39401,78801
42486,,leze18ctf9wj,39401,39402,78803
42487,,g_zz7gcqy6gj,39402,39403,78805
42488,,1kzby1x5huej,39403,39404,78807
42489,,jkyotumks0aj,39404,39405,78809
42490,,pncctx6mm88j,39405,39406,78811
42491,,pqyhdogoohij,39407,39408,78815
42492,,zde6z3cnudsj,39408,39409,78817
42493,,u5nl-kvx-4wj,39409,39410,78819
42494,,94o1jm8zbxcj,39411,39412,78823
42495,,ckiogjcxxbgj,39412,39413,78825
42496,,fra5wkvigwqj,39413,39414,78827
42497,,jfy8lbsoplcj,39414,39415,78829
42498,,t471wxlerdkj,39415,39416,78831
42499,,url:http://www.springerlink.com/index/k1l2353p181314x8.pdf,39416,39417,78833
42500,,3on6dc1vi9aj,39417,39418,78835
42501,,9ga5snmrjqij,39418,39419,78837
42502,,rcvbzam2hvyj,39419,39420,78839
42503,,se5ckfbg3caj,39420,39421,78841
42504,,1ttjxxuosuij,39421,39422,78843
42505,,2x0ifosj2s4j,39422,39423,78845
42506,,r3de-mq-q_oj,39423,39424,78847
42507,,8mf0bb7tlxuj,39424,39425,78849
42508,,amppzns-78oj,39425,39426,78851
42509,,0n5o66ogoyaj,39427,39428,78855
42510,,oh7dct7b-8aj,39428,39429,78857
42511,,oabgbn_lx3kj,39429,39430,78859
42512,,y8oci0fnmyej,39431,39432,78863
42513,,axjda0hweuij,39432,39433,78865
42514,,olkqsrs0pj0j,39433,39434,78867
42515,,o74wo4gjauuj,39434,39435,78869
42516,,nxt6fy_yxwkj,39435,39436,78871
42517,,fvkm3cuncfgj,39436,39437,78873
42518,,spnuly3x94uj,39437,39438,78875
42519,,aa8ol1i0cykj,39438,39439,78877
42520,,zgpkdwdnmz8j,39439,39440,78879
42521,,url:http://www.ingentaconnect.com/search/expand3fpub3dinfobike://els/13891286/2000/00000034/00000001/art0010026unc3d,39441,39442,78883
42522,,uvg4l9d7bkuj,39442,39443,78885
42523,,txjks__6orwj,39443,39444,78887
42524,,pb4lxjpebaij,39444,39445,78889
42525,,d6w0vnl9kcqj,39445,39446,78891
42526,,fo7zk1raabwj,39446,39447,78893
42527,,ahbr9vndbkqj,39447,39448,78895
42528,,m2ccu9cq5tgj,39448,39449,78897
42529,,3ig0frgcuaej,39449,39450,78899
42530,,zs9kibpabhcj,39450,39451,78901
42531,,iwnfzq4zt3kj,39451,39452,78903
42532,,30cxzeerjhmj,39452,39453,78905
42533,,rat67d_dkq8j,39453,39454,78907
42534,,ivre05gpk7oj,39454,39455,78909
42535,,hruaoqja_hsj,39455,39456,78911
42536,,zp6wlbjxwycj,39456,39457,78913
42537,,yca22fnfawsj,39457,39458,78915
42538,,b3fsjzk8etqj,39458,39459,78917
42539,,ksubyndlauwj,39459,39460,78919
42540,,xzsv1hgec9uj,39460,39461,78921
42541,,hh2i9t_ebgaj,39461,39462,78923
42542,,jen6knwuy0sj,39462,39463,78925
42543,,z4rk8x-uuqqj,39463,39464,78927
42544,,itb2uupjbsgj,39464,39465,78929
42545,,url:http://www.csa.com/partners/viewrecord.php3frequester3dgs26collection3dtrd26recid3d199404720350md26recid3d199404g2c0113ec26recid3d199404g2d0113ed26recid3d199404g2p0113ep,39465,39466,78931
42546,,z1gtfvlki78j,39466,39467,78933
42547,,ln9qv-y92foj,39467,39468,78935
42548,,r8fwkfxfboej,39468,39469,78937
42549,,tc8_tfmrc-uj,39469,39470,78939
42550,,ue_20czylxwj,39470,39471,78941
42551,,ww34nvgwlkgj,39471,39472,78943
42552,,gbqi7s0jtrij,39472,39473,78945
42553,,5zvrwjm-kosj,39473,39474,78947
42554,,dzfftmpesrqj,39474,39475,78949
42555,,6gypeaudjykj,39475,39476,78951
42556,,stlhvnndsxcj,39476,39477,78953
42557,,ih9f-nsuavoj,39477,39478,78955
42558,,6hunl3lcaj8j,39478,39479,78957
42559,,gmvklgjswbij,39479,39480,78959
42560,,fnqxlbhv1k8j,39480,39481,78961
42561,,edrkmgegte8j,39481,39482,78963
42562,,rx-ksohvfswj,39482,39483,78965
42563,,eoco0r63orgj,39483,39484,78967
42564,,kamzatkhcksj,39484,39485,78969
42565,,i4oqfqzru1gj,39486,39487,78973
42566,,xtgfnhecgawj,39487,39488,78975
42567,,3y0cjpeh8kqj,39488,39489,78977
42568,,frwn0eqipx4j,39489,39490,78979
42569,,s8-tkq2sxdoj,39490,39491,78981
42570,,a5ueumgbb9qj,39491,39492,78983
42571,,xfbld8n3jt8j,39492,39493,78985
42572,,oq5ptrqeb9cj,39493,39494,78987
42573,,gj_kdqwvgagj,39494,39495,78989
42574,,1ahczzi1jgaj,39495,39496,78991
42575,,tpzn1smtpqaj,39496,39497,78993
42576,,niectflncmcj,39497,39498,78995
42577,,zmmerrwulooj,39498,39499,78997
42578,,7i2kh6cbd_wj,39499,39500,78999
42579,,4yjavpdypqoj,39500,39501,79001
42580,,da_wro89jzij,39501,39502,79003
42581,,8p6ntykgipcj,39502,39503,79005
42582,,vabe51ei_imj,39503,39504,79007
42583,,aot83z6xi6cj,39504,39505,79009
42584,,wkncmye6qckj,39505,39506,79011
42585,,url:http://doi.wiley.com/10.1002/ev.1065,39506,39507,79013
42586,,len4slnpf6oj,39507,39508,79015
42587,,oi-u6vfqtfcj,39508,39509,79017
42588,,r6hy-ujvxbyj,39509,39510,79019
42589,,rybuv0_g3tsj,39510,39511,79021
42590,,gi0sajuc4yoj,39511,39512,79023
42591,,go_naqkvvxaj,39512,39513,79025
42592,,o_5qmkzc-ayj,39513,39514,79027
42593,,zgsqks7hocoj,39514,39515,79029
42594,,izkysmgamckj,39515,39516,79031
42595,,bytszjorueaj,39516,39517,79033
42596,,rrbkpms7fcuj,39517,39518,79035
42597,,xdj1lr5z5asj,39518,39519,79037
42598,,igf9ey0erecj,39519,39520,79039
42599,,42kzz_cilc0j,39520,39521,79041
42600,,8nrvk2qsfsgj,39521,39522,79043
42601,,jlzawca5me8j,39522,39523,79045
42602,,es4nhgth2ssj,39523,39524,79047
42603,,i5hibvmzpvcj,39524,39525,79049
42604,,udic7x4kqe8j,39525,39526,79051
42605,,93mtx4_6fx0j,39526,39527,79053
42606,,j4sciajjfhwj,39527,39528,79055
42607,,yoarociiqg4j,39528,39529,79057
42608,,1ameyfhhhr0j,39529,39530,79059
42609,,hm6jo3dd34sj,39530,39531,79061
42610,,lw9tqqunxqmj,39531,39532,79063
42611,,hxevlatnlgkj,39532,39533,79065
42612,,0yptj5v2d9wj,39533,39534,79067
42613,,tnlgbprthtyj,39534,39535,79069
42614,,b2lhvf8nwycj,39535,39536,79071
42615,,uxa-jw1jlnoj,39536,39537,79073
42616,,zwmjhkimtgoj,39537,39538,79075
42617,,potakim0vpwj,39538,39539,79077
42618,,url:http://www.ingentaconnect.com/search/expand3fpub3dinfobike://pep/jae/2003/00000217/00000003/art0000726unc3d,39539,39540,79079
42619,,nelrj0uqdzyj,39540,39541,79081
42620,,fmgc9cz5fmej,39541,39542,79083
42621,,jk4cfmscwfoj,39542,39543,79085
42622,,gk0i_dsj9jsj,39543,39544,79087
42623,,skgifv0dtqij,39544,39545,79089
42624,,pssksoa1kdwj,39545,39546,79091
42625,,otonaxqvpmyj,39546,39547,79093
42626,,8zzzqjh7ybmj,39547,39548,79095
42627,,mdkjmwikrr8j,39548,39549,79097
42628,,d9eokeqdsm0j,39549,39550,79099
42629,,nm73a-kf-mqj,39550,39551,79101
42630,,ilhhvddcchaj,39551,39552,79103
42631,,orx70p24bwij,39552,39553,79105
42632,,dfxzw1-ymo0j,39553,39554,79107
42633,,sqeo5pq1ngsj,39554,39555,79109
42634,,url:http://links.jstor.org/sici3fsici3d0146-4949(196422)5253a2253c105253aaeo2522lb253e2.0.co253b2-r,39555,39556,79111
42635,,hl8pv11i1maj,39556,39557,79113
42636,,nrlnizk_ocmj,39557,39558,79115
42637,,tdcenj0mmr4j,39558,39559,79117
42638,,vhu_-lluznej,39559,39560,79119
42639,,pminyl13nisj,39560,39561,79121
42640,,u6t2deoifigj,39561,39562,79123
42641,,mbtc3dsejmyj,39562,39563,79125
42642,,url:http://adsabs.harvard.edu/abs/1976stia...7642990k,39563,39564,79127
42643,,g4dvylqwptoj,39564,39565,79129
42644,,n23m41divbmj,39565,39566,79131
42645,,fbhmuoc_g3qj,39566,39567,79133
42646,,ywarqgkzgcsj,39567,39568,79135
42647,,qmgfyarhsgqj,39568,39569,79137
42648,,figmht6qng4j,39569,39570,79139
42649,,ynmjbliq74qj,39570,39571,79141
42650,,_jwwgmypnowj,39571,39572,79143
42651,,url:http://www.csa.com/partners/viewrecord.php3frequester3dgs26collection3dtrd26recid3d0014639ci,39572,39573,79145
42652,,mm-if_lc4jaj,39573,39574,79147
42653,,xky87ropuq0j,39574,39575,79149
42654,,zljtc_2k2ncj,39575,39576,79151
42655,,h4yoa_nqto4j,39576,39577,79153
42656,,ar9517ql-wwj,39577,39578,79155
42657,,mn5dbtuevzgj,39578,39579,79157
42658,,phpghh7ksxyj,39579,39580,79159
42659,,jmljthj8stoj,39580,39581,79161
42660,,qcsqgsjj_kij,39581,39582,79163
42661,,uiqispsk0x4j,39582,39583,79165
42662,,iqi5jrsrpqej,39583,39584,79167
42663,,krjp6tseituj,39584,39585,79169
42664,,_-qsvjazjdqj,39585,39586,79171
42665,,,39586,39587,79173
42666,,nlyaetek5pmj,39587,39588,79175
42667,,uzpotumagwaj,39588,39589,79177
42668,,jhiauvksg34j,39589,39590,79179
42669,,url:http://www.csa.com/partners/viewrecord.php3frequester3dgs26collection3dtrd26recid3d200111010669mt26recid3da0032572ah,39590,39591,79181
42670,,hwl8rhkcntkj,39591,39592,79183
42671,,rxit-5jmgmwj,39592,39593,79185
42672,,tuytj2kiweqj,39593,39594,79187
42673,,p316vnjypamj,39594,39595,79189
42674,,y8sm4sh4hokj,39595,39596,79191
42675,,idenhw2wtx4j,39596,39597,79193
42676,,wye9fkutj70j,39597,39598,79195
42677,,x6dbyfksvhyj,39598,39599,79197
42678,,rcwyaogikpij,39600,39601,79201
42679,,s8jbf9cu6u8j,39602,39603,79205
42680,,qwtgjh-vee8j,39603,39604,79207
42681,,url:http://portal.acm.org/ft_gateway.cfm3fid3d108372026type3dpdf,39604,39605,79209
42682,,u_cuy6pvuq8j,39605,39606,79211
42683,,zjznxv0fpxoj,39606,39607,79213
42684,,g-ucd4izggwj,39607,39608,79215
42685,,hewwa8jj8zuj,39608,39609,79217
42686,,ueppaqod8bij,39609,39610,79219
42687,,s96r8doginaj,39610,39611,79221
42688,,fd6svwgx8jwj,39611,39612,79223
42689,,dvby2qivsgcj,39612,39613,79225
42690,,88wemncqtqmj,39613,39614,79227
42691,,wxqfxiwfx2ij,39614,39615,79229
42692,,lw_0wzmdiaij,39615,39616,79231
42693,,pzig5y3uneqj,39616,39617,79233
42694,,hjuk4xqvc3cj,39617,39618,79235
42695,,omuujrbj4ryj,39618,39619,79237
42696,,url:http://www.springerlink.com/index/v3053r67rm3371p3.pdf,39619,39620,79239
42697,,url:http://www.csa.com/partners/viewrecord.php3frequester3dgs26collection3dtrd26recid3d155970ws26recid3d199301530044md,39620,39621,79241
42698,,gp59preosu4j,39621,39622,79243
42699,,quhzutuabr0j,39622,39623,79245
42700,,qznkcjfmqx8j,39623,39624,79247
42701,,p6fcwzt1u0aj,39624,39625,79249
42702,,xazphzy2m6ej,39625,39626,79251
42703,,7qegdbg3wjij,39626,39627,79253
42704,,kl1l2isi1l4j,39627,39628,79255
42705,,pvjtsy0ylyaj,39628,39629,79257
42706,,rlnvvbqttsqj,39629,39630,79259
42707,,dltzm8aczt4j,39630,39631,79261
42708,,yqg5rstq0hgj,39631,39632,79263
42709,,khy0gawuwpij,39632,39633,79265
42710,,kegnxd7fjeoj,39633,39634,79267
42711,,my_csox2nscj,39634,39635,79269
42712,,q523xi1q-ayj,39635,39636,79271
42713,,yivbmsacodij,39636,39637,79273
42714,,n9b8mvgvcgwj,39637,39638,79275
42715,,t6bwz7ig68oj,39638,39639,79277
42716,,3pqhfpw3mcwj,39639,39640,79279
42717,,dxpaytlzijwj,39640,39641,79281
42718,,pgftb-ueehuj,39641,39642,79283
42719,,8ybg_9hqroaj,39642,39643,79285
42720,,kwgzbkpttxgj,39643,39644,79287
42721,,kqllj3ijrqij,39644,39645,79289
42722,,ml8ryeuqccmj,39645,39646,79291
42723,,-3lefj2dy-uj,39646,39647,79293
42724,,djv_oaw-bcij,39647,39648,79295
42725,,cyddgjyzym8j,39648,39649,79297
42726,,jn1ztjx3ejmj,39649,39650,79299
42727,,ib-7lrflnpij,39650,39651,79301
42728,,a3tldmo76auj,39651,39652,79303
42729,,url:http://doi.wiley.com/10.1002/tl.97,39652,39653,79305
42730,,mlxe5mb0jiqj,39653,39654,79307
42731,,oqgspycuhmej,39654,39655,79309
42732,,wpkb_-e4pqyj,39655,39656,79311
42733,,url:http://portal.acm.org/citation.cfm3fid3d592200.592435,39656,39657,79313
42734,,url:http://portal.acm.org/citation.cfm3fid3d80839026dl3dacm26coll3dportal26cfid3d1111111126cftoken3d2222222,39657,39658,79315
42735,,qjt3hga0oa8j,39658,39659,79317
42736,,oucaaqruy4mj,39659,39660,79319
42737,,w5m0aqt2brcj,39660,39661,79321
42738,,fkl_yzswovij,39661,39662,79323
42739,,niapzsmp2igj,39662,39663,79325
42740,,wanmkxtsnosj,39663,39664,79327
42741,,gtw4a13psjcj,39664,39665,79329
42742,,gs3wzqekuugj,39665,39666,79331
42743,,w6kovxh2vqmj,39666,39667,79333
42744,,ir5vucdxz4sj,39667,39668,79335
42745,,ztzrbol0zg8j,39668,39669,79337
42746,,iww2itlbdtej,39669,39670,79339
42747,,smxfykrpkxmj,39670,39671,79341
42748,,yoxh48-udouj,39671,39672,79343
42749,,ybobcbxrbquj,39672,39673,79345
42750,,81bns1gw-_oj,39673,39674,79347
42751,,ctt7l0b2awej,39674,39675,79349
42752,,url:http://portal.acm.org/ft_gateway.cfm3fid3d108377526type3dpdf,39675,39676,79351
42753,,vg4tmzb7vdgj,39676,39677,79353
42754,,zpop8w12g0ij,39677,39678,79355
42755,,vel5govdbouj,39678,39679,79357
42756,,qkjd6115mtuj,39679,39680,79359
42757,,p8iiilwgekkj,39680,39681,79361
42758,,cpgjxmstd58j,39681,39682,79363
42759,,2jjxusjurakj,39682,39683,79365
42760,,dbx7gkgoo00j,39683,39684,79367
42761,,k-4gqq_8sqcj,39684,39685,79369
42762,,xwwfsla1we0j,39685,39686,79371
42763,,gcedmssowusj,39686,39687,79373
42764,,oznwidqvej0j,39687,39688,79375
42765,,5lfxnkrahegj,39688,39689,79377
42766,,qzmerozz6buj,39690,39691,79381
42767,,h3kmiqwhyuqj,39691,39692,79383
42768,,iukjt2le-xij,39692,39693,79385
42769,,b545cjxffsij,39693,39694,79387
42770,,f2992_xosewj,39694,39695,79389
42771,,lrjw7qiwelqj,39695,39696,79391
42772,,oygeutr1x_ij,39696,39697,79393
42773,,etrp5n2nxzyj,39697,39698,79395
42774,,8-0mea2knluj,39698,39699,79397
42775,,mdubkyzidicj,39699,39700,79399
42776,,zqg-8d6v7boj,39700,39701,79401
42777,,prppxxmidaej,39701,39702,79403
42778,,6b15hteksm4j,39702,39703,79405
42779,,tkkyfdl6mukj,39703,39704,79407
42780,,8fliqxjfzncj,39704,39705,79409
42781,,3osux9phomyj,39705,39706,79411
42782,,cr4jfelkicmj,39706,39707,79413
42783,,owrvbdbhhugj,39707,39708,79415
42784,,url:http://ieeexplore.ieee.org/xpl/abs_free.jsp3farnumber3d75466,39708,39709,79417
42785,,tcs1-eeh3sgj,39709,39710,79419
42786,,ix9nsqllvoij,39710,39711,79421
42787,,caqllf_yhouj,39711,39712,79423
42788,,cfnoqo5syiqj,39712,39713,79425
42789,,mzft6c7umnij,39713,39714,79427
42790,,pm5zhfiewomj,39714,39715,79429
42791,,fmbybziclgaj,39715,39716,79431
42792,,mzlmwjtyadcj,39716,39717,79433
42793,,vnso11kc4sej,39717,39718,79435
42794,,tajp2skfmfgj,39718,39719,79437
42795,,zfbbfdbgojej,39719,39720,79439
42796,,xmvlzgbcjmuj,39720,39721,79441
42797,,_pvaae0i_ooj,39721,39722,79443
42798,,url:http://portal.acm.org/ft_gateway.cfm3fid3d102754126type3dpdf,39722,39723,79445
42799,,ffp-slbiv4cj,39723,39724,79447
42800,,fetpgy3ksrqj,39724,39725,79449
42801,,krj5nkaxchyj,39725,39726,79451
42802,,mnwel8e02r0j,39726,39727,79453
42803,,tzxel1caaguj,39727,39728,79455
42804,,nabpjshwflgj,39728,39729,79457
42805,,tfw9dhks-byj,39729,39730,79459
42806,,lcqknoeczxsj,39730,39731,79461
42807,,vaxc0tr9b5cj,39731,39732,79463
42808,,zwhleedujxcj,39732,39733,79465
42809,,ub_cksjveruj,39733,39734,79467
42810,,pjstthefkkkj,39734,39735,79469
42811,,uzlrzvu0ppkj,39735,39736,79471
42812,,kslkjg8qmkqj,39736,39737,79473
42813,,7e26wer4evsj,39737,39738,79475
42814,,url:http://doi.wiley.com/10.1002/he.142,39738,39739,79477
42815,,bfyyotv2qnmj,39739,39740,79479
42816,,xjqs4s40spgj,39740,39741,79481
42817,,1f4aqnfvzxqj,39741,39742,79483
42818,,xicttkb4jlsj,39742,39743,79485
42819,,ssdewagrgtmj,39743,39744,79487
42820,,url:http://doi.wiley.com/10.1002/tl.124,39744,39745,79489
42821,,jn87qjzis0cj,39745,39746,79491
42822,,1u7ga8ipws0j,39746,39747,79493
42823,,ojdqskuerimj,39748,39749,79497
42824,,rr4qsjhqolmj,39749,39750,79499
42825,,v46xz_dmc6yj,39750,39751,79501
42826,,uyaknrlm5acj,39751,39752,79503
42827,,hzrwbhn31-yj,39752,39753,79505
42828,,utaxwh6tpbqj,39753,39754,79507
42829,,a3a4lhto_eij,39754,39755,79509
42830,,8vd-ucitl4mj,39755,39756,79511
42831,,7pgsdgjavz0j,39756,39757,79513
42832,,qevzl8wueyej,39757,39758,79515
42833,,f7ahd7xcdh4j,39758,39759,79517
42834,,yxj6hlqw7hyj,39759,39760,79519
42835,,hmevi2ebav0j,39760,39761,79521
42836,,jscq-gry8fkj,39761,39762,79523
42837,,h6hm1wvjlwaj,39762,39763,79525
42838,,url:http://pubs.acs.org/cgi-bin/abstract.cgi/achre4/2004/37/i12/abs/ar040081u.html,39763,39764,79527
42839,,ydv3da7yk08j,39764,39765,79529
42840,,fm44zq-q_okj,39765,39766,79531
42841,,f9v0ra3zooaj,39766,39767,79533
42842,,gkey34qihkej,39767,39768,79535
42843,,p0vzzgs-fwij,39768,39769,79537
42844,,prpzxjl0ipsj,39769,39770,79539
42845,,jdu5tkgzrkmj,39770,39771,79541
42846,,sqwknbcgtiej,39771,39772,79543
42847,,y8uxj6eciumj,39772,39773,79545
42848,,url:http://doi.wiley.com/10.1002/ace.29,39773,39774,79547
42849,,izqrfqytms4j,39774,39775,79549
42850,,lfjihmngvhgj,39775,39776,79551
42851,,jmamlo5vp4qj,39776,39777,79553
42852,,rnxoztzmevkj,39777,39778,79555
42853,,z-fk5lwv0puj,39778,39779,79557
42854,,bsdh2pbfudej,39779,39780,79559
42855,,u1auppq-wwmj,39780,39781,79561
42856,,m54_xxaf4wmj,39781,39782,79563
42857,,u2j8nxn_szyj,39782,39783,79565
42858,,imoml6fzbvqj,39783,39784,79567
42859,,nmatql8oz4ij,39784,39785,79569
42860,,dhuubzshtfwj,39785,39786,79571
42861,,e6zfybg732mj,39786,39787,79573
42862,,t8gbp9jgfhsj,39787,39788,79575
42863,,i7agv6u08qgj,39788,39789,79577
42864,,irsecvwgdyqj,39789,39790,79579
42865,,url:http://www.csa.com/partners/viewrecord.php3frequester3dgs26collection3dtrd26recid3dn9210584ah,39790,39791,79581
42866,,cg01bqanxhuj,39791,39792,79583
42867,,roctomlignsj,39792,39793,79585
42868,,wsmio0exczoj,39793,39794,79587
42869,,gr2svln__0kj,39794,39795,79589
42870,,xsc_hxwv11wj,39795,39796,79591
42871,,fmprskzpzawj,39796,39797,79593
42872,,h2hmytdd7kej,39797,39798,79595
42873,,o971pp_uj_qj,39798,39799,79597
42874,,hcfbemnqoy8j,39799,39800,79599
42875,,url:http://portal.acm.org/ft_gateway.cfm3fid3d50941026type3dpdf26dl3dguide26dl3dacm26cfid3d1111111126cftoken3d2222222,39800,39801,79601
42876,,cyu8xhkdzaoj,39802,39803,79605
42877,,sbkjigdxmm0j,39803,39804,79607
42878,,fipzjieymgmj,39804,39805,79609
42879,,4_4jg_eq8ekj,39805,39806,79611
42880,,5vxg9hcq844j,39806,39807,79613
42881,,url:http://portal.acm.org/ft_gateway.cfm3fid3d109968026type3dpdf,39807,39808,79615
42882,,cqmofj49xouj,39808,39809,79617
42883,,0wxqjwxcy0qj,39809,39810,79619
42884,,povennm2ll0j,39810,39811,79621
42885,,dtchbdc_z2kj,39811,39812,79623
42886,,3aftid1gqbyj,39812,39813,79625
42887,,hk05jssqsaqj,39813,39814,79627
42888,,qkqox1nf-hkj,39815,39816,79631
42889,,url:http://doi.wiley.com/10.1002/he.155,39816,39817,79633
42890,,gqdot-yszcmj,39817,39818,79635
42891,,y0ehx3y8uucj,39818,39819,79637
42892,,yyqmap-t49oj,39819,39820,79639
42893,,mrogm5qoqx4j,39820,39821,79641
42894,,sliybwbkss0j,39821,39822,79643
42895,,hihn3e8bmhsj,39822,39823,79645
42896,,vzjwfacm-byj,39823,39824,79647
42897,,0pmgzk0ou4ej,39824,39825,79649
42898,,luw5euo-eqsj,39825,39826,79651
42899,,wvvw66eph7gj,39826,39827,79653
42900,,fwbi6weorbqj,39827,39828,79655
42901,,ix5hze-wkvcj,39828,39829,79657
42902,,hwj5iremdwuj,39830,39831,79661
42903,,trc2o-rn0scj,39831,39832,79663
42904,,xwohqjmuecyj,39832,39833,79665
42905,,_9hu4xjh_0yj,39833,39834,79667
42906,,url:http://www.springerlink.com/index/gr6vw59k37p61405.pdf,39834,39835,79669
42907,,0ko1fnr_2aoj,39835,39836,79671
42908,,jaazctvmox4j,39836,39837,79673
42909,,ajvsrdftpzoj,39837,39838,79675
42910,,ztz3of60u2yj,39838,39839,79677
42911,,9rk-tqjz4qwj,39839,39840,79679
42912,,mhcy16aoi_oj,39840,39841,79681
42913,,rwqao5y9ossj,39841,39842,79683
42914,,1aqlh-9a3iuj,39842,39843,79685
42915,,,39843,39844,79687
42916,,_1b7bdzq5dgj,39844,39845,79689
42917,,crbzvg97nmij,39845,39846,79691
42918,,em-zqsflszyj,39846,39847,79693
42919,,pcpvtp9lxskj,39847,39848,79695
42920,,sjtfgwsu4poj,39848,39849,79697
42921,,hmryds0kn0mj,39849,39850,79699
42922,,url:http://doi.wiley.com/10.1002/tl.154,39850,39851,79701
42923,,ljvmd13lhjij,39851,39852,79703
42924,,owdf367xewuj,39852,39853,79705
42925,,tdp93s2n80ej,39853,39854,79707
42926,,ekscuukzpcgj,39854,39855,79709
42927,,b_gg3-xowsij,39855,39856,79711
42928,,xta8yumaotsj,39856,39857,79713
42929,,cblo6kbkeu4j,39857,39858,79715
42930,,eveon7tthuij,39858,39859,79717
42931,,url:http://www.csa.com/partners/viewrecord.php3frequester3dgs26collection3dtrd26recid3dn9210430ah,39859,39860,79719
42932,,fo8wg4w_lzaj,39860,39861,79721
42933,,0syvibk7b6yj,39861,39862,79723
42934,,qmxdvf2q764j,39862,39863,79725
42935,,7o8u91l2jmuj,39863,39864,79727
42936,,n-ejom9erd0j,39864,39865,79729
42937,,rpj7lhxtqrqj,39865,39866,79731
42938,,o_livvmtscqj,39866,39867,79733
42939,,calu_u8p3xyj,39867,39868,79735
42940,,da1u-svbqfmj,39868,39869,79737
42941,,x7s5eqytv7aj,39869,39870,79739
42942,,iytalosexhmj,39870,39871,79741
42943,,rd8ex9zy6uwj,39871,39872,79743
42944,,vxy0fvxroqmj,39873,39874,79747
42945,,sdsq4lwrizoj,39874,39875,79749
42946,,url:http://portal.acm.org/ft_gateway.cfm3fid3d36928926type3dpdf26dl3dguide26dl3dacm26cfid3d1111111126cftoken3d2222222,39875,39876,79751
42947,,p0qbmunsvy8j,39876,39877,79753
42948,,w5xpmlhvl48j,39877,39878,79755
42949,,,39878,39879,79757
42950,,qcc4kxbkzqej,39879,39880,79759
42951,,mqc96sdnorkj,39880,39881,79761
42952,,wpm8dqxik5uj,39881,39882,79763
42953,,wipifzx7tcuj,39882,39883,79765
42954,,juoilfyyklsj,39883,39884,79767
42955,,url:http://portal.acm.org/citation.cfm3fid3d984480.98448226coll3dguide26dl3dacm26idx3dj68926part3dperiodical26wanttype3dperiodical26title3dacm2520sigmod2520record26cfid3d1111111126cftoken3d2222222,39884,39885,79769
42956,,fdrkd5fn9ioj,39885,39886,79771
42957,,ce9xuipetqyj,39886,39887,79773
42958,,q1tf7xe9xkaj,39887,39888,79775
42959,,x_6ygukidckj,39888,39889,79777
42960,,i4coyhthj5oj,39889,39890,79779
42961,,lbgyiluxhdoj,39890,39891,79781
42962,,9qmi_jakdkej,39891,39892,79783
42963,,4oayvbfrjrkj,39892,39893,79785
42964,,awwlapefsp8j,39893,39894,79787
42965,,onj1qgv0ba0j,39894,39895,79789
42966,,,39895,39896,79791
42967,,7e3wcy2x6ooj,39896,39897,79793
42968,,url:http://ieeexplore.ieee.org/iel2/3038/8631/00379921.pdf3farnumber3d379921,39897,39898,79795
42969,,1dyqzl783uqj,39898,39899,79797
42970,,567osps53hij,39899,39900,79799
42971,,vvtj9adz81wj,39900,39901,79801
42972,,6qtm2t5qzuej,39901,39902,79803
42973,,url:http://www.csa.com/partners/viewrecord.php3frequester3dgs26collection3dtrd26recid3d0805939ci,39902,39903,79805
42974,,url:http://www.springerlink.com/index/a60784035283px43.pdf,39903,39904,79807
42975,,url:http://doi.wiley.com/10.1002/he.11002,39904,39905,79809
42976,,geizpz2ad90j,39905,39906,79811
42977,,w1txvoapcxkj,39906,39907,79813
42978,,6le83mbwpgmj,39907,39908,79815
42979,,dbjdrhd_hgqj,39908,39909,79817
42980,,zp7wenhqaykj,39909,39910,79819
42981,,s_5_argdv6qj,39911,39912,79823
42982,,f1evuxlxgkuj,39912,39913,79825
42983,,pwu9_3d13aej,39913,39914,79827
42984,,eu103hrus2aj,39914,39915,79829
42985,,jvazppr0zbuj,39915,39916,79831
42986,,q4xaigfdb_sj,39916,39917,79833
42987,,sexh5yciyfaj,39917,39918,79835
42988,,5xnkbfutew0j,39918,39919,79837
42989,,c349ktup7smj,39919,39920,79839
42990,,zqqhgg9erfqj,39920,39921,79841
42991,,jpvigkoodpoj,39921,39922,79843
42992,,hallih43yzaj,39923,39924,79847
42993,,akmx4zrwchsj,39924,39925,79849
42994,,url:http://www.csa.com/partners/viewrecord.php3frequester3dgs26collection3dtrd26recid3d20021212029378mt26recid3da7340047ah,39925,39926,79851
42995,,xe4ttxpjp2yj,39926,39927,79853
42996,,xm3-co0uxfwj,39927,39928,79855
42997,,y_ywe9iizeqj,39928,39929,79857
42998,,url:http://adsabs.harvard.edu/abs/1978phdt........73g,39929,39930,79859
42999,,_lahp2kr87gj,39930,39931,79861
43000,,uojgvm2g2saj,39931,39932,79863
43001,,qst0nxmh-suj,39932,39933,79865
43002,,9dlxgo61yfqj,39933,39934,79867
43003,,yb9nbolhmmyj,39934,39935,79869
43004,,se4qk85lk_wj,39935,39936,79871
43005,,ir9t41zbvikj,39936,39937,79873
43006,,xxaqo_ipog0j,39937,39938,79875
43007,,zg9ycllgwnsj,39938,39939,79877
43008,,whfwl3tfxoqj,39939,39940,79879
43009,,b3de23o9wjwj,39940,39941,79881
43010,,hhko46pf_1wj,39941,39942,79883
43011,,suhzba6s5x4j,39942,39943,79885
43012,,4jbcp5cxrxgj,39943,39944,79887
43013,,ogs5ng_t_ygj,39944,39945,79889
43014,,url:http://portal.acm.org/ft_gateway.cfm3fid3d38241726type3dpdf26coll3dguide26dl3dacm26cfid3d1111111126cftoken3d2222222,39945,39946,79891
43015,,yjzxcz5z5owj,39946,39947,79893
43016,,wld-dbsishaj,39947,39948,79895
43017,,jfgurngozl0j,39948,39949,79897
43018,,imdve4r0fboj,39949,39950,79899
43019,,ufhme2tnxayj,39950,39951,79901
43020,,zlil7k9sumgj,39951,39952,79903
43021,,hqvxee62skaj,39952,39953,79905
43022,,dkjtlxy4z5ej,39953,39954,79907
43023,,69owwbgzi_kj,39954,39955,79909
43024,,50vqkvi7olej,39955,39956,79911
43025,,ry00plytafwj,39956,39957,79913
43026,,1cjaarhamwcj,39957,39958,79915
43027,,iurbpmlhkkcj,39958,39959,79917
43028,,aktsb5wj4-aj,39959,39960,79919
43029,,ptkfusjxeiwj,39960,39961,79921
43030,,vimpo534ux4j,39961,39962,79923
43031,,smek_qwg1jkj,39962,39963,79925
43032,,url:http://www.blackwell-synergy.com/links/doi/10.1111/1475-4762.00036,39963,39964,79927
43033,,y3oek5gbw3aj,39964,39965,79929
43034,,i8mp3ax7ee4j,39965,39966,79931
43035,,url:http://www.csa.com/partners/viewrecord.php3frequester3dgs26collection3dtrd26recid3d0662531ci,39966,39967,79933
43036,,4qdq3bti_m0j,39968,39969,79937
43037,,nj116ax5hloj,39969,39970,79939
43038,,nyzjybsevwij,39970,39971,79941
43039,,hlgvz_odopqj,39971,39972,79943
43040,,yzn_ql_e2bmj,39972,39973,79945
43041,,qirvomtq7i8j,39973,39974,79947
43042,,xfvgntdtjraj,39974,39975,79949
43043,,jju5rdt2jsyj,39975,39976,79951
43044,,ctds9w1d04cj,39976,39977,79953
43045,,pvnpkvfe9taj,39977,39978,79955
43046,,-9_jk1yisegj,39978,39979,79957
43047,,oup9ywyn9tmj,39979,39980,79959
43048,,g6asbna7wp4j,39980,39981,79961
43049,,qbqlwnrazjqj,39981,39982,79963
43050,,hcsujobxlxoj,39982,39983,79965
43051,,y2_pyo_w4zmj,39983,39984,79967
43052,,_tle794_ikcj,39984,39985,79969
43053,,6lagdhttavmj,39985,39986,79971
43054,,r1abqlsnpasj,39986,39987,79973
43055,,vzoihzrjdmmj,39987,39988,79975
43056,,url:http://adsabs.harvard.edu/abs/1976scom.nasa..316k,39988,39989,79977
43057,,b8kicfw453qj,39989,39990,79979
43058,,xiefqr4q3dij,39990,39991,79981
43059,,mzbabulponmj,39991,39992,79983
43060,,bjuuddquveej,39992,39993,79985
43061,,_w3vfudfurqj,39993,39994,79987
43062,,7z8h12iuqugj,39994,39995,79989
43063,,-4evfulzyruj,39995,39996,79991
43064,,fbdluw4kcbcj,39996,39997,79993
43065,,iblcmhg2gvgj,39997,39998,79995
43066,,mw3xluyr3qqj,39998,39999,79997
43067,,et6j8pit-ksj,39999,40000,79999
43068,,4jg7ospwnsgj,40000,40001,80001
43069,,bvb32k-7-qsj,40001,40002,80003
43070,,raxyl8jt6bgj,40002,40003,80005
43071,,3mhzswyffhej,40003,40004,80007
43072,,gbib-xf0pdqj,40004,40005,80009
43073,,uk3c7o_wdnkj,40005,40006,80011
43074,,svjcl3nnxvij,40006,40007,80013
43075,,ejrqu6i2phkj,40007,40008,80015
43076,,o94tabhkzw0j,40008,40009,80017
43077,,xj-xv1uafsqj,40009,40010,80019
43078,,url:http://portal.acm.org/citation.cfm3fid3d163090.16310226dl3dguide26dl3dacm26idx3dj68926part3dperiodical26wanttype3dperiodical26title3dacm2520sigmod2520record26cfid3d1111111126cftoken3d2222222,40010,40011,80021
43079,,mfco8tf1h5qj,40011,40012,80023
43080,,pn_6blghudsj,40012,40013,80025
43081,,z_eqno5ail0j,40013,40014,80027
43082,,pbbm6inkr3qj,40015,40016,80031
43083,,xtjo9e6i2doj,40016,40017,80033
43084,,s5sdgxeio_qj,40017,40018,80035
43085,,url:http://www.ingentaconnect.com/content/pep/jae/2003/00000217/00000009/art00005,40018,40019,80037
43086,,a2n_-mmyk4sj,40019,40020,80039
43087,,03cvcxxg4-cj,40020,40021,80041
43088,,jvy0aplcsisj,40021,40022,80043
43089,,0zhmz6x5qx0j,40022,40023,80045
43090,,01awwaqn-syj,40023,40024,80047
43091,,lmnud9lv79sj,40024,40025,80049
43092,,msxh5zwq_vqj,40025,40026,80051
43093,,kigufnpuivwj,40026,40027,80053
43094,,befsjwpsb5wj,40027,40028,80055
43095,,i4dzh0cpfmoj,40028,40029,80057
43096,,zgv4wzssf0kj,40029,40030,80059
43097,,sq_wiq78plkj,40030,40031,80061
43098,,t_-cayjlesqj,40031,40032,80063
43099,,lur3sbrhclkj,40032,40033,80065
43100,,lf5xeppzinej,40033,40034,80067
43101,,h6emdbxatmkj,40034,40035,80069
43102,,uhvc3b-yuokj,40035,40036,80071
43103,,gbtqysap3dcj,40036,40037,80073
43104,,vbs4cipp0pij,40037,40038,80075
43105,,e8gcnjnkwfgj,40038,40039,80077
43106,,url:http://portal.acm.org/citation.cfm3fid3d48351.48358,40039,40040,80079
43107,,url:http://portal.acm.org/citation.cfm3fcoll3dguide26dl3dguide26id3d543638,40040,40041,80081
43108,,rqx0iklydq8j,40041,40042,80083
43109,,aumr-c5k1i4j,40042,40043,80085
43110,,azmzvxekzxij,40044,40045,80089
43111,,0awsc88rnuij,40045,40046,80091
43112,,tdnkt-c5lvej,40046,40047,80093
43113,,pwota-_k0vgj,40047,40048,80095
43114,,sgslvnyvdk4j,40048,40049,80097
43115,,eeviz9uxff4j,40049,40050,80099
43116,,5z66xkvvle8j,40050,40051,80101
43117,,url:http://www.springerlink.com/index/lmq3258k44p4485u.pdf,40051,40052,80103
43118,,ldxldgf-fdyj,40052,40053,80105
43119,,vhzhks6jbquj,40053,40054,80107
43120,,x4ooy4oisnmj,40054,40055,80109
43121,,qrj85wrcs7oj,40055,40056,80111
43122,,u_yktkbpi_mj,40056,40057,80113
43123,,e9nptqf3f-ej,40057,40058,80115
43124,,ukee4ye8joyj,40058,40059,80117
43125,,pmr8yorf8wyj,40059,40060,80119
43126,,hia7ryevp1sj,40060,40061,80121
43127,,8_mcb1sm_vyj,40061,40062,80123
43128,,url:http://portal.acm.org/ft_gateway.cfm3fid3d108371926type3dpdf,40062,40063,80125
43129,,irv1m48o_osj,40063,40064,80127
43130,,zurwamjvazqj,40064,40065,80129
43131,,nkkkw0zodicj,40065,40066,80131
43132,,vfdendh_jzij,40066,40067,80133
43133,,1xuicfko16yj,40067,40068,80135
43134,,n0x8j6qxicwj,40069,40070,80139
43135,,7iqy7tdou5cj,40070,40071,80141
43136,,url:http://www.csa.com/partners/viewrecord.php3frequester3dgs26collection3dtrd26recid3d8204540539md,40071,40072,80143
43137,,mc0srd3ahgyj,40072,40073,80145
43138,,url:http://www.ncbi.nlm.nih.gov/entrez/query.fcgi3fcmd3dretrieve26db3dpubmed26list_uids3d1526050226dopt3dcitation,40073,40074,80147
43139,,,40074,40075,80149
43140,,huztrpqlowsj,40075,40076,80151
43141,,dg9jt36pot8j,40076,40077,80153
43142,,jvutpaoycjaj,40078,40079,80157
43143,,ndanz6c3ntcj,40079,40080,80159
43144,,url:http://pubs.acs.org/cgi-bin/abstract.cgi/achre4/asap/abs/ar030244z.html,40080,40081,80161
43145,,03ajb3rn9o4j,40081,40082,80163
43146,,c1hl-dwc-hqj,40082,40083,80165
43147,,xxdrebqj7okj,40083,40084,80167
43148,,ef0upzhzbq4j,40085,40086,80171
43149,,4xf3zlxqaegj,40086,40087,80173
43150,,tuorhbiezu8j,40087,40088,80175
43151,,piq7flgaunmj,40088,40089,80177
43152,,0-twezljsfkj,40089,40090,80179
43153,,yxupxs8z1uoj,40090,40091,80181
43154,,te06taqktacj,40091,40092,80183
43155,,ts7derxciocj,40092,40093,80185
43156,,jiqc0wx4wygj,40093,40094,80187
43157,,ym3jljsp0vij,40094,40095,80189
43158,,1pmcdfucljsj,40095,40096,80191
43159,,url:http://portal.acm.org/citation.cfm3fid3d335191.33549426dl3dguide26dl3dacm26idx3d33519126part3dperiodical26wanttype3dperiodical26title3dacm2520sigmod2520record26cfid3d1111111126cftoken3d2222222,40096,40097,80193
43160,,zdubdjfwu0yj,40097,40098,80195
43161,,pab7lpqtf1wj,40098,40099,80197
43162,,xecjzlg35hij,40099,40100,80199
43163,,xpoakpa6hioj,40100,40101,80201
43164,,uzsjky6kr3wj,40101,40102,80203
43165,,qtlztpnrwokj,40102,40103,80205
43166,,cmkjjuydubwj,40103,40104,80207
43167,,dsx0ohdouwej,40104,40105,80209
43168,,uqasr8tuxjkj,40105,40106,80211
43169,,a96u5shisk0j,40106,40107,80213
43170,,pj3hyg1vmgcj,40107,40108,80215
43171,,a1qewrk5dhuj,40108,40109,80217
43172,,gyjttd2dr40j,40109,40110,80219
43173,,nfulkixzhzcj,40110,40111,80221
43174,,v65kou7j_jkj,40111,40112,80223
43175,,fastye_7xu8j,40112,40113,80225
43176,,vnwavgil2wgj,40113,40114,80227
43177,,yi86ijbwqj4j,40114,40115,80229
43178,,5yz8lqi9noej,40115,40116,80231
43179,,d_ozjh9vwlkj,40116,40117,80233
43180,,gin6vfjynfej,40117,40118,80235
43181,,o3tlpnngk9uj,40118,40119,80237
43182,,xop5esgvdxyj,40119,40120,80239
43183,,00wcgordqvmj,40120,40121,80241
43184,,6j5_vopt6haj,40121,40122,80243
43185,,url:http://doi.wiley.com/10.1002/ev.1331,40122,40123,80245
43186,,0uwxrolwca0j,40123,40124,80247
43187,,i8pm0jc3s1oj,40124,40125,80249
43188,,bueyjuzyv-mj,40125,40126,80251
43189,,jofkvdx9hyyj,40126,40127,80253
43190,,ypd5onz09ngj,40127,40128,80255
43191,,sy7xcurls90j,40128,40129,80257
43192,,eqg-j2jd2nwj,40129,40130,80259
43193,,_ytahibrdmgj,40130,40131,80261
43194,,yrbhsi8zu3ej,40131,40132,80263
43195,,cte1q2cf8bej,40132,40133,80265
43196,,jhwmrt-ay7mj,40133,40134,80267
43197,,2gwse3ewrl0j,40134,40135,80269
43198,,_dukmtriuc0j,40135,40136,80271
43199,,1rt5o1u70dgj,40136,40137,80273
43200,,7sfsr7svkhuj,40137,40138,80275
43201,,opventooybkj,40138,40139,80277
43202,,url:http://doi.wiley.com/10.1002/anie.198211550,40139,40140,80279
43203,,0tkn2-w5pfqj,40140,40141,80281
43204,,r4gx-s_g-hmj,40141,40142,80283
43205,,cnbngxd1kksj,40142,40143,80285
43206,,url:http://ieeexplore.ieee.org/xpl/abs_free.jsp3farnumber3d718113,40143,40144,80287
43207,,_ml_9m0fskwj,40144,40145,80289
43208,,edkadxdr2bcj,40145,40146,80291
43209,,ts3vlqds4vyj,40146,40147,80293
43210,,e2s_cxvgpdyj,40147,40148,80295
43211,,_btcsumhr38j,40148,40149,80297
43212,,yvq0lgebroij,40149,40150,80299
43213,,pikef7vtwt4j,40150,40151,80301
43214,,qlw_rtesgqgj,40151,40152,80303
43215,,wpe1trhh_kqj,40152,40153,80305
43216,,g1pvgu3feuwj,40153,40154,80307
43217,,url:http://www.csa.com/partners/viewrecord.php3frequester3dgs26collection3dtrd26recid3da8622917ah,40154,40155,80309
43218,,xcxfyrfppcqj,40155,40156,80311
43219,,fb13aihtxfyj,40156,40157,80313
43220,,url:http://portal.acm.org/ft_gateway.cfm3fid3d109957326type3dpdf,40157,40158,80315
43221,,nfq3gsqvrlmj,40158,40159,80317
43222,,wwbxy7z1jgej,40159,40160,80319
43223,,bpl2j2-rsfwj,40160,40161,80321
43224,,kihg_nb0z64j,40161,40162,80323
43225,,l9ymkqeqefcj,40162,40163,80325
43226,,4denao0gsx0j,40163,40164,80327
43227,,dfrhhqb7ssaj,40164,40165,80329
43228,,uqjesnisry8j,40166,40167,80333
43229,,dqzdj00u6jqj,40167,40168,80335
43230,,jvtnt-7eg3uj,40168,40169,80337
43231,,6ssw0giv4uaj,40169,40170,80339
43232,,_v32xpkfefcj,40170,40171,80341
43233,,qlz_wxqvwp4j,40171,40172,80343
43234,,nuwbtet53cyj,40172,40173,80345
43235,,hqqspfqn7q0j,40174,40175,80349
43236,,erwprxw9kk8j,40175,40176,80351
43237,,yzip7ilb-tyj,40176,40177,80353
43238,,14ig9yltx7sj,40177,40178,80355
43239,,_qdio3btsaej,40179,40180,80359
43240,,ogazkgeypzej,40180,40181,80361
43241,,wkhr4r1w6huj,40181,40182,80363
43242,,yzibvnhide0j,40182,40183,80365
43243,,rpgzb7oseugj,40183,40184,80367
43244,,g99zut8m8rgj,40184,40185,80369
43245,,fv3g2hby6naj,40185,40186,80371
43246,,a5hwalyqox0j,40186,40187,80373
43247,,l1ur1mj3-nqj,40187,40188,80375
43248,,ox-d921lqsij,40188,40189,80377
43249,,bvhiof878mkj,40189,40190,80379
43250,,yuja8jqv_joj,40190,40191,80381
43251,,qd1wgyxjb4gj,40191,40192,80383
43252,,mrin7nbj0mgj,40192,40193,80385
43253,,dwc52udzpnmj,40193,40194,80387
43254,,gw3xfwkxm-cj,40194,40195,80389
43255,,k3iikxzvjiaj,40195,40196,80391
43256,,s8rptk2vkmoj,40197,40198,80395
43257,,csyh_ytmaoij,40198,40199,80397
43258,,otl7vtw8guaj,40199,40200,80399
43259,,url:http://portal.acm.org/citation.cfm3fid3d792595.792625,40200,40201,80401
43260,,pits8rkg5nqj,40201,40202,80403
43261,,9um3b_u8nmij,40202,40203,80405
43262,,sj_piug2jhwj,40203,40204,80407
43263,,8lf_skptknoj,40204,40205,80409
43264,,denuounewrgj,40206,40207,80413
43265,,3rxbvi3csd8j,40207,40208,80415
43266,,z6xsj1ayyt4j,40208,40209,80417
43267,,nvtkfb-u_q0j,40209,40210,80419
43268,,z_wnsmhb5omj,40210,40211,80421
43269,,jzjkbkc7thgj,40211,40212,80423
43270,,0ckdg4jhmagj,40212,40213,80425
43271,,tyzttgbadsuj,40213,40214,80427
43272,,ji8kwaebv0qj,40214,40215,80429
43273,,vl69tnmpelmj,40215,40216,80431
43274,,ta-4tshtuvcj,40216,40217,80433
43275,,k4bxbjz2b3aj,40217,40218,80435
43276,,rdcdw1maj2ij,40218,40219,80437
43277,,qwnj6lndqdmj,40219,40220,80439
43278,,u0p5xn92q4gj,40220,40221,80441
43279,,tzpobyjizwej,40221,40222,80443
43280,,d6em1f_l3loj,40222,40223,80445
43281,,zzfomizwunyj,40223,40224,80447
43282,,lv1bmecuo2cj,40224,40225,80449
43283,,trzwyfqeltuj,40225,40226,80451
43284,,btutzoobbsmj,40226,40227,80453
43285,,534xxw92ygij,40227,40228,80455
43286,,btoevtpnwnej,40228,40229,80457
43287,,sajuh3rfrwwj,40229,40230,80459
43288,,ki6nf9dkpomj,40230,40231,80461
43289,,rrlihf2wsf4j,40231,40232,80463
43290,,i80metk3sdcj,40232,40233,80465
43291,,url:http://www.ingentaconnect.com/search/expand3fpub3dinfobike://els/09505849/1997/00000039/00000008/art0001226unc3d,40233,40234,80467
43292,,url:http://portal.acm.org/citation.cfm3fid3d171926.171982,40234,40235,80469
43293,,url:http://portal.acm.org/citation.cfm3fid3d234286.1053426,40235,40236,80471
43294,,vlbjjh1nolmj,40236,40237,80473
43295,,ljx4d15--voj,40237,40238,80475
43296,,0h6n4qmkc-cj,40238,40239,80477
43297,,5mmlb95pnmyj,40239,40240,80479
43298,,s54pmoqtur8j,40240,40241,80481
43299,,qcuc-6otvlmj,40241,40242,80483
43300,,9qms_caxbqaj,40242,40243,80485
43301,,hthofqnqw1wj,40243,40244,80487
43302,,o7iukwfq4ryj,40244,40245,80489
43303,,k0vyngqhu10j,40245,40246,80491
43304,,oxnudnrnjtgj,40246,40247,80493
43305,,g-wiuldamwkj,40247,40248,80495
43306,,c3mgvy9omsej,40248,40249,80497
43307,,cdkjpsyrnr8j,40249,40250,80499
43308,,yyeotlqqud0j,40250,40251,80501
43309,,4b-tferunscj,40251,40252,80503
43310,,gghdx7qonqyj,40252,40253,80505
43311,,h6rkqok8ur4j,40253,40254,80507
43312,,alekynk8gh8j,40254,40255,80509
43313,,snjg53ir3eqj,40255,40256,80511
43314,,ppruge1hmdyj,40256,40257,80513
43315,,g-tqxpblkmyj,40257,40258,80515
43316,,xa-eerf_h20j,40258,40259,80517
43317,,9_1w4cuavkgj,40259,40260,80519
43318,,il6oyxefi1wj,40260,40261,80521
43319,,lf8gyjxsb4uj,40261,40262,80523
43320,,url:http://www.springerlink.com/index/w777210182v767h3.pdf,40262,40263,80525
43321,,2c_mvx_qcqgj,40263,40264,80527
43322,,r7tblaw0o3wj,40264,40265,80529
43323,,qfqykifrwyyj,40265,40266,80531
43324,,klyoch_jsdcj,40266,40267,80533
43325,,url:http://portal.acm.org/ft_gateway.cfm3fid3d106627326type3dpdf,40267,40268,80535
43326,,1mf5mip7_twj,40268,40269,80537
43327,,mgkwmpmzt2mj,40269,40270,80539
43328,,lw6syftm7e4j,40270,40271,80541
43329,,matv2vwrkpuj,40271,40272,80543
43330,,url:http://doi.wiley.com/10.1002/tl.93,40272,40273,80545
43331,,uyqpdoh0wo0j,40273,40274,80547
43332,,url:http://portal.acm.org/ft_gateway.cfm3fid3d110191326type3dpdf,40274,40275,80549
43333,,9d8rrv3sr8aj,40275,40276,80551
43334,,n194ix0vqn0j,40276,40277,80553
43335,,alzu-ofu8igj,40277,40278,80555
43336,,pqp9tta1acyj,40278,40279,80557
43337,,eqr8pmcgo2ij,40279,40280,80559
43338,,8i_1ol1vfl4j,40280,40281,80561
43339,,4oimyiiwl1uj,40281,40282,80563
43340,,2rjoyxvgqcyj,40282,40283,80565
43341,,v8prghsrbauj,40283,40284,80567
43342,,e5ag2pb1u1aj,40284,40285,80569
43343,,zwqdd9bom5sj,40285,40286,80571
43344,,bmgrzqitr1yj,40286,40287,80573
43345,,byoegzg7bcmj,40287,40288,80575
43346,,fnbzpl3cmd4j,40288,40289,80577
43347,,ewlx7kh6f2ij,40289,40290,80579
43348,,opvs_fenttej,40290,40291,80581
43349,,jzwijnbpldgj,40291,40292,80583
43350,,tjtt-j0ioxij,40292,40293,80585
43351,,nn1i435jxxij,40293,40294,80587
43352,,jb_tukxqghoj,40294,40295,80589
43353,,epf9ainjnqwj,40295,40296,80591
43354,,url:http://doi.wiley.com/10.1002/ev.1614,40296,40297,80593
43355,,cwgtgmv7hugj,40297,40298,80595
43356,,yjaoa55kusaj,40298,40299,80597
43357,,srrngizvc9kj,40299,40300,80599
43358,,2wvsqb_8j60j,40300,40301,80601
43359,,2vnklw96g38j,40301,40302,80603
43360,,rf12p4goamgj,40302,40303,80605
43361,,bfodkqkn4aqj,40303,40304,80607
43362,,lhqshahppfgj,40304,40305,80609
43363,,2s6wpkfjfnwj,40305,40306,80611
43364,,ohjazrizzesj,40306,40307,80613
43365,,url:http://www.springerlink.com/index/m15545332rv73hk2.pdf,40307,40308,80615
43366,,suw253hshiwj,40308,40309,80617
43367,,ox8x_rq0so4j,40309,40310,80619
43368,,qm1vxtjpd3cj,40310,40311,80621
43369,,h2ankwudvgqj,40311,40312,80623
43370,,hqeod-dtkz8j,40312,40313,80625
43371,,wnhza_xdzpij,40313,40314,80627
43372,,tfvqiphmapkj,40314,40315,80629
43373,,v28snpxql7yj,40315,40316,80631
43374,,c7qqpnlytqcj,40316,40317,80633
43375,,9m3wamfv-iej,40317,40318,80635
43376,,qk6mhaqfteuj,40318,40319,80637
43377,,aztehlioenmj,40319,40320,80639
43378,,url:http://www.springerlink.com/index/l1x2660765772210.pdf,40320,40321,80641
43379,,yg9dobsmpx0j,40321,40322,80643
43380,,ohigj7gy3kgj,40322,40323,80645
43381,,htbqnyijm8wj,40323,40324,80647
43382,,z1jxvva0paqj,40324,40325,80649
43383,,zcqmooh6nbaj,40325,40326,80651
43384,,mxecvtzwe6mj,40326,40327,80653
43385,,x1czjborcyqj,40327,40328,80655
43386,,jmphdya4wtoj,40328,40329,80657
43387,,z2fk-klti1ej,40329,40330,80659
43388,,z5ea3jebwa4j,40330,40331,80661
43389,,baxswslzivsj,40332,40333,80665
43390,,7asdwscnlnwj,40333,40334,80667
43391,,dl4h0kblbfij,40334,40335,80669
43392,,url:http://portal.acm.org/ft_gateway.cfm3fid3d109959126type3dpdf,40335,40336,80671
43393,,zch-zvcdvvwj,40336,40337,80673
43394,,_aaac96uoggj,40337,40338,80675
43395,,mega1wbxpdaj,40338,40339,80677
43396,,th2jrdt4z48j,40339,40340,80679
43397,,pp4jpqdyywgj,40341,40342,80683
43398,,url:http://www.csa.com/partners/viewrecord.php3frequester3dgs26collection3dtrd26recid3da8622935ah,40342,40343,80685
43399,,a-1xzk7jkhcj,40343,40344,80687
43400,,e8gzigtjqa0j,40344,40345,80689
43401,,njzgadysmnkj,40345,40346,80691
43402,,rvqnsopv5dqj,40346,40347,80693
43403,,wl2mt_iwaomj,40347,40348,80695
43404,,oxvqmejsxngj,40348,40349,80697
43405,,plge_il13dij,40349,40350,80699
43406,,6mflimkua1uj,40350,40351,80701
43407,,kws38n4jdfcj,40351,40352,80703
43408,,dhpp353ybb8j,40352,40353,80705
43409,,wqbkbw7uhkij,40353,40354,80707
43410,,3m66e2wb_ssj,40354,40355,80709
43411,,dq2dh30l75wj,40355,40356,80711
43412,,1wfqn1j2mooj,40356,40357,80713
43413,,zf_zfmctqu0j,40357,40358,80715
43414,,o1atuwxin5kj,40358,40359,80717
43415,,b6ovo_nklewj,40359,40360,80719
43416,,0ckib90sz2aj,40360,40361,80721
43417,,uexps_0wnsaj,40361,40362,80723
43418,,qrktsz9sgtoj,40362,40363,80725
43419,,1l43fawxdegj,40363,40364,80727
43420,,cqq9posms8mj,40364,40365,80729
43421,,a5audole7tkj,40365,40366,80731
43422,,iyir-gwykiuj,40368,40369,80737
43423,,y1claziz-4gj,40369,40370,80739
43424,,zuxbeczuwt0j,40370,40371,80741
43425,,ok8tkescxpcj,40371,40372,80743
43426,,url:http://www.emeraldinsight.com/insight/viewcontentservlet3ffilename3d/published/emeraldfulltextarticle/pdf/0010431007.pdf,40372,40373,80745
43427,,txesi_gazloj,40373,40374,80747
43428,,lxynudloevkj,40374,40375,80749
43429,,url:http://portal.acm.org/ft_gateway.cfm3fid3d95908426type3dpdf26dl3dportal26dl3dacm26cfid3d1111111126cftoken3d2222222,40375,40376,80751
43430,,pfh_nskcmzej,40376,40377,80753
43431,,url:http://www.ingentaconnect.com/search/expand3fpub3dinfobike://els/09505849/1998/00000040/00000002/art0002926unc3d,40377,40378,80755
43432,,zcpdubfvfy8j,40378,40379,80757
43433,,oe9km5xg8mqj,40379,40380,80759
43434,,51r84bflh0qj,40380,40381,80761
43435,,xhauqlw0m00j,40381,40382,80763
43436,,hfixs-9mecqj,40382,40383,80765
43437,,cifyyz_iqdyj,40384,40385,80769
43438,,wk7reobklmej,40385,40386,80771
43439,,tkc_ph5y5wkj,40386,40387,80773
43440,,bxkmio5592ij,40387,40388,80775
43441,,lysf71xdwj4j,40388,40389,80777
43442,,zuhdc8m-vmsj,40389,40390,80779
43443,,qf0pr3_pupoj,40390,40391,80781
43444,,wvee8bfkbakj,40391,40392,80783
43445,,8be_ivybnomj,40392,40393,80785
43446,,4quijry2ndmj,40393,40394,80787
43447,,qj2fni1bhkuj,40394,40395,80789
43448,,jziqsg_c1fij,40395,40396,80791
43449,,url:http://www.csa.com/partners/viewrecord.php3frequester3dgs26collection3dtrd26recid3d20021211001544mt26recid3da8622942ah,40396,40397,80793
43450,,7e5nnmjgqhqj,40397,40398,80795
43451,,_p_a1fowsr8j,40398,40399,80797
43452,,-2l_wfg84n4j,40399,40400,80799
43453,,dwtjvog8vv4j,40400,40401,80801
43454,,xlxzfynlbo8j,40401,40402,80803
43455,,ejgcgwe-yasj,40402,40403,80805
43456,,j0sc4ieddayj,40404,40405,80809
43457,,yjplsozgsdmj,40405,40406,80811
43458,,l4zo0ttvjqaj,40406,40407,80813
43459,,pg2g_dk5rwej,40407,40408,80815
43460,,ixzupscivq4j,40409,40410,80819
43461,,3yrc9ehb1okj,40410,40411,80821
43462,,irjbh9rrinoj,40411,40412,80823
43463,,gelpaidytv0j,40412,40413,80825
43464,,ejqkisrz6msj,40413,40414,80827
43465,,azjri4yv7fgj,40414,40415,80829
43466,,y4j6yvdjmz8j,40415,40416,80831
43467,,ylmtdcxgbamj,40416,40417,80833
43468,,9vkcnxgdkdij,40417,40418,80835
43469,,enpz_toeaqmj,40418,40419,80837
43470,,y0cgszz-cqyj,40419,40420,80839
43471,,k6r-jdg8zjgj,40420,40421,80841
43472,,iopwjamtfmmj,40421,40422,80843
43473,,url:http://www.springerlink.com/index/k6lvuur3q5304j31.pdf,40422,40423,80845
43474,,efyzcwi_av0j,40423,40424,80847
43475,,ff5eypxrj90j,40424,40425,80849
43476,,nyasmb6bsbsj,40425,40426,80851
43477,,fkp82dzax-cj,40426,40427,80853
43478,,_exqcqk727ej,40427,40428,80855
43479,,o2usgt8hkmoj,40428,40429,80857
43480,,dl9ezdk4_rqj,40429,40430,80859
43481,,iq4q8-wwpaaj,40430,40431,80861
43482,,66u3bf7m5qoj,40431,40432,80863
43483,,q8yaise1b5qj,40432,40433,80865
43484,,ctouowq9c64j,40433,40434,80867
43485,,j92tozipdaaj,40434,40435,80869
43486,,zjufagoqj2wj,40435,40436,80871
43487,,dukgdkbw3zgj,40436,40437,80873
43488,,jor2myycww4j,40437,40438,80875
43489,,whgqfjbdrvoj,40438,40439,80877
43490,,gfecrdpc3smj,40439,40440,80879
43491,,jltif5xrlzej,40440,40441,80881
43492,,uov_xg4jc28j,40441,40442,80883
43493,,nvgjxzgqo9uj,40442,40443,80885
43494,,url:http://portal.acm.org/citation.cfm3fid3d101077.39000226dl3dguide26dl3dacm26idx3dj68926part3dperiodical26wanttype3dperiodical26title3dacm2520sigmod2520record26cfid3d1111111126cftoken3d2222222,40443,40444,80887
43495,,lbtyoc79h_mj,40444,40445,80889
43496,,qmuv7jdwzssj,40445,40446,80891
43497,,y3ccvanc_a4j,40446,40447,80893
43498,,o94tc1ulusaj,40447,40448,80895
43499,,bj-wfbgwyhgj,40448,40449,80897
43500,,q2lxs7yplrsj,40449,40450,80899
43501,,lem38gaxrvcj,40450,40451,80901
43502,,sotim3cm6ckj,40451,40452,80903
43503,,wywc4ttsf5cj,40452,40453,80905
43504,,xtwoxtvjiscj,40453,40454,80907
43505,,isxk8si7q0mj,40454,40455,80909
43506,,51xlqvczhtwj,40455,40456,80911
43507,,62fw39xycyoj,40456,40457,80913
43508,,fquqwdzpotkj,40457,40458,80915
43509,,__ygdzjxlxqj,40459,40460,80919
43510,,url:http://portal.acm.org/ft_gateway.cfm3fid3d110137226type3dpdf,40460,40461,80921
43511,,dle9rjp1vxsj,40461,40462,80923
43512,,xxp2v74trxmj,40462,40463,80925
43513,,uhx7_kiw8uyj,40463,40464,80927
43514,,0qczoyh7tnmj,40464,40465,80929
43515,,nr-olt8dpvgj,40465,40466,80931
43516,,zgoreysleraj,40466,40467,80933
43517,,url:http://www.csa.com/partners/viewrecord.php3frequester3dgs26collection3dtrd26recid3d200111010673mt26recid3da0032576ah,40467,40468,80935
43518,,admnwepysywj,40468,40469,80937
43519,,lpouvsje8t4j,40469,40470,80939
43520,,jsyu3j45lqyj,40470,40471,80941
43521,,vzt44jr-v4oj,40471,40472,80943
43522,,3v8fgnftuvmj,40472,40473,80945
43523,,eu7xhzpwn-gj,40473,40474,80947
43524,,myjgxk9y9smj,40474,40475,80949
43525,,ggk9xf2ajjwj,40475,40476,80951
43526,,wwjlyouehx4j,40476,40477,80953
43527,,1e4bamjbs8aj,40477,40478,80955
43528,,qaxj4fyk_tyj,40478,40479,80957
43529,,su_zjtch7i0j,40479,40480,80959
43530,,_ywqrv60lwcj,40480,40481,80961
43531,,ysiabasc2jcj,40481,40482,80963
43532,,5k0dgxstxdkj,40482,40483,80965
43533,,lc7d2bpubcmj,40483,40484,80967
43534,,bta0rjp3v_wj,40484,40485,80969
43535,,ckjlnfhowd8j,40485,40486,80971
43536,,gcen7i0omhmj,40486,40487,80973
43537,,g7bzzk892muj,40487,40488,80975
43538,,k2bbraj00r8j,40488,40489,80977
43539,,x0utlk9grlwj,40489,40490,80979
43540,,owtm0hynhnoj,40490,40491,80981
43541,,ckiaavnrrh4j,40491,40492,80983
43542,,dwtyilovo4qj,40492,40493,80985
43543,,url:http://www.csa.com/partners/viewrecord.php3frequester3dgs26collection3dtrd26recid3da8622982ah,40493,40494,80987
43544,,ciwiw49iaeyj,40494,40495,80989
43545,,url:http://www.csa.com/partners/viewrecord.php3frequester3dgs26collection3dtrd26recid3d0116687ci,40495,40496,80991
43546,,m2bwqrddfkuj,40496,40497,80993
43547,,vgba3aj8edsj,40498,40499,80997
43548,,noba36dazeoj,40499,40500,80999
43549,,80ehfwddo0kj,40500,40501,81001
43550,,u0coqugoo_mj,40501,40502,81003
43551,,spd21blguoqj,40502,40503,81005
43552,,z4ez1hqx-d4j,40503,40504,81007
43553,,arzledbsncuj,40504,40505,81009
43554,,rm0-gvtigcej,40505,40506,81011
43555,,kwcc7chtxuyj,40506,40507,81013
43556,,n1ne4y_na4uj,40507,40508,81015
43557,,d8r0jo4aucyj,40508,40509,81017
43558,,qscrhmj8vnej,40509,40510,81019
43559,,oizbed7p2dgj,40510,40511,81021
43560,,_n0vreg7omkj,40511,40512,81023
43561,,kzsdmgu26x8j,40512,40513,81025
43562,,owdmzsepn48j,40513,40514,81027
43563,,yksiuxx2acuj,40514,40515,81029
43564,,bvcu2b3vlcuj,40515,40516,81031
43565,,jkoqwrkim8yj,40516,40517,81033
43566,,bon43y7hewej,40517,40518,81035
43567,,hmbbd_dp3qyj,40518,40519,81037
43568,,5j6ugiiusakj,40519,40520,81039
43569,,xjtzgkj4dnij,40520,40521,81041
43570,,q7hm9arukr0j,40521,40522,81043
43571,,ccpxwguhk-qj,40522,40523,81045
43572,,i2fxqlfsuvoj,40523,40524,81047
43573,,uqsqbxpruruj,40524,40525,81049
43574,,url:http://www.springerlink.com/index/g2301771g6272j2m.pdf,40525,40526,81051
43575,,2da5gk2uv24j,40526,40527,81053
43576,,bt61jazzof8j,40527,40528,81055
43577,,i4gnupgyddkj,40528,40529,81057
43578,,e-nc29zrexwj,40530,40531,81061
43579,,xw_xvoutrdgj,40531,40532,81063
43580,,ozajkhngcloj,40532,40533,81065
43581,,kgj7hf2bw6uj,40533,40534,81067
43582,,irxqgeza72ij,40534,40535,81069
43583,,75puimsr_jkj,40535,40536,81071
43584,,yhr9njrzufgj,40536,40537,81073
43585,,k0keexw4v7aj,40537,40538,81075
43586,,_nk7plpl1luj,40538,40539,81077
43587,,5esxdtuyld4j,40539,40540,81079
43588,,nhqgqcvr85cj,40540,40541,81081
43589,,otfcnj_x5xij,40541,40542,81083
43590,,uv-egbs6-rmj,40542,40543,81085
43591,,onjdl3rlmumj,40543,40544,81087
43592,,ascqriyulzaj,40544,40545,81089
43593,,6mwtxigyiuej,40545,40546,81091
43594,,52lujzbpviaj,40546,40547,81093
43595,,9aueyrk31myj,40547,40548,81095
43596,,rm6qtpjebpej,40548,40549,81097
43597,,2kj5rxoebs4j,40549,40550,81099
43598,,fk4jevqkrpej,40550,40551,81101
43599,,vpqj6bzy0bej,40551,40552,81103
43600,,ha1ha_sdmkcj,40552,40553,81105
43601,,url:http://portal.acm.org/citation.cfm3fid3d984382.98438526coll3dguide26dl3dacm26type3dissue26idx3dj68926part3dperiodical26wanttype3dperiodical26title3dacm2520sigmod2520record26cfid3d1111111126cftoken3d2222222,40553,40554,81107
43602,,jycqeovv13aj,40554,40555,81109
43603,,bebhgqqphcgj,40555,40556,81111
43604,,eccckrmbnqqj,40556,40557,81113
43605,,2exwxoqhgrmj,40557,40558,81115
43606,,xqas11aatboj,40558,40559,81117
43607,,slzmm4q8cjaj,40559,40560,81119
43608,,4tpwt3f1jjuj,40560,40561,81121
43609,,3ix-hqdhfwyj,40561,40562,81123
43610,,q9p6rw4abhej,40562,40563,81125
43611,,gbygyzsyny4j,40563,40564,81127
43612,,k0ojfkkoodmj,40564,40565,81129
43613,,fsk81ojxpnuj,40565,40566,81131
43614,,olfrwwlpobaj,40566,40567,81133
43615,,6qc0ve2bcumj,40567,40568,81135
43616,,ll9guuh490sj,40568,40569,81137
43617,,b1ty3fjwukaj,40569,40570,81139
43618,,wphbe_w7e9oj,40570,40571,81141
43619,,xqks9wufhlkj,40571,40572,81143
43620,,url:http://www.blackwell-synergy.com/links/doi/10.1111/j.1467-8306.1977.tb01116.x/abs/,40572,40573,81145
43621,,jnl7mg5f4iaj,40573,40574,81147
43622,,cqyjoc8knlmj,40574,40575,81149
43623,,jz_c7vouqewj,40576,40577,81153
43624,,qi30mgfpj3wj,40577,40578,81155
43625,,_jy-evwmzu4j,40578,40579,81157
43626,,w_cvz6v80csj,40579,40580,81159
43627,,bwgkboedbncj,40580,40581,81161
43628,,url:http://www.csa.com/partners/viewrecord.php3frequester3dgs26collection3dtrd26recid3d155956ws26recid3d199301530041md,40581,40582,81163
43629,,frp3ynjk9z8j,40582,40583,81165
43630,,kxozbvlorgej,40583,40584,81167
43631,,ee3rrmxh4iyj,40584,40585,81169
43632,,3apleydkcioj,40585,40586,81171
43633,,zsan2qp0hyyj,40586,40587,81173
43634,,url:http://portal.acm.org/ft_gateway.cfm3fid3d100870026type3dpdf,40587,40588,81175
43635,,ltosamr6wcij,40588,40589,81177
43636,,bqxys0jericj,40589,40590,81179
43637,,r0gfd10ijbcj,40590,40591,81181
43638,,n15e7vzru9kj,40591,40592,81183
43639,,ej_5wxncheej,40592,40593,81185
43640,,apx5noczp6ij,40593,40594,81187
43641,,uktfyvzy4q8j,40594,40595,81189
43642,,qmjlnnqkgdsj,40595,40596,81191
43643,,xzf_wyz-dqij,40596,40597,81193
43644,,8wlrq3pkky0j,40597,40598,81195
43645,,uiiqtq2hbzej,40598,40599,81197
43646,,url:http://portal.acm.org/ft_gateway.cfm3fid3d106626926type3dpdf,40599,40600,81199
43647,,yet25k2i5zmj,40600,40601,81201
43648,,37kz9_6wk4yj,40601,40602,81203
43649,,fz5u9x0mydoj,40602,40603,81205
43650,,jto8w73kzvaj,40603,40604,81207
43651,,_thqcwkaovwj,40604,40605,81209
43652,,uxmykekj1_ej,40605,40606,81211
43653,,xsqtg6ejpyaj,40606,40607,81213
43654,,audoy1p8zg0j,40607,40608,81215
43655,,i03f9iwzcuwj,40608,40609,81217
43656,,ekzxzr-yvs0j,40609,40610,81219
43657,,oh1vsbihnj0j,40610,40611,81221
43658,,ji_zahe_rasj,40611,40612,81223
43659,,c8udwxzn9-mj,40612,40613,81225
43660,,4b7lm9nckt4j,40613,40614,81227
43661,,rasdhkfcxymj,40614,40615,81229
43662,,7_xau4satcyj,40615,40616,81231
43663,,ictwx0vtv-uj,40616,40617,81233
43664,,iaz34mpw4ykj,40617,40618,81235
43665,,y5607s6gpsmj,40618,40619,81237
43666,,aufxt-etmxoj,40619,40620,81239
43667,,am67tdo5ezqj,40620,40621,81241
43668,,h2apinby11uj,40621,40622,81243
43669,,6ibmhta8wicj,40622,40623,81245
43670,,osvmhkzgxfcj,40623,40624,81247
43671,,ue_ewx6m3dej,40624,40625,81249
43672,,dvqqnbyfwaij,40625,40626,81251
43673,,q0bmfwdmmokj,40626,40627,81253
43674,,url:http://links.jstor.org/sici3fsici3d0146-4949(196721)8253a2253c111253avnai253e2.0.co253b2-n,40627,40628,81255
43675,,wt2plt1aiyyj,40628,40629,81257
43676,,hvdme1egw6aj,40629,40630,81259
43677,,0whamigniskj,40630,40631,81261
43678,,p6qo-lhzpwij,40631,40632,81263
43679,,qx6b_tdrscej,40633,40634,81267
43680,,yfwcaf_iw7oj,40634,40635,81269
43681,,50kradn-r6ij,40635,40636,81271
43682,,evetpruanloj,40636,40637,81273
43683,,7unfwvkz7i4j,40637,40638,81275
43684,,i0oswcbjrfkj,40638,40639,81277
43685,,9ursf2gtvruj,40639,40640,81279
43686,,rflealpxn5qj,40640,40641,81281
43687,,_3f9cfpxutqj,40641,40642,81283
43688,,ptp7aemozfwj,40642,40643,81285
43689,,rr38xihpnt4j,40643,40644,81287
43690,,vzgn1fbnfvaj,40644,40645,81289
43691,,ffpljbabbmcj,40645,40646,81291
43692,,3nqfzkzpivmj,40646,40647,81293
43693,,zlkluzhr7tkj,40647,40648,81295
43694,,1f9zl9heldwj,40648,40649,81297
43695,,qdjnkkaamwsj,40649,40650,81299
43696,,fp9ggruvoxgj,40650,40651,81301
43697,,m5sgaa5qbwaj,40651,40652,81303
43698,,zwayq18dpn8j,40652,40653,81305
43699,,gwlbax8lkpqj,40653,40654,81307
43700,,xzrxo_jcnrij,40654,40655,81309
43701,,ysrmhvd9tngj,40655,40656,81311
43702,,_gli7izv17cj,40656,40657,81313
43703,,url:http://portal.acm.org/citation.cfm3fid3d48360.48363,40658,40659,81317
43704,,yyhebqa6znaj,40659,40660,81319
43705,,ea7t0warqqaj,40660,40661,81321
43706,,lno0b8_s6oaj,40661,40662,81323
43707,,u3bnw6rpmvqj,40662,40663,81325
43708,,glctk66wb2gj,40663,40664,81327
43709,,ohwlsav5stoj,40664,40665,81329
43710,,hwkxbufd-jqj,40665,40666,81331
43711,,jnaxc8wwvxqj,40666,40667,81333
43712,,kqicnyehnuoj,40667,40668,81335
43713,,fx37i3vwx24j,40668,40669,81337
43714,,b5vbahj4xxmj,40669,40670,81339
43715,,jorvq8ee0hcj,40670,40671,81341
43716,,i40oyebkr6gj,40671,40672,81343
43717,,_bvn-hpvzgsj,40672,40673,81345
43718,,buczy7r0nfgj,40673,40674,81347
43719,,h7706oi5kjij,40674,40675,81349
43720,,w0ibusaybcoj,40675,40676,81351
43721,,url:http://ieeexplore.ieee.org/xpl/abs_free.jsp3farnumber3d1339269,40676,40677,81353
43722,,5gujb1pfy3aj,40677,40678,81355
43723,,pw3tpnzg9cyj,40678,40679,81357
43724,,,40679,40680,81359
43725,,bgxemhgoku8j,40680,40681,81361
43726,,lgcjsy1q8u8j,40681,40682,81363
43727,,rl3qesmmpxwj,40682,40683,81365
43728,,8xgdg_zgoaoj,40683,40684,81367
43729,,oyvpnpjpnpkj,40684,40685,81369
43730,,izkt_v3bxfoj,40685,40686,81371
43731,,xvkmjseh1_ej,40686,40687,81373
43732,,1wc2vyc_k3gj,40687,40688,81375
43733,,rop_lj37it4j,40688,40689,81377
43734,,vumo6w24mjkj,40690,40691,81381
43735,,5kvr3u4cr5oj,40691,40692,81383
43736,,jpg-_9zfgjoj,40692,40693,81385
43737,,tnwtnqlmtucj,40693,40694,81387
43738,,k3cf3zjvul8j,40694,40695,81389
43739,,xwvz1xq7euaj,40695,40696,81391
43740,,tejkogcvgx8j,40696,40697,81393
43741,,nquivwq_xaqj,40697,40698,81395
43742,,5knr6ettrhuj,40698,40699,81397
43743,,v7a_mxtgq_0j,40699,40700,81399
43744,,pm7qsb_3biuj,40700,40701,81401
43745,,-9xcpeccubuj,40701,40702,81403
43746,,zfd0njjccgqj,40702,40703,81405
43747,,rgku_u7sypcj,40703,40704,81407
43748,,tvi_iyz-a8oj,40704,40705,81409
43749,,rvdyefaiaewj,40705,40706,81411
43750,,lbdzs5ytb8uj,40706,40707,81413
43751,,ctaacuvhzesj,40708,40709,81417
43752,,r2jkzqmse0gj,40709,40710,81419
43753,,41lxrlwkfuuj,40710,40711,81421
43754,,lg5rsvbqi5cj,40711,40712,81423
43755,,gj7h1bvcefyj,40712,40713,81425
43756,,url:http://www.ingentaconnect.com/search/expand3fpub3dinfobike://els/09505849/2000/00000042/00000003/art0005826unc3d,40713,40714,81427
43757,,rue3senc1s4j,40714,40715,81429
43758,,l-e5m4ykffuj,40715,40716,81431
43759,,uqnt6tlbxaqj,40716,40717,81433
43760,,-7vzxal6kbkj,40717,40718,81435
43761,,iwao-yr3tzij,40718,40719,81437
43762,,5nssvc--8ioj,40719,40720,81439
43763,,ul9csytex7uj,40720,40721,81441
43764,,d9cfew_ax2mj,40721,40722,81443
43765,,zkgo0cgiwxuj,40722,40723,81445
43766,,vtbg9v9n1m0j,40723,40724,81447
43767,,uyq4rgtwetsj,40724,40725,81449
43768,,o1i3nxqao4aj,40725,40726,81451
43769,,ng5wxf3rpswj,40726,40727,81453
43770,,265cu1i6gvqj,40727,40728,81455
43771,,hpqeavlb9i8j,40728,40729,81457
43772,,yxu9xno9-boj,40729,40730,81459
43773,,vztvg67c2w0j,40730,40731,81461
43774,,9dsag8ujuamj,40731,40732,81463
43775,,lmkrltuk53ej,40732,40733,81465
43776,,j9eo8n5hqlsj,40733,40734,81467
43777,,ptgys8jugqij,40734,40735,81469
43778,,w9dl-az6rw8j,40735,40736,81471
43779,,igoidxtz6tmj,40736,40737,81473
43780,,dse_jlwf9zyj,40737,40738,81475
43781,,ordreafkjz0j,40739,40740,81479
43782,,ohc9uu5ltmuj,40740,40741,81481
43783,,nmjuh6-ngzej,40741,40742,81483
43784,,4ah1eodq1acj,40742,40743,81485
43785,,,40743,40744,81487
43786,,tsuhuggq6qej,40744,40745,81489
43787,,c_vhc91ystkj,40746,40747,81493
43788,,url:http://doi.wiley.com/10.1002/he.9810,40747,40748,81495
43789,,v9jynlk8clyj,40748,40749,81497
43790,,jukqzydm9-oj,40750,40751,81501
43791,,6ihznqpem7mj,40751,40752,81503
43792,,eb1jj_-synqj,40752,40753,81505
43793,,rvl1ggimzyqj,40753,40754,81507
43794,,qfozbwjzclej,40754,40755,81509
43795,,9jxllsicqxwj,40755,40756,81511
43796,,m9uq3o2qji8j,40756,40757,81513
43797,,ncwmo0jsc3aj,40757,40758,81515
43798,,bnm4btyxkjej,40758,40759,81517
43799,,url:http://doi.wiley.com/10.1002/he.10706,40759,40760,81519
43800,,ec6a8eiletwj,40760,40761,81521
43801,,yd1owwixvzej,40761,40762,81523
43802,,30aruo9vqa0j,40762,40763,81525
43803,,9vdm1q41j8oj,40763,40764,81527
43804,,url:http://www.csa.com/partners/viewrecord.php3frequester3dgs26collection3dtrd26recid3d0435992ci,40764,40765,81529
43805,,qhwy-xlkfhgj,40765,40766,81531
43806,,dvxlc4-gkxej,40766,40767,81533
43807,,bscxas8veuyj,40767,40768,81535
43808,,lxcucwicncoj,40768,40769,81537
43809,,wfwk1sjz2syj,40769,40770,81539
43810,,ezsepswnowej,40770,40771,81541
43811,,pxme72a8iioj,40771,40772,81543
43812,,nlwmbvjt988j,40772,40773,81545
43813,,jdosoroqzrwj,40773,40774,81547
43814,,v6zz3qedxrej,40774,40775,81549
43815,,fesjhpbldigj,40775,40776,81551
43816,,nhllymgfdv0j,40776,40777,81553
43817,,m_q4wsbyr_gj,40777,40778,81555
43818,,url:http://www.csa.com/partners/viewrecord.php3frequester3dgs26collection3dtrd26recid3d8204540529md,40778,40779,81557
43819,,_lndzahczl4j,40779,40780,81559
43820,,,40780,40781,81561
43821,,gybr2qk1ib8j,40781,40782,81563
43822,,lynnynlzgfsj,40782,40783,81565
43823,,bnup4coqv9yj,40783,40784,81567
43824,,url:http://doi.wiley.com/10.1002/he.67,40784,40785,81569
43825,,i3hwpquhoxqj,40785,40786,81571
43826,,8la3c2bvw0gj,40786,40787,81573
43827,,url:http://www.springerlink.com/index/v684012733670j04.pdf,40787,40788,81575
43828,,yxh2dmifxlcj,40789,40790,81579
43829,,url:http://doi.wiley.com/10.1002/ace.8107,40790,40791,81581
43830,,qnbss1i0okmj,40791,40792,81583
43831,,url:http://doi.wiley.com/10.1002/he.9705,40793,40794,81587
43832,,-6bnmvtzx-sj,40794,40795,81589
43833,,uugloxm1qjqj,40795,40796,81591
43834,,pv8h7ha_bgwj,40796,40797,81593
43835,,bkfw_y3dhmkj,40797,40798,81595
43836,,url:http://portal.acm.org/citation.cfm3fid3d25326226dl3dguide26dl3dacm26type3dissue26idx3dj68926part3dperiodical26wanttype3dperiodical26title3dacm2520sigmod2520record26cfid3d1111111126cftoken3d2222222,40798,40799,81597
43837,,6xvcecinpzyj,40800,40801,81601
43838,,rcxpiw6uq-cj,40801,40802,81603
43839,,_w83islkwvoj,40802,40803,81605
43840,,xlvhq5hnetmj,40803,40804,81607
43841,,gsfwq96dp-sj,40804,40805,81609
43842,,url:http://doi.wiley.com/10.1002/ace.70,40805,40806,81611
43843,,kolj16scxcej,40806,40807,81613
43844,,kswteerfgm8j,40807,40808,81615
43845,,url:http://portal.acm.org/ft_gateway.cfm3fid3d102755026type3dpdf,40808,40809,81617
43846,,lmkf8hayukmj,40809,40810,81619
43847,,xhdo3khr5kyj,40810,40811,81621
43848,,url:http://links.jstor.org/sici3fsici3d0146-4949(196024)1253a1253c50253asbtioe253e2.0.co253b2-c,40811,40812,81623
43849,,qvfsf3s6dokj,40812,40813,81625
43850,,cgv0r1vwntcj,40813,40814,81627
43851,,ncpalv5lzqkj,40814,40815,81629
43852,,djoxnrljxbsj,40815,40816,81631
43853,,nomolzqvmwej,40817,40818,81635
43854,,lubftwoglhaj,40818,40819,81637
43855,,stuxmdf07jqj,40819,40820,81639
43856,,tz9tcbpkcwwj,40820,40821,81641
43857,,xcndqa9ekqej,40821,40822,81643
43858,,tng28hmyzrij,40822,40823,81645
43859,,p3gb0irkc2ij,40823,40824,81647
43860,,yqvbwzzoybuj,40824,40825,81649
43861,,kzgbjqllmomj,40825,40826,81651
43862,,,40826,40827,81653
43863,,v1qdbvtc4p4j,40827,40828,81655
43864,,frpmi7ph1coj,40828,40829,81657
43865,,fdbqlf-pdacj,40829,40830,81659
43866,,i-ha4jdx5swj,40831,40832,81663
43867,,jc3cawgenhoj,40832,40833,81665
43868,,_otc2iittaqj,40833,40834,81667
43869,,hk12mp5svrkj,40834,40835,81669
43870,,8bpubl6pxgqj,40835,40836,81671
43871,,wgszaxfnwr8j,40836,40837,81673
43872,,kbm_slye8w4j,40837,40838,81675
43873,,dikzcocdvtcj,40838,40839,81677
43874,,kvoipm4_fsyj,40839,40840,81679
43875,,emhpgekz8wgj,40840,40841,81681
43876,,uratzh4szegj,40841,40842,81683
43877,,bjujaihfic0j,40842,40843,81685
43878,,ykgqli-iajkj,40843,40844,81687
43879,,7f-3rsprsmcj,40844,40845,81689
43880,,mys45laxhuoj,40845,40846,81691
43881,,prjbu6jaspyj,40846,40847,81693
43882,,lie3x6f5jh4j,40847,40848,81695
43883,,exlmxqku2_uj,40848,40849,81697
43884,,n6y7ebyzgxkj,40849,40850,81699
43885,,j0l-ztjglmwj,40850,40851,81701
43886,,url:http://portal.acm.org/ft_gateway.cfm3fid3d100870726type3dpdf,40851,40852,81703
43887,,url:http://portal.acm.org/ft_gateway.cfm3fid3d110199726type3dpdf,40852,40853,81705
43888,,gkiluoepb0gj,40853,40854,81707
43889,,xmivupl1ctoj,40854,40855,81709
43890,,url:http://www.csa.com/partners/viewrecord.php3frequester3dgs26collection3dtrd26recid3d0210258ci26recid3d0210258ea,40855,40856,81711
43891,,h4uvbrw2y3wj,40856,40857,81713
43892,,xjb3aq8-azej,40857,40858,81715
43893,,ckn55dhtquwj,40858,40859,81717
43894,,v6rlsdj-h8ej,40859,40860,81719
43895,,mmsenfs-6pwj,40860,40861,81721
43896,,,40861,40862,81723
43897,,q2kashs-2zgj,40862,40863,81725
43898,,butyyhz3fccj,40863,40864,81727
43899,,cfy6jyxn_ruj,40864,40865,81729
43900,,c8yh9py67jgj,40865,40866,81731
43901,,url:http://doi.ieeecomputersociety.org/10.1109/tkde.2004.53,40866,40867,81733
43902,,jbdluwfncpkj,40867,40868,81735
43903,,url:http://doi.wiley.com/10.1002/ace.137,40868,40869,81737
43904,,zpst_smjkc8j,40869,40870,81739
43905,,tdolk4xxpp0j,40870,40871,81741
43906,,ombqceouwwij,40871,40872,81743
43907,,wvh1asekvo0j,40872,40873,81745
43908,,ffcumbe2we4j,40873,40874,81747
43909,,0tmlofhcxyij,40874,40875,81749
43910,,vjjyz00d1hkj,40875,40876,81751
43911,,br4nfbnculoj,40876,40877,81753
43912,,9xou4mnk_guj,40877,40878,81755
43913,,m_rkhaepzxij,40878,40879,81757
43914,,omr5nehncd0j,40879,40880,81759
43915,,5divq3a8qoej,40880,40881,81761
43916,,cy14n5f1upsj,40881,40882,81763
43917,,3khl6rxbtiyj,40882,40883,81765
43918,,,40883,40884,81767
43919,,vgjuxijyes0j,40884,40885,81769
43920,,qosoziycbxgj,40885,40886,81771
43921,,xe1zjdexb64j,40886,40887,81773
43922,,_-ipl5_kmhij,40887,40888,81775
43923,,za6ysysngh8j,40888,40889,81777
43924,,qzppq83sjeyj,40889,40890,81779
43925,,m-_yonmzrlwj,40890,40891,81781
43926,,xyuco-zq8qaj,40891,40892,81783
43927,,0hxgql_si4kj,40892,40893,81785
43928,,kbfhx-bl6qij,40893,40894,81787
43929,,w2e5kcv96suj,40894,40895,81789
43930,,6t6hnnxj-c8j,40895,40896,81791
43931,,f01cwmcc3mcj,40896,40897,81793
43932,,m9rnovhneagj,40897,40898,81795
43933,,url:http://portal.acm.org/citation.cfm3fid3d50224,40899,40900,81799
43934,,4oa5ngl7hnaj,40900,40901,81801
43935,,0lzzedghllej,40901,40902,81803
43936,,meggmveth20j,40902,40903,81805
43937,,sd8xeyzlrxej,40903,40904,81807
43938,,fhywt1pylnuj,40904,40905,81809
43939,,bf6nbtrj-hgj,40905,40906,81811
43940,,q773uccm89gj,40906,40907,81813
43941,,kgpe7wpo48kj,40907,40908,81815
43942,,w76m3gedlv4j,40908,40909,81817
43943,,otypkne679oj,40909,40910,81819
43944,,shfdy7xo2rwj,40910,40911,81821
43945,,3iq4uplaow0j,40911,40912,81823
43946,,wmq_vf93lbmj,40912,40913,81825
43947,,sqbdmhiggjaj,40913,40914,81827
43948,,wvshrlcxfxuj,40914,40915,81829
43949,,qmxnphhsh_yj,40915,40916,81831
43950,,wa2x41wqthej,40916,40917,81833
43951,,9uv0k6d3gnsj,40917,40918,81835
43952,,sqewa6pv3vsj,40918,40919,81837
43953,,l6rshhbtddej,40919,40920,81839
43954,,puf-4vc7oqwj,40920,40921,81841
43955,,7ikizzc8lyqj,40921,40922,81843
43956,,iqcbdtchcd4j,40922,40923,81845
43957,,pog6ne4iavkj,40923,40924,81847
43958,,cuq1ennr_1ej,40924,40925,81849
43959,,bhf8lj7wy3wj,40925,40926,81851
43960,,nag68vkzflgj,40926,40927,81853
43961,,hoiooucy3zaj,40928,40929,81857
43962,,xrptbqj-gyuj,40929,40930,81859
43963,,dzfgqgv8xbcj,40930,40931,81861
43964,,huqux5agfdmj,40931,40932,81863
43965,,rq6qkk6ppksj,40932,40933,81865
43966,,5ahk4fytnqkj,40933,40934,81867
43967,,wh2nqqdkcs0j,40934,40935,81869
43968,,cpmjupps_9kj,40935,40936,81871
43969,,isagrkdqknij,40936,40937,81873
43970,,4pbftmy88e4j,40937,40938,81875
43971,,plvhywvjmm8j,40938,40939,81877
43972,,jtioqnjaygcj,40939,40940,81879
43973,,djqkwufhtqmj,40940,40941,81881
43974,,6vpsxho2lacj,40941,40942,81883
43975,,j8vyjq-1hbyj,40942,40943,81885
43976,,8dag-kazcaij,40943,40944,81887
43977,,dp931clmhb4j,40944,40945,81889
43978,,oahm5itk_daj,40945,40946,81891
43979,,jrmdp74shmgj,40946,40947,81893
43980,,z00tidcch3sj,40947,40948,81895
43981,,w1thli9cpjcj,40948,40949,81897
43982,,3n4rhmewbwej,40949,40950,81899
43983,,ec_fnhrtk1cj,40950,40951,81901
43984,,elodhlfukwij,40951,40952,81903
43985,,oliysx6gdkcj,40952,40953,81905
43986,,2qwpaeocexcj,40953,40954,81907
43987,,v6htvkpyvf8j,40954,40955,81909
43988,,5x6ybnd-ov4j,40955,40956,81911
43989,,cbim-7_zgucj,40956,40957,81913
43990,,kfkcebscjvej,40957,40958,81915
43991,,fley0p2chwoj,40958,40959,81917
43992,,vaceynetek8j,40959,40960,81919
43993,,jl8jravscmoj,40960,40961,81921
43994,,rsafibnizimj,40961,40962,81923
43995,,bxcpptghdfoj,40962,40963,81925
43996,,z8ww5f0tvjyj,40963,40964,81927
43997,,nhokshvuzm0j,40964,40965,81929
43998,,lyurghk6iekj,40965,40966,81931
43999,,vh7kcputt20j,40966,40967,81933
44000,,0glqcw6xtvyj,40967,40968,81935
44001,,bumir0-ulryj,40968,40969,81937
44002,,x2iosqmg3nyj,40969,40970,81939
44003,,,40970,40971,81941
44004,,vk9vjilia6ej,40971,40972,81943
44005,,syg94xojrm4j,40972,40973,81945
44006,,xlvh9wrddiej,40973,40974,81947
44007,,0yjdm3rrr0aj,40974,40975,81949
44008,,nznqpzluyh8j,40975,40976,81951
44009,,6ky9cqey9dij,40976,40977,81953
44010,,jemxutb8wrij,40977,40978,81955
44011,,ng2uytr62b8j,40978,40979,81957
44012,,furzhdk_xf8j,40979,40980,81959
44013,,ophe95d4ncmj,40981,40982,81963
44014,,url:http://portal.acm.org/citation.cfm3fid3d234286.1057831,40982,40983,81965
44015,,vbcfpqman-mj,40983,40984,81967
44016,,m4s1scwguvkj,40984,40985,81969
44017,,lmsmpvdnwxij,40985,40986,81971
44018,,uw9p_yoea9oj,40986,40987,81973
44019,,0vjthnxus8mj,40987,40988,81975
44020,,ldx7wn42hgmj,40988,40989,81977
44021,,4b8kfr3d6sej,40989,40990,81979
44022,,5icb8sh5vaqj,40990,40991,81981
44023,,tqcb1qx1usij,40991,40992,81983
44024,,_j4dnytrwgcj,40992,40993,81985
44025,,damrljjvvpkj,40993,40994,81987
44026,,y3xh6s_7avsj,40994,40995,81989
44027,,zt--ta0kszqj,40995,40996,81991
44028,,pjyljqxtw8ij,40996,40997,81993
44029,,s98ajdyfvbkj,40997,40998,81995
44030,,pi2r008qthoj,40998,40999,81997
44031,,url:http://doi.ieeecomputersociety.org/10.1109/tkde.2004.28,40999,41000,81999
44032,,5bwi9ffjckyj,41000,41001,82001
44033,,q4spl32essej,41001,41002,82003
44034,,t0h3z37ldccj,41002,41003,82005
44035,,re9oqujkmkaj,41003,41004,82007
44036,,t_zvgzahpfmj,41004,41005,82009
44037,,,41005,41006,82011
44038,,hthd44pog0gj,41006,41007,82013
44039,,nziyiakrm_sj,41007,41008,82015
44040,,5fb4za8p2oij,41008,41009,82017
44041,,haj3cx0ub3gj,41009,41010,82019
44042,,npmzhyic5e4j,41010,41011,82021
44043,,,41011,41012,82023
44044,,96gi-0xdzzcj,41012,41013,82025
44045,,zlz42s62gvqj,41013,41014,82027
44046,,menryysmuksj,41014,41015,82029
44047,,qfnip_7xy_yj,41015,41016,82031
44048,,zscnhtefjdwj,41016,41017,82033
44049,,le37t_int2gj,41017,41018,82035
44050,,x3n5wljz3g4j,41018,41019,82037
44051,,nm1gtyk7tx4j,41019,41020,82039
44052,,ivrlp3d6tfqj,41021,41022,82043
44053,,voimwguq9naj,41022,41023,82045
44054,,bhcshmv861yj,41023,41024,82047
44055,,dydxqvd8ohoj,41024,41025,82049
44056,,lunsmrb5veuj,41025,41026,82051
44057,,5jjau4enpuqj,41026,41027,82053
44058,,vhphtwppvzij,41027,41028,82055
44059,,sjecnonodtqj,41028,41029,82057
44060,,hg0vezbrspcj,41029,41030,82059
44061,,3b_ipsgz4wkj,41030,41031,82061
44062,,jutalkhklb0j,41031,41032,82063
44063,,514jwrvtla0j,41032,41033,82065
44064,,x6fmiashqacj,41033,41034,82067
44065,,xulr3bfqocmj,41034,41035,82069
44066,,dcj_gc23eg0j,41035,41036,82071
44067,,vkfv0qelcyuj,41036,41037,82073
44068,,rnewkwg06l0j,41037,41038,82075
44069,,url:http://portal.acm.org/citation.cfm3fid3d507338.50735826coll3dguide26dl3dacm26idx3d98437826part3dperiodical26wanttype3dperiodical26title3dacm2520sigmod2520record26cfid3d1111111126cftoken3d2222222,41038,41039,82077
44070,,kim73lpl8vuj,41039,41040,82079
44071,,dc8ne1wkf6cj,41040,41041,82081
44072,,mtwie74qqpuj,41041,41042,82083
44073,,a_fr7k2ivgsj,41042,41043,82085
44074,,bhawoorirawj,41043,41044,82087
44075,,_bvae4jd1acj,41044,41045,82089
44076,,vvjtmze80guj,41045,41046,82091
44077,,mqua801frisj,41046,41047,82093
44078,,mh0rczvsq1cj,41047,41048,82095
44079,,10lhns3o9vuj,41048,41049,82097
44080,,67i70auzojyj,41049,41050,82099
44081,,h_exqkt1dyij,41050,41051,82101
44082,,fdd3syvb2skj,41051,41052,82103
44083,,kt2kqtgolryj,41052,41053,82105
44084,,r_89gabzu0uj,41053,41054,82107
44085,,vh9hbkwns7mj,41054,41055,82109
44086,,q3etxrkywuqj,41055,41056,82111
44087,,pzcgu4c8pfgj,41056,41057,82113
44088,,9xlgp0cciy4j,41057,41058,82115
44089,,ut9gferc4nsj,41058,41059,82117
44090,,qskacmfg6wgj,41059,41060,82119
44091,,8atqcclobryj,41060,41061,82121
44092,,gistisix_zcj,41061,41062,82123
44093,,url:http://doi.wiley.com/10.1002/he.32.abs,41062,41063,82125
44094,,3uaisofvisaj,41063,41064,82127
44095,,8fwtno3qyaoj,41064,41065,82129
44096,,xdeju7gws9ej,41065,41066,82131
44097,,url:http://pubs.acs.org/cgi-bin/abstract.cgi/achre4/asap/abs/ar0501525.html,41066,41067,82133
44098,,juvssbniliuj,41067,41068,82135
44099,,gu4nx7y1nyyj,41068,41069,82137
44100,,bhnb2pqmdvwj,41069,41070,82139
44101,,ainwfq8tcxmj,41070,41071,82141
44102,,r50u9fk4thij,41071,41072,82143
44103,,h7q1kygqwx4j,41072,41073,82145
44104,,6e1cpi0comij,41073,41074,82147
44105,,wqy061nmbcgj,41074,41075,82149
44106,,-8erewrf6cij,41075,41076,82151
44107,,z3kjbnqzltkj,41076,41077,82153
44108,,ibm_wn8nzlgj,41077,41078,82155
44109,,pnwd-bkr4vqj,41078,41079,82157
44110,,z52s21mbr6ij,41079,41080,82159
44111,,o95v4dvgu98j,41080,41081,82161
44112,,3uq3sfwerxkj,41081,41082,82163
44113,,flk_qizpv0yj,41083,41084,82167
44114,,m5kl6hnwjz8j,41084,41085,82169
44115,,6tcqksul5k8j,41085,41086,82171
44116,,8d3jvyjfhf0j,41087,41088,82175
44117,,9xcwrwgdnvcj,41088,41089,82177
44118,,url:http://portal.acm.org/citation.cfm3fid3d949770.949783,41089,41090,82179
44119,,jsyz-0ixid4j,41090,41091,82181
44120,,kjb4rxug_fqj,41091,41092,82183
44121,,p0du6ppzlkcj,41092,41093,82185
44122,,uoew6o3fry0j,41093,41094,82187
44123,,4fcg7h0_bxwj,41094,41095,82189
44124,,pxr4k5xzmicj,41095,41096,82191
44125,,ykcebucsvkwj,41096,41097,82193
44126,,m0umvoi325oj,41097,41098,82195
44127,,xmrrlkdfryij,41098,41099,82197
44128,,gpckfbsjdo8j,41099,41100,82199
44129,,9cao6cstwr0j,41100,41101,82201
44130,,8ubrdl0jsoyj,41101,41102,82203
44131,,lv-wz1tc72gj,41102,41103,82205
44132,,ao2fezsbyhoj,41103,41104,82207
44133,,bepwm7oxkccj,41104,41105,82209
44134,,iutn70tmozij,41105,41106,82211
44135,,,41106,41107,82213
44136,,qs9dvchk5mqj,41107,41108,82215
44137,,ws5yvdv66a8j,41108,41109,82217
44138,,cchrk6miwwmj,41109,41110,82219
44139,,,41110,41111,82221
44140,,vkhoay5ekusj,41111,41112,82223
44141,,b4bombrz7-0j,41112,41113,82225
44142,,zme-2oxyw9oj,41113,41114,82227
44143,,akxclgcursqj,41114,41115,82229
44144,,lhs9z1a75f0j,41115,41116,82231
44145,,fyf9uv4hroaj,41116,41117,82233
44146,,firciuitwyyj,41117,41118,82235
44147,,5vcrg3u3sbsj,41118,41119,82237
44148,,url:http://www.ingentaconnect.com/search/expand3fpub3dinfobike://els/09505849/2002/00000044/00000005/art0021226unc3d,41119,41120,82239
44149,,qr53tguhtjqj,41120,41121,82241
44150,,url:http://doi.wiley.com/10.1002/ace.156,41121,41122,82243
44151,,ip5rqt6wfxoj,41122,41123,82245
44152,,ezngtwtjdiqj,41123,41124,82247
44153,,o5d2uckf8sgj,41124,41125,82249
44154,,o1k-xjrzeeyj,41125,41126,82251
44155,,url:http://www.csa.com/partners/viewrecord.php3frequester3dgs26collection3dtrd26recid3dn9210552ah,41126,41127,82253
44156,,tqzltaip3b0j,41127,41128,82255
44157,,ww_irodty8sj,41128,41129,82257
44158,,qso3pdlmwv4j,41129,41130,82259
44159,,wxddk2h0kmyj,41130,41131,82261
44160,,lhy6ljdngy4j,41131,41132,82263
44161,,esjueq0b_euj,41132,41133,82265
44162,,djapjavfgvsj,41133,41134,82267
44163,,2alj5ei5kksj,41134,41135,82269
44164,,kmsvl4pm20ij,41135,41136,82271
44165,,nnznbyczupwj,41136,41137,82273
44166,,kwo0ssikp3kj,41137,41138,82275
44167,,url:http://www.csa.com/partners/viewrecord.php3frequester3dgs26collection3dtrd26recid3dn9210410ah,41139,41140,82279
44168,,5kuf6fpdvwsj,41140,41141,82281
44169,,j0rcsgldmxoj,41141,41142,82283
44170,,u6vlsvsco1qj,41142,41143,82285
44171,,pvkz9jyxybej,41143,41144,82287
44172,,owu3zxz_jtij,41144,41145,82289
44173,,v4fmggvotj4j,41145,41146,82291
44174,,q1darebzrywj,41146,41147,82293
44175,,ojlevox0y0oj,41147,41148,82295
44176,,s9vkn9ow6iqj,41148,41149,82297
44177,,sxenuk3kb_qj,41149,41150,82299
44178,,xa7rjffpk-aj,41150,41151,82301
44179,,nyf_ecsbpjgj,41151,41152,82303
44180,,url:http://www.csa.com/partners/viewrecord.php3frequester3dgs26collection3dtrd26recid3dn9210379ah,41152,41153,82305
44181,,7djlxscvd7oj,41153,41154,82307
44182,,ztb1yyz_0_0j,41155,41156,82311
44183,,6abzp5_oeboj,41156,41157,82313
44184,,0dc80feaj9ij,41157,41158,82315
44185,,rpytz_th5byj,41158,41159,82317
44186,,lqrnxqgvfecj,41159,41160,82319
44187,,s816ywwoteqj,41160,41161,82321
44188,,tlshbtc2d-yj,41161,41162,82323
44189,,oyafesnecywj,41162,41163,82325
44190,,22dp95kayy4j,41163,41164,82327
44191,,url:http://ieeexplore.ieee.org/iel5/9217/29235/01320097.pdf3farnumber3d1320097,41164,41165,82329
44192,,bidp45hkkkoj,41165,41166,82331
44193,,v2dqoaofcyuj,41166,41167,82333
44194,,tsjpcw7ou3gj,41167,41168,82335
44195,,hphza7bpb8uj,41168,41169,82337
44196,,wjpzuay6ixoj,41169,41170,82339
44197,,url:http://portal.acm.org/citation.cfm3fid3d354384.37649926dl3dguide26dl3dacm26type3dseries26idx3d35438426part3dproceedings26wanttype3dproceedings26title3dinternational2520multimedia2520conference26cfid3d1111111126cftoken3d2222222,41170,41171,82341
44198,,dscfajxzoayj,41171,41172,82343
44199,,wsxglror7v4j,41172,41173,82345
44200,,ftfyb2i82_wj,41173,41174,82347
44201,,jnerlyjxxymj,41174,41175,82349
44202,,ueylr_xob_ij,41175,41176,82351
44203,,s4tlm9zt_taj,41176,41177,82353
44204,,kn21pipdbvij,41177,41178,82355
44205,,poml5fu3bakj,41178,41179,82357
44206,,ngtzxfjuzokj,41179,41180,82359
44207,,vijpg-0peiej,41180,41181,82361
44208,,s1nblus0bpqj,41181,41182,82363
44209,,cwfumrfbtawj,41182,41183,82365
44210,,w4qqm5kcdcqj,41183,41184,82367
44211,,pb-ovmihmvuj,41184,41185,82369
44212,,56u_hedjyggj,41185,41186,82371
44213,,a-qj7miy6oyj,41186,41187,82373
44214,,url:http://portal.acm.org/citation.cfm3fid3d500141.50026426dl3dportal26dl3dacm26type3dseries26idx3d50014126part3dproceedings26wanttype3dproceedings26title3dinternational2520multimedia2520conference26cfid3d1111111126cftoken3d2222222,41187,41188,82375
44215,,qrfba723ryaj,41188,41189,82377
44216,,hj-tlgffsemj,41189,41190,82379
44217,,url:http://www.ncbi.nlm.nih.gov/entrez/query.fcgi3fcmd3dretrieve26db3dpubmed26list_uids3d1248478626dopt3dcitation,41190,41191,82381
44218,,vv1zrsc5npwj,41191,41192,82383
44219,,b-lrs_ok7b8j,41192,41193,82385
44220,,atj6708ygo4j,41193,41194,82387
44221,,mjmskdha5bgj,41194,41195,82389
44222,,url:http://www.ingentaconnect.com/search/expand3fpub3dinfobike://els/09505849/1998/00000040/00000002/art0003026unc3d,41195,41196,82391
44223,,j9ovtsjgozij,41196,41197,82393
44224,,sus2uqs_mskj,41197,41198,82395
44225,,6ccrlonmxecj,41198,41199,82397
44226,,ilri5oqo94uj,41199,41200,82399
44227,,bi_ngo6fisqj,41200,41201,82401
44228,,lad07q2btbgj,41201,41202,82403
44229,,nr0ijuab4iuj,41202,41203,82405
44230,,qid9o54gtckj,41203,41204,82407
44231,,kyj0pc_g3zwj,41204,41205,82409
44232,,2tulupikcbyj,41205,41206,82411
44233,,b7ueqxr-zw8j,41206,41207,82413
44234,,bo9rbkuiheej,41207,41208,82415
44235,,ck63tepxjkqj,41208,41209,82417
44236,,e_yr_zvrvlej,41209,41210,82419
44237,,ggvogb8z6voj,41210,41211,82421
44238,,a2z4dutdpaaj,41211,41212,82423
44239,,xzkxmkaqexij,41212,41213,82425
44240,,o7afgxicnb4j,41213,41214,82427
44241,,f0gsblwgy30j,41214,41215,82429
44242,,rcm8uqs31csj,41215,41216,82431
44243,,g94qxkcw07sj,41216,41217,82433
44244,,y_8hitm7yckj,41217,41218,82435
44245,,tcd9lmqau5uj,41218,41219,82437
44246,,37t0zdmnqiaj,41219,41220,82439
44247,,tnzm8e3w2k4j,41220,41221,82441
44248,,wbg5bgtsasij,41221,41222,82443
44249,,gzckzjovfdij,41222,41223,82445
44250,,wvwhr1exe2sj,41224,41225,82449
44251,,thazwhmpxekj,41226,41227,82453
44252,,yq6gmq7kmbcj,41227,41228,82455
44253,,f1i20e6wawoj,41228,41229,82457
44254,,url:http://www.blackwell-synergy.com/links/doi/10.1111/j.1467-8306.1964.tb00489.x/abs/,41229,41230,82459
44255,,921xowkpcikj,41230,41231,82461
44256,,xmu9ouplqdej,41231,41232,82463
44257,,url:http://portal.acm.org/ft_gateway.cfm3fid3d110118926type3dpdf,41232,41233,82465
44258,,zqy0qswyyjaj,41233,41234,82467
44259,,xtxn94eqbi0j,41234,41235,82469
44260,,url:http://portal.acm.org/ft_gateway.cfm3fid3d60187126type3dpdf26dl3dguide26dl3dacm26cfid3d1111111126cftoken3d2222222,41235,41236,82471
44261,,hmgznrgmj_mj,41236,41237,82473
44262,,9ylroqmdnz8j,41237,41238,82475
44263,,3_fpsdxqbe4j,41238,41239,82477
44264,,li28cs6l9fqj,41239,41240,82479
44265,,mpjnbgft6u0j,41240,41241,82481
44266,,mggvgyuqky8j,41241,41242,82483
44267,,mgdq5qpvlqyj,41242,41243,82485
44268,,pcknuvlnzwuj,41243,41244,82487
44269,,fpbhgdroagsj,41244,41245,82489
44270,,bmhhumc66jaj,41245,41246,82491
44271,,url:http://doi.wiley.com/10.1002/he.174,41246,41247,82493
44272,,url:http://www.springerlink.com/index/gx12w1150841m18x.pdf,41247,41248,82495
44273,,8tfukhvc_kaj,41248,41249,82497
44274,,6oybqzvj53uj,41249,41250,82499
44275,,2xervb6bvz0j,41250,41251,82501
44276,,8okppxsole4j,41251,41252,82503
44277,,_vgliyofohaj,41252,41253,82505
44278,,llrgxlvtf_ej,41253,41254,82507
44279,,uezmzjnzct8j,41254,41255,82509
44280,,qxdw44f5bioj,41255,41256,82511
44281,,zbdnrd9tbpuj,41257,41258,82515
44282,,kgsctlollfoj,41258,41259,82517
44283,,cmjevu2_cxij,41259,41260,82519
44284,,0t6qcjq-1b8j,41260,41261,82521
44285,,lwmwnki8jx8j,41261,41262,82523
44286,,4wptefzpmtwj,41262,41263,82525
44287,,_vxhlwvvunkj,41263,41264,82527
44288,,nn3ps1khy2oj,41264,41265,82529
44289,,jfaobbvgz1cj,41265,41266,82531
44290,,kzud-uch7ywj,41266,41267,82533
44291,,ocxktqbrn_4j,41268,41269,82537
44292,,p30a3k6zsv8j,41269,41270,82539
44293,,lltb024jvvyj,41270,41271,82541
44294,,url:http://portal.acm.org/ft_gateway.cfm3fid3d7103926type3dpdf,41271,41272,82543
44295,,nsqlfh6fro4j,41272,41273,82545
44296,,nd_5opv47vij,41273,41274,82547
44297,,lcnu1zjyfx0j,41274,41275,82549
44298,,wzysjqjeyluj,41275,41276,82551
44299,,k7r2n1koigaj,41276,41277,82553
44300,,hj9-1xt60k0j,41277,41278,82555
44301,,wmedad3c3g0j,41278,41279,82557
44302,,uafpa9guvj4j,41279,41280,82559
44303,,r7n6lzlpykkj,41281,41282,82563
44304,,0wj40lsunogj,41282,41283,82565
44305,,e773d_nd00ej,41283,41284,82567
44306,,url:http://www.springerlink.com/index/m0016p8j196v6m65.pdf,41284,41285,82569
44307,,8h2bmxpsj-yj,41285,41286,82571
44308,,jly3_bmix94j,41286,41287,82573
44309,,7vdkykyupewj,41287,41288,82575
44310,,mltelrgiuh4j,41288,41289,82577
44311,,y2fioue7xs8j,41289,41290,82579
44312,,pgwdfveccmoj,41290,41291,82581
44313,,url:http://www.springerlink.com/index/l8p40m4j04384858.pdf,41291,41292,82583
44314,,url:http://www.ingentaconnect.com/content/bpl/area/2001/00000033/00000003/art00027,41292,41293,82585
44315,,0l1hdesanqmj,41293,41294,82587
44316,,oi2d70-1nruj,41294,41295,82589
44317,,o_hpn9ifvxuj,41295,41296,82591
44318,,z6kdca2vgngj,41296,41297,82593
44319,,ldwhddw8xmcj,41297,41298,82595
44320,,o-xsz2yf-juj,41298,41299,82597
44321,,qjy2ee1s9igj,41299,41300,82599
44322,,url:http://portal.acm.org/ft_gateway.cfm3fid3d108626826type3dpdf,41300,41301,82601
44323,,url:http://ieeexplore.ieee.org/iel2/717/971/00026105.pdf3farnumber3d26105,41301,41302,82603
44324,,cchgo4zhaccj,41302,41303,82605
44325,,jwz721mdug0j,41303,41304,82607
44326,,k8zarc0bno0j,41304,41305,82609
44327,,inhodkk6laij,41305,41306,82611
44328,,fvdjppdznxoj,41306,41307,82613
44329,,xlondixvtnkj,41307,41308,82615
44330,,mcle0uv_h6yj,41308,41309,82617
44331,,zajbm4h53auj,41309,41310,82619
44332,,,41310,41311,82621
44333,,barnaxn1hesj,41311,41312,82623
44334,,qpto0intuwaj,41312,41313,82625
44335,,3txga4yz4bmj,41313,41314,82627
44336,,kt4fsy9prz8j,41314,41315,82629
44337,,url:http://portal.acm.org/ft_gateway.cfm3fid3d95710926type3dpdf26dl3dguide26dl3dacm26cfid3d1111111126cftoken3d2222222,41315,41316,82631
44338,,trod1e6gs6sj,41316,41317,82633
44339,,hdokbo9pjeoj,41317,41318,82635
44340,,j550uy8rv-wj,41318,41319,82637
44341,,ndtjtwuhzbqj,41319,41320,82639
44342,,qnf-4ic8ho4j,41320,41321,82641
44343,,ft4p5f_kdzaj,41321,41322,82643
44344,,k0pop8saubwj,41322,41323,82645
44345,,ucqz4q8s2joj,41323,41324,82647
44346,,dexpq-ezmssj,41324,41325,82649
44347,,zqyhi9ujdhcj,41325,41326,82651
44348,,prqepj3ohc8j,41326,41327,82653
44349,,urfq4npq9vuj,41327,41328,82655
44350,,jarsnyxbm0oj,41328,41329,82657
44351,,pci2ldlawzmj,41329,41330,82659
44352,,xkzig2jdnucj,41330,41331,82661
44353,,bqjmfhvkgocj,41331,41332,82663
44354,,url:http://doi.wiley.com/10.1002/ace.142,41332,41333,82665
44355,,sctphozqmnaj,41333,41334,82667
44356,,rzbsdzlsgimj,41334,41335,82669
44357,,cgzecklhs-cj,41335,41336,82671
44358,,tk5_1_u5iecj,41336,41337,82673
44359,,l4axhauw3cuj,41338,41339,82677
44360,,arvvdfddegoj,41339,41340,82679
44361,,url:http://pubs.acs.org/cgi-bin/abstract.cgi/achre4/2005/38/i08/abs/ar040293r.html,41340,41341,82681
44362,,gg-waeppxsqj,41341,41342,82683
44363,,8zinx4etgeej,41342,41343,82685
44364,,3xehi3dgujyj,41343,41344,82687
44365,,mntbe3sbt58j,41344,41345,82689
44366,,zrkdzazmfeaj,41345,41346,82691
44367,,u58pwkojuuuj,41346,41347,82693
44368,,z68l3np5dtgj,41347,41348,82695
44369,,jnheyt1zg38j,41348,41349,82697
44370,,706pz63hbd0j,41349,41350,82699
44371,,d1ygijgro4ej,41351,41352,82703
44372,,egsavoxvx7uj,41352,41353,82705
44373,,pqu1qy4di_oj,41353,41354,82707
44374,,mspzbsx8rlwj,41354,41355,82709
44375,,p0egt4sui0gj,41355,41356,82711
44376,,vbcfhmoan8aj,41356,41357,82713
44377,,k2bjwf1gkxej,41357,41358,82715
44378,,7k6r7i1hgpyj,41358,41359,82717
44379,,roykkzuei0aj,41359,41360,82719
44380,,rfd0c3lxk1aj,41360,41361,82721
44381,,ey5benvk2jgj,41361,41362,82723
44382,,y3ozfebjuzoj,41362,41363,82725
44383,,url:http://doi.wiley.com/10.1002/he.9811,41363,41364,82727
44384,,5bnddvvtbaqj,41364,41365,82729
44385,,zb29aplnouej,41366,41367,82733
44386,,p_wohijyyjkj,41367,41368,82735
44387,,bsvcbgnhmmmj,41368,41369,82737
44388,,njekpzom48kj,41369,41370,82739
44389,,8b6cthsghfkj,41370,41371,82741
44390,,r7f2f48rawqj,41372,41373,82745
44391,,4bmulnikscyj,41373,41374,82747
44392,,hdjg74d9muej,41374,41375,82749
44393,,url:http://ieeexplore.ieee.org/iel1/2206/2194/00060337.pdf3farnumber3d60337,41375,41376,82751
44394,,kexucv1yqx0j,41376,41377,82753
44395,,ucptummmf5gj,41377,41378,82755
44396,,_gs9nguhseaj,41378,41379,82757
44397,,mj8wfdhg9aaj,41379,41380,82759
44398,,utxihtz-0o8j,41381,41382,82763
44399,,dvsrwjuerwgj,41382,41383,82765
44400,,url:http://portal.acm.org/ft_gateway.cfm3fid3d102776426type3dpdf,41384,41385,82769
44401,,m9tgffsliiaj,41385,41386,82771
44402,,url:http://portal.acm.org/ft_gateway.cfm3fid3d50736726type3dpdf26dl3dguide26dl3dacm26cfid3d1111111126cftoken3d2222222,41386,41387,82773
44403,,dyxjodaynugj,41387,41388,82775
44404,,jajkdv2f1moj,41388,41389,82777
44405,,oyyc8wfmzxmj,41390,41391,82781
44406,,9wesa-03picj,41391,41392,82783
44407,,zbqrb6a1bqij,41392,41393,82785
44408,,c_8itdqfrrwj,41393,41394,82787
44409,,dcihfm3slv4j,41394,41395,82789
44410,,8z5u23skjjoj,41395,41396,82791
44411,,oivrpnxvoigj,41396,41397,82793
44412,,704a2dlxjlyj,41397,41398,82795
44413,,1axbncvdhbkj,41398,41399,82797
44414,,egpttcyhogkj,41399,41400,82799
44415,,l339642c1zij,41400,41401,82801
44416,,p7hxvt4mao0j,41401,41402,82803
44417,,qycxm0qre3mj,41402,41403,82805
44418,,url:http://www.csa.com/partners/viewrecord.php3frequester3dgs26collection3dtrd26recid3dn9210525ah,41403,41404,82807
44419,,qyeywcuwkmuj,41404,41405,82809
44420,,osiihc3v14qj,41405,41406,82811
44421,,njqvizarqo0j,41406,41407,82813
44422,,1vpy_u6c-sej,41407,41408,82815
44423,,cqymcaj2ykaj,41408,41409,82817
44424,,7oh3n_g19scj,41409,41410,82819
44425,,guajtllfvzkj,41410,41411,82821
44426,,9znhlvf52quj,41411,41412,82823
44427,,ytwav_r7xawj,41412,41413,82825
44428,,_o8pajt74pqj,41413,41414,82827
44429,,pvytzcjtr1sj,41414,41415,82829
44430,,zmbdbeecdqej,41415,41416,82831
44431,,yv5jbnlucbij,41416,41417,82833
44432,,jxzv7eiixgqj,41417,41418,82835
44433,,y4xvpsk_v-qj,41418,41419,82837
44434,,ntwi0gg06dkj,41419,41420,82839
44435,,konlhqfigvsj,41420,41421,82841
44436,,kz4pna7kbryj,41421,41422,82843
44437,,ceb1pzrats0j,41422,41423,82845
44438,,1b7o4c5mjucj,41423,41424,82847
44439,,1ocz7cohbvkj,41424,41425,82849
44440,,7ke8oy1_m5aj,41425,41426,82851
44441,,tqd4fty0abyj,41426,41427,82853
44442,,u2t4obmlxwej,41427,41428,82855
44443,,wnjdiyyichej,41428,41429,82857
44444,,0_o6dpgutz0j,41429,41430,82859
44445,,lixai94lysij,41430,41431,82861
44446,,095aievy5tuj,41432,41433,82865
44447,,url:http://www.ingentaconnect.com/content/els/08830355/2001/00000035/00000004/art00038,41433,41434,82867
44448,,,41434,41435,82869
44449,,ymqjtkk37toj,41435,41436,82871
44450,,zeckr3uympsj,41436,41437,82873
44451,,q8jc682byruj,41437,41438,82875
44452,,djlhjl32o0ij,41438,41439,82877
44453,,url:http://portal.acm.org/citation.cfm3fid3dseries9729.153070,41439,41440,82879
44454,,yfssqv5joxaj,41440,41441,82881
44455,,ou2jysq5npyj,41441,41442,82883
44456,,uozuyduroa8j,41442,41443,82885
44457,,l6roosk2qlij,41443,41444,82887
44458,,jx4diq1z8m4j,41444,41445,82889
44459,,uie7hx9mifoj,41445,41446,82891
44460,,vn94c_dboikj,41446,41447,82893
44461,,cx0d7yy7n90j,41448,41449,82897
44462,,b14-ihbckaij,41451,41452,82903
44463,,l6daxouxf-0j,41452,41453,82905
44464,,igwxpvtbpmkj,41453,41454,82907
44465,,ggvebhm19pkj,41454,41455,82909
44466,,koejbyynxl4j,41455,41456,82911
44467,,qqnxqwdaspqj,41456,41457,82913
44468,,xdsesm0vlaqj,41457,41458,82915
44469,,gocd16cobsqj,41458,41459,82917
44470,,lxtdc1xo9myj,41459,41460,82919
44471,,qoddvykuslkj,41460,41461,82921
44472,,nvigq6pm0rkj,41461,41462,82923
44473,,zlvb45inr1ij,41462,41463,82925
44474,,ctyqkycxuwgj,41463,41464,82927
44475,,cw33q8ga6isj,41464,41465,82929
44476,,x4i6x_n1jbmj,41465,41466,82931
44477,,yn537vvxi44j,41466,41467,82933
44478,,sfvpn0tys7cj,41467,41468,82935
44479,,quk1i9zob7aj,41468,41469,82937
44480,,31xqhkce4wuj,41469,41470,82939
44481,,758bvpcheucj,41470,41471,82941
44482,,vkb4jxeyc8ij,41471,41472,82943
44483,,zvvus_5bkqmj,41472,41473,82945
44484,,frk_rmeg6qoj,41473,41474,82947
44485,,sd91u0oxea8j,41474,41475,82949
44486,,gwr7govdslsj,41475,41476,82951
44487,,5dq5gbqfke8j,41476,41477,82953
44488,,sxrui1avxywj,41477,41478,82955
44489,,9cxmno45yhyj,41478,41479,82957
44490,,mne58q8wqs0j,41479,41480,82959
44491,,wyo05l2cyzmj,41481,41482,82963
44492,,_3fyv_b9z7sj,41482,41483,82965
44493,,j3yvir1ob7yj,41483,41484,82967
44494,,cvqzjbd-dzoj,41484,41485,82969
44495,,aov0fdsfd0ej,41485,41486,82971
44496,,ad3jaqwyvjqj,41486,41487,82973
44497,,b7jwoh7zqqqj,41487,41488,82975
44498,,ynchg1ge41yj,41488,41489,82977
44499,,a5ge65tjwvaj,41489,41490,82979
44500,,tnb3fsknu6ej,41490,41491,82981
44501,,wv3dviwbb_uj,41491,41492,82983
44502,,hjf8j6ssisaj,41492,41493,82985
44503,,b7maegl1cnuj,41493,41494,82987
44504,,16rt0z0cdi4j,41494,41495,82989
44505,,xdi3ntau4yqj,41495,41496,82991
44506,,ynsuay4ek7gj,41497,41498,82995
44507,,yerty1vgjiqj,41498,41499,82997
44508,,bz3ppewmsqoj,41499,41500,82999
44509,,q3dntw_fsfqj,41500,41501,83001
44510,,r6bl0pestakj,41501,41502,83003
44511,,7kez_inmclaj,41502,41503,83005
44512,,,41503,41504,83007
44513,,ty18_cemeqqj,41504,41505,83009
44514,,qjkfebth5xaj,41505,41506,83011
44515,,tyno4u-fmrij,41506,41507,83013
44516,,yv7vyzt9-yej,41507,41508,83015
44517,,nkcl48gd278j,41508,41509,83017
44518,,etls0qfwii0j,41509,41510,83019
44519,,qagqbt2za1yj,41510,41511,83021
44520,,n-hbf2t1cjgj,41511,41512,83023
44521,,vccwx5dacrcj,41512,41513,83025
44522,,ikaqbjn7um0j,41513,41514,83027
44523,,f6wzk92nqeqj,41514,41515,83029
44524,,xxm_k27fleij,41515,41516,83031
44525,,vqyvzz1g_3wj,41516,41517,83033
44526,,u_r0qirzwccj,41517,41518,83035
44527,,url:http://adsabs.harvard.edu/abs/1974mit..reptq....f,41518,41519,83037
44528,,6dhsz7dmthej,41519,41520,83039
44529,,yx2q_ob3iwuj,41520,41521,83041
44530,,c1trbsgsgikj,41521,41522,83043
44531,,ohyg3vmbptoj,41522,41523,83045
44532,,s74gzgtam1yj,41523,41524,83047
44533,,spipvwl9nz0j,41525,41526,83051
44534,,neccsitktdaj,41526,41527,83053
44535,,4kc-cqeo_muj,41527,41528,83055
44536,,pkceuhagfs0j,41528,41529,83057
44537,,7ycm8v-i9g0j,41529,41530,83059
44538,,5ittkahx6oyj,41530,41531,83061
44539,,532vdqszqb4j,41531,41532,83063
44540,,awr5e5xmcpsj,41532,41533,83065
44541,,vxgoa4-goukj,41533,41534,83067
44542,,v1m4safuoecj,41534,41535,83069
44543,,aephr-hkqpmj,41535,41536,83071
44544,,netr1satwasj,41536,41537,83073
44545,,q8yht3lib30j,41537,41538,83075
44546,,3midyhikucmj,41538,41539,83077
44547,,ioyhesoytmwj,41539,41540,83079
44548,,6f9qwfihnqij,41540,41541,83081
44549,,,41541,41542,83083
44550,,bav4ifmex1mj,41542,41543,83085
44551,,url:http://portal.acm.org/ft_gateway.cfm3fid3d110130626type3dpdf,41543,41544,83087
44552,,url:http://links.jstor.org/sici3fsici3d0146-4949(196021252f22)1253a2253c5253atdanon253e2.0.co253b2-3,41544,41545,83089
44553,,i8a2bhmoegaj,41545,41546,83091
44554,,ytyz2ixuxfej,41546,41547,83093
44555,,rzfb7co67dmj,41547,41548,83095
44556,,koaxp3tvr7cj,41548,41549,83097
44557,,ur1_mhlrrisj,41549,41550,83099
44558,,ewl7bmdz-d8j,41550,41551,83101
44559,,9z6hyanhdksj,41552,41553,83105
44560,,luamnxgginij,41553,41554,83107
44561,,wvqssblhsrkj,41554,41555,83109
44562,,xpolfbobr_ij,41555,41556,83111
44563,,bqqangqhddsj,41556,41557,83113
44564,,cqmj-uiy6ooj,41557,41558,83115
44565,,b2yaffs4rmcj,41558,41559,83117
44566,,dcgu4krsbmmj,41559,41560,83119
44567,,6nw9chdk2ysj,41560,41561,83121
44568,,mrcs4xsaadcj,41561,41562,83123
44569,,ez4cvypbexyj,41562,41563,83125
44570,,qe96kyu2hvkj,41563,41564,83127
44571,,noyc-c5ybakj,41564,41565,83129
44572,,ejo5hvra2-8j,41565,41566,83131
44573,,rogtvouirh0j,41566,41567,83133
44574,,izwwgycuwtqj,41568,41569,83137
44575,,dut1dj-_pkij,41569,41570,83139
44576,,url:http://www.csa.com/partners/viewrecord.php3frequester3dgs26collection3dtrd26recid3dn9210441ah,41570,41571,83141
44577,,b_lpj8wu7bej,41571,41572,83143
44578,,nxg4jlwklguj,41572,41573,83145
44579,,garpb86mqb4j,41573,41574,83147
44580,,nlfmyadhyccj,41574,41575,83149
44581,,mebyddsnes8j,41575,41576,83151
44582,,waatkycb_qsj,41576,41577,83153
44583,,2ttvuzfr3wij,41577,41578,83155
44584,,uh2lqga6hquj,41578,41579,83157
44585,,cbwwfk5r2l4j,41579,41580,83159
44586,,63y-t4r2rycj,41580,41581,83161
44587,,78cztdj9gkkj,41581,41582,83163
44588,,bhds0tvcb04j,41582,41583,83165
44589,,d5fr7wsbddej,41583,41584,83167
44590,,cvrcmzuq5jgj,41584,41585,83169
44591,,l3ntoovtauij,41585,41586,83171
44592,,tiflxshl-0qj,41586,41587,83173
44593,,bknkjuvnrvwj,41587,41588,83175
44594,,o5epellgtjsj,41588,41589,83177
44595,,8kitkq-uzcuj,41589,41590,83179
44596,,9rofzgq6htcj,41590,41591,83181
44597,,,41591,41592,83183
44598,,zjegk3daocsj,41592,41593,83185
44599,,5tr5bidpb98j,41593,41594,83187
44600,,cld080j61g8j,41594,41595,83189
44601,,7lexohrgz94j,41595,41596,83191
44602,,rmbikllwdskj,41596,41597,83193
44603,,hfza3c-kiruj,41597,41598,83195
44604,,,41598,41599,83197
44605,,qy9p0m6wlmcj,41599,41600,83199
44606,,q9zf0jp1dtgj,41600,41601,83201
44607,,qhnrqzbv2nwj,41601,41602,83203
44608,,okrjdcszpokj,41602,41603,83205
44609,,xbvuurmgveyj,41603,41604,83207
44610,,shevwt2hhgej,41604,41605,83209
44611,,ncono-va4pcj,41605,41606,83211
44612,,9b_6isxzoh4j,41606,41607,83213
44613,,6ogigk6aii8j,41607,41608,83215
44614,,url:http://www.csa.com/partners/viewrecord.php3frequester3dgs26collection3dtrd26recid3d0860919ci,41608,41609,83217
44615,,hgvau0ptuq8j,41609,41610,83219
44616,,aapy4e9lwtwj,41610,41611,83221
44617,,ympm9youxagj,41611,41612,83223
44618,,nfkvajwfhyoj,41612,41613,83225
44619,,d81ttizrkwgj,41613,41614,83227
44620,,oylpinznpxcj,41614,41615,83229
44621,,zjpra5z-0gmj,41615,41616,83231
44622,,4vjfuubsznuj,41616,41617,83233
44623,,url:http://links.jstor.org/sici3fsici3d0146-4949(196323)4253a3253c305253apci2522c253e2.0.co253b2-e,41617,41618,83235
44624,,aojxwl2rid8j,41618,41619,83237
44625,,wkci10lbknaj,41619,41620,83239
44626,,fdrayn0eaemj,41621,41622,83243
44627,,0nj8nttx44gj,41622,41623,83245
44628,,j596jlq0jswj,41623,41624,83247
44629,,6quc620jzw0j,41625,41626,83251
44630,,uuocmwvdc_0j,41626,41627,83253
44631,,qsv8zvsd_jcj,41627,41628,83255
44632,,dhuxnm_qbrwj,41628,41629,83257
44633,,aqqvnjolfm8j,41629,41630,83259
44634,,i3tft_usag8j,41630,41631,83261
44635,,mrpi4cyqvtej,41631,41632,83263
44636,,vs6zyp71twgj,41633,41634,83267
44637,,0tmclmakam0j,41634,41635,83269
44638,,uslvwu_foucj,41635,41636,83271
44639,,hvpvkxhjuwij,41636,41637,83273
44640,,ch2mmgqfbl8j,41637,41638,83275
44641,,kvjka7xp7aoj,41638,41639,83277
44642,,cucm_rma28cj,41639,41640,83279
44643,,url:http://portal.acm.org/citation.cfm3fid3d115864,41640,41641,83281
44644,,ru01fpjfv70j,41641,41642,83283
44645,,url:http://www.csa.com/partners/viewrecord.php3frequester3dgs26collection3denv26recid3d8913256,41642,41643,83285
44646,,dkgofu4y3vgj,41643,41644,83287
44647,,pw_pc28hs7sj,41644,41645,83289
44648,,y7bxhwbporsj,41645,41646,83291
44649,,v5v8nifi9hcj,41646,41647,83293
44650,,8utchns9hdaj,41647,41648,83295
44651,,vpx141ia9ecj,41648,41649,83297
44652,,r3xyvrp-mjij,41649,41650,83299
44653,,uwqglwi8vogj,41650,41651,83301
44654,,jf1su8w0jisj,41651,41652,83303
44655,,mixsqlcalkij,41652,41653,83305
44656,,dwxno6_jinej,41653,41654,83307
44657,,rek4qqozzgej,41654,41655,83309
44658,,prgxsioaocij,41655,41656,83311
44659,,wd8nsghnneqj,41656,41657,83313
44660,,bptfqsyfovgj,41657,41658,83315
44661,,egjkhlqmmuyj,41658,41659,83317
44662,,itq0-xmaqiaj,41659,41660,83319
44663,,8z-gfijeocuj,41660,41661,83321
44664,,3oaxy7rotemj,41661,41662,83323
44665,,ce39rndxoxmj,41662,41663,83325
44666,,57qtlntdwecj,41663,41664,83327
44667,,3x2qgdw7fwwj,41664,41665,83329
44668,,azx2nzria70j,41665,41666,83331
44669,,dkn2lhw0s78j,41666,41667,83333
44670,,dxdgpcjzu9oj,41667,41668,83335
44671,,sskgfhsvroqj,41668,41669,83337
44672,,cpb5btucnqoj,41669,41670,83339
44673,,dmvphqx9xbuj,41670,41671,83341
44674,,0pb87neknxkj,41671,41672,83343
44675,,_7_hyfs78aij,41672,41673,83345
44676,,izbwro2_bbcj,41673,41674,83347
44677,,ezzwa2yvepij,41674,41675,83349
44678,,de20rrl9viqj,41675,41676,83351
44679,,url:http://www.csa.com/partners/viewrecord.php3frequester3dgs26collection3dtrd26recid3d0014648ci,41676,41677,83353
44680,,url:http://portal.acm.org/ft_gateway.cfm3fid3d106625826type3dpdf,41677,41678,83355
44681,,cljrjkyg9j0j,41678,41679,83357
44682,,xo-4_xy3bd0j,41679,41680,83359
44683,,ccyzdfxnitgj,41680,41681,83361
44684,,sgdwuyri4mgj,41681,41682,83363
44685,,vmihykkfpfsj,41682,41683,83365
44686,,xoaq4uevqquj,41683,41684,83367
44687,,0zxzvwpznmkj,41684,41685,83369
44688,,zfnbk40ydj4j,41685,41686,83371
44689,,wjdiw8pl0ocj,41686,41687,83373
44690,,sq-g-iktm9cj,41687,41688,83375
44691,,gs3rccayi9kj,41688,41689,83377
44692,,ntb_qm3uslmj,41689,41690,83379
44693,,ydvv-aqg1f0j,41690,41691,83381
44694,,_acnc0zhbekj,41691,41692,83383
44695,,_qlkeovfu2mj,41692,41693,83385
44696,,7ggq-jy7ueyj,41693,41694,83387
44697,,jvbtdbarrvkj,41695,41696,83391
44698,,xqu9gxs4k50j,41696,41697,83393
44699,,m3dglrp9neij,41697,41698,83395
44700,,fir6kpdnkpqj,41698,41699,83397
44701,,9l3wjoaqirmj,41699,41700,83399
44702,,atp3zdnsihuj,41700,41701,83401
44703,,o0ldv7anrqyj,41701,41702,83403
44704,,ylpzg8mhcagj,41702,41703,83405
44705,,c75bu_7r29wj,41704,41705,83409
44706,,_5awpauhfu8j,41705,41706,83411
44707,,ekk2gzo_ie0j,41707,41708,83415
44708,,s2cxdl41e4uj,41708,41709,83417
44709,,og1pk9js-ecj,41709,41710,83419
44710,,mc4vcvw67puj,41711,41712,83423
44711,,eilrnljiek8j,41712,41713,83425
44712,,bw4olaaxzpuj,41713,41714,83427
44713,,glp8a1gmtvsj,41714,41715,83429
44714,,tyytlq_is1kj,41715,41716,83431
44715,,latwwfefprij,41716,41717,83433
44716,,t9vjedgadrsj,41717,41718,83435
44717,,rhp4i3rxsnoj,41718,41719,83437
44718,,qssoqbctohmj,41719,41720,83439
44719,,_dqfxnr75jgj,41720,41721,83441
44720,,3wnb_phzsbkj,41721,41722,83443
44721,,doidtg2x3hoj,41722,41723,83445
44722,,lt31qtq71ioj,41723,41724,83447
44723,,x2w8uu-esfmj,41724,41725,83449
44724,,7sn95wcmfuwj,41725,41726,83451
44725,,wkvtec2rulcj,41726,41727,83453
44726,,q4lwcfvle3wj,41727,41728,83455
44727,,7qvarj23jtgj,41728,41729,83457
44728,,ajkivtxxqd8j,41729,41730,83459
44729,,5s6focc1c60j,41730,41731,83461
44730,,g2a-s_zygl4j,41731,41732,83463
44731,,1vvdkgfmsl4j,41732,41733,83465
44732,,hvcq2suwi7oj,41733,41734,83467
44733,,peq_giznkkuj,41735,41736,83471
44734,,nsclom29s78j,41736,41737,83473
44735,,ilflj3sieccj,41737,41738,83475
44736,,ybchuz44bywj,41738,41739,83477
44737,,apvvxpgyfkcj,41739,41740,83479
44738,,y6z7q1ntsq8j,41740,41741,83481
44739,,cz2ry0e79fej,41741,41742,83483
44740,,tbdnfqqlslwj,41742,41743,83485
44741,,url:http://portal.acm.org/citation.cfm3fid3d354384.35453326dl3dguide26dl3dacm26type3dseries26idx3dseries31626part3dproceedings26wanttype3dproceedings26title3dinternational2520multimedia2520conference26cfid3d1111111126cftoken3d2222222,41743,41744,83487
44742,,s5o2mvf8otsj,41744,41745,83489
44743,,rin0-ttir28j,41745,41746,83491
44744,,u1z_-bsxfasj,41746,41747,83493
44745,,hisbb-kuyzij,41747,41748,83495
44746,,_s-2xlqsmjsj,41748,41749,83497
44747,,3mnasl4ebrsj,41749,41750,83499
44748,,vlvv2menoq4j,41751,41752,83503
44749,,30ckya8ro2uj,41752,41753,83505
44750,,loz3kpvndvmj,41753,41754,83507
44751,,8nbp4lk2zkgj,41754,41755,83509
44752,,099yvz-n4bij,41755,41756,83511
44753,,jdielfcfe-8j,41756,41757,83513
44754,,usknb5npfqej,41757,41758,83515
44755,,n7di335edh8j,41759,41760,83519
44756,,xirelrpetd4j,41760,41761,83521
44757,,1zvbrfoggpwj,41761,41762,83523
44758,,qsoudpxwz5sj,41762,41763,83525
44759,,o3o_mlgxh4uj,41763,41764,83527
44760,,ulieqn5na_ij,41765,41766,83531
44761,,idzlyuiw_hwj,41766,41767,83533
44762,,qvdw9njubnaj,41767,41768,83535
44763,,z61t1n0brqmj,41768,41769,83537
44764,,rpnf-k7mnloj,41769,41770,83539
44765,,idpjparh9n8j,41770,41771,83541
44766,,1adtxxpxsagj,41771,41772,83543
44767,,d16jy8-qgeej,41772,41773,83545
44768,,befqp0ps6hgj,41773,41774,83547
44769,,i7nuqt_hldyj,41774,41775,83549
44770,,ktumpwnivbej,41775,41776,83551
44771,,wudardq_khmj,41776,41777,83553
44772,,15xnu2vynaqj,41777,41778,83555
44773,,8eigm6_szgqj,41778,41779,83557
44774,,w6cq9fawdxgj,41779,41780,83559
44775,,9rbkzgl9yqwj,41780,41781,83561
44776,,rutd2zn2cdsj,41781,41782,83563
44777,,t_l57rsxtqyj,41782,41783,83565
44778,,t9psbmfdnnij,41783,41784,83567
44779,,npuyk2ztdgej,41784,41785,83569
44780,,rlmnaz2t5iqj,41785,41786,83571
44781,,pozlqf9a57kj,41786,41787,83573
44782,,edyeowszlosj,41787,41788,83575
44783,,rck1bdp8tu4j,41788,41789,83577
44784,,fjl6b4ouds0j,41789,41790,83579
44785,,gubvo3qntxuj,41790,41791,83581
44786,,0k9gimd7g9wj,41791,41792,83583
44787,,4zdgoqcawooj,41792,41793,83585
44788,,ixn4s0wcp5aj,41793,41794,83587
44789,,vj51ovhobjej,41794,41795,83589
44790,,cxbli9tviboj,41795,41796,83591
44791,,ziiw-26ibzcj,41796,41797,83593
44792,,wma4fmryrt0j,41797,41798,83595
44793,,9b_zuujyou0j,41798,41799,83597
44794,,i5ryk3j_zc8j,41799,41800,83599
44795,,jid-5bmqu00j,41800,41801,83601
44796,,jkthdj7_8kuj,41801,41802,83603
44797,,xpy2upc6vp0j,41802,41803,83605
44798,,ipgzljwx6n8j,41803,41804,83607
44799,,eqsacxrs41qj,41804,41805,83609
44800,,kooqijvbmscj,41805,41806,83611
44801,,url:http://www.csa.com/partners/viewrecord.php3frequester3dgs26collection3dtrd26recid3dn9210529ah,41806,41807,83613
44802,,z9j3h11tc6ij,41807,41808,83615
44803,,hqpos4johzaj,41808,41809,83617
44804,,s_qlzjytu6oj,41809,41810,83619
44805,,upsxdw-gi3wj,41810,41811,83621
44806,,wejpor9_28sj,41811,41812,83623
44807,,umuti8spj1qj,41812,41813,83625
44808,,uu5otufvw6sj,41813,41814,83627
44809,,dz9bjjjvu64j,41814,41815,83629
44810,,cco497nr3moj,41815,41816,83631
44811,,wkynplykwzgj,41816,41817,83633
44812,,dbrt-nbd1qaj,41817,41818,83635
44813,,xlejqvzkypkj,41818,41819,83637
44814,,fkxbpxegzdaj,41819,41820,83639
44815,,cwuhnvh90aej,41820,41821,83641
44816,,_xbdpom-ukkj,41821,41822,83643
44817,,hxskert_fi8j,41822,41823,83645
44818,,lkdr1lxxvnaj,41823,41824,83647
44819,,7whrhyclqjgj,41824,41825,83649
44820,,wh3muccapg4j,41825,41826,83651
44821,,ellcvnrytpwj,41826,41827,83653
44822,,,41827,41828,83655
44823,,i3quvu6byquj,41828,41829,83657
44824,,gx8vrjrdci8j,41829,41830,83659
44825,,gmijxwz7ibej,41830,41831,83661
44826,,inp6om8gywoj,41831,41832,83663
44827,,hkbkh9zujecj,41832,41833,83665
44828,,_jsiwidh_t8j,41833,41834,83667
44829,,6q7lycoamn8j,41834,41835,83669
44830,,l-vdhniohc4j,41835,41836,83671
44831,,5b-z2bnkzpwj,41836,41837,83673
44832,,xdzmzpnpox4j,41837,41838,83675
44833,,u8ykfaxhufaj,41838,41839,83677
44834,,wjdgwwnhhe4j,41839,41840,83679
44835,,hj3vyh0tjvsj,41840,41841,83681
44836,,lxvzwgwktaej,41841,41842,83683
44837,,vuhxoz-utmkj,41842,41843,83685
44838,,hu3p6ugdggmj,41843,41844,83687
44839,,0zqm6gimkygj,41844,41845,83689
44840,,jyqaio92stwj,41845,41846,83691
44841,,rjz4fojgfguj,41846,41847,83693
44842,,pw4ih8h8pn0j,41847,41848,83695
44843,,tc36qxrb808j,41848,41849,83697
44844,,zohasyhkk08j,41849,41850,83699
44845,,jnv3v-rkzeyj,41850,41851,83701
44846,,qzpjahb-fqej,41851,41852,83703
44847,,v3paviu5_44j,41852,41853,83705
44848,,dctoud8ly2qj,41853,41854,83707
44849,,h5w0hzh1c14j,41854,41855,83709
44850,,7oza2bnb7aaj,41855,41856,83711
44851,,p_pgek-eu9mj,41857,41858,83715
44852,,hulqqy3c6kaj,41858,41859,83717
44853,,mnimzzaqagcj,41859,41860,83719
44854,,ipcrwaaoszcj,41860,41861,83721
44855,,j0zel2g8xaej,41861,41862,83723
44856,,wgzm52e3tfkj,41862,41863,83725
44857,,ni7nhzvbrw0j,41863,41864,83727
44858,,gto-spqtbvej,41864,41865,83729
44859,,i-g72p6jczcj,41865,41866,83731
44860,,6nbdemqbowwj,41866,41867,83733
44861,,wiafmcymy8oj,41867,41868,83735
44862,,kurweqxqvqej,41868,41869,83737
44863,,ynt7u8jzxr8j,41869,41870,83739
44864,,ol2whvo5x0cj,41870,41871,83741
44865,,0k4w0tzv13ej,41871,41872,83743
44866,,obt5pggwcqaj,41872,41873,83745
44867,,jomiczv-75wj,41873,41874,83747
44868,,b1irheyn1a0j,41874,41875,83749
44869,,8txjtgqprc8j,41875,41876,83751
44870,,oux2xjaj8c8j,41876,41877,83753
44871,,hwbkafmfgp0j,41877,41878,83755
44872,,asdiut-hutmj,41878,41879,83757
44873,,d4c-pgdlbh0j,41879,41880,83759
44874,,lgvxa0qoatgj,41880,41881,83761
44875,,bow4auh4emsj,41881,41882,83763
44876,,7o_t0goqs-uj,41882,41883,83765
44877,,dciqxfehsnsj,41883,41884,83767
44878,,kpldwad664sj,41884,41885,83769
44879,,eggyzphkqosj,41885,41886,83771
44880,,db1r_yrftqsj,41886,41887,83773
44881,,wpwddc9x3c0j,41887,41888,83775
44882,,ddd-piijjnqj,41888,41889,83777
44883,,5bqkp_g3qe4j,41889,41890,83779
44884,,vxbkkifjobmj,41890,41891,83781
44885,,9retciispp8j,41891,41892,83783
44886,,jfphzxxluomj,41892,41893,83785
44887,,by19bscdqswj,41893,41894,83787
44888,,djiywg5spgaj,41894,41895,83789
44889,,hkjjqr8ljm0j,41895,41896,83791
44890,,u-wpgandzukj,41896,41897,83793
44891,,pzl9lqddikij,41897,41898,83795
44892,,unmdj297qhgj,41898,41899,83797
44893,,qzqaggqs8pyj,41899,41900,83799
44894,,w0l9nocuhmij,41900,41901,83801
44895,,exq8y31ebnsj,41901,41902,83803
44896,,sv7nttw1gwwj,41902,41903,83805
44897,,ovoakghdgjkj,41903,41904,83807
44898,,wyjcw9dg5lij,41904,41905,83809
44899,,pse-sks82tcj,41905,41906,83811
44900,,u0vewwss6cqj,41906,41907,83813
44901,,oikvqrncswsj,41907,41908,83815
44902,,kr2vyei_wvij,41908,41909,83817
44903,,o3r6jm_ye2kj,41909,41910,83819
44904,,ieg7ldbv2doj,41910,41911,83821
44905,,yr-zh_yhzi0j,41911,41912,83823
44906,,tkzziijyatwj,41912,41913,83825
44907,,nna0x9qdh08j,41913,41914,83827
44908,,yao5sgpcog8j,41914,41915,83829
44909,,3qjr7zl3vjyj,41915,41916,83831
44910,,2lncf7wewrij,41916,41917,83833
44911,,siwxemothasj,41917,41918,83835
44912,,kuxase8e1e8j,41918,41919,83837
44913,,lc2apv5ujmsj,41919,41920,83839
44914,,d2yo1crlryuj,41920,41921,83841
44915,,c6weifrefyej,41921,41922,83843
44916,,xlbgwodbft8j,41922,41923,83845
44917,,793timxuvzoj,41923,41924,83847
44918,,npxwsmpk_hyj,41924,41925,83849
44919,,qntft9j6cywj,41925,41926,83851
44920,,aai3go6accaj,41926,41927,83853
44921,,hwvhp8nrwbmj,41927,41928,83855
44922,,41jvfafbirmj,41928,41929,83857
44923,,b0-tgcrbtjej,41929,41930,83859
44924,,url:http://www.csa.com/partners/viewrecord.php3frequester3dgs26collection3dtrd26recid3d1137846ci,41930,41931,83861
44925,,jo1vnivhn6wj,41931,41932,83863
44926,,cobjc5lcm4ij,41932,41933,83865
44927,,url:http://portal.acm.org/citation.cfm3fid3d130868.13087826dl3dguide26dl3dacm26idx3dj68926part3dperiodical26wanttype3dperiodical26title3dacm2520sigmod2520record26cfid3d1111111126cftoken3d2222222,41933,41934,83867
44928,,tbyjcudext0j,41934,41935,83869
44929,,xxjxq3ijsraj,41935,41936,83871
44930,,url:http://portal.acm.org/citation.cfm3fid3d33938826dl3dacm26coll3dportal26cfid3d1111111126cftoken3d2222222,41936,41937,83873
44931,,uopipegrr2yj,41937,41938,83875
44932,,gwzsmom3z5yj,41938,41939,83877
44933,,url:http://www.csa.com/partners/viewrecord.php3frequester3dgs26collection3denv26recid3d7901465,41939,41940,83879
44934,,lfrnebpfrwgj,41940,41941,83881
44935,,of5ehrqh3xgj,41941,41942,83883
44936,,lrrzfvatcocj,41942,41943,83885
44937,,g1e5pwzwdsmj,41943,41944,83887
44938,,4pnv7ebzfm0j,41944,41945,83889
44939,,yi0fc_dptukj,41945,41946,83891
44940,,90yblglamcuj,41946,41947,83893
44941,,hdgcao81pygj,41947,41948,83895
44942,,vk60pfldgymj,41948,41949,83897
44943,,2yxxeywj4p0j,41949,41950,83899
44944,,dqmr4pzd9oqj,41950,41951,83901
44945,,ia0tlfawm7mj,41951,41952,83903
44946,,zwzcccu3_r0j,41952,41953,83905
44947,,buto0w6eybej,41953,41954,83907
44948,,e_s873gjuwsj,41954,41955,83909
44949,,jzd9dxy6hpwj,41955,41956,83911
44950,,g2o5m3l4-yuj,41956,41957,83913
44951,,rxlogstshf4j,41957,41958,83915
44952,,nm3wj9zkmm8j,41958,41959,83917
44953,,rwcoees-qdkj,41959,41960,83919
44954,,tpbxmltbuaej,41960,41961,83921
44955,,6ydkvsolfwmj,41961,41962,83923
44956,,url:http://www.csa.com/partners/viewrecord.php3frequester3dgs26collection3dtrd26recid3d0697559ci,41962,41963,83925
44957,,,41963,41964,83927
44958,,ohup9dcp9qkj,41964,41965,83929
44959,,h54gnm4chbaj,41966,41967,83933
44960,,hgsuaw-dnhmj,41967,41968,83935
44961,,3-ilq1zcxpyj,41968,41969,83937
44962,,xke1cxvxq8gj,41969,41970,83939
44963,,ydufqeglpx0j,41970,41971,83941
44964,,6ykl7sqwhguj,41971,41972,83943
44965,,tl1m32klpbuj,41972,41973,83945
44966,,lakxifgnzzyj,41973,41974,83947
44967,,gpi7ejtjyl0j,41974,41975,83949
44968,,lbtvii9mshcj,41975,41976,83951
44969,,azvms4l5eqmj,41976,41977,83953
44970,,ljdqjdqeiawj,41977,41978,83955
44971,,2ukizrztncsj,41978,41979,83957
44972,,sgixtycqcjuj,41979,41980,83959
44973,,u1tfzpl6gkaj,41980,41981,83961
44974,,w4sdzblvsacj,41981,41982,83963
44975,,fx2yl4uz5ogj,41982,41983,83965
44976,,url:http://portal.acm.org/citation.cfm3fid3d171926.172001,41983,41984,83967
44977,,no_-a29kprmj,41984,41985,83969
44978,,zs6s1kutyqoj,41985,41986,83971
44979,,j1iedadjbysj,41986,41987,83973
44980,,8i4i4k2n5dmj,41987,41988,83975
44981,,url:http://www.springerlink.com/index/k311t8245228264j.pdf,41988,41989,83977
44982,,g3uwffgo4byj,41989,41990,83979
44983,,thbn0kedmp8j,41990,41991,83981
44984,,ub_85f4cekmj,41991,41992,83983
44985,,ucegcd6rc-gj,41992,41993,83985
44986,,alcbm2dl1pmj,41993,41994,83987
44987,,mt-sabp9iu4j,41994,41995,83989
44988,,xxmsbqso7i4j,41995,41996,83991
44989,,fyqq9h0uceqj,41996,41997,83993
44990,,cfjextypocyj,41997,41998,83995
44991,,ythrukhamhgj,41998,41999,83997
44992,,sievywtny4wj,41999,42000,83999
44993,,hgm1iufaeccj,42000,42001,84001
44994,,kmhsap6gsfgj,42001,42002,84003
44995,,mloex4ujupwj,42002,42003,84005
44996,,3hjgffwndluj,42003,42004,84007
44997,,r_uurng34q8j,42004,42005,84009
44998,,l9avbzrwm6gj,42005,42006,84011
44999,,yyo-wcbq2z8j,42006,42007,84013
45000,,yrm04f_syv8j,42007,42008,84015
45001,,7qdg4onbfl0j,42008,42009,84017
45002,,10dkagtsuekj,42009,42010,84019
45003,,mzavvrwv9s0j,42010,42011,84021
45004,,mkuxy32k5aoj,42011,42012,84023
45005,,ym5msucd6uqj,42012,42013,84025
45006,,uiohno8mds4j,42013,42014,84027
45007,,ccrtjnmz3hej,42014,42015,84029
45008,,bmhxkquc6w4j,42015,42016,84031
45009,,2ox5n6qc1caj,42016,42017,84033
45010,,wtgnl96va7qj,42017,42018,84035
45011,,v29ocnog1wgj,42018,42019,84037
45012,,hd0wxwuiuiej,42019,42020,84039
45013,,yphni0dzuvuj,42020,42021,84041
45014,,url:http://adsabs.harvard.edu/abs/1976scom.nasa..597h,42021,42022,84043
45015,,fwmg0ppuqgyj,42022,42023,84045
45016,,bvwlixiwfesj,42023,42024,84047
45017,,3tima9-a-ngj,42024,42025,84049
45018,,hb78cdpw72qj,42025,42026,84051
45019,,onjuwrb-f1ej,42026,42027,84053
45020,,egch_nq8eywj,42027,42028,84055
45021,,jwwxskb-pwyj,42028,42029,84057
45022,,tqqgu-bcdwij,42029,42030,84059
45023,,eeinnqbe4gmj,42030,42031,84061
45024,,wxxoydxzoomj,42031,42032,84063
45025,,kcf52wpl4hcj,42032,42033,84065
45026,,u6kojfiogy8j,42033,42034,84067
45027,,qmqz7zr3i9yj,42034,42035,84069
45028,,xm3lb0-jfl0j,42035,42036,84071
45029,,vn2hbz6vdvcj,42036,42037,84073
45030,,4vrfdicqwlgj,42037,42038,84075
45031,,ujxzyo8hyzaj,42038,42039,84077
45032,,cognmongwboj,42039,42040,84079
45033,,e9i1t00_oogj,42040,42041,84081
45034,,er0fqcufzyij,42041,42042,84083
45035,,jd-wntaok1kj,42042,42043,84085
45036,,ho67rkmdkqaj,42043,42044,84087
45037,,sjy7zzdakj4j,42044,42045,84089
45038,,nkwcbyfwkicj,42045,42046,84091
45039,,sivnwmcidb0j,42046,42047,84093
45040,,tts6iq_dfdaj,42047,42048,84095
45041,,url:http://portal.acm.org/ft_gateway.cfm3fid3d108361426type3dpdf,42048,42049,84097
45042,,zz17jufigtoj,42049,42050,84099
45043,,ea-_ki4fd2yj,42050,42051,84101
45044,,phj1rv1xfjuj,42051,42052,84103
45045,,zrkyktq85bmj,42052,42053,84105
45046,,fcdfk03kclaj,42053,42054,84107
45047,,1myf4-urh14j,42055,42056,84111
45048,,reziczgybzsj,42056,42057,84113
45049,,sxdqis-gg3cj,42057,42058,84115
45050,,_oxrtka1a8kj,42058,42059,84117
45051,,2can1ry4vnuj,42059,42060,84119
45052,,url:http://www.csa.com/partners/viewrecord.php3frequester3dgs26collection3denv26recid3d7704292,42060,42061,84121
45053,,hgju1uyq-ocj,42061,42062,84123
45054,,rb53udk1fmsj,42062,42063,84125
45055,,l1z8zh2rsjej,42063,42064,84127
45056,,hql4mwaw8wqj,42064,42065,84129
45057,,tp3zphmjs4yj,42065,42066,84131
45058,,zsbjfics3_sj,42066,42067,84133
45059,,s5q9yrz4w0aj,42067,42068,84135
45060,,,42068,42069,84137
45061,,cxnj6lkvju8j,42069,42070,84139
45062,,igilja-dyryj,42070,42071,84141
45063,,hguni7yggucj,42071,42072,84143
45064,,olj7qnuiep8j,42072,42073,84145
45065,,,42073,42074,84147
45066,,yvpvdfdjwo8j,42074,42075,84149
45067,,awnlksm8fx0j,42075,42076,84151
45068,,mkzm4xgiu5sj,42076,42077,84153
45069,,3qgonuiwvzmj,42077,42078,84155
45070,,ivafbkooth0j,42078,42079,84157
45071,,fpvq-y63utqj,42079,42080,84159
45072,,ooc4yxymoiyj,42080,42081,84161
45073,,2ev4egup6_ij,42081,42082,84163
45074,,url:http://portal.acm.org/ft_gateway.cfm3fid3d110117426type3dpdf,42082,42083,84165
45075,,6ukypmnkwdkj,42083,42084,84167
45076,,qqszkfdwv7kj,42084,42085,84169
45077,,fhtahasdo-aj,42085,42086,84171
45078,,i3zdfrschkij,42086,42087,84173
45079,,qhlqzqwlbtsj,42087,42088,84175
45080,,demolj7zvbyj,42088,42089,84177
45081,,dvxuz5vbtdoj,42089,42090,84179
45082,,dlieb9vhmryj,42090,42091,84181
45083,,fhiq0m8_e6ij,42091,42092,84183
45084,,crlauhuqz5wj,42092,42093,84185
45085,,byk6zyyaaqcj,42093,42094,84187
45086,,ms1h4s44a4oj,42094,42095,84189
45087,,1mn_7hm6n-uj,42095,42096,84191
45088,,2byvcny4akaj,42096,42097,84193
45089,,url:http://www.csa.com/partners/viewrecord.php3frequester3dgs26collection3dtrd26recid3d821379co,42097,42098,84195
45090,,mzpcvz9fhpgj,42098,42099,84197
45091,,zqh4_g37hvqj,42099,42100,84199
45092,,2j_9scp1cayj,42100,42101,84201
45093,,n-50fkx39sqj,42101,42102,84203
45094,,hir6flkopgoj,42102,42103,84205
45095,,url:http://doi.wiley.com/10.1002/ace.175,42103,42104,84207
45096,,rjcvzp34sasj,42104,42105,84209
45097,,yrhdijcrulsj,42105,42106,84211
45098,,tkggrc2sw8wj,42106,42107,84213
45099,,jm-cso9lwqyj,42107,42108,84215
45100,,yat0gab8jiuj,42108,42109,84217
45101,,wbf98hzkgzgj,42109,42110,84219
45102,,gi-0wmscqhaj,42110,42111,84221
45103,,foobzdglvygj,42111,42112,84223
45104,,prdmovf_h-0j,42112,42113,84225
45105,,pur1c3fyyaej,42113,42114,84227
45106,,9ib22n0u1l8j,42114,42115,84229
45107,,zlqystr07_uj,42115,42116,84231
45108,,url:http://portal.acm.org/ft_gateway.cfm3fid3d106623126type3dpdf,42116,42117,84233
45109,,dtonz4dyekaj,42117,42118,84235
45110,,qq5kwtquwt8j,42118,42119,84237
45111,,m55v1zae12cj,42119,42120,84239
45112,,fu4osjvjzp8j,42120,42121,84241
45113,,erb1ld2m9wkj,42122,42123,84245
45114,,rjxtbholcroj,42123,42124,84247
45115,,9ntappql8jij,42124,42125,84249
45116,,84r8hpndixqj,42125,42126,84251
45117,,gnedtv8hregj,42126,42127,84253
45118,,7klhysbpdgwj,42127,42128,84255
45119,,cq2yylpyzg8j,42128,42129,84257
45120,,rl70ru5utgkj,42129,42130,84259
45121,,vvh1gjm82nyj,42130,42131,84261
45122,,wlnjcnvsulkj,42131,42132,84263
45123,,8imlzcctf8qj,42132,42133,84265
45124,,0svcm6dvvfwj,42133,42134,84267
45125,,9lskqrxn1poj,42136,42137,84273
45126,,uxuqr05smi0j,42137,42138,84275
45127,,fknorhtorokj,42138,42139,84277
45128,,it-fadbsmtsj,42139,42140,84279
45129,,xcy6pwearscj,42140,42141,84281
45130,,yksjoigoowgj,42141,42142,84283
45131,,zegii7obnvwj,42142,42143,84285
45132,,vpuud_qq3oyj,42143,42144,84287
45133,,tbldxi0_h2gj,42144,42145,84289
45134,,lirxv2xlv6aj,42145,42146,84291
45135,,n-evsltvlogj,42146,42147,84293
45136,,xy9ldv6mohqj,42147,42148,84295
45137,,8h7p_kzgsdgj,42149,42150,84299
45138,,orifihdal6qj,42150,42151,84301
45139,,ykoxvujpfhgj,42151,42152,84303
45140,,ynhgjgxvqzwj,42152,42153,84305
45141,,kkcfwbthzrcj,42153,42154,84307
45142,,mx-nhewhh-aj,42154,42155,84309
45143,,fy760pivekkj,42155,42156,84311
45144,,9w8i1vwor70j,42156,42157,84313
45145,,url:http://www.csa.com/partners/viewrecord.php3frequester3dgs26collection3dtrd26recid3d017406530154ai,42157,42158,84315
45146,,url:http://www.csa.com/partners/viewrecord.php3frequester3dgs26collection3dtrd26recid3d200111010717mt26recid3da0032655ah,42158,42159,84317
45147,,url:http://www.csa.com/partners/viewrecord.php3frequester3dgs26collection3dtrd26recid3d017306530216ai,42159,42160,84319
45148,,vf3p5zcmqnaj,42160,42161,84321
45149,,dr4szohnlb8j,42161,42162,84323
45150,,qzsqxow5b1cj,42162,42163,84325
45151,,qipmqr4nllqj,42163,42164,84327
45152,,ztpcerbo43ej,42164,42165,84329
45153,,k8fvw1dlaluj,42165,42166,84331
45154,,vvgeame6oz4j,42166,42167,84333
45155,,mll-8hnkqz8j,42167,42168,84335
45156,,qrexod58hkyj,42168,42169,84337
45157,,jhegiwr1zsej,42169,42170,84339
45158,,hl9xlvju0goj,42170,42171,84341
45159,,ah_cznfkrl8j,42171,42172,84343
45160,,iom_vgc_do8j,42172,42173,84345
45161,,hcr7j7htebsj,42173,42174,84347
45162,,prcyoy9tmxgj,42174,42175,84349
45163,,zrcpngacjxyj,42175,42176,84351
45164,,lqkrqwjkm2ij,42176,42177,84353
45165,,eeqsrfkuphmj,42177,42178,84355
45166,,koi8crwkaysj,42178,42179,84357
45167,,pxfp5yztpf8j,42179,42180,84359
45168,,yvgf4lxnamsj,42180,42181,84361
45169,,hnx8ob0xtfuj,42181,42182,84363
45170,,url:http://portal.acm.org/ft_gateway.cfm3fid3d110198026type3dpdf,42182,42183,84365
45171,,vaa30v75dlqj,42184,42185,84369
45172,,3esmtd3o_hoj,42185,42186,84371
45173,,r5ly6g5t5oqj,42186,42187,84373
45174,,d2yl--uzzvgj,42187,42188,84375
45175,,ynkgtpqlhnuj,42188,42189,84377
45176,,9xvq8deez_0j,42189,42190,84379
45177,,url:http://www.csa.com/partners/viewrecord.php3frequester3dgs26collection3dtrd26recid3dn9210509ah,42190,42191,84381
45178,,ueq04odaiooj,42191,42192,84383
45179,,byliysfx5_cj,42192,42193,84385
45180,,0hq6_6sl0okj,42193,42194,84387
45181,,conbtxejqiuj,42194,42195,84389
45182,,rlh2shmtkfwj,42195,42196,84391
45183,,35kdadl81z8j,42196,42197,84393
45184,,lifzznlsqlsj,42197,42198,84395
45185,,iqftgs-nityj,42198,42199,84397
45186,,xfbiiv07c20j,42199,42200,84399
45187,,tqjoc__ybuaj,42200,42201,84401
45188,,mwp9m0gzwhsj,42201,42202,84403
45189,,sake5qn47haj,42202,42203,84405
45190,,36dvb8jtklcj,42203,42204,84407
45191,,4se-nmjevlcj,42204,42205,84409
45192,,url:http://www.ingentaconnect.com/content/els/09505849/2002/00000044/00000001/art00210,42205,42206,84411
45193,,ck_ja-lw7f8j,42206,42207,84413
45194,,6ffnetgea4sj,42207,42208,84415
45195,,i8sc0nvopwmj,42208,42209,84417
45196,,vxe8wt2l0w0j,42209,42210,84419
45197,,syqpvx3wxquj,42210,42211,84421
45198,,gnxotliq6juj,42211,42212,84423
45199,,4ftnlxbl0zgj,42212,42213,84425
45200,,gmfudmaigzmj,42213,42214,84427
45201,,5ytksgngeyej,42214,42215,84429
45202,,psrzk1z-oj8j,42216,42217,84433
45203,,c6fdhmz-y4uj,42217,42218,84435
45204,,ddvlln9qgusj,42218,42219,84437
45205,,h7_vmoczrbij,42219,42220,84439
45206,,xiv8sajiwy8j,42220,42221,84441
45207,,gxlqg6k62rcj,42221,42222,84443
45208,,,42222,42223,84445
45209,,zlhamuvyxiwj,42223,42224,84447
45210,,we-yqqwaiigj,42224,42225,84449
45211,,r5pgemy2zzej,42225,42226,84451
45212,,kgtb6zctr1qj,42226,42227,84453
45213,,xijnqi1iapej,42227,42228,84455
45214,,uja7hdsnprsj,42228,42229,84457
45215,,ajp5ihi9ez4j,42229,42230,84459
45216,,t6-kdydmr3kj,42230,42231,84461
45217,,r-rwyirkdrmj,42232,42233,84465
45218,,lk1iaxv9at8j,42233,42234,84467
45219,,i4llvy7hjmmj,42234,42235,84469
45220,,0wtytedh0k8j,42235,42236,84471
45221,,p6h_2x16_awj,42236,42237,84473
45222,,irmbgptrzkyj,42237,42238,84475
45223,,fg0y-u39c7oj,42238,42239,84477
45224,,w1gza5omywgj,42239,42240,84479
45225,,39mreywxvgmj,42240,42241,84481
45226,,ssg6jrxbouoj,42241,42242,84483
45227,,kn9lisdqhkkj,42242,42243,84485
45228,,mgczqzdptm4j,42243,42244,84487
45229,,vx4oj5v-2pgj,42244,42245,84489
45230,,9t0t-bhub3uj,42245,42246,84491
45231,,8mkxpofawi8j,42246,42247,84493
45232,,z2vydjj105ej,42247,42248,84495
45233,,jasbsiwn9hij,42248,42249,84497
45234,,di7w8y-cvtyj,42249,42250,84499
45235,,sdtuxogooaqj,42250,42251,84501
45236,,myw6pq7ahmsj,42251,42252,84503
45237,,ubewhs50sa4j,42252,42253,84505
45238,,dcnydeuffzwj,42253,42254,84507
45239,,gvteykbgl1aj,42254,42255,84509
45240,,myt0tznrqdmj,42255,42256,84511
45241,,kcidjvowmzmj,42256,42257,84513
45242,,viwheuljolcj,42257,42258,84515
45243,,hq5zyz2vbxyj,42259,42260,84519
45244,,url:http://journals.iucr.org/c/issues/1999/11/00/sk1317/sk1317.pdf,42260,42261,84521
45245,,r48fzya00gcj,42261,42262,84523
45246,,url:http://www.xeper.org/maquino/nm/neutronbomb.pdf,42262,42263,84525
45247,,6svfj-qwy60j,42263,42264,84527
45248,,rqnlqluk39cj,42264,42265,84529
45249,,b_j0mjc87fsj,42265,42266,84531
45250,,t19wvapiy_4j,42266,42267,84533
45251,,7zhfmow0w0cj,42267,42268,84535
45252,,nnxygdo63rmj,42268,42269,84537
45253,,we5ldozvdkqj,42269,42270,84539
45254,,zk039zwnedaj,42270,42271,84541
45255,,fda9tvwwcucj,42271,42272,84543
45256,,url:http://portal.acm.org/citation.cfm3fid3d242786,42272,42273,84545
45257,,x3ofv7t-vzuj,42273,42274,84547
45258,,1m5_m_nbu2qj,42274,42275,84549
45259,,oh2u3cz3zj0j,42275,42276,84551
45260,,2wxo8v7seduj,42276,42277,84553
45261,,kf4tznryzm0j,42277,42278,84555
45262,,cqzmsorugxcj,42278,42279,84557
45263,,6j6vbl7qqjgj,42279,42280,84559
45264,,n8glmxpiypmj,42280,42281,84561
45265,,ufi0khzynv8j,42281,42282,84563
45266,,wlxz0fqty_mj,42282,42283,84565
45267,,pd-ympedy7gj,42283,42284,84567
45268,,pknjlid6ghcj,42284,42285,84569
45269,,zfhvrqgg7icj,42285,42286,84571
45270,,gffy1h_4kv8j,42286,42287,84573
45271,,fodpuzohs1wj,42287,42288,84575
45272,,sbnd4ksidq4j,42288,42289,84577
45273,,url:http://portal.acm.org/citation.cfm3fid3d645921.67330326coll3dguide26dl3dacm26cfid3d1111111126cftoken3d2222222,42289,42290,84579
45274,,mndoylmypqgj,42290,42291,84581
45275,,dmh9kd36ycoj,42291,42292,84583
45276,,bvs9zlycrlcj,42292,42293,84585
45277,,umpfkunqzwqj,42293,42294,84587
45278,,wyzp30easemj,42294,42295,84589
45279,,rz269zkwiz8j,42295,42296,84591
45280,,s3iz4nh3yk0j,42296,42297,84593
45281,,_x3vty8b3xoj,42297,42298,84595
45282,,x1fwhdbyhp0j,42298,42299,84597
45283,,55hhrndabj0j,42299,42300,84599
45284,,y5rldpkqsxkj,42301,42302,84603
45285,,xs0vqmnmaukj,42302,42303,84605
45286,,opyirctp6quj,42303,42304,84607
45287,,qqhd0sd-mpaj,42304,42305,84609
45288,,nwbcr_-v7scj,42305,42306,84611
45289,,nkqym9uumikj,42306,42307,84613
45290,,e7xayg_esg8j,42307,42308,84615
45291,,zenp30m7oo4j,42308,42309,84617
45292,,ulifw5mwgksj,42309,42310,84619
45293,,krc_l3njbuuj,42310,42311,84621
45294,,hxatwgrnlbkj,42311,42312,84623
45295,,xhdfn81wkpqj,42312,42313,84625
45296,,ebhzqyqcc44j,42313,42314,84627
45297,,dhenhigwxj8j,42314,42315,84629
45298,,ddx3a1ttgoqj,42315,42316,84631
45299,,btirfatqwqsj,42316,42317,84633
45300,,url:http://portal.acm.org/ft_gateway.cfm3fid3d60188226type3dpdf26dl3dguide26dl3dacm26cfid3d1111111126cftoken3d2222222,42317,42318,84635
45301,,qfogdnmwfxij,42319,42320,84639
45302,,nob0ypgtdwsj,42320,42321,84641
45303,,8b9gtmzbkwaj,42321,42322,84643
45304,,t1f8k1k13ocj,42322,42323,84645
45305,,5bhaeimsh1aj,42323,42324,84647
45306,,e_kibhwl82kj,42324,42325,84649
45307,,ty3lhsy7jjwj,42325,42326,84651
45308,,h8xj_56d6jmj,42326,42327,84653
45309,,57m7nniytrkj,42327,42328,84655
45310,,qfv0cgmumtij,42328,42329,84657
45311,,t6-1ytgeef4j,42329,42330,84659
45312,,url:http://www.csa.com/partners/viewrecord.php3frequester3dgs26collection3dtrd26recid3dn9210518ah,42330,42331,84661
45313,,bqn0d0h67fsj,42331,42332,84663
45314,,ygkpleu-ubgj,42332,42333,84665
45315,,dhpr8-qxdakj,42333,42334,84667
45316,,j5_8wgolccaj,42334,42335,84669
45317,,a5qxnwtdj_ej,42335,42336,84671
45318,,dae6hvkn8joj,42336,42337,84673
45319,,j2w6ggis1p8j,42337,42338,84675
45320,,iiifyczh054j,42338,42339,84677
45321,,jfsge81fwdkj,42339,42340,84679
45322,,c2neicud8cqj,42340,42341,84681
45323,,ggav0hztso8j,42341,42342,84683
45324,,puxbxwqmfncj,42342,42343,84685
45325,,kw1za9kzyduj,42343,42344,84687
45326,,dkgclkwayeij,42344,42345,84689
45327,,kvydc1o09k0j,42345,42346,84691
45328,,url:http://portal.acm.org/ft_gateway.cfm3fid3d106627226type3dpdf,42346,42347,84693
45329,,erh9txspjzyj,42348,42349,84697
45330,,ahxxopeak_aj,42349,42350,84699
45331,,zgy-3h8ar_mj,42350,42351,84701
45332,,ealpx577pa0j,42351,42352,84703
45333,,mnjfek_dmw0j,42352,42353,84705
45334,,m_yuul34dmuj,42353,42354,84707
45335,,url:http://links.jstor.org/sici3fsici3d0146-4949(196523)6253a3253c346253agnanat253e2.0.co253b2-m,42354,42355,84709
45336,,ewv9jp5bghqj,42355,42356,84711
45337,,x_rwzdqgflkj,42356,42357,84713
45338,,url:http://adsabs.harvard.edu/abs/1990mit..reptz....s,42357,42358,84715
45339,,qve0chlbw1cj,42358,42359,84717
45340,,btm8wlpgfqcj,42359,42360,84719
45341,,ygun_u8acvej,42360,42361,84721
45342,,ap_cso-7bfmj,42361,42362,84723
45343,,4zoax9eddowj,42362,42363,84725
45344,,a-ykx7w8huqj,42363,42364,84727
45345,,zxiwehylsayj,42365,42366,84731
45346,,dgs3gcow2ooj,42366,42367,84733
45347,,frqn0fnsyvaj,42367,42368,84735
45348,,ifhqacd2d_kj,42368,42369,84737
45349,,url:http://portal.acm.org/ft_gateway.cfm3fid3d110751926type3dpdf,42369,42370,84739
45350,,txdkxd8-ya0j,42370,42371,84741
45351,,iegdbpzqr0oj,42371,42372,84743
45352,,ofhcdcxn0s8j,42372,42373,84745
45353,,url:http://www.springerlink.com/index/u04r834455v753r5.pdf,42373,42374,84747
45354,,uyqmfhswge0j,42374,42375,84749
45355,,gbwmsverzuoj,42375,42376,84751
45356,,dzq1zm99wlqj,42376,42377,84753
45357,,7x-blcyfc4yj,42377,42378,84755
45358,,pbtsyxiqa04j,42378,42379,84757
45359,,iwhc7eicpnkj,42379,42380,84759
45360,,lvmu7zrclayj,42380,42381,84761
45361,,5cz9srbxjkwj,42381,42382,84763
45362,,fecobk73acyj,42382,42383,84765
45363,,lol1v2ss65yj,42383,42384,84767
45364,,ztzpb1uherwj,42384,42385,84769
45365,,wyauklzrouyj,42385,42386,84771
45366,,ewqhts4nfvmj,42386,42387,84773
45367,,17cgvpzvhjsj,42387,42388,84775
45368,,hq6de9x4pz0j,42388,42389,84777
45369,,pcm7ny4pvbkj,42389,42390,84779
45370,,aecknq9vrcoj,42390,42391,84781
45371,,h6cxfit0cykj,42391,42392,84783
45372,,vu4tcgppuvmj,42392,42393,84785
45373,,yeez6xrf8kaj,42393,42394,84787
45374,,zz0yi528l9uj,42394,42395,84789
45375,,a_jkq75rhyij,42395,42396,84791
45376,,4ybhcldcowej,42396,42397,84793
45377,,pj1mkocpw9qj,42397,42398,84795
45378,,6j0whq-xeesj,42398,42399,84797
45379,,ihmhodoviykj,42399,42400,84799
45380,,uj9jtdgkhiyj,42400,42401,84801
45381,,url:http://www.springerlink.com/index/t5801wl22374n0m5.pdf,42401,42402,84803
45382,,0sqvbohb7dcj,42402,42403,84805
45383,,jj8lgnikbsmj,42403,42404,84807
45384,,lazqmkhnsqwj,42404,42405,84809
45385,,keojjlqrfwgj,42405,42406,84811
45386,,gwqekwjied4j,42406,42407,84813
45387,,riz3opuzpuij,42408,42409,84817
45388,,zyb23xeuu3ej,42409,42410,84819
45389,,gt5yru0fm4qj,42410,42411,84821
45390,,srgum7br9eaj,42411,42412,84823
45391,,vtmczo3uvoej,42412,42413,84825
45392,,r2tlk7giczcj,42413,42414,84827
45393,,fj1l5xsb4pmj,42414,42415,84829
45394,,0epm518wwx8j,42415,42416,84831
45395,,qz0fst_atpwj,42416,42417,84833
45396,,5m1rxxwiqn8j,42417,42418,84835
45397,,cleg_qflv1aj,42418,42419,84837
45398,,svkn9qyexsyj,42419,42420,84839
45399,,w6an0j73zlaj,42420,42421,84841
45400,,5dojvkb8764j,42421,42422,84843
45401,,jdkraq_jvdcj,42422,42423,84845
45402,,v1n5hbnjqagj,42423,42424,84847
45403,,sdufr_2enhuj,42424,42425,84849
45404,,mxxjsd6kdgkj,42425,42426,84851
45405,,kv0gb8pm0ioj,42426,42427,84853
45406,,e7h-2nkdfsmj,42427,42428,84855
45407,,llr1a9benswj,42428,42429,84857
45408,,jgk9ldbuqmsj,42429,42430,84859
45409,,ujqli2aegngj,42430,42431,84861
45410,,0g-5ayzaobsj,42431,42432,84863
45411,,wyfnflalux8j,42432,42433,84865
45412,,ec_jvwfihggj,42433,42434,84867
45413,,7-nnirkt4qej,42434,42435,84869
45414,,ngqgeqd4y9uj,42435,42436,84871
45415,,cd_dj-odpfgj,42436,42437,84873
45416,,kxpzjy5mhesj,42437,42438,84875
45417,,h4auufpagz8j,42438,42439,84877
45418,,spewhngn1dcj,42439,42440,84879
45419,,y8ydyckuxzsj,42440,42441,84881
45420,,qe_fvmml3nkj,42441,42442,84883
45421,,ppcddfbncoej,42442,42443,84885
45422,,fgsnkx7zvrij,42443,42444,84887
45423,,idqur01ufgsj,42444,42445,84889
45424,,ffeeiugzjzej,42445,42446,84891
45425,,6qf2ptmvn4kj,42446,42447,84893
45426,,url:http://adsabs.harvard.edu/abs/1993ucsb.repts....b,42447,42448,84895
45427,,s6avtuywinuj,42448,42449,84897
45428,,vprkt2ritz8j,42449,42450,84899
45429,,8ckwegz6gmsj,42450,42451,84901
45430,,6d2d6kg7twmj,42451,42452,84903
45431,,l8uuf3bkgwoj,42452,42453,84905
45432,,tsq9laikadej,42453,42454,84907
45433,,3mfpworr_ucj,42454,42455,84909
45434,,c8ozzzdo1gsj,42455,42456,84911
45435,,1c-b6edz5o4j,42456,42457,84913
45436,,dcpddivpjnwj,42457,42458,84915
45437,,asdum-l5t-ij,42458,42459,84917
45438,,url:http://ieeexplore.ieee.org/iel1/2206/325/00006489.pdf3farnumber3d6489,42459,42460,84919
45439,,d_u-kmketdwj,42460,42461,84921
45440,,url:http://portal.acm.org/ft_gateway.cfm3fid3d102758026type3dpdf,42461,42462,84923
45441,,jyez9eobeoyj,42462,42463,84925
45442,,v-aen_mv2_aj,42463,42464,84927
45443,,wpehahwxigcj,42464,42465,84929
45444,,c7roflioajwj,42465,42466,84931
45445,,kbc1mzfrldsj,42466,42467,84933
45446,,os704sarqzuj,42467,42468,84935
45447,,ne2bxp4fddgj,42468,42469,84937
45448,,xkdlpq5x-yij,42469,42470,84939
45449,,zdk7somifvej,42470,42471,84941
45450,,url:http://portal.acm.org/citation.cfm3fid3d212433.220203,42471,42472,84943
45451,,ivppfgjtao0j,42472,42473,84945
45452,,z-kyh4hn_qcj,42473,42474,84947
45453,,v0ehxfndns0j,42474,42475,84949
45454,,,42475,42476,84951
45455,,ykpqpzgfnzij,42476,42477,84953
45456,,svjb1r-df_mj,42477,42478,84955
45457,,hcozmoqgotej,42478,42479,84957
45458,,ror3aco__cej,42479,42480,84959
45459,,6mdiqtp20aoj,42480,42481,84961
45460,,unwtcafl3t4j,42481,42482,84963
45461,,b98lvuuuuhij,42482,42483,84965
45462,,9lan4l5ffw0j,42483,42484,84967
45463,,zwm1gkhwgeuj,42484,42485,84969
45464,,,42485,42486,84971
45465,,url:http://www.ncbi.nlm.nih.gov/entrez/query.fcgi3fcmd3dretrieve26db3dpubmed26list_uids3d64130426dopt3dcitation,42486,42487,84973
45466,,zqpl01tdvzqj,42487,42488,84975
45467,,pb9oghasal0j,42488,42489,84977
45468,,an2hgkusuokj,42489,42490,84979
45469,,tgd-rcibazij,42490,42491,84981
45470,,n7ksdsyuivgj,42492,42493,84985
45471,,ze9kwahaigsj,42493,42494,84987
45472,,zhcrbzlvlwoj,42494,42495,84989
45473,,ggu3sg8lclej,42495,42496,84991
45474,,kqaoegp8jgmj,42496,42497,84993
45475,,,42497,42498,84995
45476,,9i3aiehkf6oj,42498,42499,84997
45477,,ghziygkdlxsj,42499,42500,84999
45478,,0ryksvygd_wj,42500,42501,85001
45479,,x7_r6vgezegj,42501,42502,85003
45480,,qtqf6mcprw8j,42502,42503,85005
45481,,,42503,42504,85007
45482,,xgchb1nagn0j,42505,42506,85011
45483,,gfwsmgrjmkaj,42506,42507,85013
45484,,ghxvwkcxxakj,42507,42508,85015
45485,,odsorol8za4j,42509,42510,85019
45486,,url:http://www.csa.com/partners/viewrecord.php3frequester3dgs26collection3denv26recid3d8603848,42510,42511,85021
45487,,5ozxn689njej,42511,42512,85023
45488,,citnjdi2l_cj,42512,42513,85025
45489,,0iclcrycg8uj,42513,42514,85027
45490,,hrb_lmadep8j,42514,42515,85029
45491,,url:http://www.ingentaconnect.com/content/els/13891286/1999/00000031/00000018/art00025,42515,42516,85031
45492,,ry_2vvcckx8j,42516,42517,85033
45493,,m2acov68zymj,42517,42518,85035
45494,,c8cdgk9i3kaj,42518,42519,85037
45495,,4y_cidkw9iyj,42519,42520,85039
45496,,qqbao20jp4gj,42520,42521,85041
45497,,95cugaqvglwj,42521,42522,85043
45498,,d44mcqzsqkkj,42522,42523,85045
45499,,psb93bihh3cj,42523,42524,85047
45500,,o5zbdk02aloj,42524,42525,85049
45501,,wmdhsdt4assj,42526,42527,85053
45502,,tawlfq4z-cwj,42527,42528,85055
45503,,dtywk-vb8duj,42528,42529,85057
45504,,whsenntq2yej,42529,42530,85059
45505,,scnvrvuzuz0j,42530,42531,85061
45506,,d-z1ivzgxluj,42531,42532,85063
45507,,v5aikptbt5yj,42532,42533,85065
45508,,r4w8is5pazij,42533,42534,85067
45509,,wslrdubo8e8j,42534,42535,85069
45510,,a0kukjlbtn0j,42535,42536,85071
45511,,xjnpgbboovuj,42536,42537,85073
45512,,uipuoua6g68j,42537,42538,85075
45513,,url:http://portal.acm.org/ft_gateway.cfm3fid3d108628826type3dpdf,42538,42539,85077
45514,,bdtz-m_qrnej,42539,42540,85079
45515,,m-gqvuvm714j,42540,42541,85081
45516,,wystxs8femsj,42541,42542,85083
45517,,8hdo6qczozmj,42542,42543,85085
45518,,fvcoefljo5gj,42543,42544,85087
45519,,9ogg5irp5kyj,42544,42545,85089
45520,,url:http://www.geography.org.uk/journals/download.asp3farticleid3d152,42545,42546,85091
45521,,5z1qw7vi6xej,42546,42547,85093
45522,,k61rc1_f8wqj,42547,42548,85095
45523,,,42548,42549,85097
45524,,ipt7du1wqryj,42549,42550,85099
45525,,lxicmq7locaj,42550,42551,85101
45526,,vojmqprhlaqj,42551,42552,85103
45527,,a6l4j57mm1cj,42552,42553,85105
45528,,u74t2ybr5_4j,42553,42554,85107
45529,,url:http://www.springerlink.com/index/x77205878752036g.pdf,42554,42555,85109
45530,,ukb-g2_1m5aj,42555,42556,85111
45531,,0cd9uupdnbuj,42556,42557,85113
45532,,fwhoqz6bmpqj,42557,42558,85115
45533,,gfykoufolsmj,42558,42559,85117
45534,,wekozxca3ngj,42559,42560,85119
45535,,jkcwtwb5-w0j,42560,42561,85121
45536,,4g48ghvgqwej,42561,42562,85123
45537,,t6agxqohtnij,42562,42563,85125
45538,,bqv04f9wqzoj,42563,42564,85127
45539,,f2wvteykbwaj,42564,42565,85129
45540,,rax5jxs0b_wj,42566,42567,85133
45541,,7fp_izdsqwoj,42567,42568,85135
45542,,ujd5yn2nkdkj,42568,42569,85137
45543,,1owqzj7b1asj,42569,42570,85139
45544,,ll5cuwkr7kyj,42570,42571,85141
45545,,tx9ajkm0av8j,42571,42572,85143
45546,,ikqp8y-9en8j,42572,42573,85145
45547,,2kdtsxyi5dgj,42573,42574,85147
45548,,rdyappgnnpwj,42574,42575,85149
45549,,hbutcn45z_yj,42575,42576,85151
45550,,d_pydtbylk4j,42576,42577,85153
45551,,ybl91zqwajcj,42578,42579,85157
45552,,h08uplagv2ej,42579,42580,85159
45553,,fnovu-fyqbgj,42580,42581,85161
45554,,3avrno8bht4j,42581,42582,85163
45555,,z1hvkdsl1-8j,42582,42583,85165
45556,,url:http://portal.acm.org/ft_gateway.cfm3fid3d95703626type3dpdf26dl3dacm26dl3dacm26cfid3d1111111126cftoken3d2222222,42583,42584,85167
45557,,gggtgtsr9maj,42584,42585,85169
45558,,pt8tnca9eryj,42585,42586,85171
45559,,cs-5zbwujvqj,42586,42587,85173
45560,,gnb52dokdjwj,42587,42588,85175
45561,,7agr-uuiyuqj,42588,42589,85177
45562,,url:http://www.csa.com/partners/viewrecord.php3frequester3dgs26collection3dtrd26recid3dn9210553ah,42589,42590,85179
45563,,h3e25kuzh7sj,42590,42591,85181
45564,,ztujqpyjrs8j,42592,42593,85185
45565,,taz-hs0l_cmj,42593,42594,85187
45566,,q8_1n3k4boij,42594,42595,85189
45567,,gfrbqizfux4j,42595,42596,85191
45568,,ismwitskoucj,42596,42597,85193
45569,,v3p9jgrnhmqj,42597,42598,85195
45570,,1s8pfrhu5csj,42598,42599,85197
45571,,yc81ms-nk1qj,42599,42600,85199
45572,,eyq52swqijyj,42600,42601,85201
45573,,sz7e67girisj,42601,42602,85203
45574,,5ubhbvp2uboj,42602,42603,85205
45575,,fwga1_dkv_gj,42603,42604,85207
45576,,ddqctxulu4qj,42604,42605,85209
45577,,gztdng-h_x4j,42605,42606,85211
45578,,url:http://adsabs.harvard.edu/abs/2002stin...0243043p,42606,42607,85213
45579,,hni4jpq5gtej,42607,42608,85215
45580,,ocgjgotfy4qj,42608,42609,85217
45581,,ix3awhp0-mmj,42609,42610,85219
45582,,we1e_wcocqkj,42610,42611,85221
45583,,in4ul8vgrqkj,42611,42612,85223
45584,,busohumslvij,42612,42613,85225
45585,,xnxwj32hr2qj,42613,42614,85227
45586,,12pvyhouh9uj,42614,42615,85229
45587,,nqis59zplugj,42615,42616,85231
45588,,erh4vvlvrkuj,42616,42617,85233
45589,,cmn9rms3x3yj,42617,42618,85235
45590,,stfasznr9iij,42618,42619,85237
45591,,,42619,42620,85239
45592,,9di7xy01j44j,42620,42621,85241
45593,,bidbhysjb3cj,42621,42622,85243
45594,,tvhhyox0clij,42622,42623,85245
45595,,4bpft8ayexsj,42623,42624,85247
45596,,b0ssu37qb4aj,42624,42625,85249
45597,,aw63-elyl7uj,42625,42626,85251
45598,,url:http://www.blackwell-synergy.com/links/doi/10.1111/j.1467-8306.1972.tb00848.x/abs/,42626,42627,85253
45599,,ptggxfj9lyej,42627,42628,85255
45600,,qmv55n1hpkaj,42628,42629,85257
45601,,xb-apx1gksij,42629,42630,85259
45602,,nzshsentd-mj,42630,42631,85261
45603,,url:http://www.csa.com/partners/viewrecord.php3frequester3dgs26collection3dtrd26recid3d017302610093xai,42631,42632,85263
45604,,eovihyh2tz0j,42632,42633,85265
45605,,bqfhzeptp_wj,42633,42634,85267
45606,,pzda_um6akgj,42634,42635,85269
45607,,je3zuc1bkrkj,42635,42636,85271
45608,,kb3lgkfspqqj,42636,42637,85273
45609,,s1litggmea8j,42637,42638,85275
45610,,url:http://www.ingentaconnect.com/search/expand3fpub3dinfobike://els/13891286/2003/00000041/00000003/art0042126unc3d,42638,42639,85277
45611,,cd9qqrifs1uj,42639,42640,85279
45612,,phrbzhgqpqgj,42640,42641,85281
45613,,pkezhsskjncj,42641,42642,85283
45614,,2oxey3r4rlej,42642,42643,85285
45615,,ycua8vegq2uj,42643,42644,85287
45616,,bjomdiletlwj,42644,42645,85289
45617,,zq8ckduvincj,42645,42646,85291
45618,,98ivszptywkj,42646,42647,85293
45619,,bxljqnedjdaj,42647,42648,85295
45620,,8cd64f0t0-ej,42648,42649,85297
45621,,94kl4plwzikj,42649,42650,85299
45622,,wisxjpqlwzoj,42650,42651,85301
45623,,bwojlvqme20j,42651,42652,85303
45624,,rxtiu6qcyouj,42652,42653,85305
45625,,2mmkzeekowcj,42653,42654,85307
45626,,x5w3bzpbokij,42654,42655,85309
45627,,7vwjmgnyl6uj,42655,42656,85311
45628,,0forjktxjnwj,42656,42657,85313
45629,,7tqkvr4-lmqj,42657,42658,85315
45630,,j3gou1mcdaaj,42658,42659,85317
45631,,clrhfp2fz-wj,42659,42660,85319
45632,,ohy3zrhgpgyj,42660,42661,85321
45633,,jnytjjmt-buj,42661,42662,85323
45634,,i0vxxbboiegj,42662,42663,85325
45635,,bxvybgg7buaj,42663,42664,85327
45636,,nmqyqzno5gej,42664,42665,85329
45637,,url:http://doi.wiley.com/10.1002/tl.168,42665,42666,85331
45638,,qvs-mefo8bsj,42666,42667,85333
45639,,sxtji0mfjaaj,42667,42668,85335
45640,,cuo7kcmiwkmj,42668,42669,85337
45641,,tgmufz3uzo0j,42669,42670,85339
45642,,1ms09_ueeh4j,42670,42671,85341
45643,,tiayevcp-dej,42671,42672,85343
45644,,lciftgiiulqj,42672,42673,85345
45645,,swxpylzbrlej,42673,42674,85347
45646,,url:http://www.csa.com/partners/viewrecord.php3frequester3dgs26collection3dtrd26recid3dn9210473ah,42674,42675,85349
45647,,gwjzmfz1-04j,42675,42676,85351
45648,,iztrpgg_-rej,42676,42677,85353
45649,,cn4jlm1ztuwj,42677,42678,85355
45650,,ftlinf_b2kmj,42678,42679,85357
45651,,jmgs4naa4akj,42679,42680,85359
45652,,aemyllipeb8j,42680,42681,85361
45653,,url:http://doi.wiley.com/10.1002/tl.111,42681,42682,85363
45654,,g6mk35vsgymj,42682,42683,85365
45655,,l2fdvd1m6zcj,42683,42684,85367
45656,,yvqrdosf17ij,42684,42685,85369
45657,,wl8wa2o28_oj,42685,42686,85371
45658,,m_vrguliphuj,42687,42688,85375
45659,,zbebqwiaxtmj,42688,42689,85377
45660,,hteo_jrrvpgj,42689,42690,85379
45661,,5rwgeccdprqj,42690,42691,85381
45662,,djk0a-tipqsj,42691,42692,85383
45663,,ym5xv3dc3dwj,42692,42693,85385
45664,,lqljdayxwhkj,42693,42694,85387
45665,,url:http://www.csa.com/partners/viewrecord.php3frequester3dgs26collection3dtrd26recid3d0294522ci,42694,42695,85389
45666,,9vlexk1mov0j,42695,42696,85391
45667,,jg3mjbaej7gj,42696,42697,85393
45668,,x6yml_qwffsj,42697,42698,85395
45669,,6ygznu3uqqmj,42698,42699,85397
45670,,cbqx2yprc-uj,42699,42700,85399
45671,,2lv_kbi8jryj,42700,42701,85401
45672,,nfstjl_evfkj,42701,42702,85403
45673,,ajrsdwhlamaj,42702,42703,85405
45674,,x-k7jsynxu4j,42703,42704,85407
45675,,iz3rrstdmbij,42704,42705,85409
45676,,nbzwotiya3ij,42705,42706,85411
45677,,ybrevry12y0j,42706,42707,85413
45678,,url:http://doi.wiley.com/10.1002/anie.197603151,42707,42708,85415
45679,,lsuchsgvm5aj,42708,42709,85417
45680,,dnlhe7w2wggj,42709,42710,85419
45681,,s8zgd0r4m0wj,42710,42711,85421
45682,,gnerbothmsij,42711,42712,85423
45683,,4y125m3-bsyj,42712,42713,85425
45684,,5bwo8dlwc9ej,42713,42714,85427
45685,,tihup0qejqgj,42714,42715,85429
45686,,tb6oy0mmg6sj,42715,42716,85431
45687,,tj1z_e_isf8j,42716,42717,85433
45688,,vhvnf1cuytej,42717,42718,85435
45689,,lpqnrybmuiej,42718,42719,85437
45690,,qntvsdkhyxij,42719,42720,85439
45691,,vebhqy2zn1uj,42720,42721,85441
45692,,ygjrnqqfx8yj,42721,42722,85443
45693,,rnvwzaurr1mj,42722,42723,85445
45694,,kixfa0ltn8yj,42723,42724,85447
45695,,ud8qpycp9xgj,42724,42725,85449
45696,,yncwrfx-abgj,42725,42726,85451
45697,,7dhozz9fxmwj,42726,42727,85453
45698,,lgkylb_nr6qj,42727,42728,85455
45699,,p0reblzjhkuj,42728,42729,85457
45700,,n1kiaieguiwj,42729,42730,85459
45701,,95cbqhqa4x8j,42730,42731,85461
45702,,si-3v_d5thkj,42731,42732,85463
45703,,h8bmvcnv7o4j,42732,42733,85465
45704,,uqfnaziy2rsj,42733,42734,85467
45705,,jq5vkbtybksj,42734,42735,85469
45706,,b-1zx5g3rmqj,42735,42736,85471
45707,,7avj1sk0q2yj,42736,42737,85473
45708,,2r67-8wcmtwj,42737,42738,85475
45709,,5l0z9xxrgb8j,42738,42739,85477
45710,,e2lsl4wdkxkj,42739,42740,85479
45711,,poyoywikgpyj,42740,42741,85481
45712,,udbklaap_l8j,42741,42742,85483
45713,,1moimgnobbcj,42742,42743,85485
45714,,lp571q5en4gj,42743,42744,85487
45715,,03r6bm7ahh4j,42744,42745,85489
45716,,pbt8we9ly2cj,42745,42746,85491
45717,,gvppphm5oosj,42746,42747,85493
45718,,ygo77jxejssj,42748,42749,85497
45719,,,42749,42750,85499
45720,,zhhhvmykjcyj,42750,42751,85501
45721,,url:http://portal.acm.org/citation.cfm3fid3d197392,42751,42752,85503
45722,,mvfisb1qibmj,42752,42753,85505
45723,,kpqj6d9cmraj,42753,42754,85507
45724,,raoz84atdq4j,42754,42755,85509
45725,,iiblu3a0kvkj,42755,42756,85511
45726,,gan0zqwd5aqj,42756,42757,85513
45727,,ozhdprvgn2qj,42757,42758,85515
45728,,qwdtpwm2qfuj,42758,42759,85517
45729,,khctqdvgt10j,42759,42760,85519
45730,,wiwnxrf0mxuj,42760,42761,85521
45731,,5cusmpymcpsj,42761,42762,85523
45732,,rttea4pt-tsj,42762,42763,85525
45733,,url:http://portal.acm.org/citation.cfm3fid3d582318.582325,42763,42764,85527
45734,,url:http://doi.wiley.com/10.1002/tl.62,42764,42765,85529
45735,,ffrz_n4kqmqj,42765,42766,85531
45736,,1c1zmkdv9paj,42766,42767,85533
45737,,qecjwgrhaksj,42767,42768,85535
45738,,yeihjcl5uykj,42768,42769,85537
45739,,xl2ungt2alwj,42769,42770,85539
45740,,zcj6ecexclwj,42770,42771,85541
45741,,apxrpsq42byj,42771,42772,85543
45742,,todsodffojej,42772,42773,85545
45743,,kj404kej1bmj,42773,42774,85547
45744,,taruj_ng9p8j,42774,42775,85549
45745,,v0h5zfaimimj,42775,42776,85551
45746,,6cp0zqtd0lej,42776,42777,85553
45747,,7lqbuzpperij,42777,42778,85555
45748,,ag1yg-ikw4ij,42778,42779,85557
45749,,aecmbnlslaij,42779,42780,85559
45750,,hfqdlkoa_pqj,42780,42781,85561
45751,,occadpvqqg0j,42781,42782,85563
45752,,ynn7zjvnri8j,42782,42783,85565
45753,,saiwqriee74j,42783,42784,85567
45754,,url:http://portal.acm.org/citation.cfm3fid3d983065.98306826coll3dguide26dl3dacm26idx3dj68926part3dperiodical26wanttype3dperiodical26title3dacm2520sigmod2520record26cfid3d1111111126cftoken3d2222222,42784,42785,85569
45755,,f35s5joxldej,42785,42786,85571
45756,,hcqen1rdusqj,42786,42787,85573
45757,,hrxllo_babej,42787,42788,85575
45758,,eilo175qj-sj,42788,42789,85577
45759,,z2aenoxbkvij,42789,42790,85579
45760,,htzuyw21td0j,42791,42792,85583
45761,,b0el0achebmj,42792,42793,85585
45762,,9ymr4naro1oj,42793,42794,85587
45763,,ygw_swn07baj,42794,42795,85589
45764,,tgvyzopvpcwj,42795,42796,85591
45765,,t6d4a1uxalkj,42796,42797,85593
45766,,p1-8w_xd4taj,42797,42798,85595
45767,,f1refm4fs9uj,42798,42799,85597
45768,,epiy9yknbjgj,42799,42800,85599
45769,,7cu__rbx6smj,42800,42801,85601
45770,,kbkikjuuvomj,42801,42802,85603
45771,,4rp-_cdqxkqj,42802,42803,85605
45772,,0wtqlbtplqej,42803,42804,85607
45773,,pzn717qf4a4j,42804,42805,85609
45774,,fx0s58tj75ej,42805,42806,85611
45775,,c-kotlla0haj,42806,42807,85613
45776,,z46wwdi2t7mj,42807,42808,85615
45777,,fow0zvz43cuj,42808,42809,85617
45778,,url:http://www.springerlink.com/index/nxe3d2cuhn61xmmh.pdf,42809,42810,85619
45779,,nbg3q8otuqsj,42810,42811,85621
45780,,n_s40c_cxogj,42811,42812,85623
45781,,5femod1tidwj,42812,42813,85625
45782,,3sq1vhk1n9sj,42813,42814,85627
45783,,_a6hdgthmp4j,42814,42815,85629
45784,,9_ustna_yhej,42815,42816,85631
45785,,mby-hlq8mcaj,42816,42817,85633
45786,,i5rrntzdkvuj,42817,42818,85635
45787,,zmg_scd5lbwj,42818,42819,85637
45788,,sfvmjlj3b20j,42819,42820,85639
45789,,eglp0efz-jqj,42820,42821,85641
45790,,agikrb7rafgj,42821,42822,85643
45791,,iu17l5il_2ej,42822,42823,85645
45792,,hp4jqhxiwvaj,42823,42824,85647
45793,,kagbi7ysfx8j,42824,42825,85649
45794,,fc8ykys7rh0j,42825,42826,85651
45795,,qib6mz-g_eij,42826,42827,85653
45796,,4warkzp3vkoj,42827,42828,85655
45797,,juqlvnyupxwj,42828,42829,85657
45798,,iarsnup0zdkj,42829,42830,85659
45799,,bwizqnougikj,42830,42831,85661
45800,,glsm4dkcieej,42832,42833,85665
45801,,vsawp4rb-aqj,42833,42834,85667
45802,,url:http://portal.acm.org/citation.cfm3fid3d354538,42834,42835,85669
45803,,xw9emh3ogasj,42835,42836,85671
45804,,nxejjeywpm0j,42836,42837,85673
45805,,ull5ogad3byj,42837,42838,85675
45806,,hsz9ppf0nxyj,42838,42839,85677
45807,,url:http://www.blackwell-synergy.com/links/doi/10.1111/1475-4762.00028,42839,42840,85679
45808,,ib79rotuiwij,42840,42841,85681
45809,,hfei0pkh2quj,42841,42842,85683
45810,,thmsbpaxazmj,42842,42843,85685
45811,,7qksoryrsboj,42843,42844,85687
45812,,zwkbkgepjsmj,42844,42845,85689
45813,,myjzx61m7m4j,42845,42846,85691
45814,,dzh2oaqphdij,42846,42847,85693
45815,,y8pt8wwdnauj,42847,42848,85695
45816,,k2sqc7qhnosj,42848,42849,85697
45817,,,42849,42850,85699
45818,,9nsrx4fwt20j,42850,42851,85701
45819,,k-tgdcjiyloj,42851,42852,85703
45820,,url:http://www.springerlink.com/index/j267m1g774146066.pdf,42852,42853,85705
45821,,url:http://ieeexplore.ieee.org/iel5/69/29318/01324631.pdf3farnumber3d1324631,42853,42854,85707
45822,,2xwkdua0di8j,42854,42855,85709
45823,,tdfthgtrra4j,42855,42856,85711
45824,,k7rs7giqmgqj,42856,42857,85713
45825,,lil7uecldmsj,42857,42858,85715
45826,,qn3jmb65znsj,42858,42859,85717
45827,,h8t-jtsiz74j,42859,42860,85719
45828,,yrkdnorbwmuj,42860,42861,85721
45829,,_57gmi01mjyj,42861,42862,85723
45830,,robapil1aqcj,42862,42863,85725
45831,,3gwdiesg3gej,42864,42865,85729
45832,,wuptcigabsej,42865,42866,85731
45833,,hzpylf6n6bwj,42866,42867,85733
45834,,pkzn7v7x1poj,42867,42868,85735
45835,,k4qifxs3ifmj,42868,42869,85737
45836,,url:http://doi.wiley.com/10.1002/tl.127,42869,42870,85739
45837,,tolsoq0vizmj,42870,42871,85741
45838,,x8vrbzzqtauj,42871,42872,85743
45839,,p2urh_jh8zsj,42872,42873,85745
45840,,yoowuocdnisj,42874,42875,85749
45841,,mzuxhyfr7fgj,42875,42876,85751
45842,,njdl_1othqwj,42876,42877,85753
45843,,url:http://adsabs.harvard.edu/abs/1991phdt........67m,42879,42880,85759
45844,,dadjwudw_f4j,42880,42881,85761
45845,,pcixyiqjrtuj,42881,42882,85763
45846,,pzjtpplymxaj,42882,42883,85765
45847,,ibi6u32pw8sj,42883,42884,85767
45848,,1dgvnxga83mj,42884,42885,85769
45849,,its9hseemyoj,42885,42886,85771
45850,,t91d5li-xiwj,42886,42887,85773
45851,,svkvyw65bx8j,42887,42888,85775
45852,,fsmqn4jkedaj,42888,42889,85777
45853,,wfvt7nkpmx0j,42889,42890,85779
45854,,e-l7qcudbumj,42890,42891,85781
45855,,x4tknpzzpagj,42891,42892,85783
45856,,27zbtbudhdaj,42892,42893,85785
45857,,lukfrgpjyxkj,42893,42894,85787
45858,,c1zzzpklqnqj,42894,42895,85789
45859,,f2tc2xjkxr0j,42895,42896,85791
45860,,zfomc11vetej,42896,42897,85793
45861,,url:http://www.csa.com/partners/viewrecord.php3frequester3dgs26collection3dtrd26recid3da9640118ah,42897,42898,85795
45862,,apt2kdlxj20j,42898,42899,85797
45863,,yopubaeejxej,42899,42900,85799
45864,,cb_nlnrtde8j,42900,42901,85801
45865,,jize7lnsto4j,42901,42902,85803
45866,,nkjvok_yiewj,42902,42903,85805
45867,,sc5xnzjbzpej,42903,42904,85807
45868,,vw5ophu9co8j,42904,42905,85809
45869,,jpjkm3np1w0j,42905,42906,85811
45870,,di0fr_qlv8ej,42906,42907,85813
45871,,t6au3zkeetuj,42907,42908,85815
45872,,ihg2madghnkj,42908,42909,85817
45873,,kfadloekwokj,42909,42910,85819
45874,,i5ihylozoegj,42910,42911,85821
45875,,rt1yus28luwj,42911,42912,85823
45876,,gbxjnun2gjej,42912,42913,85825
45877,,oe9r26sjxouj,42913,42914,85827
45878,,trsgmwh--maj,42914,42915,85829
45879,,xcd3qow2fd4j,42915,42916,85831
45880,,ewgn0iur08qj,42916,42917,85833
45881,,10yrrt9buwaj,42917,42918,85835
45882,,url:http://www.csa.com/partners/viewrecord.php3frequester3dgs26collection3dtrd26recid3d20021211001541mt26recid3da8622967ah,42918,42919,85837
45883,,8riv41x24xoj,42919,42920,85839
45884,,ifbxsemnpzgj,42920,42921,85841
45885,,kmnhlmcbun0j,42921,42922,85843
45886,,zuxcdlruzdyj,42922,42923,85845
45887,,qpwch_gwdbij,42923,42924,85847
45888,,kqjksymzovcj,42924,42925,85849
45889,,ax4sfnkvjwwj,42925,42926,85851
45890,,upgtze4qjt4j,42926,42927,85853
45891,,3q1wpcxehbmj,42927,42928,85855
45892,,url:http://portal.acm.org/ft_gateway.cfm3fid3d102769426type3dpdf,42928,42929,85857
45893,,nffwjwoudk0j,42929,42930,85859
45894,,lcha4aty9d8j,42930,42931,85861
45895,,4bvh6jt8qv8j,42931,42932,85863
45896,,4g2-_tjpr_wj,42932,42933,85865
45897,,oxn2q5ck-twj,42933,42934,85867
45898,,a4cc2fgmamwj,42934,42935,85869
45899,,cefx7j0su20j,42935,42936,85871
45900,,9_urgtyshjwj,42936,42937,85873
45901,,oikhgixnfdkj,42937,42938,85875
45902,,qzow6yzmjesj,42938,42939,85877
45903,,e18pijmwo5ej,42939,42940,85879
45904,,08lammve7duj,42940,42941,85881
45905,,xsv7dkji-ymj,42941,42942,85883
45906,,jonvry3twhgj,42942,42943,85885
45907,,cynld9wsoxmj,42943,42944,85887
45908,,bspndzm6x0ij,42944,42945,85889
45909,,nslwaulezwej,42945,42946,85891
45910,,689rk_pd3kqj,42946,42947,85893
45911,,_vlxdvemxiqj,42947,42948,85895
45912,,url:http://links.jstor.org/sici3fsici3d0146-4949(196723)8253a4253c528253ahvdai253e2.0.co253b2-z,42948,42949,85897
45913,,zwixv8et3xuj,42949,42950,85899
45914,,nu8oqzjfaagj,42950,42951,85901
45915,,njuc2fmeuroj,42951,42952,85903
45916,,fc33ky254u0j,42952,42953,85905
45917,,nnoijsfsotqj,42953,42954,85907
45918,,nj_v16k1dvoj,42954,42955,85909
45919,,jntluo7prqyj,42955,42956,85911
45920,,h4bafnrstbwj,42956,42957,85913
45921,,mwrhr8gauxij,42957,42958,85915
45922,,wxljrcni8ukj,42958,42959,85917
45923,,e-f_5v896jcj,42959,42960,85919
45924,,xgbwzgaffrsj,42960,42961,85921
45925,,yhxa0ffqmhgj,42961,42962,85923
45926,,zqbt5mu2bz0j,42962,42963,85925
45927,,kz6gc3vvwrmj,42963,42964,85927
45928,,frwsbgd14xsj,42964,42965,85929
45929,,upn-18toiuoj,42965,42966,85931
45930,,9ho18bdxxtoj,42966,42967,85933
45931,,zbdgaezyexuj,42967,42968,85935
45932,,h3yrmmiltfej,42968,42969,85937
45933,,wq3r5kaoxwoj,42969,42970,85939
45934,,joqpcofbzkuj,42970,42971,85941
45935,,ltemslubrykj,42971,42972,85943
45936,,ahn51ft78h0j,42972,42973,85945
45937,,murvv2h6fmij,42973,42974,85947
45938,,tuuxgfj9emwj,42974,42975,85949
45939,,m5jqq6btqb8j,42975,42976,85951
45940,,v84_ylnpgcaj,42976,42977,85953
45941,,sqdng30d4-sj,42977,42978,85955
45942,,wgb6yzfja_ej,42978,42979,85957
45943,,unsvooc2goyj,42979,42980,85959
45944,,mjjlx7gsxquj,42980,42981,85961
45945,,wlzifmioyysj,42981,42982,85963
45946,,b5-iisyny9aj,42982,42983,85965
45947,,jytw8chjvaoj,42983,42984,85967
45948,,g2itsflborej,42984,42985,85969
45949,,bgjz81nvmooj,42985,42986,85971
45950,,ik9ior-i7mwj,42986,42987,85973
45951,,a6vlck0-3jyj,42987,42988,85975
45952,,dmyorlbm63cj,42988,42989,85977
45953,,917gyt0_smcj,42989,42990,85979
45954,,n60xccwwgmkj,42990,42991,85981
45955,,knhcizp3kjqj,42991,42992,85983
45956,,4ivlvcg-eycj,42992,42993,85985
45957,,hs8iw6kojfmj,42993,42994,85987
45958,,ztkt4t_lt1wj,42994,42995,85989
45959,,nqcutx5nclej,42995,42996,85991
45960,,_kd-5ejkst8j,42996,42997,85993
45961,,srkpmkq1phej,42997,42998,85995
45962,,0je9dppcfm8j,42998,42999,85997
45963,,ygc4paysgsuj,42999,43000,85999
45964,,bo7qobdu1jij,43000,43001,86001
45965,,2xirt20mb0yj,43001,43002,86003
45966,,3axhcwxqqn0j,43002,43003,86005
45967,,fkg8zfesfpyj,43003,43004,86007
45968,,pff6mrcnsycj,43004,43005,86009
45969,,bzzoqvkew3ij,43006,43007,86013
45970,,oyymmqyrfl0j,43007,43008,86015
45971,,i0djh5j4dy8j,43008,43009,86017
45972,,ceurtsslakaj,43009,43010,86019
45973,,7c1w4dd8vyuj,43010,43011,86021
45974,,j0dodst35yij,43011,43012,86023
45975,,1bhrw8wjuo4j,43012,43013,86025
45976,,yjsrcmn5qpmj,43013,43014,86027
45977,,wzsxfjbgrwej,43014,43015,86029
45978,,joapxf2k_o0j,43015,43016,86031
45979,,ktsjtu0cnnsj,43016,43017,86033
45980,,rm3rfo99x9gj,43017,43018,86035
45981,,w0pvh0adck8j,43018,43019,86037
45982,,pqqmivgbjekj,43019,43020,86039
45983,,0japt3k-y-uj,43020,43021,86041
45984,,,43021,43022,86043
45985,,pe7uo9nmczuj,43022,43023,86045
45986,,o-nqz8vhwa0j,43023,43024,86047
45987,,zcboaemf_i8j,43024,43025,86049
45988,,jvskfzjunu0j,43025,43026,86051
45989,,mt47j1onmgwj,43026,43027,86053
45990,,fsmq8shoazmj,43027,43028,86055
45991,,uwfogdmz6nkj,43028,43029,86057
45992,,q42ruw4_fogj,43029,43030,86059
45993,,d3vglznxejsj,43030,43031,86061
45994,,_xzzkw4bawcj,43031,43032,86063
45995,,cgiwltmx9uqj,43032,43033,86065
45996,,ponazrd2bugj,43033,43034,86067
45997,,e-eqlgna4fgj,43034,43035,86069
45998,,,43035,43036,86071
45999,,v_irw5wfsq8j,43036,43037,86073
46000,,3fcoeuxe5woj,43037,43038,86075
46001,,saojf8iiffoj,43038,43039,86077
46002,,5xazb7uhhngj,43039,43040,86079
46003,,jf0dh8lscv8j,43040,43041,86081
46004,,o_5wdzqwqsmj,43041,43042,86083
46005,,jm3jsnhkbmmj,43042,43043,86085
46006,,s4hnlt1bak0j,43043,43044,86087
46007,,xqqvza3y3amj,43044,43045,86089
46008,,cgn55f1xpquj,43045,43046,86091
46009,,n2hwvedevkoj,43046,43047,86093
46010,,xiaevyxhry0j,43048,43049,86097
46011,,xz2fybbm_xsj,43049,43050,86099
46012,,06cjbq_gdmuj,43050,43051,86101
46013,,jmhvob9vv4uj,43051,43052,86103
46014,,url:http://www.csa.com/partners/viewrecord.php3frequester3dgs26collection3dtrd26recid3d017402630015ai,43052,43053,86105
46015,,mthno-ubrsaj,43053,43054,86107
46016,,url:http://portal.acm.org/citation.cfm3fid3d171926.171939,43054,43055,86109
46017,,qyg5cpock_cj,43055,43056,86111
46018,,og7iha879cej,43056,43057,86113
46019,,0sute4xplvsj,43057,43058,86115
46020,,sut0gxdls_ij,43058,43059,86117
46021,,q0ybwf0bpe4j,43059,43060,86119
46022,,cbaa2cfox0ij,43060,43061,86121
46023,,kbghtfzrybcj,43061,43062,86123
46024,,eh8pe9djbtuj,43062,43063,86125
46025,,5vdet__bskgj,43063,43064,86127
46026,,ujwzwce8ap0j,43064,43065,86129
46027,,lrp0aen5enoj,43065,43066,86131
46028,,yqalevuc5dsj,43066,43067,86133
46029,,9bhdat1kfboj,43067,43068,86135
46030,,umxqg-tvbgcj,43068,43069,86137
46031,,3t7q6jd1pg4j,43069,43070,86139
46032,,pxrkzrtmligj,43070,43071,86141
46033,,9-fd8jocwf4j,43071,43072,86143
46034,,url:http://www.csa.com/partners/viewrecord.php3frequester3dgs26collection3dtrd26recid3d20021212023587mt26recid3da7642832ah,43072,43073,86145
46035,,m7vgjecvunej,43073,43074,86147
46036,,krriikfqeqkj,43074,43075,86149
46037,,glv6fgwtflij,43075,43076,86151
46038,,j0xrfz99bwsj,43076,43077,86153
46039,,6jmjisegxbsj,43077,43078,86155
46040,,9ixg0yhiihmj,43078,43079,86157
46041,,ipb3swexii4j,43079,43080,86159
46042,,1d9blg837uij,43080,43081,86161
46043,,0vmp__pyg_4j,43081,43082,86163
46044,,ncxysb5yqj0j,43082,43083,86165
46045,,ntmz82d7liaj,43083,43084,86167
46046,,q3y8xq3fkjwj,43084,43085,86169
46047,,cjh4wzcy-1yj,43085,43086,86171
46048,,mkpilsbwz1qj,43086,43087,86173
46049,,kv83pnrgpiwj,43087,43088,86175
46050,,mrgcboq5kouj,43088,43089,86177
46051,,2-tbb1snvykj,43089,43090,86179
46052,,1huz4gox5tqj,43090,43091,86181
46053,,3m6loxlljpyj,43091,43092,86183
46054,,99os8iqnvg4j,43092,43093,86185
46055,,1v9yv9w-qoqj,43093,43094,86187
46056,,dqa3ahtbjkaj,43094,43095,86189
46057,,hahl-ks2ejsj,43095,43096,86191
46058,,trjx0-xhq3qj,43096,43097,86193
46059,,ztllt8vlssaj,43097,43098,86195
46060,,url:http://www.ingentaconnect.com/search/expand3fpub3dinfobike://els/13891286/2001/00000037/00000003/art0018526unc3d,43098,43099,86197
46061,,xen_vtg6oh4j,43099,43100,86199
46062,,afdi-xmdl5yj,43100,43101,86201
46063,,6nw6sn-mhdkj,43101,43102,86203
46064,,bspbyxioelcj,43102,43103,86205
46065,,mo_4np-ga6sj,43103,43104,86207
46066,,esvkezb-zzij,43104,43105,86209
46067,,sokqivgfznkj,43105,43106,86211
46068,,rll6o5hhpdaj,43106,43107,86213
46069,,m5fdemahs9mj,43107,43108,86215
46070,,url:http://adsabs.harvard.edu/abs/2002stin...0246994e,43108,43109,86217
46071,,zrjhtrcfyb4j,43109,43110,86219
46072,,hpyhcvpi9t8j,43110,43111,86221
46073,,oshfmgctcxoj,43111,43112,86223
46074,,sziqznwxjxqj,43112,43113,86225
46075,,tleslmplfgij,43113,43114,86227
46076,,ktl5ydy9f6ij,43114,43115,86229
46077,,url:http://links.jstor.org/sici3fsici3d0146-4949(196123)2253a3253c5253atudsao253e2.0.co253b2-9,43115,43116,86231
46078,,dlp8afwq7r0j,43116,43117,86233
46079,,vm_hydyfej0j,43117,43118,86235
46080,,rla2zdlnky4j,43118,43119,86237
46081,,ealfi8_2ygsj,43119,43120,86239
46082,,ntepptzgdboj,43120,43121,86241
46083,,wjfzja61u2mj,43121,43122,86243
46084,,c_n0wqe1fhaj,43122,43123,86245
46085,,-3zfc5-aszij,43123,43124,86247
46086,,kplu_8ivz0ij,43124,43125,86249
46087,,jppfev_664ej,43125,43126,86251
46088,,b6_w4ldvnaoj,43126,43127,86253
46089,,vfmv_xpmfiqj,43127,43128,86255
46090,,v2nvgkiae4mj,43128,43129,86257
46091,,6tvrweaptwwj,43129,43130,86259
46092,,x6rzk1zjfi8j,43130,43131,86261
46093,,7fvbzxnxflwj,43131,43132,86263
46094,,orz-yafdcrcj,43132,43133,86265
46095,,mtq6krpbtnmj,43133,43134,86267
46096,,fz-p6b89noyj,43134,43135,86269
46097,,nn6yhidfy4gj,43135,43136,86271
46098,,hhamh57reqoj,43137,43138,86275
46099,,iy4s4uatvmoj,43138,43139,86277
46100,,h95ipbs8craj,43139,43140,86279
46101,,tazyc3frxekj,43140,43141,86281
46102,,faqxt6h5bquj,43141,43142,86283
46103,,,43142,43143,86285
46104,,71x7yilazc4j,43143,43144,86287
46105,,zcspew8v8kej,43144,43145,86289
46106,,yjsxspk2xrgj,43145,43146,86291
46107,,1my08yfjy2ej,43146,43147,86293
46108,,2vukxghy_lqj,43147,43148,86295
46109,,url:http://portal.acm.org/ft_gateway.cfm3fid3d108367626type3dpdf,43148,43149,86297
46110,,qmxbpo9yv5oj,43149,43150,86299
46111,,jkk6fpyyf9mj,43150,43151,86301
46112,,tcpzuqyfycaj,43151,43152,86303
46113,,f45xntwtup0j,43152,43153,86305
46114,,j-wzij-akusj,43153,43154,86307
46115,,ikxt_ial8akj,43154,43155,86309
46116,,doonx9wvr3ij,43155,43156,86311
46117,,f698utt_ig8j,43156,43157,86313
46118,,ttyckpnvyhej,43157,43158,86315
46119,,-n-ud-c1utmj,43158,43159,86317
46120,,kww2mfcw_w4j,43159,43160,86319
46121,,2gzrs3zvnaoj,43160,43161,86321
46122,,url:http://www.ncbi.nlm.nih.gov/entrez/query.fcgi3fcmd3dretrieve26db3dpubmed26list_uids3d74842526dopt3dcitation,43161,43162,86323
46123,,rwdsu8aie1qj,43162,43163,86325
46124,,yxc9t87hjwsj,43163,43164,86327
46125,,url:http://doi.wiley.com/10.1002/tl.7507,43164,43165,86329
46126,,pe4uwp5xqo4j,43165,43166,86331
46127,,0ibmohmgssoj,43166,43167,86333
46128,,6jijuzuaeakj,43167,43168,86335
46129,,c3wdntnvbeej,43168,43169,86337
46130,,i6i7ee7k44cj,43169,43170,86339
46131,,wcxbhqh4ffkj,43170,43171,86341
46132,,1fciqpgcaaaj,43171,43172,86343
46133,,tryiamfcqf4j,43172,43173,86345
46134,,iz9cypbxivwj,43173,43174,86347
46135,,bypgbicshfwj,43174,43175,86349
46136,,tgq7zef62zaj,43175,43176,86351
46137,,5mkijifbkn8j,43176,43177,86353
46138,,,43177,43178,86355
46139,,l-9pykkovrkj,43178,43179,86357
46140,,lbwmfd7-t2yj,43179,43180,86359
46141,,ffasz5ia8qqj,43180,43181,86361
46142,,n-ftsedvfcyj,43181,43182,86363
46143,,98kaeznggk8j,43182,43183,86365
46144,,f0djmwq54d8j,43183,43184,86367
46145,,iwq48evudcoj,43184,43185,86369
46146,,k_fes3grolqj,43185,43186,86371
46147,,wkia4_xlvxgj,43186,43187,86373
46148,,url:http://portal.acm.org/citation.cfm3fid3d1101149.1101242,43187,43188,86375
46149,,bpp9mqjyyhcj,43188,43189,86377
46150,,ukrfcghgx6cj,43189,43190,86379
46151,,es22dfzd3hcj,43190,43191,86381
46152,,5pmg2qtsfsoj,43191,43192,86383
46153,,lvrxzctoz0cj,43192,43193,86385
46154,,zore6b5jtkoj,43193,43194,86387
46155,,5b_pmylwrlsj,43194,43195,86389
46156,,url:http://portal.acm.org/citation.cfm3fid3d1083592.1083761,43195,43196,86391
46157,,9ho1uqckeeej,43196,43197,86393
46158,,vglti41zg6cj,43197,43198,86395
46159,,v6fllaodk18j,43199,43200,86399
46160,,oypstkzifb0j,43200,43201,86401
46161,,gh65osuquj8j,43201,43202,86403
46162,,url:http://www.ncbi.nlm.nih.gov/entrez/query.fcgi3fcmd3dretrieve26db3dpubmed26list_uids3d7970426dopt3dcitation,43202,43203,86405
46163,,ekxuyn5lyv4j,43203,43204,86407
46164,,zxggo58jcwuj,43204,43205,86409
46165,,ozhjim5hg2uj,43206,43207,86413
46166,,egl7gpt0sacj,43207,43208,86415
46167,,vzj6bkwsku8j,43208,43209,86417
46168,,brghxqiargej,43209,43210,86419
46169,,hebndttfygcj,43211,43212,86423
46170,,umcerg4hntgj,43212,43213,86425
46171,,bwbsljo5pg4j,43213,43214,86427
46172,,phh2t0v0uc0j,43214,43215,86429
46173,,hqw96dmjz6ej,43215,43216,86431
46174,,yhfndqmczmoj,43216,43217,86433
46175,,pnaai66b95yj,43217,43218,86435
46176,,wyktmw7eg50j,43218,43219,86437
46177,,skgcng6qmnqj,43219,43220,86439
46178,,4jyxr3edd5cj,43220,43221,86441
46179,,lzobe4ggtocj,43221,43222,86443
46180,,3jq1gtxe3owj,43222,43223,86445
46181,,dxivypfajwaj,43223,43224,86447
46182,,pres0o46nwij,43225,43226,86451
46183,,url:http://www.ingentaconnect.com/search/expand3fpub3dinfobike://els/13891286/2001/00000037/00000006/art0025126unc3d,43226,43227,86453
46184,,cbsamsw58uoj,43227,43228,86455
46185,,ubpdljycfggj,43228,43229,86457
46186,,mm5sjbsvshwj,43229,43230,86459
46187,,g_gl0oqw0_mj,43230,43231,86461
46188,,b8ormaa320uj,43232,43233,86465
46189,,v42vyysngo4j,43233,43234,86467
46190,,9xin5w5rzkkj,43234,43235,86469
46191,,ao8gm79tbrkj,43235,43236,86471
46192,,url:http://pubs.acs.org/cgi-bin/abstract.cgi/achre4/2005/38/i08/abs/ar030210r.html,43236,43237,86473
46193,,5abbkch_xzej,43237,43238,86475
46194,,3q8hxvufi3ij,43238,43239,86477
46195,,,43239,43240,86479
46196,,lgjlcyios6gj,43240,43241,86481
46197,,wcjau9qpwcaj,43241,43242,86483
46198,,uw8gbaoffsuj,43242,43243,86485
46199,,mz6n_cybqhyj,43243,43244,86487
46200,,wkq2dfbgy6uj,43244,43245,86489
46201,,k1szrwpo568j,43245,43246,86491
46202,,cfbisx_2jdsj,43246,43247,86493
46203,,cnz203r0axij,43247,43248,86495
46204,,n1_dobmrpdaj,43248,43249,86497
46205,,s6je9xuv86ij,43249,43250,86499
46206,,4djtfkzofimj,43250,43251,86501
46207,,b_v0mihd9-qj,43251,43252,86503
46208,,dihgk6lwyguj,43252,43253,86505
46209,,zyf4oatjhg8j,43253,43254,86507
46210,,ru_v4rwepyaj,43254,43255,86509
46211,,l-quliyx15kj,43255,43256,86511
46212,,tmqsre0gjlmj,43256,43257,86513
46213,,ruznib0pxqqj,43259,43260,86519
46214,,g9tnqvryvx4j,43260,43261,86521
46215,,xzy4jj8psykj,43261,43262,86523
46216,,t9u01patedsj,43263,43264,86527
46217,,g9jcd5nvtjwj,43264,43265,86529
46218,,szcoe1mgowaj,43265,43266,86531
46219,,url:http://doi.wiley.com/10.1002/tl.7708,43266,43267,86533
46220,,tsew8hawrs4j,43267,43268,86535
46221,,aolju65pd2sj,43268,43269,86537
46222,,phjucsaifpmj,43269,43270,86539
46223,,1vsuqysj2cwj,43270,43271,86541
46224,,url:http://portal.acm.org/ft_gateway.cfm3fid3d109971426type3dpdf,43271,43272,86543
46225,,88jhjdqc7xgj,43272,43273,86545
46226,,bvnxp1iptquj,43273,43274,86547
46227,,url:http://links.jstor.org/sici3fsici3d0146-4949(196622)7253a2253c160253a2522tohat253e2.0.co253b2-r,43274,43275,86549
46228,,f2kqv6efbioj,43275,43276,86551
46229,,014dle23ve0j,43276,43277,86553
46230,,oksudpxmlmoj,43277,43278,86555
46231,,ywqwkd1ov7ij,43278,43279,86557
46232,,vduee6xbgz8j,43279,43280,86559
46233,,oxvx7fx1etqj,43280,43281,86561
46234,,jdbzax6krdqj,43281,43282,86563
46235,,,43282,43283,86565
46236,,zydf7ho_rm8j,43283,43284,86567
46237,,swyyrgihl24j,43284,43285,86569
46238,,ouubfmwsdxkj,43285,43286,86571
46239,,0zanlo8dt98j,43286,43287,86573
46240,,v9dtlhhibxej,43288,43289,86577
46241,,q31ezxy-uywj,43289,43290,86579
46242,,wtaabtalkfij,43290,43291,86581
46243,,q_swqdchrk0j,43291,43292,86583
46244,,adfdz5wli68j,43292,43293,86585
46245,,rc41k8ry2nuj,43293,43294,86587
46246,,mz6rmzdlaiuj,43294,43295,86589
46247,,86u6vvhnkikj,43295,43296,86591
46248,,so-pcwpgfgyj,43296,43297,86593
46249,,l5rxxwksj4qj,43297,43298,86595
46250,,url:http://portal.acm.org/ft_gateway.cfm3fid3d110200426type3dpdf,43298,43299,86597
46251,,vzhzmg0w2sgj,43299,43300,86599
46252,,jdveecm54gkj,43300,43301,86601
46253,,pvkdfqw4zsaj,43301,43302,86603
46254,,bumpmxyz-twj,43302,43303,86605
46255,,url:http://www.springerlink.com/index/gt7355q0817246q5.pdf,43303,43304,86607
46256,,url:http://portal.acm.org/ft_gateway.cfm3fid3d109970926type3dpdf,43304,43305,86609
46257,,efxuqie9c9cj,43305,43306,86611
46258,,fvraorsnsamj,43306,43307,86613
46259,,0xnw-zzqvnoj,43307,43308,86615
46260,,j4xl6tjt_fcj,43308,43309,86617
46261,,opggmj3nov4j,43309,43310,86619
46262,,xyeukjup59aj,43310,43311,86621
46263,,j0jqgfojvz4j,43311,43312,86623
46264,,nvto_tvuuroj,43312,43313,86625
46265,,proe1j42yeqj,43313,43314,86627
46266,,xxo-o3yxqiwj,43314,43315,86629
46267,,rsi0skgjzlsj,43315,43316,86631
46268,,wnifhwxog7cj,43316,43317,86633
46269,,avti96dnlbaj,43317,43318,86635
46270,,9jz2hhieaxmj,43318,43319,86637
46271,,6c65b9xagbmj,43319,43320,86639
46272,,zlffnrmpd9uj,43320,43321,86641
46273,,cx8_d0s0p14j,43321,43322,86643
46274,,url:http://portal.acm.org/ft_gateway.cfm3fid3d109962326type3dpdf,43322,43323,86645
46275,,tdfgizjgspmj,43323,43324,86647
46276,,ywgd3rbafl0j,43324,43325,86649
46277,,elysrcee0haj,43325,43326,86651
46278,,huniv3us_yij,43326,43327,86653
46279,,i7lddigrds4j,43327,43328,86655
46280,,migjd-bhmfij,43328,43329,86657
46281,,rpez6c55zxwj,43329,43330,86659
46282,,cvinwtp9eh8j,43330,43331,86661
46283,,ul4faycs3tgj,43331,43332,86663
46284,,url:http://www.csa.com/partners/viewrecord.php3frequester3dgs26collection3dtrd26recid3d200114001099mt26recid3da0032594ah,43332,43333,86665
46285,,cnqeqaxxiwqj,43333,43334,86667
46286,,jmkb2vl7jt4j,43334,43335,86669
46287,,53tvegjviquj,43335,43336,86671
46288,,ohht-a3vhjaj,43336,43337,86673
46289,,t0ama56q7uij,43337,43338,86675
46290,,zyintag7x8qj,43338,43339,86677
46291,,aptizxv_ebij,43339,43340,86679
46292,,xu8gyz78ackj,43340,43341,86681
46293,,kxrxy492990j,43341,43342,86683
46294,,e07dhuh4hooj,43342,43343,86685
46295,,lufrqm48jaej,43343,43344,86687
46296,,wagztmnfvdsj,43344,43345,86689
46297,,npywtyev3gkj,43345,43346,86691
46298,,rjnjsb-pwj0j,43346,43347,86693
46299,,hy9_d6mnk9ej,43347,43348,86695
46300,,uld3j3ibtgwj,43348,43349,86697
46301,,spujwtkh-jgj,43349,43350,86699
46302,,qzbfots7rqaj,43350,43351,86701
46303,,bzfvsgjbpsaj,43351,43352,86703
46304,,jgkspftyyu8j,43352,43353,86705
46305,,url:http://doi.wiley.com/10.1002/he.134,43353,43354,86707
46306,,ef68qf_iuv8j,43354,43355,86709
46307,,url:http://links.jstor.org/sici3fsici3d0146-4949(196021252f22)1253a2253c49253atcolit253e2.0.co253b2-m,43355,43356,86711
46308,,url:http://ieeexplore.ieee.org/iel2/3038/8631/00379944.pdf3farnumber3d379944,43356,43357,86713
46309,,6xecf4aii84j,43357,43358,86715
46310,,qeal4jwutz8j,43358,43359,86717
46311,,yey-lcf4buqj,43360,43361,86721
46312,,u_io0hxfo54j,43361,43362,86723
46313,,oee4nch3g48j,43362,43363,86725
46314,,xf4cms66rjwj,43363,43364,86727
46315,,8ucp_xzdmxij,43365,43366,86731
46316,,rwat7anwfnwj,43366,43367,86733
46317,,8mimfqftwjcj,43367,43368,86735
46318,,uhduzllyarcj,43368,43369,86737
46319,,3rzr5qvvavwj,43369,43370,86739
46320,,oyhe1iclgf0j,43370,43371,86741
46321,,jr_fc8ynoyyj,43371,43372,86743
46322,,4-yyt-ii0bmj,43372,43373,86745
46323,,zkph0jgeksoj,43373,43374,86747
46324,,h03sir7v7hej,43374,43375,86749
46325,,rtuw2eo-mvgj,43375,43376,86751
46326,,3uehugwtafoj,43376,43377,86753
46327,,_e5p1f9vimsj,43377,43378,86755
46328,,sefi2vzznj8j,43378,43379,86757
46329,,scc8oiwynmgj,43379,43380,86759
46330,,921awrkh6c8j,43380,43381,86761
46331,,yhgurvaazhij,43381,43382,86763
46332,,oy6gipr1nqej,43382,43383,86765
46333,,wbaq1ah3dnsj,43383,43384,86767
46334,,uz3m4jasskoj,43384,43385,86769
46335,,2vcgqmnynkqj,43385,43386,86771
46336,,sip9yjgvct0j,43386,43387,86773
46337,,u6hmo15wwpwj,43387,43388,86775
46338,,irf1og4wlgcj,43388,43389,86777
46339,,girs6lqt7-ij,43389,43390,86779
46340,,wbqy1ahyujij,43390,43391,86781
46341,,phikumje5eqj,43391,43392,86783
46342,,96jlnbe2mvej,43392,43393,86785
46343,,su28qmkjwnuj,43393,43394,86787
46344,,ylyahukt8nwj,43394,43395,86789
46345,,xpjpq3h5bhuj,43395,43396,86791
46346,,aztw9kb1250j,43396,43397,86793
46347,,jq5sblenh4cj,43397,43398,86795
46348,,j27te-xxsoqj,43398,43399,86797
46349,,x-pkdi9gon0j,43399,43400,86799
46350,,_pk70t1z9n4j,43400,43401,86801
46351,,dj8bcuzbkgij,43401,43402,86803
46352,,ca-lhfomlmyj,43402,43403,86805
46353,,zuqlrsr04kaj,43403,43404,86807
46354,,url:http://doi.wiley.com/10.1002/ev.1316,43404,43405,86809
46355,,upowhh-ukuwj,43405,43406,86811
46356,,vfnv_km253wj,43406,43407,86813
46357,,xfqnrxvrslyj,43407,43408,86815
46358,,gknxjirdhawj,43408,43409,86817
46359,,yd3umumosmyj,43409,43410,86819
46360,,z5riahq12osj,43410,43411,86821
46361,,vrczj2llgw8j,43411,43412,86823
46362,,4xnvwls1cgsj,43412,43413,86825
46363,,w-nyb76gqxmj,43413,43414,86827
46364,,kkfmibysqpej,43414,43415,86829
46365,,y1l98gk6xs8j,43415,43416,86831
46366,,ggwn-dykfkij,43416,43417,86833
46367,,2chtc6bnximj,43417,43418,86835
46368,,q2d4fzhk7ksj,43418,43419,86837
46369,,tlhmeccil-gj,43419,43420,86839
46370,,wxciar57gpsj,43420,43421,86841
46371,,6wlbpsi0pduj,43421,43422,86843
46372,,8gzg1etzx8sj,43422,43423,86845
46373,,okgjyqpgvxej,43423,43424,86847
46374,,zeycii44fnmj,43424,43425,86849
46375,,gjjpjeabzqij,43425,43426,86851
46376,,qb4inpbn1esj,43426,43427,86853
46377,,dpm4l_kyt9wj,43427,43428,86855
46378,,fyq_wqu08zkj,43428,43429,86857
46379,,qt0-kxvnyjcj,43429,43430,86859
46380,,stjh5vaxhrwj,43430,43431,86861
46381,,zelkgzji5qmj,43431,43432,86863
46382,,jkmf_y4nw34j,43432,43433,86865
46383,,3p-ivqz2rlqj,43433,43434,86867
46384,,lxxxttwfhdyj,43434,43435,86869
46385,,wyyi09karvwj,43435,43436,86871
46386,,tkgjk7c_eloj,43436,43437,86873
46387,,qr3fptakv6ij,43437,43438,86875
46388,,tlci9irnsd0j,43438,43439,86877
46389,,xhfqf4jb7asj,43439,43440,86879
46390,,tv2zj_h-1ckj,43440,43441,86881
46391,,952dwfmgriyj,43441,43442,86883
46392,,url:http://www.springerlink.com/index/tw42x1r7468h5v41.pdf,43442,43443,86885
46393,,ie6miwghtm4j,43443,43444,86887
46394,,ogfru-q4qtoj,43444,43445,86889
46395,,lhmm96bnhkwj,43445,43446,86891
46396,,vlkj16dxbugj,43446,43447,86893
46397,,8tyeahdytacj,43447,43448,86895
46398,,8cqxhj0q4jej,43448,43449,86897
46399,,ow5sezwtytej,43449,43450,86899
46400,,pn8kuxwobkoj,43450,43451,86901
46401,,8ktaxeqrfycj,43451,43452,86903
46402,,xoh2pqrqrdkj,43452,43453,86905
46403,,ht6hzfmo1wcj,43453,43454,86907
46404,,ygf-6yryg3uj,43454,43455,86909
46405,,7ekbk0qnmuuj,43455,43456,86911
46406,,whvgn_902wcj,43456,43457,86913
46407,,8mzqpofu1uaj,43457,43458,86915
46408,,wk-liyibt8wj,43458,43459,86917
46409,,url:http://www.csa.com/partners/viewrecord.php3frequester3dgs26collection3dtrd26recid3dn8335702ah,43459,43460,86919
46410,,5jaqy9mdf9ej,43460,43461,86921
46411,,3l0ccyoptjyj,43461,43462,86923
46412,,ooswqh5ndygj,43462,43463,86925
46413,,bvqn5obn3hij,43463,43464,86927
46414,,8msdsdoiqvaj,43464,43465,86929
46415,,auga3mukxywj,43465,43466,86931
46416,,viw3asxrurej,43466,43467,86933
46417,,6d4kmh8bmagj,43467,43468,86935
46418,,_2ntprt8clqj,43468,43469,86937
46419,,,43470,43471,86941
46420,,fol7fhczs-gj,43471,43472,86943
46421,,uoy4gzqwbgwj,43472,43473,86945
46422,,fgwhgcvdklej,43473,43474,86947
46423,,lz8yxynffe0j,43474,43475,86949
46424,,wlni7obmsccj,43475,43476,86951
46425,,glgjz_chvgaj,43476,43477,86953
46426,,1_vhzrbw3fsj,43477,43478,86955
46427,,4gahtmuqcycj,43478,43479,86957
46428,,msjl7aj1kcij,43479,43480,86959
46429,,qfg0jtfuuh0j,43480,43481,86961
46430,,zunuie1rfoyj,43481,43482,86963
46431,,mrwny8pj4oej,43482,43483,86965
46432,,wxopj3n-r34j,43483,43484,86967
46433,,re0feoqyfnyj,43484,43485,86969
46434,,5lyjfarzcmcj,43485,43486,86971
46435,,cranu758rpuj,43486,43487,86973
46436,,x85ideblspij,43487,43488,86975
46437,,wdncokxwmtoj,43488,43489,86977
46438,,rn2z46_1ee8j,43489,43490,86979
46439,,li-bbjopangj,43490,43491,86981
46440,,hw70mxuzv5qj,43491,43492,86983
46441,,url:http://doi.wiley.com/10.1002/ace.166,43492,43493,86985
46442,,,43493,43494,86987
46443,,fvclyk-3kncj,43494,43495,86989
46444,,uamyuocerxaj,43495,43496,86991
46445,,iizrhqb1kiaj,43497,43498,86995
46446,,jcoaac-0kq4j,43499,43500,86999
46447,,jk7re49ycgej,43500,43501,87001
46448,,ppjjhl3yfbqj,43501,43502,87003
46449,,yzqq2jnt7z8j,43502,43503,87005
46450,,aj6_ng_tf-sj,43503,43504,87007
46451,,urhjt83yzfkj,43504,43505,87009
46452,,vaivaf-byt0j,43505,43506,87011
46453,,cenhrvpy-oqj,43506,43507,87013
46454,,b2m1brcm64wj,43507,43508,87015
46455,,hl35hnrg8tmj,43508,43509,87017
46456,,url:http://portal.acm.org/ft_gateway.cfm3fid3d110196626type3dpdf,43509,43510,87019
46457,,,43510,43511,87021
46458,,lwawrndjn_yj,43512,43513,87025
46459,,z33frvozpagj,43513,43514,87027
46460,,nhurmztkyaoj,43514,43515,87029
46461,,qsog9baryvwj,43515,43516,87031
46462,,dxlljacywsuj,43516,43517,87033
46463,,tymoi8ymikaj,43517,43518,87035
46464,,7i3ectriiakj,43518,43519,87037
46465,,yc6oidwti_ij,43519,43520,87039
46466,,a-u7tf9qwi0j,43520,43521,87041
46467,,lqeoxhg6n_4j,43521,43522,87043
46468,,5bgyv4_ycmyj,43522,43523,87045
46469,,n3zbxzvzmzgj,43523,43524,87047
46470,,zkjwthgubb0j,43524,43525,87049
46471,,6bdf7hvltpcj,43525,43526,87051
46472,,yrxobj2fjkgj,43526,43527,87053
46473,,kuxi82ux8qgj,43527,43528,87055
46474,,0xnvez0lhucj,43528,43529,87057
46475,,prpdd-l5t3kj,43529,43530,87059
46476,,url:http://portal.acm.org/citation.cfm3fid3d811526,43530,43531,87061
46477,,ukfx5lycjisj,43531,43532,87063
46478,,cv9tbvjcxoaj,43532,43533,87065
46479,,co2yaai_qp4j,43533,43534,87067
46480,,nlwn1af3iqgj,43534,43535,87069
46481,,9s5480ptummj,43535,43536,87071
46482,,zfaa8lqu8vgj,43536,43537,87073
46483,,wj108-zezxwj,43537,43538,87075
46484,,bcej6ycpbemj,43538,43539,87077
46485,,url:http://adsabs.harvard.edu/abs/1976scom.nasa..330k,43539,43540,87079
46486,,url:http://portal.acm.org/citation.cfm3fid3d592197.59233226coll3dguide26dl3dacm26cfid3d1111111126cftoken3d2222222,43540,43541,87081
46487,,0nz6tihbvm4j,43541,43542,87083
46488,,cbil-b2myjij,43542,43543,87085
46489,,hgzjai4e9hmj,43543,43544,87087
46490,,u6vn0zj9bpij,43545,43546,87091
46491,,kn-50ywuci4j,43546,43547,87093
46492,,o8avrxrvriij,43547,43548,87095
46493,,1wxbs3lkmlgj,43548,43549,87097
46494,,qeayykbsgoaj,43549,43550,87099
46495,,vpfznfea3jyj,43550,43551,87101
46496,,url:http://portal.acm.org/ft_gateway.cfm3fid3d102775326type3dpdf,43551,43552,87103
46497,,2uq_i6g-dvwj,43552,43553,87105
46498,,xiqyyefkxpcj,43553,43554,87107
46499,,etlenxkokg4j,43554,43555,87109
46500,,nbktpambkrqj,43555,43556,87111
46501,,ok6z9uzqioij,43556,43557,87113
46502,,,43557,43558,87115
46503,,g1hrphndk0wj,43558,43559,87117
46504,,n_wwfcsousqj,43559,43560,87119
46505,,bmijxyuig2cj,43560,43561,87121
46506,,9tyddvwtlemj,43561,43562,87123
46507,,ei_fnj_aqygj,43562,43563,87125
46508,,6fljsouanvej,43563,43564,87127
46509,,dugi1uz1sxqj,43564,43565,87129
46510,,g0fcszvegguj,43565,43566,87131
46511,,gt36act_2luj,43566,43567,87133
46512,,od_2-oldmlsj,43567,43568,87135
46513,,wornxp5gehsj,43568,43569,87137
46514,,qc82yagnu-kj,43569,43570,87139
46515,,bq-gz0bq6k0j,43570,43571,87141
46516,,njmls_3efmej,43571,43572,87143
46517,,34qnrkms0y8j,43572,43573,87145
46518,,o2tudkchwxkj,43573,43574,87147
46519,,,43574,43575,87149
46520,,ooc0cep1rxyj,43575,43576,87151
46521,,ixwdu3fz40aj,43576,43577,87153
46522,,47efzypty38j,43577,43578,87155
46523,,mvmjpp8e624j,43578,43579,87157
46524,,url:http://doi.wiley.com/10.1002/he.48,43579,43580,87159
46525,,bddkeag-_m4j,43580,43581,87161
46526,,uxd8p47apuyj,43581,43582,87163
46527,,m0pxhszwuyaj,43582,43583,87165
46528,,ro3ukb3we2uj,43584,43585,87169
46529,,d28abgs8q10j,43585,43586,87171
46530,,frngvwki9tsj,43586,43587,87173
46531,,url:http://www.csa.com/partners/viewrecord.php3frequester3dgs26collection3denv26recid3d1582418,43587,43588,87175
46532,,znwtj39xbluj,43588,43589,87177
46533,,nqiqtc1jfwkj,43589,43590,87179
46534,,5rxkvvw35iuj,43590,43591,87181
46535,,pcijv8ggdncj,43591,43592,87183
46536,,94azqonhgrwj,43592,43593,87185
46537,,yq1npckbseij,43593,43594,87187
46538,,cdzpz9jstmkj,43594,43595,87189
46539,,ohks4vsmj8oj,43595,43596,87191
46540,,0qraeg7yzimj,43596,43597,87193
46541,,-c8qsqecniwj,43597,43598,87195
46542,,mzh4nvhc8e8j,43598,43599,87197
46543,,aichljbyb9qj,43599,43600,87199
46544,,dxpiy6kce1oj,43600,43601,87201
46545,,_pg_ykzkk1kj,43601,43602,87203
46546,,torcz8u0joej,43603,43604,87207
46547,,ugmcyb09r1sj,43604,43605,87209
46548,,,43605,43606,87211
46549,,zdfxmyywreaj,43606,43607,87213
46550,,2hevtemgwryj,43607,43608,87215
46551,,ogvdmd1pcqgj,43608,43609,87217
46552,,i9lvisjhugcj,43609,43610,87219
46553,,bwqidcfhsbsj,43610,43611,87221
46554,,4i8g_vbxdayj,43611,43612,87223
46555,,,43612,43613,87225
46556,,byy_iauvz1qj,43613,43614,87227
46557,,4ltkf3cbaekj,43614,43615,87229
46558,,v7iic1tkafcj,43615,43616,87231
46559,,yupvqudr02sj,43616,43617,87233
46560,,jpx6hlf1gfcj,43617,43618,87235
46561,,258zm2qd28ej,43618,43619,87237
46562,,xtriujd3czsj,43619,43620,87239
46563,,bzzbvp23prqj,43620,43621,87241
46564,,fntfulvrmcij,43621,43622,87243
46565,,qofefhm-0mcj,43622,43623,87245
46566,,url:http://www.csa.com/partners/viewrecord.php3frequester3dgs26collection3dtrd26recid3d155949ws26recid3d199301560034md,43623,43624,87247
46567,,ri-t6ppfitqj,43624,43625,87249
46568,,r3lx4vym248j,43625,43626,87251
46569,,ag-lekr1iv8j,43626,43627,87253
46570,,l3lk9bmokmqj,43627,43628,87255
46571,,5-c3yd8m0maj,43628,43629,87257
46572,,h53mpz86v3uj,43629,43630,87259
46573,,ytgwoct4ktcj,43630,43631,87261
46574,,paqagh2i9loj,43631,43632,87263
46575,,seut0mxqwiyj,43632,43633,87265
46576,,d8ejz-fyfikj,43633,43634,87267
46577,,eh1evkiiws0j,43634,43635,87269
46578,,sobqvzopruej,43635,43636,87271
46579,,g8v9zyaffwuj,43636,43637,87273
46580,,ei55efb9rsoj,43637,43638,87275
46581,,1bjauwdp86aj,43638,43639,87277
46582,,cjzb0e9vmxaj,43639,43640,87279
46583,,6v2gftuwjzoj,43640,43641,87281
46584,,4xukdgl9me8j,43641,43642,87283
46585,,8we6oiomej0j,43642,43643,87285
46586,,ovhbuc1pswyj,43643,43644,87287
46587,,i8gmst_x5smj,43644,43645,87289
46588,,ypkh1t2cgamj,43645,43646,87291
46589,,tvewedainhoj,43646,43647,87293
46590,,tv6yivqbokyj,43647,43648,87295
46591,,zywxg8kt7s4j,43648,43649,87297
46592,,mh5postr45wj,43649,43650,87299
46593,,pfmdhiqkc2wj,43650,43651,87301
46594,,8uccatx5k_mj,43651,43652,87303
46595,,8zk228h0jxaj,43652,43653,87305
46596,,6nglhkysjtqj,43653,43654,87307
46597,,ftnhy7ckvw0j,43654,43655,87309
46598,,wzdgk2thjbqj,43655,43656,87311
46599,,8byt9rgglkkj,43656,43657,87313
46600,,g1hchlpk6w0j,43657,43658,87315
46601,,txhlxl2leykj,43658,43659,87317
46602,,yjmoazc_lrmj,43659,43660,87319
46603,,iknghewleooj,43660,43661,87321
46604,,8tx8sjluv2yj,43661,43662,87323
46605,,m_rkrhc73ywj,43662,43663,87325
46606,,r9wwpx0c4qoj,43663,43664,87327
46607,,zibeb9jb_h0j,43664,43665,87329
46608,,hr5uv0ahc7sj,43665,43666,87331
46609,,duwgehw1wzsj,43666,43667,87333
46610,,hvclhmeopxij,43667,43668,87335
46611,,bihaoaizwowj,43668,43669,87337
46612,,zbb9rz0vxkaj,43669,43670,87339
46613,,aykfdxe44kmj,43670,43671,87341
46614,,fugzpyo_ctgj,43671,43672,87343
46615,,hieob9cupp8j,43672,43673,87345
46616,,fwf1fz2vrvsj,43673,43674,87347
46617,,tkm6q202k2kj,43674,43675,87349
46618,,og2h8civhkuj,43675,43676,87351
46619,,mgc5s499nnoj,43676,43677,87353
46620,,oaokosd-u-uj,43677,43678,87355
46621,,zfhn49gummij,43678,43679,87357
46622,,url:http://adsabs.harvard.edu/abs/1976scom.nasa..660w,43679,43680,87359
46623,,nnxly9teswkj,43680,43681,87361
46624,,oiesxmavp5aj,43681,43682,87363
46625,,xnqgqqqgpb4j,43682,43683,87365
46626,,o8_xtmld_e4j,43683,43684,87367
46627,,wrjrhwa5nxij,43684,43685,87369
46628,,tm0yhdv-0nqj,43685,43686,87371
46629,,5bzlyiwsmfaj,43686,43687,87373
46630,,2gmelrlgziuj,43687,43688,87375
46631,,cr9xo11ct_yj,43688,43689,87377
46632,,url:http://www.ingentaconnect.com/search/expand3fpub3dinfobike://els/09505849/1998/00000039/00000014/art0005926unc3d,43689,43690,87379
46633,,akc7qxu-skmj,43690,43691,87381
46634,,4v5qrv0hyxwj,43691,43692,87383
46635,,txhnq00ndaoj,43692,43693,87385
46636,,lkcjw-rdzjcj,43693,43694,87387
46637,,j49apee1ankj,43694,43695,87389
46638,,pr19dnqxldej,43695,43696,87391
46639,,tl9x9fjep9yj,43696,43697,87393
46640,,gr91oywx_jkj,43697,43698,87395
46641,,0nb47k4ptagj,43698,43699,87397
46642,,kqicjivxvsoj,43699,43700,87399
46643,,1q0zxjfbgvej,43700,43701,87401
46644,,wqsmwunhofij,43701,43702,87403
46645,,ddmkzbjusnij,43702,43703,87405
46646,,cmzcab_qhqmj,43703,43704,87407
46647,,a1ftvesqevsj,43705,43706,87411
46648,,3x9udvzsyluj,43706,43707,87413
46649,,zcjvbg8r1wij,43707,43708,87415
46650,,gmlg_iktrjij,43708,43709,87417
46651,,cmnmd02c-jaj,43709,43710,87419
46652,,hd_6aal4hdwj,43711,43712,87423
46653,,n9geljyl3tkj,43712,43713,87425
46654,,7rjoqs7ok6ij,43713,43714,87427
46655,,hgmxgwi-o98j,43714,43715,87429
46656,,06nhspss_skj,43715,43716,87431
46657,,ob9kpuzddgaj,43716,43717,87433
46658,,jfu6d1iubuuj,43717,43718,87435
46659,,eazgfmlrwsaj,43718,43719,87437
46660,,uublduoqbf0j,43719,43720,87439
46661,,ume4rgx6si4j,43720,43721,87441
46662,,orbby3d1864j,43721,43722,87443
46663,,sf8hkjtrpguj,43722,43723,87445
46664,,o5dkxaulyzij,43723,43724,87447
46665,,url:http://portal.acm.org/ft_gateway.cfm3fid3d110200126type3dpdf,43724,43725,87449
46666,,mrqkhryuoe8j,43725,43726,87451
46667,,url:http://portal.acm.org/ft_gateway.cfm3fid3d16309226type3dpdf26coll3dguide26dl3dacm26cfid3d1111111126cftoken3d2222222,43726,43727,87453
46668,,r2iybmhxbayj,43727,43728,87455
46669,,r3cjsdrp6tqj,43728,43729,87457
46670,,kbnzniycc5sj,43729,43730,87459
46671,,bxqumex7dnoj,43730,43731,87461
46672,,wyngnoqsv1sj,43731,43732,87463
46673,,nxuu3e316jkj,43732,43733,87465
46674,,ns5lggeoncqj,43733,43734,87467
46675,,i6n6ovuwi80j,43734,43735,87469
46676,,url:http://portal.acm.org/citation.cfm3fid3d81150326coll3dportal26dl3dacm,43735,43736,87471
46677,,_chtcmc3fzyj,43736,43737,87473
46678,,ro5wre4va2wj,43737,43738,87475
46679,,ggqjjhfckjaj,43738,43739,87477
46680,,-r7kpxkmx7kj,43739,43740,87479
46681,,poelxavm8tqj,43740,43741,87481
46682,,livn85verl0j,43741,43742,87483
46683,,fxgrfardm8gj,43742,43743,87485
46684,,nyg9sj6cnngj,43743,43744,87487
46685,,gdiqj-iie98j,43744,43745,87489
46686,,2hbllujdsbij,43745,43746,87491
46687,,url:http://www.springerlink.com/index/h8377n7632q17285.pdf,43746,43747,87493
46688,,nis_ru_-oyqj,43747,43748,87495
46689,,lnfuvlerv5wj,43748,43749,87497
46690,,i5kbkbgvqugj,43749,43750,87499
46691,,cchf39npe1mj,43751,43752,87503
46692,,th84duaygi4j,43752,43753,87505
46693,,vhloiofepdqj,43753,43754,87507
46694,,t4iiuxehhwwj,43754,43755,87509
46695,,fbnw4due7ykj,43755,43756,87511
46696,,0s19ty9b89wj,43756,43757,87513
46697,,lkughr_yrd8j,43757,43758,87515
46698,,nj0j4gxeem8j,43758,43759,87517
46699,,njlkm1vuixsj,43759,43760,87519
46700,,2phm9dczp0ej,43760,43761,87521
46701,,inrrc0kijewj,43761,43762,87523
46702,,b9fx05ik9iqj,43762,43763,87525
46703,,url:http://doi.wiley.com/10.1002/(sici)1521-3757(19991004)111:19253c3073::aid-ange3073253e3.0.co3b2-s,43763,43764,87527
46704,,pi6xtjz3b60j,43764,43765,87529
46705,,4vwm8j0af6yj,43765,43766,87531
46706,,8xpiceygc2yj,43766,43767,87533
46707,,eqzde0c0gt8j,43767,43768,87535
46708,,fgtaarx5f9wj,43768,43769,87537
46709,,ui1n9np0cpoj,43769,43770,87539
46710,,3cgrrubstj8j,43770,43771,87541
46711,,x7z4xu6zra4j,43771,43772,87543
46712,,jqfebjic16sj,43772,43773,87545
46713,,ave5al_0howj,43773,43774,87547
46714,,ikgycs2dtw4j,43774,43775,87549
46715,,hnwdalhnvgqj,43775,43776,87551
46716,,ul5o4pdkm1kj,43776,43777,87553
46717,,sbfjdclr9i8j,43777,43778,87555
46718,,v0hqoyamlc4j,43778,43779,87557
46719,,8sop2kzzifyj,43779,43780,87559
46720,,lihncogqiaej,43780,43781,87561
46721,,blu1pjej25mj,43781,43782,87563
46722,,j7coyiiy2igj,43782,43783,87565
46723,,eqoh5krhrsej,43783,43784,87567
46724,,dmoizhy2mrij,43784,43785,87569
46725,,dffbobdfumej,43785,43786,87571
46726,,tb0daaeyctaj,43786,43787,87573
46727,,mrfyy67gvmmj,43787,43788,87575
46728,,upx8w3k7nyqj,43788,43789,87577
46729,,8kg0o00qwbgj,43789,43790,87579
46730,,ufssacqdffej,43790,43791,87581
46731,,e48iomuyhwuj,43792,43793,87585
46732,,zezcwblidbkj,43793,43794,87587
46733,,n0qiaoniovgj,43794,43795,87589
46734,,url:http://portal.acm.org/ft_gateway.cfm3fid3d106630926type3dpdf,43795,43796,87591
46735,,mu7c4zd0ahmj,43796,43797,87593
46736,,qlku7t4urlij,43797,43798,87595
46737,,lfnms-y85eaj,43798,43799,87597
46738,,dqkmctski-mj,43799,43800,87599
46739,,v5snuwxblqwj,43800,43801,87601
46740,,vdjrf_r7soaj,43801,43802,87603
46741,,9p24lzth_w0j,43802,43803,87605
46742,,bkreisz3mcyj,43803,43804,87607
46743,,vpxusgtr9v8j,43804,43805,87609
46744,,c9crhgunbfuj,43805,43806,87611
46745,,axzps0svv7yj,43806,43807,87613
46746,,oalkfb8xqhcj,43807,43808,87615
46747,,sf3moebl5iaj,43808,43809,87617
46748,,jxorxaghlgkj,43809,43810,87619
46749,,0zyqvq2zvi0j,43810,43811,87621
46750,,8hklizykmloj,43811,43812,87623
46751,,sthbaeiozg0j,43812,43813,87625
46752,,hlu97sblfaij,43813,43814,87627
46753,,niagh-yyo6qj,43814,43815,87629
46754,,xzzjyfshwrwj,43815,43816,87631
46755,,phx_wccjhoyj,43816,43817,87633
46756,,kn3iki-8rvkj,43817,43818,87635
46757,,8dnz0fnbsekj,43818,43819,87637
46758,,x2c_pmyvtcoj,43819,43820,87639
46759,,url:http://doi.wiley.com/10.1002/he.11105,43820,43821,87641
46760,,knt-lucs26aj,43821,43822,87643
46761,,rycjjaoss_mj,43822,43823,87645
46762,,1jwm7j_4d8oj,43823,43824,87647
46763,,syozymlwce4j,43824,43825,87649
46764,,cbno_djidv4j,43825,43826,87651
46765,,_83ytupv-naj,43826,43827,87653
46766,,,43827,43828,87655
46767,,oubiayl1628j,43828,43829,87657
46768,,url:http://portal.acm.org/ft_gateway.cfm3fid3d100759726type3dpdf,43829,43830,87659
46769,,tgdjn3bbhiwj,43830,43831,87661
46770,,d0bx5bzh8fuj,43831,43832,87663
46771,,azbgbluk3huj,43832,43833,87665
46772,,t94dl7lgfzcj,43833,43834,87667
46773,,rke_no_9rbcj,43834,43835,87669
46774,,v5kwfsbsfokj,43835,43836,87671
46775,,uvntktxpzduj,43836,43837,87673
46776,,url:http://doi.wiley.com/10.1002/ace.162,43837,43838,87675
46777,,url:http://doi.wiley.com/10.1002/he.171,43838,43839,87677
46778,,qcrjmkjybq8j,43839,43840,87679
46779,,4py0hbl7deaj,43840,43841,87681
46780,,i1cspjv2cfgj,43841,43842,87683
46781,,kpgrtsizfa4j,43842,43843,87685
46782,,lkdlsajskmqj,43843,43844,87687
46783,,btqkt9lgtbqj,43844,43845,87689
46784,,jgcyhqb7piqj,43845,43846,87691
46785,,olmc3gy7qq4j,43846,43847,87693
46786,,unk4y9wquvmj,43847,43848,87695
46787,,uaowmk-jegaj,43848,43849,87697
46788,,_4wgfx6fs9kj,43849,43850,87699
46789,,avz6qonf-xoj,43850,43851,87701
46790,,eo-cxjksucmj,43851,43852,87703
46791,,0nner0quoygj,43852,43853,87705
46792,,url:http://www.springerlink.com/index/t8g147834746l5v2.pdf,43853,43854,87707
46793,,n1d3thjeqjqj,43854,43855,87709
46794,,arincpe3a64j,43855,43856,87711
46795,,url:http://adsabs.harvard.edu/abs/1976injme..57...22j,43856,43857,87713
46796,,,43857,43858,87715
46797,,sur7k7fgb6cj,43858,43859,87717
46798,,uwpqq8fnj4yj,43859,43860,87719
46799,,rtdhg7artmsj,43860,43861,87721
46800,,1cevzr7zjwuj,43861,43862,87723
46801,,gqibl-lfwa8j,43862,43863,87725
46802,,sk66-oo2gu4j,43863,43864,87727
46803,,tndnxzi5e0cj,43864,43865,87729
46804,,fg1ba9qzocqj,43865,43866,87731
46805,,c_wey7zipdyj,43866,43867,87733
46806,,gcwxxfcvl_ij,43867,43868,87735
46807,,9xxjbywoc08j,43868,43869,87737
46808,,pcgpb2uhamgj,43869,43870,87739
46809,,xmykvsl_4m4j,43870,43871,87741
46810,,v0nferfhvmkj,43871,43872,87743
46811,,igyjqlyjrioj,43872,43873,87745
46812,,asr_4in8ivaj,43873,43874,87747
46813,,x-_67dfpcbej,43874,43875,87749
46814,,gz0uad8l3t4j,43875,43876,87751
46815,,ncajnzqvauyj,43876,43877,87753
46816,,pssbm1olqngj,43877,43878,87755
46817,,url:http://adsabs.harvard.edu/abs/1976phdt.........7j,43878,43879,87757
46818,,mfwyuyu7eksj,43879,43880,87759
46819,,zruh9eomav0j,43880,43881,87761
46820,,00wl2rq9jdkj,43881,43882,87763
46821,,gxuda3wrdyuj,43882,43883,87765
46822,,efizbvleoeyj,43883,43884,87767
46823,,lm1cu3oqtoqj,43884,43885,87769
46824,,ke6pbjsgwtuj,43885,43886,87771
46825,,fbylthyetqij,43886,43887,87773
46826,,zizzrdkefbmj,43887,43888,87775
46827,,uget8lzx2eoj,43888,43889,87777
46828,,eqa1v9bclx0j,43889,43890,87779
46829,,bnp6b7uv6bcj,43890,43891,87781
46830,,mnff9ys8zbij,43891,43892,87783
46831,,-6ghcbvlvaij,43892,43893,87785
46832,,x0-l4zuv_b0j,43893,43894,87787
46833,,url:http://portal.acm.org/citation.cfm3fid3d115853,43894,43895,87789
46834,,fl1ixpy2s9oj,43895,43896,87791
46835,,wrcg3c0a1pij,43896,43897,87793
46836,,x3gtvdiu1hqj,43897,43898,87795
46837,,xin4u9outsaj,43898,43899,87797
46838,,qdvtcasdkpsj,43899,43900,87799
46839,,3gf3m5rkq0uj,43900,43901,87801
46840,,9gszhpvf2_cj,43901,43902,87803
46841,,qfmcjj-yxtmj,43902,43903,87805
46842,,gqzgez_egkyj,43903,43904,87807
46843,,iggw3sjqstkj,43904,43905,87809
46844,,3yfxxabbycgj,43905,43906,87811
46845,,u-kd4gq_vcmj,43906,43907,87813
46846,,adr__0crxfsj,43907,43908,87815
46847,,3tucnfz2etkj,43908,43909,87817
46848,,gqx4xnbxvuaj,43909,43910,87819
46849,,bqicwrxm4fyj,43910,43911,87821
46850,,,43911,43912,87823
46851,,kpgzdxavwloj,43912,43913,87825
46852,,apgwr5rnzk4j,43913,43914,87827
46853,,-9muynee4iej,43914,43915,87829
46854,,e5xtmlqfuguj,43915,43916,87831
46855,,ndtqeqpzdamj,43916,43917,87833
46856,,uodzrcm9khcj,43917,43918,87835
46857,,sbke5wvqqcsj,43918,43919,87837
46858,,qkneqnouctsj,43919,43920,87839
46859,,l72i358_vjyj,43920,43921,87841
46860,,j0sb8bv_hgej,43921,43922,87843
46861,,tghgbxvh9d4j,43922,43923,87845
46862,,r8cwmklmuicj,43923,43924,87847
46863,,vf5kfrsb5lyj,43924,43925,87849
46864,,8997uwtvhowj,43925,43926,87851
46865,,e0efdytwlv4j,43926,43927,87853
46866,,8hd-peebzkuj,43927,43928,87855
46867,,jb684f38diwj,43928,43929,87857
46868,,kkmaxbswapwj,43929,43930,87859
46869,,zhwwy43jx78j,43930,43931,87861
46870,,grqiyepkc4ij,43931,43932,87863
46871,,hsweesjh1scj,43932,43933,87865
46872,,nlgqpo0imacj,43933,43934,87867
46873,,cn-ulokeqkkj,43934,43935,87869
46874,,ggwd1kvmob0j,43936,43937,87873
46875,,iwwm4shka5qj,43938,43939,87877
46876,,0-fw4eriukoj,43939,43940,87879
46877,,ds24ayd5f64j,43940,43941,87881
46878,,idyxfmgdhjsj,43941,43942,87883
46879,,url:http://www.csa.com/partners/viewrecord.php3frequester3dgs26collection3dtrd26recid3d2005102518076ci,43942,43943,87885
46880,,eh3cx46i0vkj,43943,43944,87887
46881,,dwm4jppzvhuj,43944,43945,87889
46882,,ns-noprcgz0j,43945,43946,87891
46883,,7yg7az_fw6yj,43946,43947,87893
46884,,afbsv6qqztuj,43947,43948,87895
46885,,ux6wjj1douej,43948,43949,87897
46886,,zdznh1gba7uj,43949,43950,87899
46887,,k0ja_6fubsoj,43950,43951,87901
46888,,6xluacp0r7oj,43951,43952,87903
46889,,l3aajv_hyasj,43952,43953,87905
46890,,p5xda1krhikj,43953,43954,87907
46891,,lklldqchb4qj,43954,43955,87909
46892,,j3omzflrwkkj,43955,43956,87911
46893,,ouquyse4qe4j,43956,43957,87913
46894,,c67volyx1j4j,43957,43958,87915
46895,,yaekzf1y9rmj,43958,43959,87917
46896,,5zg7ad3vl0yj,43959,43960,87919
46897,,p0-26bodaj4j,43960,43961,87921
46898,,url:http://www.springerlink.com/index/h86q0w47m4454483.pdf,43961,43962,87923
46899,,58wktou3rfwj,43962,43963,87925
46900,,url:http://adsabs.harvard.edu/abs/1976scom.nasa..123m,43963,43964,87927
46901,,5-oviwykkg8j,43964,43965,87929
46902,,csdksbvykh8j,43965,43966,87931
46903,,yioqnteikdoj,43966,43967,87933
46904,,xhl_ilyv_lej,43967,43968,87935
46905,,t3xn84kzmikj,43968,43969,87937
46906,,7l2b_zjxt5ej,43969,43970,87939
46907,,dek3umhgblij,43970,43971,87941
46908,,vwxkspecft4j,43971,43972,87943
46909,,ee-5tm_qosaj,43972,43973,87945
46910,,zdwkbksomuqj,43973,43974,87947
46911,,2i9wdndfzm8j,43974,43975,87949
46912,,b7mw8cqyztej,43975,43976,87951
46913,,azhhcpbu-w4j,43976,43977,87953
46914,,r9isulb31vwj,43977,43978,87955
46915,,jaxjdsgryqqj,43978,43979,87957
46916,,tnnbw1nv7jyj,43979,43980,87959
46917,,cxabhnooramj,43980,43981,87961
46918,,hhdencee4i8j,43981,43982,87963
46919,,tbmw94mf7dwj,43982,43983,87965
46920,,j_yfqefsllmj,43983,43984,87967
46921,,vju6w7rpug4j,43984,43985,87969
46922,,b4umtemlit0j,43985,43986,87971
46923,,s-kvsohhyksj,43986,43987,87973
46924,,tgzquzznt7gj,43987,43988,87975
46925,,dzmvbrruwbkj,43988,43989,87977
46926,,erso6glqlroj,43989,43990,87979
46927,,wf-q2tellz4j,43990,43991,87981
46928,,nkmvpobb01oj,43991,43992,87983
46929,,url:http://portal.acm.org/ft_gateway.cfm3fid3d23490026type3dpdf26dl3dguide26dl3dacm26cfid3d1111111126cftoken3d2222222,43992,43993,87985
46930,,v73bwfnylkoj,43993,43994,87987
46931,,rnfsb6foz_aj,43994,43995,87989
46932,,xphxanwmqvkj,43995,43996,87991
46933,,cnkdfzl89t4j,43996,43997,87993
46934,,ir_jslfjg50j,43998,43999,87997
46935,,ymbdbwsuut4j,43999,44000,87999
46936,,,44000,44001,88001
46937,,frd-hprqg7yj,44001,44002,88003
46938,,awyphogvstuj,44002,44003,88005
46939,,i2ykbsyeuoij,44003,44004,88007
46940,,4w7nra8lhhqj,44004,44005,88009
46941,,z0rr3txkkoyj,44005,44006,88011
46942,,foabcwsha7uj,44006,44007,88013
46943,,odcrftcshhqj,44007,44008,88015
46944,,waenoki_royj,44008,44009,88017
46945,,dieg-fmalcaj,44009,44010,88019
46946,,4bvqkvz0ueoj,44010,44011,88021
46947,,whv3pi-k2l0j,44011,44012,88023
46948,,sge7qlocnkij,44012,44013,88025
46949,,oco2gnpdg2aj,44013,44014,88027
46950,,izlryi6x2hcj,44014,44015,88029
46951,,otoi41cqh9uj,44015,44016,88031
46952,,iuimq3j4syij,44016,44017,88033
46953,,_gelyfuesiwj,44017,44018,88035
46954,,oajnycwif8kj,44018,44019,88037
46955,,l7elxbfctfgj,44019,44020,88039
46956,,v-f0wmtzzrsj,44020,44021,88041
46957,,kl9adt6dsjej,44021,44022,88043
46958,,bydypu6ggy4j,44022,44023,88045
46959,,06_ofpqseloj,44023,44024,88047
46960,,vua9f9vscrmj,44024,44025,88049
46961,,url:http://doi.wiley.com/10.1002/ace.124,44025,44026,88051
46962,,t49bbxb5utyj,44026,44027,88053
46963,,gnej-5to_jaj,44027,44028,88055
46964,,hqucdldusooj,44028,44029,88057
46965,,sg63evucru4j,44029,44030,88059
46966,,vqbfg3mom90j,44030,44031,88061
46967,,htk0lonlcdcj,44031,44032,88063
46968,,pu4xsny9kxoj,44032,44033,88065
46969,,8-aexb_vmiij,44033,44034,88067
46970,,url:http://www.csa.com/partners/viewrecord.php3frequester3dgs26collection3dtrd26recid3dn9210471ah,44034,44035,88069
46971,,4gp77kxhdq4j,44035,44036,88071
46972,,68cpd7tnz3yj,44036,44037,88073
46973,,rm-wxykpybkj,44037,44038,88075
46974,,cfjfemrwohij,44038,44039,88077
46975,,ern0bartj_0j,44039,44040,88079
46976,,oo0m1224eqwj,44040,44041,88081
46977,,zdhhec0wnekj,44041,44042,88083
46978,,0zj4najfchyj,44042,44043,88085
46979,,do-sthbkqroj,44043,44044,88087
46980,,auigq87bhg4j,44044,44045,88089
46981,,dqpmv0_pwwaj,44045,44046,88091
46982,,mdfobxsog4oj,44046,44047,88093
46983,,ruf-ih_gotij,44047,44048,88095
46984,,q1hq5nazzykj,44048,44049,88097
46985,,isfafiwel7ij,44049,44050,88099
46986,,jyex0yvmp5oj,44050,44051,88101
46987,,uh20w_blwh8j,44051,44052,88103
46988,,wogyt-mlycyj,44052,44053,88105
46989,,p3wtaa-1nmyj,44053,44054,88107
46990,,knumddoikhij,44054,44055,88109
46991,,gfjqf_tilkcj,44055,44056,88111
46992,,cy5qcobgr4sj,44056,44057,88113
46993,,25hpzxmpcl4j,44057,44058,88115
46994,,68iougvdu48j,44058,44059,88117
46995,,fh-1y6fftlyj,44059,44060,88119
46996,,c67obwrh3ygj,44061,44062,88123
46997,,ogpelsndnd8j,44062,44063,88125
46998,,r0dpao1ezm4j,44063,44064,88127
46999,,runhnyf8ttej,44064,44065,88129
47000,,71p7h18yc40j,44065,44066,88131
47001,,olilxscij8yj,44066,44067,88133
47002,,ng8cp2m8euqj,44067,44068,88135
47003,,k-cwor2aydkj,44068,44069,88137
47004,,xa5jtvi9vfuj,44069,44070,88139
47005,,wclgbk_g6boj,44070,44071,88141
47006,,ci04dpi4wvyj,44071,44072,88143
47007,,ducg-9d1gcqj,44072,44073,88145
47008,,ytlyfivig0yj,44073,44074,88147
47009,,zr8impirryaj,44074,44075,88149
47010,,jyx5zwiw18gj,44075,44076,88151
47011,,artoyk9ewxmj,44076,44077,88153
47012,,igdk8s0x7sej,44077,44078,88155
47013,,enw6z1vv07uj,44078,44079,88157
47014,,,44079,44080,88159
47015,,gf8udv2my3cj,44080,44081,88161
47016,,klnl6ipid9cj,44081,44082,88163
47017,,h1k1knyftnmj,44082,44083,88165
47018,,q_ln1q0zvgij,44083,44084,88167
47019,,6bjgqz3wisij,44085,44086,88171
47020,,bksockmyv2mj,44086,44087,88173
47021,,4_vplyotiukj,44087,44088,88175
47022,,bdmijavfoc8j,44088,44089,88177
47023,,bxd9rgg42sij,44089,44090,88179
47024,,eacx8jgpuvgj,44090,44091,88181
47025,,48psuesh70wj,44091,44092,88183
47026,,ywvatfgpyzsj,44092,44093,88185
47027,,url:http://portal.acm.org/ft_gateway.cfm3fid3d109962026type3dpdf,44093,44094,88187
47028,,xhnyrvj7v60j,44094,44095,88189
47029,,3anotvjjjbgj,44095,44096,88191
47030,,d0yshlwen7aj,44096,44097,88193
47031,,4zd9m-3xan8j,44097,44098,88195
47032,,flffliarbcoj,44098,44099,88197
47033,,lpwumxtx9yyj,44099,44100,88199
47034,,pr8xaxdbx-8j,44100,44101,88201
47035,,3y5qswf9h1kj,44101,44102,88203
47036,,tkcyxzacwh4j,44102,44103,88205
47037,,i9_kxoqg8cgj,44103,44104,88207
47038,,7_s_pkop9vkj,44104,44105,88209
47039,,ekae1eifiwyj,44105,44106,88211
47040,,k45hbyj35awj,44106,44107,88213
47041,,ue1eeuemzzcj,44107,44108,88215
47042,,fr-pi1l4tvmj,44108,44109,88217
47043,,yi7wtkvocj4j,44109,44110,88219
47044,,hlfvyzgeohkj,44110,44111,88221
47045,,zj-wixarafwj,44111,44112,88223
47046,,lubnrpjzrtaj,44112,44113,88225
47047,,n9nhi5y3k38j,44113,44114,88227
47048,,13ytd5hgpf0j,44114,44115,88229
47049,,l5db_r6wotaj,44115,44116,88231
47050,,ium2ipldsxej,44116,44117,88233
47051,,cs1eoynqiakj,44117,44118,88235
47052,,dtdvvyn332sj,44118,44119,88237
47053,,x3jpfeh_f5uj,44119,44120,88239
47054,,p5wil9rnykuj,44120,44121,88241
47055,,k00nz_9kt74j,44121,44122,88243
47056,,mltdvfs1r4kj,44122,44123,88245
47057,,yit10natvj8j,44123,44124,88247
47058,,,44124,44125,88249
47059,,or_rh1ldswej,44125,44126,88251
47060,,um3ppxhrttwj,44126,44127,88253
47061,,fxmidaln48aj,44127,44128,88255
47062,,pgbvrdee5q4j,44128,44129,88257
47063,,zir-jeneqaoj,44129,44130,88259
47064,,1i1vnehn4jyj,44130,44131,88261
47065,,jqvxwsc6vhyj,44131,44132,88263
47066,,fm-bcby1gjqj,44132,44133,88265
47067,,lyleocktvdoj,44133,44134,88267
47068,,1ghrnz4sq58j,44134,44135,88269
47069,,jxewhy5ie0wj,44136,44137,88273
47070,,qh_7s7gya40j,44137,44138,88275
47071,,mtcxihad_huj,44138,44139,88277
47072,,84d7uur2r1mj,44139,44140,88279
47073,,4h_j_f-rnn0j,44140,44141,88281
47074,,gvxv14c8jsaj,44141,44142,88283
47075,,url:http://doi.wiley.com/10.1002/tl.114,44142,44143,88285
47076,,kyljrsg0rsyj,44143,44144,88287
47077,,baym-fklrbqj,44144,44145,88289
47078,,eda9jqwstmoj,44145,44146,88291
47079,,url:http://portal.acm.org/ft_gateway.cfm3fid3d5171126type3dpdf,44146,44147,88293
47080,,whlq97xclj8j,44147,44148,88295
47081,,lujhnyrdvcaj,44148,44149,88297
47082,,rnjyqzrm5p4j,44149,44150,88299
47083,,eitxkmazbb4j,44150,44151,88301
47084,,bgnbztia474j,44151,44152,88303
47085,,kmerbl8k_wej,44153,44154,88307
47086,,url:http://links.jstor.org/sici3fsici3d0146-4949(196324)4253a1253c41253ajds2522so253e2.0.co253b2-n,44154,44155,88309
47087,,n3hyyb1qw8sj,44155,44156,88311
47088,,sox_wvgvv6oj,44156,44157,88313
47089,,5wjeyzlzppuj,44157,44158,88315
47090,,gccbx9tkmpcj,44158,44159,88317
47091,,06_hajrogfqj,44159,44160,88319
47092,,s0jokxiouiaj,44160,44161,88321
47093,,901cvvz72loj,44161,44162,88323
47094,,cd1no8h0yjej,44162,44163,88325
47095,,lly00uoluvyj,44163,44164,88327
47096,,17ev5efprmej,44164,44165,88329
47097,,px2cykwlli8j,44165,44166,88331
47098,,4zbtm3do-quj,44166,44167,88333
47099,,blkiv3yhc_ij,44167,44168,88335
47100,,cjiruxrk-x0j,44168,44169,88337
47101,,ljh0gtwat9ij,44169,44170,88339
47102,,2iwuvghagiej,44170,44171,88341
47103,,_8vu10wsirkj,44171,44172,88343
47104,,xmq-hlr_wwkj,44172,44173,88345
47105,,wewu-yw8kx0j,44173,44174,88347
47106,,k-v4bwrmenij,44174,44175,88349
47107,,9-bscnqvrlkj,44175,44176,88351
47108,,ftphjdcukbyj,44176,44177,88353
47109,,xav4-jmufvsj,44177,44178,88355
47110,,a54w6qhndpuj,44178,44179,88357
47111,,w72xfqgoncmj,44179,44180,88359
47112,,neoa2iur-zmj,44180,44181,88361
47113,,4rpugcwvpkmj,44181,44182,88363
47114,,o3anddszjqmj,44182,44183,88365
47115,,url:http://www.springerlink.com/index/n144055406516232.pdf,44183,44184,88367
47116,,5thssxsurhuj,44184,44185,88369
47117,,ahrekqzbui8j,44185,44186,88371
47118,,x6uytwrmg7yj,44186,44187,88373
47119,,3xxxztua9oqj,44187,44188,88375
47120,,oubw1zrbgdwj,44188,44189,88377
47121,,wfxmyflmtbyj,44189,44190,88379
47122,,gmo3af7uzyij,44190,44191,88381
47123,,ztto31vebtoj,44191,44192,88383
47124,,p-fmx-xknxaj,44192,44193,88385
47125,,zif21jvcin0j,44194,44195,88389
47126,,movx47-acw4j,44195,44196,88391
47127,,gqwf8bydvlyj,44196,44197,88393
47128,,undjtdwxgw0j,44197,44198,88395
47129,,qy6wfttkmisj,44198,44199,88397
47130,,ruodxckg0cij,44199,44200,88399
47131,,sln0dgsxhxmj,44200,44201,88401
47132,,xhlq9uz0w-qj,44201,44202,88403
47133,,074azvlnvoej,44202,44203,88405
47134,,rigrp0ljnsaj,44203,44204,88407
47135,,iok183kig-cj,44204,44205,88409
47136,,llyrtjdej5cj,44205,44206,88411
47137,,tmgrkbep9woj,44206,44207,88413
47138,,cm66c3yytdgj,44207,44208,88415
47139,,pqahpmiqywqj,44208,44209,88417
47140,,vpze4nld6iej,44209,44210,88419
47141,,wzhyqm5t7dyj,44210,44211,88421
47142,,o9wbg4ufccwj,44211,44212,88423
47143,,umokdx7qkhaj,44212,44213,88425
47144,,tdixa7f585wj,44213,44214,88427
47145,,hhy1thogxd0j,44214,44215,88429
47146,,mkehgmbfh5uj,44215,44216,88431
47147,,ggmpsm6in9wj,44216,44217,88433
47148,,url:http://doi.wiley.com/10.1002/(sici)1521-3773(19980216)37:3253c342::aid-anie342253e3.3.co253b2-g,44218,44219,88437
47149,,lxniil-qahgj,44219,44220,88439
47150,,gy-jt5blkfmj,44220,44221,88441
47151,,4h5a_xpegumj,44221,44222,88443
47152,,gcxnaba239aj,44222,44223,88445
47153,,zqnirojrzssj,44223,44224,88447
47154,,eocada6c-vcj,44224,44225,88449
47155,,_kpytrzdfh8j,44225,44226,88451
47156,,hmgzqxqqou4j,44226,44227,88453
47157,,jz3xky2xbmyj,44227,44228,88455
47158,,lcatqt-itomj,44228,44229,88457
47159,,qa2znuo0zecj,44229,44230,88459
47160,,9a9g4cir-_kj,44230,44231,88461
47161,,vwmz0yoom1qj,44231,44232,88463
47162,,hzlmq9njj5mj,44232,44233,88465
47163,,8bw3o1tjrc0j,44233,44234,88467
47164,,jj3lc7woiauj,44234,44235,88469
47165,,2f99_9w6qpkj,44235,44236,88471
47166,,l4dnnmjed24j,44236,44237,88473
47167,,mizwoghw12mj,44237,44238,88475
47168,,kqzb8le7bpqj,44238,44239,88477
47169,,qqvakggvvwgj,44240,44241,88481
47170,,tsy_hxp5xfkj,44241,44242,88483
47171,,fxmlwzomnscj,44242,44243,88485
47172,,5foena5t7mcj,44243,44244,88487
47173,,dpyubamk1guj,44244,44245,88489
47174,,qewgbi1fzcaj,44245,44246,88491
47175,,as5tajejv10j,44246,44247,88493
47176,,8appn1kij3sj,44247,44248,88495
47177,,mmlh9sqnrzsj,44248,44249,88497
47178,,wvnsp5ocggkj,44249,44250,88499
47179,,222lhcblkwgj,44250,44251,88501
47180,,ey2obzvbgdij,44251,44252,88503
47181,,nv3rdci4jroj,44252,44253,88505
47182,,6_8j6snssnaj,44253,44254,88507
47183,,ugmjxmphqaoj,44254,44255,88509
47184,,yourgcj56aoj,44255,44256,88511
47185,,url:http://doi.wiley.com/10.1002/dc.20284,44256,44257,88513
47186,,xv2-mdock2sj,44257,44258,88515
47187,,url:http://portal.acm.org/citation.cfm3fid3d30829.30832,44258,44259,88517
47188,,lavrfj-yjngj,44259,44260,88519
47189,,j1ww1yznpaaj,44261,44262,88523
47190,,tiyq08trsmej,44262,44263,88525
47191,,l6xd_otibz4j,44263,44264,88527
47192,,url:http://www.ingentaconnect.com/content/els/13891286/1999/00000031/00000017/art00059,44264,44265,88529
47193,,url:http://portal.acm.org/ft_gateway.cfm3fid3d102774426type3dpdf,44265,44266,88531
47194,,rxhueh4hs3cj,44266,44267,88533
47195,,1bbjnx0qrokj,44267,44268,88535
47196,,yg_ufh-dygmj,44268,44269,88537
47197,,ufhvinfhx48j,44269,44270,88539
47198,,s8ztjirpq2ij,44270,44271,88541
47199,,p2hrc4rbqysj,44272,44273,88545
47200,,ewx9c7z1dggj,44273,44274,88547
47201,,nq3dksomgjyj,44275,44276,88551
47202,,xuo_jshzqiuj,44276,44277,88553
47203,,sadmowd0bqgj,44277,44278,88555
47204,,7ol849doxlyj,44278,44279,88557
47205,,ey98j1npreyj,44279,44280,88559
47206,,w8_eugmncyaj,44280,44281,88561
47207,,zb_8gxdpomyj,44281,44282,88563
47208,,sukf85cfrt0j,44282,44283,88565
47209,,5j51gd5zgzgj,44283,44284,88567
47210,,tr0mxrkkuvwj,44284,44285,88569
47211,,ofqkbxvclwgj,44285,44286,88571
47212,,hduqzfowxaoj,44286,44287,88573
47213,,6cjcvotcufqj,44287,44288,88575
47214,,p13ci7hl2pej,44288,44289,88577
47215,,url:http://www.geography.org.uk/journals/journals.asp3farticleid3d58,44289,44290,88579
47216,,_tgs8xj6ofkj,44290,44291,88581
47217,,qwrbwa7b57mj,44291,44292,88583
47218,,zvndr3_dcxoj,44292,44293,88585
47219,,ibqlhsji3luj,44293,44294,88587
47220,,6v10yi_pp4mj,44294,44295,88589
47221,,5j9jfkcus9wj,44295,44296,88591
47222,,_9mtg4fykxwj,44296,44297,88593
47223,,lbthhw1_tb8j,44297,44298,88595
47224,,jchwrhqhlnyj,44298,44299,88597
47225,,m4bnsioopbkj,44299,44300,88599
47226,,chf_wijadhej,44300,44301,88601
47227,,url:http://adsabs.harvard.edu/abs/1976infph..16..325b,44301,44302,88603
47228,,crpqzosmzjsj,44302,44303,88605
47229,,url:http://www.springerlink.com/index/w37131l27625701x.pdf,44303,44304,88607
47230,,19fagkbplpij,44304,44305,88609
47231,,,44305,44306,88611
47232,,imx6nl2gh54j,44306,44307,88613
47233,,eeg7wqaqdqaj,44307,44308,88615
47234,,gqjpvjeqseqj,44308,44309,88617
47235,,m8esexf_oxwj,44309,44310,88619
47236,,yldqhhxdfocj,44310,44311,88621
47237,,ptpzonvx55aj,44311,44312,88623
47238,,scryiw7vu6aj,44312,44313,88625
47239,,xwkj9zsnepij,44313,44314,88627
47240,,9gztxr__oayj,44314,44315,88629
47241,,_jl1itarwtoj,44316,44317,88633
47242,,27oprkqyinqj,44317,44318,88635
47243,,qbs4b0nef08j,44318,44319,88637
47244,,vrzddcyp2qwj,44319,44320,88639
47245,,3nasgifxxfaj,44320,44321,88641
47246,,url:http://www.csa.com/partners/viewrecord.php3frequester3dgs26collection3dtrd26recid3d20021211001538mt26recid3da8622975ah,44321,44322,88643
47247,,2fqc5aavoecj,44322,44323,88645
47248,,h4k1wsszkgqj,44324,44325,88649
47249,,syohqrzqeeyj,44325,44326,88651
47250,,dcvzgpls1vyj,44326,44327,88653
47251,,vhqhy11csbij,44327,44328,88655
47252,,x7nxgdlcu8mj,44328,44329,88657
47253,,6h4lpfdkijgj,44330,44331,88661
47254,,oi7ezvqbukaj,44332,44333,88665
47255,,t34uicnsqpej,44333,44334,88667
47256,,5m7d1bzugjgj,44334,44335,88669
47257,,k8sizavb9f4j,44335,44336,88671
47258,,5vbabklzv-ij,44336,44337,88673
47259,,url:http://doi.wiley.com/10.1002/ace.60,44337,44338,88675
47260,,sbiwa_0edzyj,44338,44339,88677
47261,,jky71n8guu4j,44339,44340,88679
47262,,xlu1ff3hxjmj,44340,44341,88681
47263,,05bm66grqi0j,44341,44342,88683
47264,,apmbbl8smv0j,44342,44343,88685
47265,,k4kikh8wfhmj,44343,44344,88687
47266,,_ooabbil240j,44344,44345,88689
47267,,wxx70nd7j4kj,44345,44346,88691
47268,,cg2y5stquqkj,44346,44347,88693
47269,,hvdrh3iypvgj,44347,44348,88695
47270,,_3k31p-z-2gj,44348,44349,88697
47271,,tqggn-gnat4j,44349,44350,88699
47272,,pmcq3tvyuymj,44350,44351,88701
47273,,qqqzcvu1wusj,44351,44352,88703
47274,,rly5agdp_qwj,44353,44354,88707
47275,,v-wvgitiig8j,44354,44355,88709
47276,,zk4zmuaq6rij,44355,44356,88711
47277,,jj4btq2nthoj,44356,44357,88713
47278,,url:http://adsabs.harvard.edu/abs/1976phdt........56w,44357,44358,88715
47279,,kzvf30tptxuj,44358,44359,88717
47280,,2lf4pt1fps0j,44359,44360,88719
47281,,b9g9u1fkxpuj,44360,44361,88721
47282,,url:http://portal.acm.org/citation.cfm3fid3d109080.109087,44361,44362,88723
47283,,n43hcfodxpij,44362,44363,88725
47284,,upsyqb7hgcaj,44363,44364,88727
47285,,ntfurf911zkj,44364,44365,88729
47286,,ftsi-9e9i30j,44365,44366,88731
47287,,vq4ssq3rfdgj,44366,44367,88733
47288,,ehxygrygph0j,44367,44368,88735
47289,,url:http://www.csa.com/partners/viewrecord.php3frequester3dgs26collection3denv26recid3d8913233,44368,44369,88737
47290,,roh7efym6buj,44369,44370,88739
47291,,pzslvnv6e9ij,44371,44372,88743
47292,,53vwomlsquoj,44372,44373,88745
47293,,tph_tienjvsj,44373,44374,88747
47294,,n89rfbc8g-yj,44374,44375,88749
47295,,ussvtrcprraj,44375,44376,88751
47296,,n8_entwbhhqj,44376,44377,88753
47297,,piystbcak7wj,44377,44378,88755
47298,,yly0wnf0jxgj,44378,44379,88757
47299,,hbn2bn4-xs0j,44379,44380,88759
47300,,cuthniidyb4j,44380,44381,88761
47301,,url:http://portal.acm.org/ft_gateway.cfm3fid3d35322926type3dpdf26dl3dportal26dl3dacm26cfid3d1111111126cftoken3d2222222,44381,44382,88763
47302,,9fuehqfibjsj,44382,44383,88765
47303,,kbtfhy_v6-kj,44383,44384,88767
47304,,dpw2dlds_xcj,44384,44385,88769
47305,,e8rshctp9fuj,44385,44386,88771
47306,,8hpwpo11w0aj,44386,44387,88773
47307,,lhvmmrbkrboj,44387,44388,88775
47308,,vl0ugt_ceymj,44388,44389,88777
47309,,qddgsttepfaj,44389,44390,88779
47310,,url:http://ieeexplore.ieee.org/iel5/69/28287/01264816.pdf3farnumber3d1264816,44390,44391,88781
47311,,url:http://www.csa.com/partners/viewrecord.php3frequester3dgs26collection3dtrd26recid3dn9210534ah,44391,44392,88783
47312,,wjrpqvhgkjaj,44392,44393,88785
47313,,onzftmwl5ikj,44393,44394,88787
47314,,yf3ipayl5ikj,44394,44395,88789
47315,,ocjostjec7wj,44395,44396,88791
47316,,i19jllyxajaj,44396,44397,88793
47317,,7c5g0tl1lo0j,44397,44398,88795
47318,,mv1b2tngrdmj,44398,44399,88797
47319,,xhcijje2iraj,44399,44400,88799
47320,,lfqer8rmzscj,44400,44401,88801
47321,,d-xe0chn9guj,44401,44402,88803
47322,,akksfi0qgnyj,44402,44403,88805
47323,,_qzrkv5itxej,44403,44404,88807
47324,,gueae8fajc0j,44404,44405,88809
47325,,url:http://doi.wiley.com/10.1002/he.14.abs,44405,44406,88811
47326,,xoau8dnc8fqj,44406,44407,88813
47327,,8uvj31n-qasj,44407,44408,88815
47328,,aj8m6vtmqyoj,44408,44409,88817
47329,,bnjziudvts4j,44409,44410,88819
47330,,41fl8g2hq9cj,44410,44411,88821
47331,,ycccnzvdafsj,44411,44412,88823
47332,,6d0o8fs8hw8j,44412,44413,88825
47333,,fg4f0f4diogj,44413,44414,88827
47334,,pqxaakingi0j,44414,44415,88829
47335,,luqgfyntgbkj,44415,44416,88831
47336,,xlxbvk3_hvgj,44416,44417,88833
47337,,u2hzstm1x0ej,44417,44418,88835
47338,,z3c9lpgeh0ij,44418,44419,88837
47339,,url:http://www.csa.com/partners/viewrecord.php3frequester3dgs26collection3dtrd26recid3d0646806ci,44419,44420,88839
47340,,bn6izcoblsmj,44420,44421,88841
47341,,ihvcyadz62ej,44421,44422,88843
47342,,q7mrcvhfsfej,44422,44423,88845
47343,,kgfcn_uboqsj,44423,44424,88847
47344,,gjfn3ewu_gmj,44424,44425,88849
47345,,lqyx36gzfscj,44425,44426,88851
47346,,_pjihsbampoj,44426,44427,88853
47347,,en1zta3dp7mj,44427,44428,88855
47348,,ptvugh5pdocj,44428,44429,88857
47349,,dxgjeannma4j,44429,44430,88859
47350,,jhrqvzrbk2sj,44430,44431,88861
47351,,cd_65sjkamsj,44431,44432,88863
47352,,rv7hkrblvd4j,44432,44433,88865
47353,,jw2yzlbhim0j,44433,44434,88867
47354,,0wejlzq2vusj,44434,44435,88869
47355,,hobm5kogujmj,44435,44436,88871
47356,,tka8-hqvxeuj,44436,44437,88873
47357,,ttdfwncrlswj,44437,44438,88875
47358,,vyi7rwliveyj,44438,44439,88877
47359,,w_u08skdsawj,44439,44440,88879
47360,,fysikdchszgj,44440,44441,88881
47361,,my18hnafggwj,44441,44442,88883
47362,,nsmuz5dbpquj,44442,44443,88885
47363,,wgmssb5a-xyj,44443,44444,88887
47364,,twc_rmzodxyj,44444,44445,88889
47365,,68kgfvbxccej,44445,44446,88891
47366,,yq9jx4u-9hgj,44446,44447,88893
47367,,up8960y354sj,44447,44448,88895
47368,,vjfgy4-j9ocj,44448,44449,88897
47369,,bcqienbu4y4j,44449,44450,88899
47370,,jkj8vr2g5woj,44450,44451,88901
47371,,wry2eguqcqqj,44451,44452,88903
47372,,v4-s6uku944j,44452,44453,88905
47373,,jsrkqacgfiuj,44453,44454,88907
47374,,yq476hpupgkj,44454,44455,88909
47375,,zhabaj3vfhoj,44455,44456,88911
47376,,zmddxfv0pgij,44456,44457,88913
47377,,dwiowxolk1mj,44457,44458,88915
47378,,url:http://www.csa.com/partners/viewrecord.php3frequester3dgs26collection3dtrd26recid3da8622941ah,44458,44459,88917
47379,,msoth7u9vnkj,44459,44460,88919
47380,,lgpqwbyprduj,44460,44461,88921
47381,,jywy5fypqwgj,44461,44462,88923
47382,,url:http://adsabs.harvard.edu/abs/1977aero.reptt....v,44462,44463,88925
47383,,viaglgrkhgej,44463,44464,88927
47384,,v4rjmxprfl8j,44464,44465,88929
47385,,mfhdv09mfg8j,44465,44466,88931
47386,,r2pbumkxxhij,44466,44467,88933
47387,,62kur8qztwqj,44467,44468,88935
47388,,v-x-who2suwj,44468,44469,88937
47389,,0joqs5c8qqmj,44469,44470,88939
47390,,vlgdeya2bj4j,44470,44471,88941
47391,,l2wo5nfujhsj,44471,44472,88943
47392,,uu-wazgwzjgj,44472,44473,88945
47393,,7on369j8ecuj,44473,44474,88947
47394,,6ejylv5sgdsj,44474,44475,88949
47395,,s1hfkakuffaj,44475,44476,88951
47396,,,44476,44477,88953
47397,,qrnzq8mgatej,44477,44478,88955
47398,,pmgucsck3gyj,44478,44479,88957
47399,,qxoabrli95oj,44479,44480,88959
47400,,itr3qvmseqaj,44480,44481,88961
47401,,k5bm2xmmjbkj,44481,44482,88963
47402,,nayftenowgwj,44482,44483,88965
47403,,xncyxpau99mj,44483,44484,88967
47404,,dskq1z8gubwj,44484,44485,88969
47405,,9eovk2e2guij,44485,44486,88971
47406,,2fm_jpzcktoj,44486,44487,88973
47407,,rvdhn89zgqij,44487,44488,88975
47408,,qvzylnwrnfwj,44488,44489,88977
47409,,lcmaogudo_yj,44489,44490,88979
47410,,,44490,44491,88981
47411,,jyhmcjjvuocj,44491,44492,88983
47412,,nydymwwixu4j,44492,44493,88985
47413,,jx7oitkl6eej,44493,44494,88987
47414,,6dqkji_do3sj,44494,44495,88989
47415,,gxkstfitxdej,44495,44496,88991
47416,,tz77uxauqjqj,44496,44497,88993
47417,,ja0xnibdhp4j,44497,44498,88995
47418,,5u6_gnirqauj,44498,44499,88997
47419,,url:http://portal.acm.org/ft_gateway.cfm3fid3d24590726type3dpdf26coll3dguide26dl3dacm26cfid3d1111111126cftoken3d2222222,44499,44500,88999
47420,,x7m6wbx2cwej,44500,44501,89001
47421,,uqqtir7pcvoj,44501,44502,89003
47422,,k36jn8ozqwaj,44502,44503,89005
47423,,url:http://portal.acm.org/ft_gateway.cfm3fid3d110132826type3dpdf,44503,44504,89007
47424,,_oxod0vaqkaj,44504,44505,89009
47425,,as_cgh1vxn4j,44505,44506,89011
47426,,h5ttajqzj8ej,44506,44507,89013
47427,,lzsghxzoloyj,44507,44508,89015
47428,,920f4od6-ayj,44508,44509,89017
47429,,0unmxt3hk10j,44509,44510,89019
47430,,fsksngpsbhyj,44510,44511,89021
47431,,h8lks4jvcfsj,44511,44512,89023
47432,,psbjv2ks28uj,44512,44513,89025
47433,,ae1ktc8gssoj,44513,44514,89027
47434,,chesiuoihfaj,44514,44515,89029
47435,,vqf4vkciof0j,44515,44516,89031
47436,,r6snqmysgcaj,44516,44517,89033
47437,,zykzkjstqg4j,44517,44518,89035
47438,,url:http://www.csa.com/partners/viewrecord.php3frequester3dgs26collection3dtrd26recid3dn9210451ah,44518,44519,89037
47439,,xtcc5gjw_0yj,44519,44520,89039
47440,,1v8tvvqg3owj,44520,44521,89041
47441,,t7ckx4rasm0j,44521,44522,89043
47442,,xhoz700ay7sj,44522,44523,89045
47443,,o2vqik6qelyj,44523,44524,89047
47444,,vah6oceanzoj,44524,44525,89049
47445,,noagfwslgyuj,44525,44526,89051
47446,,cmok3yn6wd8j,44526,44527,89053
47447,,aqhq2xqvbxgj,44527,44528,89055
47448,,pxeryzhzvc8j,44528,44529,89057
47449,,lpcb7paljxgj,44529,44530,89059
47450,,fiap1ourk58j,44530,44531,89061
47451,,ukqpxhgf8wij,44531,44532,89063
47452,,url:http://portal.acm.org/citation.cfm3fid3d592202.592473,44532,44533,89065
47453,,uhw68nnyyegj,44533,44534,89067
47454,,gfk6etireo4j,44534,44535,89069
47455,,04vtvaetifcj,44535,44536,89071
47456,,t6tl4ywmf4uj,44536,44537,89073
47457,,ewdjciv1enwj,44537,44538,89075
47458,,ks58st_fukaj,44538,44539,89077
47459,,url:http://pubs.acs.org/cgi-bin/abstract.cgi/achre4/2002/35/i06/abs/ar010014p.html,44539,44540,89079
47460,,t3kvgj19lxej,44540,44541,89081
47461,,7l3gzxmiifej,44542,44543,89085
47462,,9ht_u3udbd0j,44543,44544,89087
47463,,url:http://portal.acm.org/ft_gateway.cfm3fid3d110128026type3dpdf,44544,44545,89089
47464,,7-dzvu48oy4j,44547,44548,89095
47465,,wca1l5srkj4j,44548,44549,89097
47466,,uwt8tazx5a0j,44549,44550,89099
47467,,1kqmqqppbwij,44550,44551,89101
47468,,zzzj0jtnp4ij,44551,44552,89103
47469,,47qsdahvvwij,44552,44553,89105
47470,,df_av80vas8j,44553,44554,89107
47471,,z2exkwlq_caj,44554,44555,89109
47472,,qvjyko8yy9uj,44555,44556,89111
47473,,avvliwla_eaj,44556,44557,89113
47474,,n7h258lz0ycj,44557,44558,89115
47475,,uff5eucl7qsj,44558,44559,89117
47476,,lbdwwpu0vyaj,44559,44560,89119
47477,,c7qmgi0ftiuj,44560,44561,89121
47478,,zsgfws7xqo8j,44561,44562,89123
47479,,ttsvc4qyagmj,44562,44563,89125
47480,,nedehvvotrij,44563,44564,89127
47481,,joesyipwzzij,44564,44565,89129
47482,,pzleod6rpyuj,44565,44566,89131
47483,,xz5_5em-0jyj,44566,44567,89133
47484,,wy7fy9g-xk8j,44567,44568,89135
47485,,5utcpolhbxej,44568,44569,89137
47486,,7aibozn96hwj,44569,44570,89139
47487,,3dbnl8ysmwyj,44570,44571,89141
47488,,zpejfnpnsvgj,44571,44572,89143
47489,,n66_hckcxgij,44572,44573,89145
47490,,9issempeexqj,44573,44574,89147
47491,,herzmxxc6uqj,44574,44575,89149
47492,,oxqcgippavsj,44575,44576,89151
47493,,r5r1wuaxj3gj,44576,44577,89153
47494,,4q0egnf-xngj,44577,44578,89155
47495,,s8lwjqs9ltwj,44578,44579,89157
47496,,pc_wap2_zukj,44579,44580,89159
47497,,usfftc23jvej,44580,44581,89161
47498,,yqubucm73gej,44581,44582,89163
47499,,pr4osuhlf5aj,44582,44583,89165
47500,,wd8slak6elyj,44583,44584,89167
47501,,rw5hpzndgd0j,44584,44585,89169
47502,,z8e69ebbesoj,44585,44586,89171
47503,,url:http://doi.wiley.com/10.1002/he.64,44586,44587,89173
47504,,zdxen0litiwj,44587,44588,89175
47505,,bz7ky92fhmqj,44588,44589,89177
47506,,2gxogujmaauj,44589,44590,89179
47507,,ctsqkfnoqbij,44590,44591,89181
47508,,timv2inv7icj,44591,44592,89183
47509,,jgcmifrz3fyj,44592,44593,89185
47510,,c7rejrumjzuj,44593,44594,89187
47511,,,44594,44595,89189
47512,,w6k7yxksr5cj,44595,44596,89191
47513,,png-znfvntmj,44596,44597,89193
47514,,6em_lct1yoij,44597,44598,89195
47515,,p669yxaks1aj,44598,44599,89197
47516,,ntjykdwwncmj,44599,44600,89199
47517,,khejwyzzzssj,44600,44601,89201
47518,,kpgvuismlauj,44601,44602,89203
47519,,mrplr1zh-luj,44602,44603,89205
47520,,dgul94w262wj,44603,44604,89207
47521,,-2omvhwmdkij,44604,44605,89209
47522,,v9nmekldaygj,44605,44606,89211
47523,,wlbwrueqcbmj,44606,44607,89213
47524,,7bi1kw-u0j0j,44607,44608,89215
47525,,2ozfkkojrv8j,44608,44609,89217
47526,,6rqplbiuvisj,44609,44610,89219
47527,,p-nlzgwnbegj,44610,44611,89221
47528,,y_ffh66_5huj,44611,44612,89223
47529,,2q6spoaq9jwj,44612,44613,89225
47530,,0-p-rtw26fsj,44613,44614,89227
47531,,s49fvsseldcj,44614,44615,89229
47532,,tnzzdtssbh4j,44615,44616,89231
47533,,jgdktk4bd9uj,44616,44617,89233
47534,,sl3ed4j6a5kj,44617,44618,89235
47535,,do1htlbme4qj,44618,44619,89237
47536,,avm-w3trj5ej,44619,44620,89239
47537,,f9cbejvjbxmj,44620,44621,89241
47538,,7hxdf7natvwj,44621,44622,89243
47539,,ajwbt8nejoaj,44622,44623,89245
47540,,n_nzak_dg38j,44623,44624,89247
47541,,yt-mxjkesl4j,44624,44625,89249
47542,,5xleprc88vsj,44625,44626,89251
47543,,urlab3x0i0sj,44626,44627,89253
47544,,g2kl-p2lbaej,44627,44628,89255
47545,,twj8xtlz1y0j,44628,44629,89257
47546,,url:http://www.springerlink.com/index/ru42151t787x2800.pdf,44629,44630,89259
47547,,ns71h6psqogj,44630,44631,89261
47548,,kusarjprvbej,44631,44632,89263
47549,,syeiasqfygqj,44632,44633,89265
47550,,y3vaa8qu7mmj,44633,44634,89267
47551,,n3pndewylqkj,44634,44635,89269
47552,,pqa-rbqajf0j,44635,44636,89271
47553,,zumawx2fo2ej,44636,44637,89273
47554,,vzntatxrmnsj,44637,44638,89275
47555,,mau7fjb8k8gj,44639,44640,89279
47556,,hjoxll4ep04j,44640,44641,89281
47557,,dugjzd3sxbuj,44641,44642,89283
47558,,qgnwfmhh1bsj,44642,44643,89285
47559,,vagav1ycm2kj,44643,44644,89287
47560,,r-2t3n1vtbij,44644,44645,89289
47561,,vltf81cazo0j,44645,44646,89291
47562,,rb8fggunvuej,44646,44647,89293
47563,,fy7c3y4iftij,44647,44648,89295
47564,,xstfqlpfsfgj,44648,44649,89297
47565,,un9un8bxivkj,44649,44650,89299
47566,,fnwe-5kgvyij,44650,44651,89301
47567,,url:http://portal.acm.org/ft_gateway.cfm3fid3d108627926type3dpdf,44651,44652,89303
47568,,url:http://portal.acm.org/ft_gateway.cfm3fid3d108368026type3dpdf,44652,44653,89305
47569,,iwtysfxk5laj,44653,44654,89307
47570,,8xk6hm9y_8aj,44654,44655,89309
47571,,xv26bpectwoj,44655,44656,89311
47572,,url:http://www.csa.com/partners/viewrecord.php3frequester3dgs26collection3dtrd26recid3d8406720408md,44656,44657,89313
47573,,0zg8ug23ujyj,44657,44658,89315
47574,,1fzclwxsgqcj,44658,44659,89317
47575,,oqdugmfxyfuj,44659,44660,89319
47576,,atof_49lq3oj,44660,44661,89321
47577,,e04dba9ytl8j,44661,44662,89323
47578,,odakjc7pjjyj,44662,44663,89325
47579,,srw4njlznfsj,44664,44665,89329
47580,,a4cgjcfzt7sj,44665,44666,89331
47581,,1izernzybagj,44666,44667,89333
47582,,xuw9ulznhusj,44667,44668,89335
47583,,yxnrp5v9v8yj,44668,44669,89337
47584,,cnaqbtq8-dqj,44669,44670,89339
47585,,ijsikh7eyzkj,44670,44671,89341
47586,,vyqhbd3_8juj,44671,44672,89343
47587,,lhxparec0rgj,44672,44673,89345
47588,,9bgj2ow0su4j,44673,44674,89347
47589,,bwm4odd2kd0j,44674,44675,89349
47590,,ko1zn6uk4bij,44675,44676,89351
47591,,8pvbcs32i88j,44676,44677,89353
47592,,jnofbwplfo4j,44677,44678,89355
47593,,url:http://portal.acm.org/citation.cfm3fid3d30120,44678,44679,89357
47594,,wlrxl7973oij,44679,44680,89359
47595,,p7o7lasn8m4j,44680,44681,89361
47596,,zxsskc3prcgj,44681,44682,89363
47597,,url:http://portal.acm.org/ft_gateway.cfm3fid3d108364726type3dpdf,44682,44683,89365
47598,,url:http://www.csa.com/partners/viewrecord.php3frequester3dgs26collection3dtrd26recid3d20021212023584mt26recid3da7642825ah,44683,44684,89367
47599,,5g46phzevtkj,44684,44685,89369
47600,,xe6fhx8ziaej,44685,44686,89371
47601,,ne-q_n17xjgj,44686,44687,89373
47602,,,44687,44688,89375
47603,,b1htkgktrcij,44688,44689,89377
47604,,bnnnuvfklfcj,44689,44690,89379
47605,,kstwssqwjdgj,44690,44691,89381
47606,,ypnkmp3flzsj,44691,44692,89383
47607,,mzpodhajixsj,44692,44693,89385
47608,,59f46eqwx8sj,44693,44694,89387
47609,,mtygefbrq4cj,44694,44695,89389
47610,,zespb68vlvej,44695,44696,89391
47611,,ti79kthgsrcj,44696,44697,89393
47612,,xjakgv7-nwuj,44698,44699,89397
47613,,oc0p9-hvmiuj,44699,44700,89399
47614,,iki6m7qwxgqj,44700,44701,89401
47615,,mi73d4u7heyj,44701,44702,89403
47616,,60o47rhngv4j,44702,44703,89405
47617,,_yi021oetbqj,44703,44704,89407
47618,,_bbnqumbk4ij,44704,44705,89409
47619,,cyfpe8yfm2ij,44705,44706,89411
47620,,dgjdlb1aj8mj,44706,44707,89413
47621,,avwzmjc8o2sj,44707,44708,89415
47622,,kd9yltpwb1wj,44708,44709,89417
47623,,qcapoqz-l6yj,44709,44710,89419
47624,,o5epcee1qx4j,44710,44711,89421
47625,,ge8jx9zzgemj,44711,44712,89423
47626,,wd4t7qipzmcj,44713,44714,89427
47627,,7pjdobo9e_ej,44714,44715,89429
47628,,uonk0_wtv3yj,44715,44716,89431
47629,,x25vb0cbakqj,44716,44717,89433
47630,,nhc1d3x7bl0j,44717,44718,89435
47631,,91ydmqra4sij,44718,44719,89437
47632,,8a8zqofru6mj,44719,44720,89439
47633,,mxyogisjs2oj,44721,44722,89443
47634,,fwsvuwpvxgej,44722,44723,89445
47635,,8zlzkiiblt8j,44723,44724,89447
47636,,o_bxblwwesgj,44724,44725,89449
47637,,izs7brda_huj,44725,44726,89451
47638,,ngndqljtmvwj,44726,44727,89453
47639,,url:http://portal.acm.org/citation.cfm3fid3d234286.1057821,44727,44728,89455
47640,,wei-0js920sj,44729,44730,89459
47641,,e6mhkpsxvl8j,44730,44731,89461
47642,,urbfc7hnpnej,44731,44732,89463
47643,,t9kjz9xbve0j,44732,44733,89465
47644,,6hg7rjw78csj,44733,44734,89467
47645,,pobxvfh1casj,44734,44735,89469
47646,,o5v5p6npqv0j,44735,44736,89471
47647,,whguzfqg9dkj,44736,44737,89473
47648,,lzdvzuxmdtaj,44737,44738,89475
47649,,kjq67cfbwyij,44738,44739,89477
47650,,nuncle_b9aaj,44739,44740,89479
47651,,toivdsj-d4wj,44740,44741,89481
47652,,l6sg5coucqgj,44741,44742,89483
47653,,jsocp4nzmgsj,44742,44743,89485
47654,,url:http://doi.wiley.com/10.1002/he.119,44743,44744,89487
47655,,1k2mlbqrthoj,44744,44745,89489
47656,,b-lrltwyomij,44745,44746,89491
47657,,su0wcbbqbeij,44746,44747,89493
47658,,url:http://doi.wiley.com/10.1002/ace.109,44747,44748,89495
47659,,gjwdaku8psuj,44748,44749,89497
47660,,wmu5rv_rohej,44749,44750,89499
47661,,5hlfqo3av1yj,44750,44751,89501
47662,,t6-ljslcumcj,44751,44752,89503
47663,,url:http://portal.acm.org/citation.cfm3fid3d144111.144135,44752,44753,89505
47664,,b0yvkm-x2agj,44753,44754,89507
47665,,zf-ho0okz_gj,44754,44755,89509
47666,,4lfhctsmq1cj,44755,44756,89511
47667,,ittob-h45isj,44756,44757,89513
47668,,im1v1ce4c7oj,44757,44758,89515
47669,,csg6cp-ebs8j,44759,44760,89519
47670,,hr9tpdtkykcj,44760,44761,89521
47671,,h0e8jydjre0j,44761,44762,89523
47672,,y78vz7ze-waj,44762,44763,89525
47673,,79dbpq758kaj,44763,44764,89527
47674,,3mv40oev5osj,44764,44765,89529
47675,,wfyfbamd2_mj,44765,44766,89531
47676,,aqvdjixwxnwj,44766,44767,89533
47677,,jma2k4poliwj,44767,44768,89535
47678,,gkmcrtkhl70j,44768,44769,89537
47679,,m6caiyocdu4j,44769,44770,89539
47680,,az_y5d5rsymj,44770,44771,89541
47681,,vbokiblafugj,44771,44772,89543
47682,,ugznwigecd0j,44772,44773,89545
47683,,fiqyx5se120j,44773,44774,89547
47684,,knia1z3tjbij,44774,44775,89549
47685,,acqqsebwsqaj,44775,44776,89551
47686,,fnvk1vq2txej,44776,44777,89553
47687,,url:http://portal.acm.org/citation.cfm3fid3d130868.130880,44777,44778,89555
47688,,_tjmxamypcgj,44778,44779,89557
47689,,u2sxqatrtoqj,44779,44780,89559
47690,,tw9vlladliuj,44780,44781,89561
47691,,8yr3iyz-ue8j,44781,44782,89563
47692,,xzvhkt02g8sj,44782,44783,89565
47693,,7oyvduheptmj,44783,44784,89567
47694,,ow-gphvo3cej,44784,44785,89569
47695,,34e8oknbgosj,44785,44786,89571
47696,,cz4u-ybwcvkj,44786,44787,89573
47697,,dnskyc9wfbqj,44787,44788,89575
47698,,c2y2drkloiij,44788,44789,89577
47699,,ucqjlbqhvkij,44789,44790,89579
47700,,ajdarmw3b4cj,44790,44791,89581
47701,,_smlxi2s54mj,44791,44792,89583
47702,,4idujqsmuwij,44792,44793,89585
47703,,p6mnwrjp-s4j,44793,44794,89587
47704,,k6floe-2droj,44794,44795,89589
47705,,kvqea37xipqj,44795,44796,89591
47706,,ure0crzwnd8j,44796,44797,89593
47707,,lyr2s0hvuxuj,44797,44798,89595
47708,,7s8ztlnjofmj,44798,44799,89597
47709,,r9zhledjlcuj,44799,44800,89599
47710,,uf2sa_4njrej,44800,44801,89601
47711,,-607eyolbi4j,44801,44802,89603
47712,,o886_f6zahsj,44802,44803,89605
47713,,fgujz8lcluij,44803,44804,89607
47714,,tj3jebqzglij,44804,44805,89609
47715,,sih4ahazwekj,44805,44806,89611
47716,,hmt0d3xpr4uj,44806,44807,89613
47717,,erdmpsre0uej,44807,44808,89615
47718,,hfzcz3dkvsej,44809,44810,89619
47719,,cbm5jaqaajgj,44810,44811,89621
47720,,2sovhztxjxij,44811,44812,89623
47721,,url:http://portal.acm.org/ft_gateway.cfm3fid3d110138426type3dpdf,44812,44813,89625
47722,,mrnvtvwrkrkj,44813,44814,89627
47723,,ooqy3tgnaygj,44814,44815,89629
47724,,fe2oj3h6ekkj,44815,44816,89631
47725,,zhrldrrfrxmj,44816,44817,89633
47726,,jqpkf_sjv1wj,44817,44818,89635
47727,,dxbbpuigjhej,44818,44819,89637
47728,,1u3iucyiodij,44819,44820,89639
47729,,qiotixvmngaj,44820,44821,89641
47730,,yzimriwa4woj,44821,44822,89643
47731,,wkx2o2oadyyj,44822,44823,89645
47732,,dwq7_w921qgj,44823,44824,89647
47733,,z2os_vy58ryj,44824,44825,89649
47734,,rfqtyun3i1kj,44825,44826,89651
47735,,miytzhylgmaj,44826,44827,89653
47736,,url:http://portal.acm.org/citation.cfm3fid3d192678,44828,44829,89657
47737,,a7lfhht5dw0j,44829,44830,89659
47738,,jsdazwjx6xqj,44830,44831,89661
47739,,,44831,44832,89663
47740,,url:http://portal.acm.org/citation.cfm3fid3d234286.1057829,44832,44833,89665
47741,,skxx8cdw_6kj,44833,44834,89667
47742,,olhzgqfsbhqj,44834,44835,89669
47743,,lasitnqokkoj,44835,44836,89671
47744,,_zuusty2hkqj,44837,44838,89675
47745,,lixcnh-8cmmj,44838,44839,89677
47746,,sgp2kwz_i8ij,44839,44840,89679
47747,,5nnw0m5dj6ej,44840,44841,89681
47748,,ej_ellu6tnaj,44841,44842,89683
47749,,xxfh9xqyvtej,44842,44843,89685
47750,,0e4ippxtz2aj,44843,44844,89687
47751,,yfc66c7ay6yj,44844,44845,89689
47752,,ej6oe852ajaj,44845,44846,89691
47753,,ry_y9fyys8gj,44846,44847,89693
47754,,dylblmccbs0j,44847,44848,89695
47755,,6gf1vvutqecj,44848,44849,89697
47756,,d4a5ymjmka4j,44849,44850,89699
47757,,24-7lbzhv28j,44850,44851,89701
47758,,9oeozgwh3pcj,44851,44852,89703
47759,,ub7wqesge3mj,44853,44854,89707
47760,,va6zk78-j_ij,44854,44855,89709
47761,,url:http://portal.acm.org/ft_gateway.cfm3fid3d110138026type3dpdf,44855,44856,89711
47762,,modh1onw8z4j,44856,44857,89713
47763,,hgzioatnoicj,44857,44858,89715
47764,,izq0qhvm08wj,44858,44859,89717
47765,,zxhvx0fi3woj,44859,44860,89719
47766,,pqdel2bwku0j,44860,44861,89721
47767,,nj1oji_5zxsj,44861,44862,89723
47768,,2_wskky-oyej,44862,44863,89725
47769,,xx1me2gtiwkj,44863,44864,89727
47770,,o5l4wo-zwqaj,44864,44865,89729
47771,,5kqaepwgc-uj,44865,44866,89731
47772,,dwfpcjah3fcj,44866,44867,89733
47773,,bi3gern7fqij,44867,44868,89735
47774,,url:http://doi.wiley.com/10.1002/ev.1429,44868,44869,89737
47775,,xefzh7abtgaj,44869,44870,89739
47776,,sxbzcc8piraj,44870,44871,89741
47777,,xjjtgu4wgyaj,44871,44872,89743
47778,,npmgiim4l3cj,44872,44873,89745
47779,,fis5kxe2hdsj,44873,44874,89747
47780,,2q183qil0lej,44874,44875,89749
47781,,fw6jionrqaqj,44875,44876,89751
47782,,qykbxs9edrqj,44876,44877,89753
47783,,cfdrf-n5yumj,44877,44878,89755
47784,,ooblfunjzigj,44878,44879,89757
47785,,url:http://www.ies.wisc.edu/ltc/live/zimbabwe/prop_0206.pdf,44879,44880,89759
47786,,gsmrb4i7jc0j,44880,44881,89761
47787,,url:http://doi.wiley.com/10.1002/ev.1469,44881,44882,89763
47788,,btexvkri5dcj,44882,44883,89765
47789,,dj1igxb26osj,44883,44884,89767
47790,,vd4jhdc2z6wj,44884,44885,89769
47791,,dhygw_wrtugj,44885,44886,89771
47792,,mw9z00kllsaj,44886,44887,89773
47793,,url:http://doi.wiley.com/10.1002/ev.1516,44887,44888,89775
47794,,,44888,44889,89777
47795,,iobxrw4qpnoj,44889,44890,89779
47796,,ulv7bog4218j,44890,44891,89781
47797,,shy1vvwkxj8j,44891,44892,89783
47798,,ssc6psg_fzaj,44892,44893,89785
47799,,lrtlqcnqk3wj,44894,44895,89789
47800,,xpxifpebjcoj,44895,44896,89791
47801,,nzxw85qysc4j,44896,44897,89793
47802,,oiawnp97cpsj,44897,44898,89795
47803,,ltgcin2a0e4j,44898,44899,89797
47804,,baijc_qvch8j,44899,44900,89799
47805,,,44900,44901,89801
47806,,dpaaxbaufs0j,44901,44902,89803
47807,,ld1vbfvymkij,44902,44903,89805
47808,,ab8rpq2vbyaj,44903,44904,89807
47809,,nr0ucznomn8j,44904,44905,89809
47810,,rtsxumrpa-wj,44905,44906,89811
47811,,8ckdkupvonwj,44906,44907,89813
47812,,4xi6vrc5doqj,44907,44908,89815
47813,,xssxr_oyj1yj,44908,44909,89817
47814,,ulppijqrzhkj,44909,44910,89819
47815,,url:http://portal.acm.org/citation.cfm3fid3d1027527.1027763,44910,44911,89821
47816,,5nxoe2hvikej,44911,44912,89823
47817,,0pxedde5qhaj,44912,44913,89825
47818,,wh2dil1fl1oj,44913,44914,89827
47819,,px5lknthxfkj,44914,44915,89829
47820,,plbitl4sxucj,44915,44916,89831
47821,,p0w7ysmbjiej,44916,44917,89833
47822,,fn8avmh34auj,44917,44918,89835
47823,,wzguxby8l6mj,44918,44919,89837
47824,,tqihbahmzesj,44919,44920,89839
47825,,bef5xqm4xb8j,44920,44921,89841
47826,,_kqritxcbvuj,44921,44922,89843
47827,,luxkvnbbvrij,44922,44923,89845
47828,,y_uwqwpzzlej,44923,44924,89847
47829,,url:http://www.springerlink.com/index/m070356433654v02.pdf,44924,44925,89849
47830,,dydp7uwroloj,44925,44926,89851
47831,,yfmunqonfgwj,44926,44927,89853
47832,,0unugpi_vhsj,44927,44928,89855
47833,,5uckfdlnn3aj,44928,44929,89857
47834,,1egqh4chaisj,44929,44930,89859
47835,,hc0ab7k-efuj,44930,44931,89861
47836,,381ivlx3nycj,44931,44932,89863
47837,,9qrvdaeawawj,44932,44933,89865
47838,,_ylcfor4oqyj,44933,44934,89867
47839,,hwt3m9wtq0sj,44934,44935,89869
47840,,9-m_mjymiygj,44935,44936,89871
47841,,djolxtbpvrej,44936,44937,89873
47842,,99wks4xphtqj,44937,44938,89875
47843,,,44938,44939,89877
47844,,ddgs0ijt7d0j,44939,44940,89879
47845,,ueshp39ekdkj,44940,44941,89881
47846,,ledjppc58egj,44941,44942,89883
47847,,i2r7l6g4whoj,44942,44943,89885
47848,,rri6tuwe5uij,44943,44944,89887
47849,,camowdgsdj4j,44944,44945,89889
47850,,url:http://www.csa.com/partners/viewrecord.php3frequester3dgs26collection3dtrd26recid3d199403720235md26recid3d199403g2c0092ec26recid3d199403g2d0092ed26recid3d199403g2p0092ep,44945,44946,89891
47851,,url:http://doi.wiley.com/10.1002/tl.162,44946,44947,89893
47852,,url:http://www.csa.com/partners/viewrecord.php3frequester3dgs26collection3dtrd26recid3d882416co,44947,44948,89895
47853,,lxeasngsquqj,44948,44949,89897
47854,,kxqqmz5mtlsj,44949,44950,89899
47855,,qcjeygp-izcj,44950,44951,89901
47856,,ugpcgsle_w0j,44951,44952,89903
47857,,wddrcdkyv1cj,44952,44953,89905
47858,,sypqiifdgmoj,44953,44954,89907
47859,,s8narbf1wvaj,44954,44955,89909
47860,,buyn3eskwjij,44955,44956,89911
47861,,bqwzpwmqod4j,44956,44957,89913
47862,,yuwdftjibtgj,44957,44958,89915
47863,,4_zv0qhn-yyj,44958,44959,89917
47864,,q2dmvjxweb0j,44959,44960,89919
47865,,earpm5zw2wmj,44960,44961,89921
47866,,hjz6nnrzpfej,44961,44962,89923
47867,,5ulfwxyx8suj,44962,44963,89925
47868,,yaxhgicsvtmj,44963,44964,89927
47869,,_lmp7ekfybuj,44964,44965,89929
47870,,gnlkskbfnfkj,44965,44966,89931
47871,,nlpb6qwjgcyj,44966,44967,89933
47872,,eubl1jcgxyyj,44967,44968,89935
47873,,hzvlty1kxbmj,44968,44969,89937
47874,,o4sujr2ijagj,44969,44970,89939
47875,,18fppwwaadij,44970,44971,89941
47876,,url:http://doi.wiley.com/10.1002/ev.1618,44971,44972,89943
47877,,,44972,44973,89945
47878,,ftmwzhat1amj,44973,44974,89947
47879,,box0iypteeqj,44974,44975,89949
47880,,url:http://portal.acm.org/citation.cfm3fid3d641007.641027,44976,44977,89953
47881,,hwxz01nyiasj,44977,44978,89955
47882,,wxgphef6lxwj,44978,44979,89957
47883,,wkhkk_qk9aej,44979,44980,89959
47884,,rmukj-zdubwj,44980,44981,89961
47885,,43k14y5xa0yj,44981,44982,89963
47886,,,44982,44983,89965
47887,,dg19alurzcwj,44983,44984,89967
47888,,dg98pf4omkkj,44984,44985,89969
47889,,9twtltijp7cj,44985,44986,89971
47890,,o5tus6-cyccj,44986,44987,89973
47891,,aktotj4cu3cj,44987,44988,89975
47892,,0zuk07zfg8uj,44988,44989,89977
47893,,v98z3uzuvpqj,44989,44990,89979
47894,,iyiy3g-u8-aj,44990,44991,89981
47895,,eooosredvquj,44991,44992,89983
47896,,bfonmygstluj,44992,44993,89985
47897,,oy2qwxrcyioj,44993,44994,89987
47898,,wk4pympo33gj,44994,44995,89989
47899,,v1quddtkh5aj,44995,44996,89991
47900,,jstt_atgt8ej,44996,44997,89993
47901,,oq7z_y1m6suj,44997,44998,89995
47902,,vtg9o5ddkwoj,44998,44999,89997
47903,,url:http://pubs.rsc.org/ej/cc/2002/b207661f.pdf,44999,45000,89999
47904,,hms0cvf1zfsj,45000,45001,90001
47905,,se-n0luarjcj,45002,45003,90005
47906,,egwnxdehaeqj,45003,45004,90007
47907,,evylyfg5r9uj,45004,45005,90009
47908,,url:http://www.csa.com/partners/viewrecord.php3frequester3dgs26collection3dtrd26recid3dn9210375ah,45005,45006,90011
47909,,tfyjvfxa3fwj,45006,45007,90013
47910,,0gkpykepyrkj,45007,45008,90015
47911,,ct3sgftydkgj,45008,45009,90017
47912,,aahapzuffsaj,45009,45010,90019
47913,,bcxzctb3_d0j,45010,45011,90021
47914,,wdthvhu1fduj,45011,45012,90023
47915,,egbrvpfqwdoj,45012,45013,90025
47916,,url:http://portal.acm.org/ft_gateway.cfm3fid3d108628726type3dpdf,45013,45014,90027
47917,,pqrezgjpyquj,45014,45015,90029
47918,,aseexpnkhymj,45015,45016,90031
47919,,u2xk77ofbl4j,45016,45017,90033
47920,,jdyvpq19wnoj,45017,45018,90035
47921,,l6t-ooiw2imj,45018,45019,90037
47922,,,45019,45020,90039
47923,,url:http://www.springerlink.com/index/u1k1ufad34n3xxvt.pdf,45020,45021,90041
47924,,67aorflxe64j,45021,45022,90043
47925,,uwfuodh4hicj,45022,45023,90045
47926,,-2kqyg5gyjuj,45023,45024,90047
47927,,fvjuikgftxoj,45024,45025,90049
47928,,lqge439mkdqj,45025,45026,90051
47929,,bqfliva5hroj,45026,45027,90053
47930,,rperpihts0qj,45027,45028,90055
47931,,b_opsme15ikj,45028,45029,90057
47932,,1dlteqfeusgj,45029,45030,90059
47933,,rsbh0u9detij,45030,45031,90061
47934,,j2x6_sf6ivcj,45031,45032,90063
47935,,lrvwfovtpq8j,45032,45033,90065
47936,,vevppfqiq2uj,45033,45034,90067
47937,,awiehfkwswej,45034,45035,90069
47938,,url:http://portal.acm.org/citation.cfm3fid3d74120.7412626dl3dguide26dl3dacm26idx3dj68926part3dperiodical26wanttype3dperiodical26title3dacm2520sigmod2520record26cfid3d1111111126cftoken3d2222222,45035,45036,90071
47939,,s6vwuubs1dkj,45036,45037,90073
47940,,zkzznhkiowkj,45037,45038,90075
47941,,fx2-z9b6btuj,45038,45039,90077
47942,,x3piefqdn5ij,45039,45040,90079
47943,,wgooxusezwwj,45040,45041,90081
47944,,pywhthpc_sqj,45041,45042,90083
47945,,xiyisfadogcj,45042,45043,90085
47946,,rakdmsfux6qj,45043,45044,90087
47947,,_qx_bo92tzej,45044,45045,90089
47948,,sikbmfbkvduj,45045,45046,90091
47949,,url:http://portal.acm.org/citation.cfm3fid3d3871426dl3dguide26dl3dacm26type3dissue26idx3dj68926part3dperiodical26wanttype3dperiodical26title3dacm2520sigmod2520record26cfid3d1111111126cftoken3d2222222,45046,45047,90093
47950,,sgqlirbxv6ej,45047,45048,90095
47951,,cbrsnxgs3vij,45048,45049,90097
47952,,rikwyo6grwij,45051,45052,90103
47953,,kjtucatx_uoj,45052,45053,90105
47954,,wqb3bik1spkj,45053,45054,90107
47955,,gtnsqhrvpy0j,45054,45055,90109
47956,,ktyti3-agkwj,45055,45056,90111
47957,,1al2b2c1v3ij,45056,45057,90113
47958,,mzzpi10c6duj,45057,45058,90115
47959,,ssayagd_tqmj,45058,45059,90117
47960,,w6ioaq24jsoj,45059,45060,90119
47961,,jtndq0-mosuj,45060,45061,90121
47962,,nluyeqrnhpgj,45061,45062,90123
47963,,u1rbyi2fxeyj,45062,45063,90125
47964,,siqgj2oojemj,45063,45064,90127
47965,,u14djyymmzwj,45064,45065,90129
47966,,i1mpjpqxnvij,45065,45066,90131
47967,,xjzfohg60dqj,45066,45067,90133
47968,,cdgurdr2gwej,45067,45068,90135
47969,,qxxdtljmvwwj,45068,45069,90137
47970,,c2hietjptvuj,45069,45070,90139
47971,,8v8ekmqvhzej,45070,45071,90141
47972,,5rfyo29cenej,45071,45072,90143
47973,,yeeyiowk2koj,45072,45073,90145
47974,,jdww99nlxkkj,45073,45074,90147
47975,,_umg0r4qygcj,45074,45075,90149
47976,,kewbuxrb01yj,45075,45076,90151
47977,,sregx_yaigoj,45076,45077,90153
47978,,url:http://portal.acm.org/ft_gateway.cfm3fid3d109966326type3dpdf,45077,45078,90155
47979,,url:http://www.csa.com/partners/viewrecord.php3frequester3dgs26collection3dtrd26recid3dn9210372ah,45078,45079,90157
47980,,url:http://www.ingentaconnect.com/content/els/13891286/2001/00000035/00000002/art00170,45079,45080,90159
47981,,mcdueg1vg-aj,45080,45081,90161
47982,,wkyswrsq4xwj,45081,45082,90163
47983,,xrykvxrbtk8j,45082,45083,90165
47984,,jd2mxt_dgzgj,45083,45084,90167
47985,,2uv5iyh9rfej,45084,45085,90169
47986,,yjgg6p2w0luj,45085,45086,90171
47987,,re6re8yi7gaj,45086,45087,90173
47988,,ugsmojqxbewj,45087,45088,90175
47989,,b44wtno-c6sj,45088,45089,90177
47990,,lbciqj-_fmgj,45089,45090,90179
47991,,m9m0ypwao4yj,45090,45091,90181
47992,,kdecks-zauij,45091,45092,90183
47993,,cospweuyfxej,45092,45093,90185
47994,,dbknqxe4a1yj,45093,45094,90187
47995,,cxblp_xlg5ij,45094,45095,90189
47996,,wyz2f5mclaij,45095,45096,90191
47997,,oc5ji_ettgsj,45096,45097,90193
47998,,xtdhvtdkwgmj,45097,45098,90195
47999,,rqhz-xp-ju4j,45098,45099,90197
48000,,wvqz83npkoaj,45099,45100,90199
48001,,nn3ohxtt-lqj,45100,45101,90201
48002,,url:http://www.csa.com/partners/viewrecord.php3frequester3dgs26collection3denv26recid3d3933838,45101,45102,90203
48003,,olduf4rxxm8j,45102,45103,90205
48004,,vcnt5aizvtej,45103,45104,90207
48005,,aaakpjxwalaj,45104,45105,90209
48006,,fegcnhj17mej,45105,45106,90211
48007,,bmpwcctiejaj,45106,45107,90213
48008,,uzaql1o-c0mj,45107,45108,90215
48009,,k_dxuvn3_csj,45108,45109,90217
48010,,mjdu2vhgk6sj,45109,45110,90219
48011,,acz0soxtz5oj,45110,45111,90221
48012,,qllxe5mjoisj,45111,45112,90223
48013,,kutsxofrzwaj,45112,45113,90225
48014,,pnynabw-wvgj,45113,45114,90227
48015,,y97c7qm5chkj,45114,45115,90229
48016,,1ztzr4tvuluj,45115,45116,90231
48017,,ak1x7niuwjuj,45116,45117,90233
48018,,mgwxgpipjbij,45117,45118,90235
48019,,l571v8sm0_qj,45118,45119,90237
48020,,muq22_ybezcj,45119,45120,90239
48021,,asqlsbxnqrkj,45120,45121,90241
48022,,57bjcpqaywmj,45121,45122,90243
48023,,vhpeound_j0j,45122,45123,90245
48024,,p7otc4wyjawj,45123,45124,90247
48025,,1tvl5t0wcoej,45124,45125,90249
48026,,hvn1bko4ataj,45125,45126,90251
48027,,url:http://www.nature.com/cgi-taf/dynapage.taf3ffile3d/nature/journal/v408/n6809/full/408184a0_fs.html26content_filetype3dpdf,45126,45127,90253
48028,,yuuznp8tbpmj,45127,45128,90255
48029,,typ2m9d43hcj,45128,45129,90257
48030,,k6j2o50kickj,45129,45130,90259
48031,,ezqh5riqwpgj,45130,45131,90261
48032,,mtfonmierksj,45131,45132,90263
48033,,bonr6eu2fvwj,45132,45133,90265
48034,,tfwuzupwduij,45133,45134,90267
48035,,zecmw7ggtx4j,45134,45135,90269
48036,,yvx5ivn179oj,45135,45136,90271
48037,,1tbnhfyujyoj,45136,45137,90273
48038,,z24x2fvsnqgj,45137,45138,90275
48039,,v_goabn-018j,45138,45139,90277
48040,,rxxbcetgrqcj,45139,45140,90279
48041,,url:http://ieeexplore.ieee.org/iel1/2206/934/00024741.pdf3farnumber3d24741,45140,45141,90281
48042,,_xyasp5ubfij,45141,45142,90283
48043,,p7vjllsmk8kj,45143,45144,90287
48044,,tfj6cdn7ebsj,45144,45145,90289
48045,,s7oyeih6fooj,45145,45146,90291
48046,,url:http://www.csa.com/partners/viewrecord.php3frequester3dgs26collection3dtrd26recid3d20021214044999mt26recid3da7212162ah,45146,45147,90293
48047,,y05rdrnqwhyj,45147,45148,90295
48048,,ejkcudqqnkgj,45149,45150,90299
48049,,km-iuyu8vx4j,45150,45151,90301
48050,,1fcelpknf9ej,45151,45152,90303
48051,,hciuipknznkj,45152,45153,90305
48052,,iypeboprvqcj,45153,45154,90307
48053,,umf3ghhtbbij,45154,45155,90309
48054,,yfl3flqn7g4j,45155,45156,90311
48055,,xqmktggstzwj,45156,45157,90313
48056,,ca1zsnlz-tij,45157,45158,90315
48057,,d3ese47abosj,45158,45159,90317
48058,,lyhoh7nnsoij,45159,45160,90319
48059,,url:http://www.ingentaconnect.com/search/expand3fpub3dinfobike://els/08830355/2001/00000035/00000004/art0004026unc3d,45161,45162,90323
48060,,sdo9hlouz7oj,45162,45163,90325
48061,,x3ldojobye8j,45163,45164,90327
48062,,aaybskcmqwsj,45164,45165,90329
48063,,durrtesnfdaj,45165,45166,90331
48064,,5lhdwbt8hx0j,45166,45167,90333
48065,,yoyggvie5csj,45167,45168,90335
48066,,3trtdt5vfdkj,45168,45169,90337
48067,,1bxx8uovfqaj,45169,45170,90339
48068,,q38iip458yaj,45171,45172,90343
48069,,rbbzmy1xnyqj,45172,45173,90345
48070,,iyzyxtgs9quj,45173,45174,90347
48071,,yku96srzsjyj,45174,45175,90349
48072,,ne61rjulezuj,45175,45176,90351
48073,,ai4kzeyv0f4j,45176,45177,90353
48074,,t3y7rio95nuj,45177,45178,90355
48075,,uydry_ryhqmj,45178,45179,90357
48076,,wixpiqf_txuj,45179,45180,90359
48077,,og9xfr4-9nej,45180,45181,90361
48078,,url:http://www.springerlink.com/index/9077v01nq2226572.pdf,45181,45182,90363
48079,,url:http://portal.acm.org/citation.cfm3fid3d171926.172009,45182,45183,90365
48080,,url:http://portal.acm.org/ft_gateway.cfm3fid3d104142326type3dpdf,45183,45184,90367
48081,,ob86lp9m5vyj,45184,45185,90369
48082,,wzr5ebkteboj,45185,45186,90371
48083,,aw960mel7y8j,45186,45187,90373
48084,,tjl0ehcaqukj,45187,45188,90375
48085,,lenijq96c3cj,45188,45189,90377
48086,,ohnn_e9uxwcj,45189,45190,90379
48087,,8dox0htebgoj,45190,45191,90381
48088,,elvlgwvlxwsj,45192,45193,90385
48089,,hgltcgkqzbaj,45193,45194,90387
48090,,vueze8vprlmj,45194,45195,90389
48091,,wsoesrv9bx4j,45195,45196,90391
48092,,knbxza7orkqj,45196,45197,90393
48093,,x-0oh_vhpfij,45197,45198,90395
48094,,ciuc-pdvdgej,45198,45199,90397
48095,,_y767mldm38j,45199,45200,90399
48096,,url:http://www.springerlink.com/index/f2254767474728w7.pdf,45200,45201,90401
48097,,bmsocmqepkij,45201,45202,90403
48098,,igqad2urrhoj,45202,45203,90405
48099,,puu1wu_slt4j,45203,45204,90407
48100,,rcbtscb_acaj,45204,45205,90409
48101,,gsnlgvewxz8j,45205,45206,90411
48102,,7mn7r-avc7wj,45206,45207,90413
48103,,1xvozg3lxbgj,45207,45208,90415
48104,,9jubz-w-fx8j,45208,45209,90417
48105,,a2s_anptbyej,45209,45210,90419
48106,,vewcpp7bv2wj,45210,45211,90421
48107,,oidbw0l_vbwj,45211,45212,90423
48108,,urr3cgjycy4j,45212,45213,90425
48109,,url:http://portal.acm.org/ft_gateway.cfm3fid3d102756426type3dpdf,45213,45214,90427
48110,,n5p8zfljgzyj,45214,45215,90429
48111,,dcjwxvea6uaj,45215,45216,90431
48112,,cyylrmcb5n0j,45216,45217,90433
48113,,wxyrizcwywuj,45217,45218,90435
48114,,url:http://pubs.acs.org/cgi-bin/abstract.cgi/achre4/2005/38/i12/abs/ar0501212b.html,45218,45219,90437
48115,,3ocxqls2jgqj,45219,45220,90439
48116,,ik2uvq8uutyj,45220,45221,90441
48117,,82bjufcrylwj,45221,45222,90443
48118,,ivgtgciwhrgj,45222,45223,90445
48119,,mdtlhlox8qej,45223,45224,90447
48120,,50ijbxlewnsj,45224,45225,90449
48121,,m2yt_vy2bmaj,45225,45226,90451
48122,,ksy5cjpdeqoj,45226,45227,90453
48123,,thewmsmz-3cj,45227,45228,90455
48124,,5ocpd805puej,45228,45229,90457
48125,,qvmwvri3myqj,45229,45230,90459
48126,,du025feqvzcj,45230,45231,90461
48127,,gaqbao4re_0j,45231,45232,90463
48128,,tfrfuaxyc1sj,45232,45233,90465
48129,,wtfg7fhlzkaj,45233,45234,90467
48130,,ehi_i1spueqj,45234,45235,90469
48131,,c-o6bvcpuhyj,45235,45236,90471
48132,,rlvszc11etcj,45236,45237,90473
48133,,idrpt-gm1qkj,45237,45238,90475
48134,,bzm6yexjxqaj,45238,45239,90477
48135,,c99rdbr-3s4j,45239,45240,90479
48136,,url:http://www.csa.com/partners/viewrecord.php3frequester3dgs26collection3dtrd26recid3dn9210506ah,45240,45241,90481
48137,,pasr4jb9p9sj,45241,45242,90483
48138,,ayzdfvxin_uj,45242,45243,90485
48139,,abbjyvy-rp4j,45243,45244,90487
48140,,3d8_tlnimhsj,45244,45245,90489
48141,,url:http://portal.acm.org/citation.cfm3fid3d95713726dl3dacm26coll3dportal26cfid3d1111111126cftoken3d2222222,45245,45246,90491
48142,,9vozleiwauwj,45246,45247,90493
48143,,igm_dvqlhtej,45247,45248,90495
48144,,bqet4buzot4j,45248,45249,90497
48145,,j69ikgucs3ij,45249,45250,90499
48146,,j1fbt7b9m1kj,45250,45251,90501
48147,,vfis_skr-4kj,45251,45252,90503
48148,,im3kaoljikqj,45252,45253,90505
48149,,2ozrk8yei_qj,45253,45254,90507
48150,,_8tredzthwuj,45254,45255,90509
48151,,0lf7cdieakoj,45256,45257,90513
48152,,sudbjtdzv1mj,45257,45258,90515
48153,,wwhmmrxq8uij,45258,45259,90517
48154,,9gqre7ek8gqj,45260,45261,90521
48155,,bvei5ta5pxaj,45261,45262,90523
48156,,url:http://portal.acm.org/ft_gateway.cfm3fid3d95908326type3dpdf,45262,45263,90525
48157,,hkczt7lmewaj,45264,45265,90529
48158,,url:http://www.csa.com/partners/viewrecord.php3frequester3dgs26collection3dtrd26recid3dn9210446ah,45265,45266,90531
48159,,,45266,45267,90533
48160,,jadhvr0m9rgj,45267,45268,90535
48161,,aghrde4vkaej,45269,45270,90539
48162,,4dodzu7bvvsj,45270,45271,90541
48163,,,45271,45272,90543
48164,,i8yndqo9pg8j,45272,45273,90545
48165,,bwqefmzjyukj,45273,45274,90547
48166,,gpra1qdpyf0j,45274,45275,90549
48167,,u-4fneb9hiuj,45275,45276,90551
48168,,hf84fepx5agj,45276,45277,90553
48169,,iw_8vnage8qj,45277,45278,90555
48170,,mqkzpmh4moij,45278,45279,90557
48171,,6c5t1jkwgvaj,45279,45280,90559
48172,,url:http://www.csa.com/partners/viewrecord.php3frequester3dgs26collection3denv26recid3d8913258,45280,45281,90561
48173,,ucu2g94_foij,45281,45282,90563
48174,,o46xocfsphoj,45283,45284,90567
48175,,dkcnqw_fme0j,45284,45285,90569
48176,,fa7gqhdtvqaj,45285,45286,90571
48177,,i5siu6flqsaj,45286,45287,90573
48178,,ap4cyigjktej,45287,45288,90575
48179,,cxuiuovmctej,45288,45289,90577
48180,,wwlild48sl0j,45289,45290,90579
48181,,eqmvp0jrinij,45290,45291,90581
48182,,v6t2zsu76paj,45291,45292,90583
48183,,zqhq6arrvjej,45292,45293,90585
48184,,3aghsj4cy-8j,45293,45294,90587
48185,,url:http://portal.acm.org/ft_gateway.cfm3fid3d13034526type3dpdf26dl3dportal26dl3dacm26cfid3d1111111126cftoken3d2222222,45294,45295,90589
48186,,uvpnreh_djmj,45295,45296,90591
48187,,aoco67tm9mqj,45296,45297,90593
48188,,qpwwxjqcs04j,45297,45298,90595
48189,,cu2hdqdq5fej,45299,45300,90599
48190,,ntuwsut1pu4j,45300,45301,90601
48191,,cuw9kjkx3uyj,45301,45302,90603
48192,,p89cek-ksh4j,45302,45303,90605
48193,,yse66tx40bqj,45303,45304,90607
48194,,m62d7g2nfq0j,45304,45305,90609
48195,,tvtwmco8u4uj,45305,45306,90611
48196,,efvv6wt0cruj,45306,45307,90613
48197,,fi6zvahmawaj,45307,45308,90615
48198,,wdpgwt7tjqkj,45308,45309,90617
48199,,l9b9mvkonwcj,45309,45310,90619
48200,,,45311,45312,90623
48201,,o2k6axa-npej,45312,45313,90625
48202,,e9ehiycwjdmj,45313,45314,90627
48203,,iqzodruacf4j,45314,45315,90629
48204,,kkrae6xt5jmj,45315,45316,90631
48205,,5qg4bniroqmj,45316,45317,90633
48206,,ug1uwj4z3lej,45317,45318,90635
48207,,k9vnmwr3lwcj,45318,45319,90637
48208,,fjmdkmnoo3sj,45319,45320,90639
48209,,l-jdgogp1tyj,45320,45321,90641
48210,,k09bt2colhmj,45321,45322,90643
48211,,9vkye0mj2ouj,45322,45323,90645
48212,,jcee38eqvgkj,45323,45324,90647
48213,,9uzprkdxehcj,45324,45325,90649
48214,,zh-issb02buj,45325,45326,90651
48215,,k_c541m61y0j,45326,45327,90653
48216,,url:http://portal.acm.org/ft_gateway.cfm3fid3d109967126type3dpdf,45327,45328,90655
48217,,ezvsommuaz8j,45328,45329,90657
48218,,i4ka46kiuaaj,45329,45330,90659
48219,,lv2_vexw6ryj,45330,45331,90661
48220,,mbl4t0vu_lcj,45331,45332,90663
48221,,url:http://www.springerlink.com/index/l453166171408244.pdf,45332,45333,90665
48222,,srepwmq942aj,45333,45334,90667
48223,,hanjpsb8yn0j,45334,45335,90669
48224,,u5vlxti4bmaj,45335,45336,90671
48225,,pnsmqwa8ovkj,45336,45337,90673
48226,,kj9zlg2nfdsj,45337,45338,90675
48227,,6k0takprpmsj,45338,45339,90677
48228,,url:http://ieeexplore.ieee.org/iel1/2206/1500/00035879.pdf3farnumber3d35879,45340,45341,90681
48229,,mpwzlwc0j3qj,45341,45342,90683
48230,,url:http://portal.acm.org/citation.cfm3fid3d1073204.1073215,45342,45343,90685
48231,,rbt5ohn01tgj,45344,45345,90689
48232,,9cku75vajlqj,45345,45346,90691
48233,,url:http://www.csa.com/partners/viewrecord.php3frequester3dgs26collection3dtrd26recid3d0411949ci,45346,45347,90693
48234,,egx8aq2wfhaj,45347,45348,90695
48235,,url:http://doi.wiley.com/10.1002/he.71,45348,45349,90697
48236,,_ovehkxk19oj,45349,45350,90699
48237,,wtxgz8m0jwqj,45350,45351,90701
48238,,k8rm5i4q1quj,45351,45352,90703
48239,,arla724kukoj,45352,45353,90705
48240,,url:http://portal.acm.org/citation.cfm3fid3d1024694.1024713,45353,45354,90707
48241,,xd_nqnq-ad0j,45354,45355,90709
48242,,pxxml-wjqcej,45355,45356,90711
48243,,6c0kt4h6j2cj,45356,45357,90713
48244,,zakegdcas3aj,45357,45358,90715
48245,,lkpxhb78dy4j,45358,45359,90717
48246,,m-8hralo0fyj,45359,45360,90719
48247,,yd2dxabjvtaj,45360,45361,90721
48248,,rnanyka3ogwj,45361,45362,90723
48249,,varwbd78gb0j,45362,45363,90725
48250,,0hj_yphdnlqj,45364,45365,90729
48251,,hqvgtmxcqggj,45365,45366,90731
48252,,t8synicntjqj,45366,45367,90733
48253,,wn20amcwunwj,45367,45368,90735
48254,,y_5ifgpu9ycj,45368,45369,90737
48255,,czngr7kq5sej,45369,45370,90739
48256,,url:http://links.jstor.org/sici3fsici3d0146-4949(196324)4253a1253c62253atrsos2522253e2.0.co253b2-1,45370,45371,90741
48257,,4n1fqbcbmccj,45371,45372,90743
48258,,_ufapxxrmvuj,45372,45373,90745
48259,,,45373,45374,90747
48260,,gt_czunuyf0j,45374,45375,90749
48261,,hfmsbzsmdvkj,45375,45376,90751
48262,,url:http://pubs.acs.org/cgi-bin/abstract.cgi/achre4/2004/37/i12/abs/ar0301577.html,45376,45377,90753
48263,,9iw5qhopchqj,45377,45378,90755
48264,,jmlffnmd_d0j,45378,45379,90757
48265,,tj_lqafwre0j,45379,45380,90759
48266,,vtcwfiyinlij,45380,45381,90761
48267,,2zmsl47hbvoj,45381,45382,90763
48268,,kudpymmwkuij,45382,45383,90765
48269,,url:http://portal.acm.org/citation.cfm3fid3d168825.161158,45383,45384,90767
48270,,cfyutmptsesj,45384,45385,90769
48271,,ef_x3dwbj-ej,45385,45386,90771
48272,,ntdrsjyn2smj,45386,45387,90773
48273,,at2enzsludoj,45388,45389,90777
48274,,bue9xa1of2uj,45389,45390,90779
48275,,bx3e6bvhy4ij,45390,45391,90781
48276,,0qcp-q-xwjij,45391,45392,90783
48277,,gva3bipekbmj,45392,45393,90785
48278,,pofhgbvyvtkj,45393,45394,90787
48279,,qvecq-1c7paj,45394,45395,90789
48280,,z5jnpww3mnuj,45395,45396,90791
48281,,fo-my5orkiqj,45396,45397,90793
48282,,ztfdpmpu0fuj,45397,45398,90795
48283,,dyabrixiwd4j,45398,45399,90797
48284,,er1lej1rs-sj,45399,45400,90799
48285,,url:http://portal.acm.org/ft_gateway.cfm3fid3d35320226type3dpdf26dl3dguide26dl3dacm26cfid3d1111111126cftoken3d2222222,45400,45401,90801
48286,,zkpzkmss3ucj,45401,45402,90803
48287,,idgsythkl6yj,45402,45403,90805
48288,,uu5rjuzdyigj,45403,45404,90807
48289,,6qpauozrypsj,45404,45405,90809
48290,,pxlarlduyymj,45405,45406,90811
48291,,ueknq575jroj,45406,45407,90813
48292,,d49ytldpdomj,45407,45408,90815
48293,,m2i27rzqsyej,45408,45409,90817
48294,,zo1ygnw_u84j,45409,45410,90819
48295,,9kehr7wd8-qj,45410,45411,90821
48296,,ufhserrc3tej,45412,45413,90825
48297,,xc1iahlomkuj,45413,45414,90827
48298,,d-ay87ssqwsj,45414,45415,90829
48299,,fp2ozrd3qj8j,45415,45416,90831
48300,,owyh_om16gaj,45416,45417,90833
48301,,kkvuddc38bcj,45417,45418,90835
48302,,znjezo1fj_ej,45418,45419,90837
48303,,quxjjv86heuj,45419,45420,90839
48304,,6oxtrz7has8j,45420,45421,90841
48305,,rowvk9vv248j,45421,45422,90843
48306,,gsqb-6zrzhcj,45422,45423,90845
48307,,zf4mqlvn8naj,45423,45424,90847
48308,,a1nzzmjh5sej,45424,45425,90849
48309,,ioa2hy7fs1ij,45425,45426,90851
48310,,1fpw9q09yfsj,45426,45427,90853
48311,,ivphha01uukj,45427,45428,90855
48312,,ylhu6bh_memj,45428,45429,90857
48313,,sea9xx9sxl8j,45429,45430,90859
48314,,8r-haf8id30j,45430,45431,90861
48315,,8ztqthkrcdyj,45432,45433,90865
48316,,pcakdutqlgoj,45433,45434,90867
48317,,e08ovnfwt0sj,45434,45435,90869
48318,,8sw5frxf6w8j,45435,45436,90871
48319,,a25usqmgqycj,45436,45437,90873
48320,,,45437,45438,90875
48321,,rsxkrpdu1pwj,45438,45439,90877
48322,,qtedccikbnyj,45439,45440,90879
48323,,dxmmmkcuad0j,45440,45441,90881
48324,,zo7q8ipycxyj,45441,45442,90883
48325,,f6n64kknkq4j,45442,45443,90885
48326,,v0lbjtfe2qcj,45443,45444,90887
48327,,ljhljq04i_yj,45444,45445,90889
48328,,ik-w-91m7zuj,45445,45446,90891
48329,,,45446,45447,90893
48330,,ycnzhehpjwwj,45447,45448,90895
48331,,2j0yxtj59boj,45448,45449,90897
48332,,8kzav8wziauj,45449,45450,90899
48333,,v_bimevtvpwj,45450,45451,90901
48334,,wlsgdhqf8caj,45452,45453,90905
48335,,mgzq_3y3hg8j,45453,45454,90907
48336,,ypg5bouhg6gj,45454,45455,90909
48337,,jm1x7hho718j,45455,45456,90911
48338,,t47vzm44_pqj,45456,45457,90913
48339,,ryyrssmdbqij,45457,45458,90915
48340,,ksmxj5b1xfsj,45458,45459,90917
48341,,,45459,45460,90919
48342,,_sfipy75zyqj,45460,45461,90921
48343,,fdakdldfgq0j,45461,45462,90923
48344,,5qszfzu11yij,45462,45463,90925
48345,,4t216yz-n5qj,45463,45464,90927
48346,,ktlhmbxfzf4j,45464,45465,90929
48347,,hltuezvzrfcj,45465,45466,90931
48348,,z1lb7yfn8vuj,45466,45467,90933
48349,,fy5vqhh1y74j,45467,45468,90935
48350,,fvloy79ygryj,45469,45470,90939
48351,,mmc7nyc4kgij,45470,45471,90941
48352,,99oqrzgwaymj,45471,45472,90943
48353,,vg-mj4wd734j,45472,45473,90945
48354,,xa8b8q1eu_qj,45473,45474,90947
48355,,url:http://www.csa.com/partners/viewrecord.php3frequester3dgs26collection3dtrd26recid3d155971ws26recid3d199301530045md,45474,45475,90949
48356,,tukpz2hydekj,45475,45476,90951
48357,,ak__72yjixaj,45476,45477,90953
48358,,s6vszsmf_iaj,45477,45478,90955
48359,,sv-ipheqi60j,45478,45479,90957
48360,,ebhlmzzyuxuj,45479,45480,90959
48361,,jff2ybasfycj,45480,45481,90961
48362,,kt-g2t8v3euj,45481,45482,90963
48363,,e1rc9xs6rqkj,45482,45483,90965
48364,,0hahngoagpqj,45483,45484,90967
48365,,url:http://adsabs.harvard.edu/abs/1976infph..16...29m,45484,45485,90969
48366,,uwytjtipouij,45485,45486,90971
48367,,4bynzdzjuucj,45486,45487,90973
48368,,fkixycq0lngj,45487,45488,90975
48369,,,45488,45489,90977
48370,,4bnjjxsft60j,45489,45490,90979
48371,,url:http://portal.acm.org/ft_gateway.cfm3fid3d108363126type3dpdf,45490,45491,90981
48372,,atddyctdrpij,45491,45492,90983
48373,,url:http://www.csa.com/partners/viewrecord.php3frequester3dgs26collection3denv26recid3d8913254,45492,45493,90985
48374,,mpfqyxod7juj,45493,45494,90987
48375,,ywiyrsawsdgj,45494,45495,90989
48376,,cvqsgbnuqomj,45495,45496,90991
48377,,31xurnim2tmj,45496,45497,90993
48378,,qbbnubapqh4j,45497,45498,90995
48379,,lmv5vic6utkj,45498,45499,90997
48380,,2lwh21kujw0j,45499,45500,90999
48381,,1qv5-83rtyuj,45500,45501,91001
48382,,caikbvfcuucj,45501,45502,91003
48383,,e8u702eliuwj,45502,45503,91005
48384,,lj3aqoub8yqj,45503,45504,91007
48385,,_qkt7nss5tsj,45504,45505,91009
48386,,o4gy4wqcahkj,45505,45506,91011
48387,,wuvkab--sa8j,45506,45507,91013
48388,,j2lx4woq9fuj,45507,45508,91015
48389,,apjopaq5slwj,45508,45509,91017
48390,,cxoignrpj1uj,45509,45510,91019
48391,,thxorua-1csj,45510,45511,91021
48392,,nx85t01_kugj,45511,45512,91023
48393,,sz3xaqyla9aj,45512,45513,91025
48394,,uubeyrkflogj,45513,45514,91027
48395,,ijrrntu6dlwj,45514,45515,91029
48396,,xeyr9lwrjqkj,45515,45516,91031
48397,,opxbu1twlpqj,45516,45517,91033
48398,,vahreivamnoj,45517,45518,91035
48399,,sqgzzetsdgmj,45518,45519,91037
48400,,mpe4u6xb8oyj,45519,45520,91039
48401,,lq4jaw-xvxsj,45520,45521,91041
48402,,h4povtzymboj,45521,45522,91043
48403,,lpnhdh6p-wwj,45522,45523,91045
48404,,ne5je1ugwhmj,45523,45524,91047
48405,,8o8twtsk-kkj,45524,45525,91049
48406,,7800h4rqrx0j,45525,45526,91051
48407,,gbpzhvyef60j,45526,45527,91053
48408,,hrv0rbbfapij,45527,45528,91055
48409,,poc8pen__hej,45528,45529,91057
48410,,url:http://portal.acm.org/citation.cfm3fid3d33939026coll3dportal26dl3dacm,45529,45530,91059
48411,,1049gihpya0j,45530,45531,91061
48412,,agttrkif4rcj,45531,45532,91063
48413,,2jxgt2e7te0j,45532,45533,91065
48414,,uqbk3jbilccj,45533,45534,91067
48415,,isfvyp0o8n4j,45534,45535,91069
48416,,qyybpzi65yuj,45535,45536,91071
48417,,0higl3viumcj,45536,45537,91073
48418,,v4twlh2c3tej,45537,45538,91075
48419,,gqthww5qvsgj,45538,45539,91077
48420,,zvbm3taazkuj,45539,45540,91079
48421,,bbwdzs06ybsj,45540,45541,91081
48422,,q2f2htxnucwj,45541,45542,91083
48423,,lxwnfjvgk_aj,45542,45543,91085
48424,,8xavusmpq0ij,45543,45544,91087
48425,,8uny4bbxndoj,45544,45545,91089
48426,,t1g1whk6_nej,45545,45546,91091
48427,,ai1tjot2mfmj,45547,45548,91095
48428,,140d7phkmrkj,45548,45549,91097
48429,,0mufixxeyeij,45549,45550,91099
48430,,cwjwwbyulxwj,45550,45551,91101
48431,,xnnw7tuied4j,45551,45552,91103
48432,,appq_9fnjbcj,45552,45553,91105
48433,,plj1-8ox6sij,45553,45554,91107
48434,,nmkktmq_1paj,45554,45555,91109
48435,,nehfbzw-npkj,45555,45556,91111
48436,,1el5v5tso8oj,45556,45557,91113
48437,,dkjevmsfqw4j,45557,45558,91115
48438,,hmpvl49lg9uj,45558,45559,91117
48439,,mutnb1yqcyuj,45559,45560,91119
48440,,7aq2ioe3uwyj,45560,45561,91121
48441,,za_pxbmfc64j,45561,45562,91123
48442,,oqi2naor6msj,45562,45563,91125
48443,,j4akrnlothwj,45563,45564,91127
48444,,ltadueokuzqj,45564,45565,91129
48445,,8gzyhnoo69ej,45565,45566,91131
48446,,yd4eykvasrij,45566,45567,91133
48447,,tni-lxrcuhgj,45567,45568,91135
48448,,wzpeg-ocuckj,45568,45569,91137
48449,,8iqoqg8yggqj,45569,45570,91139
48450,,t6i_tcnwiwqj,45570,45571,91141
48451,,vsvidjmpmdkj,45571,45572,91143
48452,,cdpqiz4-_mcj,45572,45573,91145
48453,,ebugyyz71ssj,45573,45574,91147
48454,,wcjlqpkvd24j,45574,45575,91149
48455,,ejn8r5opy3wj,45575,45576,91151
48456,,e1ku0ohhjquj,45576,45577,91153
48457,,ruwossulqiaj,45577,45578,91155
48458,,dni7xq08jxmj,45578,45579,91157
48459,,ye29nmdctq4j,45579,45580,91159
48460,,_kg9so3nc8gj,45580,45581,91161
48461,,ycjspfvwh9gj,45581,45582,91163
48462,,ved5mzhqkwoj,45582,45583,91165
48463,,5wfsfgyxtaaj,45583,45584,91167
48464,,ieflh8wrbdsj,45584,45585,91169
48465,,cuvo4iur1sqj,45585,45586,91171
48466,,url:http://www.csa.com/partners/viewrecord.php3frequester3dgs26collection3dtrd26recid3d0141200ci,45586,45587,91173
48467,,p4yhz1uh8eqj,45587,45588,91175
48468,,5umufzmwaqgj,45588,45589,91177
48469,,pf_yfj-znkqj,45589,45590,91179
48470,,bh6lgex0ghej,45590,45591,91181
48471,,t9tb1klgmcuj,45591,45592,91183
48472,,,45592,45593,91185
48473,,6mhdpsrk5l4j,45593,45594,91187
48474,,p0leb9n3k-cj,45594,45595,91189
48475,,atf2siiifmsj,45595,45596,91191
48476,,1q-fnc9qpv0j,45596,45597,91193
48477,,url:http://www.springerlink.com/index/g2325447131x8981.pdf,45597,45598,91195
48478,,x9zhi0afammj,45598,45599,91197
48479,,w2ebimkjjvej,45599,45600,91199
48480,,gxopxscpzymj,45600,45601,91201
48481,,33cwjo4uunkj,45601,45602,91203
48482,,rptxmx8jzj4j,45602,45603,91205
48483,,url:http://portal.acm.org/citation.cfm3fid3d6173326dl3dguide26dl3dacm26type3dissue26idx3dj68926part3dperiodical26wanttype3dperiodical26title3dacm2520sigmod2520record26cfid3d1111111126cftoken3d2222222,45603,45604,91207
48484,,tgitz0cddmgj,45604,45605,91209
48485,,qtrms48svnyj,45605,45606,91211
48486,,xv8ahqhircgj,45606,45607,91213
48487,,_79cet6wremj,45607,45608,91215
48488,,ss3ldlduuwmj,45608,45609,91217
48489,,niahiu-wqacj,45610,45611,91221
48490,,zabwzvjkznyj,45611,45612,91223
48491,,g24-n179gnaj,45612,45613,91225
48492,,9kxdkpmon0qj,45613,45614,91227
48493,,g_2nx9y8mmoj,45614,45615,91229
48494,,dikbvn_0qzaj,45615,45616,91231
48495,,edhwtackorij,45616,45617,91233
48496,,kmxq1yvcdfgj,45617,45618,91235
48497,,v-vlbze5tbkj,45618,45619,91237
48498,,wzxqwnislakj,45619,45620,91239
48499,,bd4bkojhag4j,45620,45621,91241
48500,,gb6het7u_kuj,45621,45622,91243
48501,,d71dntfl-1uj,45622,45623,91245
48502,,vvv4eddsb7gj,45623,45624,91247
48503,,ru0rnt3jetaj,45624,45625,91249
48504,,ohq-ru44zvmj,45625,45626,91251
48505,,szzar65p2lmj,45626,45627,91253
48506,,5ippvlrhdqoj,45627,45628,91255
48507,,ckduswynpa8j,45628,45629,91257
48508,,vy7dgrkn-daj,45629,45630,91259
48509,,,45630,45631,91261
48510,,yhjzshskwgwj,45631,45632,91263
48511,,ntnxim3rxkkj,45632,45633,91265
48512,,os9ipojdhxsj,45633,45634,91267
48513,,rjqusikozpej,45634,45635,91269
48514,,vegpddownzuj,45635,45636,91271
48515,,hcityifvpskj,45636,45637,91273
48516,,url:http://www.csa.com/partners/viewrecord.php3frequester3dgs26collection3dtrd26recid3d0517753ci,45637,45638,91275
48517,,l-ucbkiljxoj,45638,45639,91277
48518,,yci9hkjhmkmj,45639,45640,91279
48519,,eo2xdvfnpzsj,45640,45641,91281
48520,,,45641,45642,91283
48521,,nsboc3c8tz8j,45642,45643,91285
48522,,sfkincvfq0yj,45643,45644,91287
48523,,liefwae941kj,45644,45645,91289
48524,,7azskvwzl3mj,45645,45646,91291
48525,,vtisejldkt4j,45646,45647,91293
48526,,crbex1tpfioj,45647,45648,91295
48527,,fd9ygczgeqwj,45648,45649,91297
48528,,dy7ck82_17ij,45649,45650,91299
48529,,d4zdxth2ku0j,45650,45651,91301
48530,,x9qvnsgzh20j,45651,45652,91303
48531,,1fid8j3cibgj,45652,45653,91305
48532,,ddawjxebs98j,45653,45654,91307
48533,,rifx6snis_ej,45654,45655,91309
48534,,vaa-ebf0bfkj,45655,45656,91311
48535,,auc6nwul6acj,45656,45657,91313
48536,,42e2vzn_oyej,45657,45658,91315
48537,,pmrxvqgdkosj,45658,45659,91317
48538,,cvakqililzqj,45660,45661,91321
48539,,y6w7ypo4eykj,45662,45663,91325
48540,,,45663,45664,91327
48541,,giiurht9a9ej,45664,45665,91329
48542,,qem37lvs-eoj,45665,45666,91331
48543,,3cnazgczdfqj,45666,45667,91333
48544,,xp_lrbjmg04j,45667,45668,91335
48545,,hifiherlpy4j,45669,45670,91339
48546,,ly6lr2gdzwmj,45670,45671,91341
48547,,myqfd2dy-zgj,45671,45672,91343
48548,,rrtfredys7aj,45672,45673,91345
48549,,atnya0jnqhuj,45673,45674,91347
48550,,naqlcsyirbsj,45674,45675,91349
48551,,rwxcnwtpzkmj,45675,45676,91351
48552,,pwil5xybawmj,45676,45677,91353
48553,,lxnictne0qyj,45677,45678,91355
48554,,suubxxfrbgcj,45678,45679,91357
48555,,asiytbgmck4j,45679,45680,91359
48556,,rns4af5sajij,45680,45681,91361
48557,,vzblnsg9xggj,45681,45682,91363
48558,,8h0ohrysvjij,45682,45683,91365
48559,,jh2zgczxqtuj,45683,45684,91367
48560,,6uzdjc1j0nuj,45684,45685,91369
48561,,foyui8igtrij,45685,45686,91371
48562,,3hw17oq7v6mj,45686,45687,91373
48563,,i6kmypfd39aj,45687,45688,91375
48564,,mxe1zozqbquj,45688,45689,91377
48565,,mwsxuzk1lhgj,45689,45690,91379
48566,,sxkiq_cbnfoj,45690,45691,91381
48567,,0pogh51z_omj,45691,45692,91383
48568,,url:http://portal.acm.org/citation.cfm3fid3d192593.19745426dl3dguide26dl3dacm26type3dseries26idx3d19259326part3dproceedings26wanttype3dproceedings26title3dinternational2520multimedia2520conference26cfid3d1111111126cftoken3d2222222,45692,45693,91385
48569,,vwzqmafqke0j,45693,45694,91387
48570,,qvgubgp1s2mj,45694,45695,91389
48571,,g3ute14axcij,45695,45696,91391
48572,,4gmhuphot3uj,45696,45697,91393
48573,,djgz6txn1euj,45697,45698,91395
48574,,xwnzx9kcl_wj,45698,45699,91397
48575,,sbayiv08yuqj,45699,45700,91399
48576,,qocdq85fgwaj,45700,45701,91401
48577,,pdy1rexhjscj,45701,45702,91403
48578,,12c0mk7wzpoj,45702,45703,91405
48579,,mywno3nyqscj,45703,45704,91407
48580,,z6xsmfxv2dmj,45704,45705,91409
48581,,udlgtswhmbqj,45705,45706,91411
48582,,zcypb1kovh4j,45706,45707,91413
48583,,3vhgb5ehpzkj,45707,45708,91415
48584,,vtub10z-vnij,45708,45709,91417
48585,,rux0qvu4yruj,45709,45710,91419
48586,,uzan3e3s6_0j,45710,45711,91421
48587,,j0-tejkf5xqj,45711,45712,91423
48588,,2mjw7sk9r98j,45712,45713,91425
48589,,ncjrusmsm2ej,45713,45714,91427
48590,,fe4s5jv-iqwj,45714,45715,91429
48591,,hg8ma7q1sncj,45715,45716,91431
48592,,xwkedchideyj,45718,45719,91437
48593,,qaihrpatrqij,45719,45720,91439
48594,,38xagcz3ob0j,45720,45721,91441
48595,,9c9ifujjgsmj,45721,45722,91443
48596,,wokvn2jtg08j,45722,45723,91445
48597,,7dup_p8h0zmj,45723,45724,91447
48598,,url:http://adsabs.harvard.edu/abs/1975stin...7624520e,45724,45725,91449
48599,,e4ceed7rkaaj,45725,45726,91451
48600,,rzg3gjlbtyij,45726,45727,91453
48601,,apvy4xxj3vij,45727,45728,91455
48602,,x9isndwhmigj,45728,45729,91457
48603,,kveynaa3gw4j,45729,45730,91459
48604,,8kt9ri1rnhaj,45730,45731,91461
48605,,gwbrv0j1ezoj,45733,45734,91467
48606,,atcu7rygmnaj,45735,45736,91471
48607,,wfraki4b_6wj,45737,45738,91475
48608,,bvyy-njp1zqj,45738,45739,91477
48609,,fjoqmp_agz0j,45739,45740,91479
48610,,hugfmn3j9koj,45740,45741,91481
48611,,8q3o7y_rycaj,45741,45742,91483
48612,,5yi3bsppkvqj,45742,45743,91485
48613,,5ke2awbbtdoj,45743,45744,91487
48614,,av7a_kwbfxoj,45744,45745,91489
48615,,hslqux0jojqj,45745,45746,91491
48616,,ehgvf_aeq80j,45746,45747,91493
48617,,xgfnqdzpd5qj,45747,45748,91495
48618,,qk4iepbgiwyj,45748,45749,91497
48619,,42yqhrpoqzuj,45749,45750,91499
48620,,fs0rle5-aaaj,45750,45751,91501
48621,,nrn3crkid-ej,45751,45752,91503
48622,,hp3y0b1il08j,45752,45753,91505
48623,,yngfpaua_jcj,45753,45754,91507
48624,,url:http://www.csa.com/partners/viewrecord.php3frequester3dgs26collection3dtrd26recid3d200111010680mt26recid3da0032586ah,45754,45755,91509
48625,,url:http://portal.acm.org/citation.cfm3fid3d645923,45755,45756,91511
48626,,njiuao7nghyj,45756,45757,91513
48627,,q5gubxc03tmj,45757,45758,91515
48628,,r1sqj1qvpiaj,45758,45759,91517
48629,,tzqjzrtyli4j,45759,45760,91519
48630,,asgsmuc5cpoj,45760,45761,91521
48631,,xrrx8zxvwxij,45761,45762,91523
48632,,jhi4xyt-jnkj,45762,45763,91525
48633,,fyr1xrt4w1kj,45763,45764,91527
48634,,3dobgahn7l0j,45764,45765,91529
48635,,ysirsxmbjtmj,45766,45767,91533
48636,,2fhlmzuiadgj,45767,45768,91535
48637,,zh3ea0urcjwj,45768,45769,91537
48638,,nyttreopca4j,45769,45770,91539
48639,,q_bqlij-kzaj,45770,45771,91541
48640,,mjkptrxcspwj,45771,45772,91543
48641,,3ko4celcvtkj,45772,45773,91545
48642,,sjgg4j0osa0j,45773,45774,91547
48643,,vq7f0l22jduj,45774,45775,91549
48644,,o8ai_zycg2mj,45775,45776,91551
48645,,v8bemf9539mj,45776,45777,91553
48646,,xsqprldikeuj,45777,45778,91555
48647,,lmp8px1wyv8j,45778,45779,91557
48648,,iujiprkh4tcj,45779,45780,91559
48649,,cqquk1j-3cij,45780,45781,91561
48650,,_0xkq3kqssoj,45781,45782,91563
48651,,_e-kpwmaxgqj,45783,45784,91567
48652,,url:http://portal.acm.org/citation.cfm3fid3d1027675,45784,45785,91569
48653,,br-a2go2hpuj,45785,45786,91571
48654,,tx1muablp0wj,45786,45787,91573
48655,,dvavjihzttej,45787,45788,91575
48656,,fp2et6dhzlqj,45788,45789,91577
48657,,0rlmneznbtmj,45789,45790,91579
48658,,toevavwjb8sj,45790,45791,91581
48659,,s8cirjl6ackj,45791,45792,91583
48660,,ywj2vntpeiwj,45792,45793,91585
48661,,tyzcg_j8afej,45793,45794,91587
48662,,mmegkz0cce4j,45794,45795,91589
48663,,usnveymgjtkj,45795,45796,91591
48664,,url:http://doi.wiley.com/10.1002/he.100,45796,45797,91593
48665,,fitzufk27auj,45797,45798,91595
48666,,1zqkjsdm1u8j,45798,45799,91597
48667,,xyf7rgkxzb4j,45799,45800,91599
48668,,09mp-bedej0j,45800,45801,91601
48669,,bnomcqau7_aj,45801,45802,91603
48670,,kbq392lj3rej,45802,45803,91605
48671,,url:http://doi.wiley.com/10.1002/ace.99,45803,45804,91607
48672,,gvbhuqjgcd4j,45804,45805,91609
48673,,xg0u9orqywcj,45805,45806,91611
48674,,pgq1uaoxyzij,45806,45807,91613
48675,,,45807,45808,91615
48676,,bjxumxu0pmuj,45808,45809,91617
48677,,jaryepxgw8qj,45809,45810,91619
48678,,fsgd-mniagkj,45810,45811,91621
48679,,bzj9gl0_yuij,45811,45812,91623
48680,,9wyasdu9cwuj,45812,45813,91625
48681,,vbbmuaylqiuj,45813,45814,91627
48682,,vzungnqq0r0j,45814,45815,91629
48683,,uu0xkrfhfbcj,45815,45816,91631
48684,,url:http://www.csa.com/partners/viewrecord.php3frequester3dgs26collection3dtrd26recid3dn9210472ah,45816,45817,91633
48685,,,45817,45818,91635
48686,,9yn1ljygj0cj,45818,45819,91637
48687,,qp6rm3-hbjuj,45819,45820,91639
48688,,zrkswyp872gj,45820,45821,91641
48689,,mfmnuuqpx4sj,45821,45822,91643
48690,,2ycmljr2rkqj,45822,45823,91645
48691,,rc8zr1m-kykj,45823,45824,91647
48692,,6mc5nny96z4j,45824,45825,91649
48693,,epo0w9vqq6kj,45825,45826,91651
48694,,lcrnmbfxc8ej,45826,45827,91653
48695,,veu5mkl2oa8j,45827,45828,91655
48696,,38t0qixtc20j,45828,45829,91657
48697,,w60uxltcogmj,45829,45830,91659
48698,,6ssfeafvjwcj,45830,45831,91661
48699,,5aqoy7rfwsmj,45831,45832,91663
48700,,unc_man-4k4j,45832,45833,91665
48701,,_dy2q_fowxuj,45833,45834,91667
48702,,tbi7rug4zhqj,45834,45835,91669
48703,,c3tldlqg12oj,45835,45836,91671
48704,,,45836,45837,91673
48705,,_6vht0v2kt8j,45837,45838,91675
48706,,r9wjyz3m7jsj,45838,45839,91677
48707,,0zvkamwwp80j,45839,45840,91679
48708,,xiel1kerdtcj,45840,45841,91681
48709,,xgh1hoet0moj,45841,45842,91683
48710,,btixgqve3rij,45842,45843,91685
48711,,ragmw0tbq9oj,45843,45844,91687
48712,,xvv524euwyoj,45844,45845,91689
48713,,j0m81yetjbgj,45846,45847,91693
48714,,d6wxnxgzs0kj,45847,45848,91695
48715,,muz1u31qbz0j,45848,45849,91697
48716,,ilrcjx04m4qj,45849,45850,91699
48717,,b7peoi_8k0wj,45850,45851,91701
48718,,brxrycqgweqj,45851,45852,91703
48719,,taxjqlfqq_uj,45852,45853,91705
48720,,v42nlphqjcaj,45853,45854,91707
48721,,co7mezmewe4j,45854,45855,91709
48722,,jlqwub1uhykj,45855,45856,91711
48723,,vitnhnmyeb8j,45856,45857,91713
48724,,fugguy1sf4ej,45857,45858,91715
48725,,bhflug9oeiej,45858,45859,91717
48726,,_omuf5x1n-0j,45860,45861,91721
48727,,sl5ffav_duqj,45861,45862,91723
48728,,w693cj3q_fkj,45862,45863,91725
48729,,url:http://www.csa.com/partners/viewrecord.php3frequester3dgs26collection3dtrd26recid3dn9210522ah,45863,45864,91727
48730,,ocpyqkptnhqj,45864,45865,91729
48731,,psi_txai8voj,45865,45866,91731
48732,,fpnkj2jwk1cj,45866,45867,91733
48733,,r1dtuzdk_dsj,45867,45868,91735
48734,,skmljtg_vaij,45868,45869,91737
48735,,jmlgou516w8j,45869,45870,91739
48736,,ac59zcu_3gsj,45870,45871,91741
48737,,aop7texoiyqj,45871,45872,91743
48738,,mwn9l9pnaawj,45872,45873,91745
48739,,osoopul5vdyj,45873,45874,91747
48740,,m5oxzogzbamj,45874,45875,91749
48741,,tycci2dndboj,45875,45876,91751
48742,,frtfidu3-4sj,45876,45877,91753
48743,,po021l61rq4j,45877,45878,91755
48744,,r30ivk44om0j,45878,45879,91757
48745,,urppvolm9ryj,45879,45880,91759
48746,,ap5ocasv73yj,45880,45881,91761
48747,,_4bbccr8qhaj,45881,45882,91763
48748,,adkfa7nlhqsj,45882,45883,91765
48749,,v2jpkmgnjuoj,45883,45884,91767
48750,,t19psygam1ej,45884,45885,91769
48751,,prip3vfqtpej,45885,45886,91771
48752,,url:http://portal.acm.org/citation.cfm3fid3d234286.1057833,45886,45887,91773
48753,,zp2huzvqaz0j,45887,45888,91775
48754,,k-oqqq5n3zsj,45888,45889,91777
48755,,,45889,45890,91779
48756,,ederpj6dhpuj,45890,45891,91781
48757,,u5loyg1_dtaj,45891,45892,91783
48758,,7u5nahqrjayj,45892,45893,91785
48759,,nekq-ie8c04j,45893,45894,91787
48760,,lg6usyhegnqj,45894,45895,91789
48761,,v0deskhinmqj,45895,45896,91791
48762,,gn6zxa1aiwmj,45896,45897,91793
48763,,jqrog5j5fesj,45897,45898,91795
48764,,h51hc_amerkj,45898,45899,91797
48765,,url:http://www.csa.com/partners/viewrecord.php3frequester3dgs26collection3dtrd26recid3dn9210464ah,45899,45900,91799
48766,,zlysiub53eoj,45900,45901,91801
48767,,url:http://portal.acm.org/ft_gateway.cfm3fid3d106624426type3dpdf,45901,45902,91803
48768,,viuzppbpwe0j,45902,45903,91805
48769,,tz-dwrvzwe0j,45903,45904,91807
48770,,u1hec2w1vwmj,45905,45906,91811
48771,,ahozbgex7vuj,45906,45907,91813
48772,,qfeoklqrsyoj,45907,45908,91815
48773,,jl7umf7fs88j,45908,45909,91817
48774,,6bv3nkpdpgqj,45909,45910,91819
48775,,g38zjchdixuj,45910,45911,91821
48776,,bttecnfn-nmj,45911,45912,91823
48777,,okskgd3yeyqj,45912,45913,91825
48778,,w5tfis6juekj,45913,45914,91827
48779,,lxze0i0lwqwj,45914,45915,91829
48780,,_nisj-0lkiaj,45915,45916,91831
48781,,url:http://www.csa.com/partners/viewrecord.php3frequester3dgs26collection3dtrd26recid3dn9210373ah,45916,45917,91833
48782,,1eafjzq7smkj,45917,45918,91835
48783,,bry-7gb2qusj,45918,45919,91837
48784,,k_wehf7dpykj,45919,45920,91839
48785,,hsymtshy_yuj,45920,45921,91841
48786,,0sytjmx-yfij,45922,45923,91845
48787,,7pmpwktpzayj,45923,45924,91847
48788,,qy9ybkdqyh8j,45924,45925,91849
48789,,jjb2g9hknnqj,45925,45926,91851
48790,,rerg7gda73ij,45926,45927,91853
48791,,ljhhxr0iutcj,45927,45928,91855
48792,,xfarrb25ru4j,45928,45929,91857
48793,,9cckstscayej,45929,45930,91859
48794,,thsxadj2a2oj,45930,45931,91861
48795,,d8wtyacqy70j,45931,45932,91863
48796,,3q8ncgugjpqj,45932,45933,91865
48797,,url:http://www.ncbi.nlm.nih.gov/entrez/query.fcgi3fcmd3dretrieve26db3dpubmed26list_uids3d1280952126dopt3dcitation,45933,45934,91867
48798,,xencsjet208j,45934,45935,91869
48799,,kkj2broy-ruj,45935,45936,91871
48800,,9puxd8wyc8qj,45936,45937,91873
48801,,f4ahy7fcimcj,45937,45938,91875
48802,,4yhwre1-slkj,45938,45939,91877
48803,,xtwtblbehxwj,45939,45940,91879
48804,,,45940,45941,91881
48805,,84fgsaoslyaj,45941,45942,91883
48806,,ieedmnanivgj,45942,45943,91885
48807,,xmvkl_0gxi0j,45943,45944,91887
48808,,mgrzyskoxowj,45944,45945,91889
48809,,fooaa5qhx_qj,45945,45946,91891
48810,,gtaefye8zhmj,45946,45947,91893
48811,,kl3cf1fa64oj,45947,45948,91895
48812,,bd_1t_ecswoj,45948,45949,91897
48813,,5imo2877qgcj,45949,45950,91899
48814,,9zn0dh6lhxsj,45950,45951,91901
48815,,cm5laum0wwuj,45951,45952,91903
48816,,6-pmjw7eidcj,45952,45953,91905
48817,,idsc8pya68wj,45955,45956,91911
48818,,6epxu-ytmr4j,45956,45957,91913
48819,,_uwgrllh_2cj,45957,45958,91915
48820,,98g2zghc2xyj,45958,45959,91917
48821,,zefrgpef0haj,45959,45960,91919
48822,,f-apxyutf5mj,45960,45961,91921
48823,,fuvq08aw4agj,45961,45962,91923
48824,,6uz9bnud0cuj,45962,45963,91925
48825,,ugm_c72l_m4j,45963,45964,91927
48826,,jgbel2ppczqj,45964,45965,91929
48827,,n5jgruabmt0j,45965,45966,91931
48828,,m2h1sbqdyqyj,45966,45967,91933
48829,,64c1zewf5jkj,45967,45968,91935
48830,,oryzeyclfwej,45968,45969,91937
48831,,7yk9bg_ixmij,45969,45970,91939
48832,,c5p1s9c1owgj,45970,45971,91941
48833,,gqxtqog6x-sj,45971,45972,91943
48834,,2f-rmsvm8c4j,45972,45973,91945
48835,,pftn--id3hcj,45973,45974,91947
48836,,cp12kxdzgmyj,45974,45975,91949
48837,,zp--hf4kjmaj,45975,45976,91951
48838,,lvcgz_0zvsgj,45976,45977,91953
48839,,oynyctdlmcoj,45977,45978,91955
48840,,c3nz2pxuc1uj,45978,45979,91957
48841,,u6mrtuu3prcj,45979,45980,91959
48842,,ilpaqefxv58j,45980,45981,91961
48843,,ymhsedovgnwj,45981,45982,91963
48844,,7xqd9sqajhgj,45982,45983,91965
48845,,url:http://doi.wiley.com/10.1002/ev.1409,45983,45984,91967
48846,,url:http://adsabs.harvard.edu/abs/1981gazt...10..159z,45984,45985,91969
48847,,fmabevneorcj,45985,45986,91971
48848,,avafnmc0hg4j,45986,45987,91973
48849,,viqp9rwuxwsj,45987,45988,91975
48850,,ebbfxuhn5_gj,45988,45989,91977
48851,,03jp0o8wk6wj,45989,45990,91979
48852,,rs2jt_a8nboj,45990,45991,91981
48853,,clveet92xzij,45991,45992,91983
48854,,wcwl4r5t5gwj,45992,45993,91985
48855,,1wwp-kqc5l4j,45993,45994,91987
48856,,x0qhqwmzdmej,45995,45996,91991
48857,,7fgcizub2mgj,45996,45997,91993
48858,,55njfbxihraj,45997,45998,91995
48859,,yji-jsahigkj,45998,45999,91997
48860,,mk2ni9hpmoaj,45999,46000,91999
48861,,yvkm-liyeiqj,46000,46001,92001
48862,,xmdoxy_m1ayj,46001,46002,92003
48863,,jifefd8zl0gj,46002,46003,92005
48864,,bejcxcnfyhaj,46003,46004,92007
48865,,igs3ttqfkugj,46004,46005,92009
48866,,lrc7obqv9bij,46005,46006,92011
48867,,x4511mro76sj,46006,46007,92013
48868,,4kkvhdrimmij,46007,46008,92015
48869,,rwoxht4eywkj,46008,46009,92017
48870,,jatlkcgq1nkj,46009,46010,92019
48871,,ian_8gavpnaj,46010,46011,92021
48872,,url:http://doi.wiley.com/10.1002/ace.49,46011,46012,92023
48873,,zsvwnsvwluyj,46012,46013,92025
48874,,qxl7b0le2m8j,46013,46014,92027
48875,,url:http://doi.wiley.com/10.1002/ace.146,46014,46015,92029
48876,,azjpnptqzwsj,46015,46016,92031
48877,,2npqy6jxiycj,46016,46017,92033
48878,,l3xm1d_p91gj,46017,46018,92035
48879,,m-hdidywtvmj,46018,46019,92037
48880,,kl7a49pqkluj,46019,46020,92039
48881,,lkmdafnw4eqj,46021,46022,92043
48882,,fnfwsyk9e9gj,46022,46023,92045
48883,,ub1wyswtrquj,46023,46024,92047
48884,,ezt0kzxna3oj,46024,46025,92049
48885,,jazpbjzp6k8j,46025,46026,92051
48886,,2t2zs9y_q4gj,46026,46027,92053
48887,,ngou52tv_r4j,46027,46028,92055
48888,,o35csdjhcccj,46028,46029,92057
48889,,wks02qpoivcj,46029,46030,92059
48890,,h_ze08zlmkuj,46030,46031,92061
48891,,aqhwl8cnyjwj,46031,46032,92063
48892,,url:http://portal.acm.org/citation.cfm3fid3d1101908.1101995,46032,46033,92065
48893,,xmncf9glweij,46033,46034,92067
48894,,6vok45qxv2qj,46034,46035,92069
48895,,lcaxz1gaw5cj,46035,46036,92071
48896,,dvb8tnztzeyj,46036,46037,92073
48897,,m8ofvbxxatuj,46037,46038,92075
48898,,v4naswqz530j,46038,46039,92077
48899,,1oonwk_qkfaj,46039,46040,92079
48900,,stt0pagxtjkj,46040,46041,92081
48901,,kna2utpj4qqj,46041,46042,92083
48902,,7s9j5aom5tgj,46042,46043,92085
48903,,j37vuwpfioyj,46043,46044,92087
48904,,url:http://www.csa.com/partners/viewrecord.php3frequester3dgs26collection3dtrd26recid3dn9210428ah,46044,46045,92089
48905,,ot5-utn7jawj,46045,46046,92091
48906,,r-yzn6axdzaj,46046,46047,92093
48907,,c1n2ohcqmyej,46047,46048,92095
48908,,dzdetdhusrwj,46048,46049,92097
48909,,cwlzsbbt2vaj,46049,46050,92099
48910,,5til4_smkgkj,46050,46051,92101
48911,,qhufqcapl8wj,46051,46052,92103
48912,,bbizj3k1czwj,46052,46053,92105
48913,,nrg1cgeriikj,46053,46054,92107
48914,,yyarcubhj_mj,46054,46055,92109
48915,,j-hdquisylkj,46055,46056,92111
48916,,ict5zfkomhoj,46056,46057,92113
48917,,tk6jacktdq8j,46057,46058,92115
48918,,swsxhtnda-aj,46058,46059,92117
48919,,qt-hs70kdg0j,46059,46060,92119
48920,,v8t4uxbzia0j,46060,46061,92121
48921,,3cmnzshx7koj,46061,46062,92123
48922,,yvvztaj19gij,46062,46063,92125
48923,,stnflip8zl8j,46063,46064,92127
48924,,,46064,46065,92129
48925,,dbzpkoxfr2sj,46065,46066,92131
48926,,ep8dd1qbe3aj,46066,46067,92133
48927,,jbuvtxsucb0j,46067,46068,92135
48928,,xfuiky5aodoj,46068,46069,92137
48929,,kgtwnx94ezuj,46069,46070,92139
48930,,vlcwivefe-4j,46070,46071,92141
48931,,f4ceam5mjlyj,46071,46072,92143
48932,,url:http://adsabs.harvard.edu/abs/1973phdt.........1g,46072,46073,92145
48933,,7l9eyilojygj,46073,46074,92147
48934,,rmxvwzp31goj,46074,46075,92149
48935,,rhexfxyxavmj,46075,46076,92151
48936,,a1a7lfalwuwj,46076,46077,92153
48937,,ciubaby0glqj,46077,46078,92155
48938,,ulxrg7ybn5oj,46078,46079,92157
48939,,yjgitjdv8g0j,46079,46080,92159
48940,,tyh8wyg4nwqj,46080,46081,92161
48941,,cggin1kmmhuj,46081,46082,92163
48942,,998kcfcxuwej,46082,46083,92165
48943,,b1f0sv4j0zuj,46083,46084,92167
48944,,hti1tvkcmqaj,46084,46085,92169
48945,,0lrbtte_fsyj,46085,46086,92171
48946,,a2l7saunezkj,46086,46087,92173
48947,,lbhzzewwcbqj,46088,46089,92177
48948,,d67rgjaaetej,46089,46090,92179
48949,,7kqbkn1leyqj,46090,46091,92181
48950,,5q3980unebgj,46093,46094,92187
48951,,ockygvki_kwj,46094,46095,92189
48952,,url:http://doi.wiley.com/10.1002/tl.6909,46095,46096,92191
48953,,url:http://www.csa.com/partners/viewrecord.php3frequester3dgs26collection3dtrd26recid3da8622949ah,46096,46097,92193
48954,,5dgwnqizx3cj,46097,46098,92195
48955,,nw9vybmsqfoj,46098,46099,92197
48956,,luh8esqpnrcj,46099,46100,92199
48957,,lxbpamlnpogj,46100,46101,92201
48958,,defymfo2jpyj,46101,46102,92203
48959,,lo5wckj60qmj,46102,46103,92205
48960,,nlna-xelm08j,46103,46104,92207
48961,,e5uww_u7mhsj,46104,46105,92209
48962,,url:http://ieeexplore.ieee.org/iel5/9217/29235/01320089.pdf3farnumber3d1320089,46105,46106,92211
48963,,waypc34fpn4j,46106,46107,92213
48964,,ufg3awtrxyyj,46107,46108,92215
48965,,awgtiqgxs7qj,46108,46109,92217
48966,,vmpeo178ye4j,46109,46110,92219
48967,,blwhtt2je90j,46110,46111,92221
48968,,ra2ftaesyuoj,46111,46112,92223
48969,,bjjh-4yqm4yj,46112,46113,92225
48970,,ws_kvdaydh8j,46113,46114,92227
48971,,jbb4svdpbf8j,46114,46115,92229
48972,,rqxipzxzeaoj,46116,46117,92233
48973,,hjk-ml_qiomj,46117,46118,92235
48974,,9sofuw9daaoj,46118,46119,92237
48975,,vj8ysyretwmj,46119,46120,92239
48976,,ida89erzuusj,46120,46121,92241
48977,,jghxk_1w2_sj,46121,46122,92243
48978,,6la4nn1fmtqj,46122,46123,92245
48979,,squ8znidi50j,46123,46124,92247
48980,,qjb9nwdxz_oj,46124,46125,92249
48981,,k53eicg4ta8j,46125,46126,92251
48982,,6jtmofoz71wj,46126,46127,92253
48983,,ky7hdq9gpsyj,46127,46128,92255
48984,,_le5t2vkpucj,46128,46129,92257
48985,,0j9o6qbmzmej,46129,46130,92259
48986,,a0hyotcwqnqj,46130,46131,92261
48987,,joav4goamvyj,46131,46132,92263
48988,,7d9gpbgxxogj,46132,46133,92265
48989,,uaob9o42w5aj,46133,46134,92267
48990,,ndvk5c1hjjmj,46134,46135,92269
48991,,ykj9uhflgnkj,46135,46136,92271
48992,,z8hjlpomptsj,46136,46137,92273
48993,,ixliwkqzgdcj,46137,46138,92275
48994,,ltg0fgslxxqj,46138,46139,92277
48995,,url:http://www.springerlink.com/index/x554442136601718.pdf,46140,46141,92281
48996,,lbmoz_xv5sej,46141,46142,92283
48997,,iq8hu-evmwyj,46142,46143,92285
48998,,yhwsmlsy7haj,46143,46144,92287
48999,,jo126rtjkvsj,46144,46145,92289
49000,,url:http://www.csa.com/partners/viewrecord.php3frequester3dgs26collection3dtrd26recid3dn9210419ah,46145,46146,92291
49001,,nlsavk-oyeij,46146,46147,92293
49002,,bdbjlcsypjcj,46147,46148,92295
49003,,pw7knflkhboj,46148,46149,92297
49004,,xhz_wupndxmj,46149,46150,92299
49005,,mfvgyfd6e20j,46150,46151,92301
49006,,cndexr-lu8oj,46151,46152,92303
49007,,fmj3dq1ftzmj,46152,46153,92305
49008,,vaj3spzpxpcj,46153,46154,92307
49009,,d8grjk3iei0j,46154,46155,92309
49010,,vec7xiniznaj,46155,46156,92311
49011,,5z1wfdftffmj,46156,46157,92313
49012,,d5hqqeqbdlej,46157,46158,92315
49013,,q65wwqsyamej,46158,46159,92317
49014,,f9bjedtxc0qj,46159,46160,92319
49015,,dka3cxyrtwuj,46160,46161,92321
49016,,ngbnvhi1cqij,46161,46162,92323
49017,,9kblathinxij,46162,46163,92325
49018,,ke1er5_6e7qj,46163,46164,92327
49019,,snjiqix1h7yj,46164,46165,92329
49020,,werjietnu5wj,46165,46166,92331
49021,,dpbjqjcuydcj,46166,46167,92333
49022,,url:http://portal.acm.org/citation.cfm3fid3d509252.509276,46167,46168,92335
49023,,q-0irdrw47wj,46168,46169,92337
49024,,6rqr_jv_ptmj,46169,46170,92339
49025,,0pg4fhje4xcj,46170,46171,92341
49026,,ukuxkzimuh4j,46171,46172,92343
49027,,deswaqaelhcj,46172,46173,92345
49028,,cavmzd1b_tcj,46173,46174,92347
49029,,amqa7q5xegmj,46174,46175,92349
49030,,vkfvzzfes_4j,46175,46176,92351
49031,,dxjeofhdbyij,46176,46177,92353
49032,,pt5n4ppdsmej,46177,46178,92355
49033,,8k4i5kxqevyj,46178,46179,92357
49034,,upb4sqft3k0j,46179,46180,92359
49035,,kj3mvmggcyej,46180,46181,92361
49036,,lvtk1s-s8qaj,46181,46182,92363
49037,,jn9kk4x-gb4j,46182,46183,92365
49038,,edjjol-k2icj,46183,46184,92367
49039,,3qfrxqkesuqj,46184,46185,92369
49040,,il9kgasnepgj,46185,46186,92371
49041,,fwperttdtrmj,46186,46187,92373
49042,,2qkz6bu5mbuj,46187,46188,92375
49043,,va_ytbbnegej,46188,46189,92377
49044,,l-t9tzr5fekj,46190,46191,92381
49045,,url:http://www.springerlink.com/index/x256555608656055.pdf,46191,46192,92383
49046,,j7g4zm0q2eaj,46192,46193,92385
49047,,l7vxwllli0mj,46193,46194,92387
49048,,url:http://portal.acm.org/ft_gateway.cfm3fid3d106624726type3dpdf,46194,46195,92389
49049,,4ucxjaqre5kj,46195,46196,92391
49050,,22x3_h68m5ij,46196,46197,92393
49051,,puhsr4jvg0cj,46197,46198,92395
49052,,qj9cndz7-1wj,46198,46199,92397
49053,,url:http://portal.acm.org/ft_gateway.cfm3fid3d110132526type3dpdf,46199,46200,92399
49054,,qlpetgwg1jij,46200,46201,92401
49055,,fympjipf8ckj,46201,46202,92403
49056,,bw4thuvuxbsj,46202,46203,92405
49057,,9ofjbtsyr9sj,46203,46204,92407
49058,,luveus4vzkgj,46204,46205,92409
49059,,ajdywucfzg4j,46205,46206,92411
49060,,cubgkesclakj,46206,46207,92413
49061,,w_kdmjt_ywoj,46207,46208,92415
49062,,ffyxqvxwqd0j,46208,46209,92417
49063,,lwomoyftbqcj,46209,46210,92419
49064,,envzuuxvmyuj,46210,46211,92421
49065,,_onwunade8ij,46211,46212,92423
49066,,yztqfwbzu6ej,46212,46213,92425
49067,,ggx0qwtznlkj,46213,46214,92427
49068,,stbozeqswmij,46214,46215,92429
49069,,tlggh8n4rmmj,46215,46216,92431
49070,,xbkplx1m9daj,46216,46217,92433
49071,,l9h6480krhgj,46217,46218,92435
49072,,zy5ygtzmetoj,46218,46219,92437
49073,,2blgpit7inej,46219,46220,92439
49074,,aap-jc1z6wkj,46220,46221,92441
49075,,sknclom2s3ij,46221,46222,92443
49076,,tpct1e53jv4j,46222,46223,92445
49077,,l7huoqfgw08j,46223,46224,92447
49078,,u7-pgdsw4yij,46224,46225,92449
49079,,rwc1vajesvgj,46225,46226,92451
49080,,c5jfm5lkgj0j,46226,46227,92453
49081,,c-sn4uiog-cj,46227,46228,92455
49082,,yt4lku_os6qj,46228,46229,92457
49083,,wbncozq04maj,46229,46230,92459
49084,,bqzowooolkij,46230,46231,92461
49085,,822q30z4gnkj,46231,46232,92463
49086,,dpcewiiqfvej,46232,46233,92465
49087,,ajbqujdk2i4j,46233,46234,92467
49088,,url:http://www.csa.com/partners/viewrecord.php3frequester3dgs26collection3dtrd26recid3d0691552ci,46235,46236,92471
49089,,9nwvjxjd7ysj,46236,46237,92473
49090,,4n-zfsga33yj,46237,46238,92475
49091,,d_rfm7sa_-uj,46238,46239,92477
49092,,vrxbzlpoidaj,46239,46240,92479
49093,,gazvkfcwuo4j,46240,46241,92481
49094,,yizv-d5ojvaj,46241,46242,92483
49095,,homfgci8zlwj,46242,46243,92485
49096,,diwhj9jwq30j,46243,46244,92487
49097,,b-_xknihq-ej,46244,46245,92489
49098,,lzgtv8tm9yoj,46245,46246,92491
49099,,_oiaapy2h9ej,46246,46247,92493
49100,,rejwqbru7haj,46247,46248,92495
49101,,tpc-5fktb6sj,46248,46249,92497
49102,,io1b514xp9yj,46249,46250,92499
49103,,bvljttcn4bij,46250,46251,92501
49104,,w1haekslycwj,46251,46252,92503
49105,,b8vwhwnp_kij,46252,46253,92505
49106,,abyvxoaxjygj,46253,46254,92507
49107,,qvcxurh24saj,46254,46255,92509
49108,,haffoqxc0y4j,46255,46256,92511
49109,,bxrpscts6f4j,46256,46257,92513
49110,,v5yet_3pjyyj,46257,46258,92515
49111,,wxpdgbz2i_uj,46258,46259,92517
49112,,ibsnztq347ej,46259,46260,92519
49113,,_lyvm4frfcej,46260,46261,92521
49114,,iiktbmnemiej,46261,46262,92523
49115,,dbpmdxm-xsaj,46262,46263,92525
49116,,rexoxydrw90j,46263,46264,92527
49117,,55cxtkew_rwj,46264,46265,92529
49118,,1xfltyr2i2uj,46265,46266,92531
49119,,4twcfxbycvwj,46266,46267,92533
49120,,sv1rxzj89wgj,46267,46268,92535
49121,,vyslifitu4aj,46268,46269,92537
49122,,v-o39agjib4j,46269,46270,92539
49123,,wm7cniufvqyj,46270,46271,92541
49124,,url:http://www.csa.com/partners/viewrecord.php3frequester3dgs26collection3dtrd26recid3d200404612243mt,46271,46272,92543
49125,,ioslrc7vxd0j,46272,46273,92545
49126,,lvbtpnhhn78j,46273,46274,92547
49127,,uju4t2hyomuj,46274,46275,92549
49128,,yffz4hzd1-ij,46275,46276,92551
49129,,37taohjjq5qj,46276,46277,92553
49130,,qlbmvucl96kj,46277,46278,92555
49131,,1eo8r0htttuj,46278,46279,92557
49132,,l1v86vtdhq8j,46279,46280,92559
49133,,url:http://www.springerlink.com/index/p56563666744g6wx.pdf,46280,46281,92561
49134,,5ynan3w7c5qj,46282,46283,92565
49135,,uzhjor4jamyj,46283,46284,92567
49136,,ujjywcrve18j,46284,46285,92569
49137,,b3k04mzw80oj,46285,46286,92571
49138,,e6mmujohxoij,46286,46287,92573
49139,,url:http://www.ingentaconnect.com/search/expand3fpub3dinfobike://pep/jae/2001/00000215/00000001/art0000226unc3d,46287,46288,92575
49140,,kis8sg1jg_kj,46288,46289,92577
49141,,b31uo05woocj,46289,46290,92579
49142,,u5lubw2mstyj,46290,46291,92581
49143,,hrywecmfg3gj,46291,46292,92583
49144,,zporgh4nbtuj,46292,46293,92585
49145,,bflzp1c7e1cj,46293,46294,92587
49146,,ioutqcd-uh8j,46294,46295,92589
49147,,i6shqe8uxhwj,46295,46296,92591
49148,,z0_ozstykruj,46296,46297,92593
49149,,louraim8hwmj,46297,46298,92595
49150,,mzoxc5mzwoyj,46298,46299,92597
49151,,9cczku0zgmcj,46299,46300,92599
49152,,tfvwjjgioqgj,46301,46302,92603
49153,,xnfz4nru6wij,46302,46303,92605
49154,,uxptbdsdkjaj,46303,46304,92607
49155,,mylvk93jdkoj,46304,46305,92609
49156,,cbwkcxeudp4j,46305,46306,92611
49157,,lre5mhoufd4j,46306,46307,92613
49158,,url:http://portal.acm.org/citation.cfm3fid3d30984426dl3dguide26dl3dacm26type3dissue26idx3dj68926part3dperiodical26wanttype3dperiodical26title3dacm2520sigmod2520record26cfid3d1111111126cftoken3d2222222,46307,46308,92615
49159,,5bjawygc4sij,46308,46309,92617
49160,,8tox4lwaswcj,46309,46310,92619
49161,,hpxwojacaxaj,46310,46311,92621
49162,,vtht5mjz8c4j,46311,46312,92623
49163,,b3vetdjescaj,46312,46313,92625
49164,,4lifeg724kkj,46315,46316,92631
49165,,5w-ohyfkhrsj,46316,46317,92633
49166,,wyuk5rqzpooj,46317,46318,92635
49167,,di9c1asnd8sj,46318,46319,92637
49168,,kkhvqyoqb4mj,46319,46320,92639
49169,,7-1xyixiblaj,46320,46321,92641
49170,,m3elkaz4wbmj,46321,46322,92643
49171,,f3lh7e2eogcj,46322,46323,92645
49172,,0iwizgvcpxsj,46323,46324,92647
49173,,1q_siisph7mj,46324,46325,92649
49174,,tu50k-9n3uyj,46325,46326,92651
49175,,sotnmu2ikk4j,46326,46327,92653
49176,,yclopnavsu0j,46327,46328,92655
49177,,ewlhh1dvp_gj,46328,46329,92657
49178,,kb2rz3qow1uj,46329,46330,92659
49179,,_p_zxmqkqywj,46330,46331,92661
49180,,url:http://pubs.acs.org/cgi-bin/abstract.cgi/achre4/2005/38/i03/abs/ar040234d.html,46331,46332,92663
49181,,ui-4ik477rij,46332,46333,92665
49182,,5bsmowr6zjij,46333,46334,92667
49183,,fddn_csgmpej,46334,46335,92669
49184,,pqrwsplclwsj,46335,46336,92671
49185,,jg-7y2y3uksj,46336,46337,92673
49186,,url:http://www.csa.com/partners/viewrecord.php3frequester3dgs26collection3denv26recid3d3050895,46337,46338,92675
49187,,hnlwq-z1h9gj,46338,46339,92677
49188,,v2dj2um3euoj,46339,46340,92679
49189,,hams7a_odjwj,46340,46341,92681
49190,,uhj8fzag6aej,46341,46342,92683
49191,,dnuxz3ph-zaj,46342,46343,92685
49192,,lp7a4lniel8j,46343,46344,92687
49193,,af9_5ebdp9gj,46344,46345,92689
49194,,rpygtdplyiwj,46345,46346,92691
49195,,url:http://www.springerlink.com/index/p761k52n10785362.pdf,46346,46347,92693
49196,,ortglh1835aj,46347,46348,92695
49197,,yrydf1nzleuj,46348,46349,92697
49198,,u-yavp6w5imj,46350,46351,92701
49199,,xsvrlub6_9cj,46351,46352,92703
49200,,lzmbdasfoa8j,46352,46353,92705
49201,,xa-fkffdjjyj,46353,46354,92707
49202,,eyklmxnwvnmj,46354,46355,92709
49203,,ir2azmauf7ej,46355,46356,92711
49204,,n7vl1ia_w-uj,46356,46357,92713
49205,,kcez7wn1y0yj,46357,46358,92715
49206,,8vhpkbldckyj,46358,46359,92717
49207,,l_fvwfi_cryj,46359,46360,92719
49208,,2nfcythmxg4j,46360,46361,92721
49209,,ivo-6m4gv6aj,46361,46362,92723
49210,,url:http://www.ingentaconnect.com/search/expand3fpub3dinfobike://els/09505849/2004/00000046/00000002/art0011326unc3d,46362,46363,92725
49211,,iz-btynuiekj,46363,46364,92727
49212,,ri-q6n1spruj,46364,46365,92729
49213,,4qw8wm_kupcj,46365,46366,92731
49214,,itg_xrygxxij,46366,46367,92733
49215,,tj4jvh0tsr0j,46367,46368,92735
49216,,url:http://www.csa.com/partners/viewrecord.php3frequester3dgs26collection3dtrd26recid3d20021211001545mt26recid3da8622924ah,46368,46369,92737
49217,,v6y4ttmymkyj,46369,46370,92739
49218,,ytjvndag5jqj,46370,46371,92741
49219,,url:http://ieeexplore.ieee.org/iel5/2/4048/x0715521.pdf,46371,46372,92743
49220,,hwfqswkdn2aj,46372,46373,92745
49221,,url:http://portal.acm.org/citation.cfm3fid3d983061.98306226coll3dguide26dl3dacm26idx3dj68926part3dperiodical26wanttype3dperiodical26title3dacm2520sigmod2520record26cfid3d1111111126cftoken3d2222222,46373,46374,92747
49222,,kn416e4dmrkj,46374,46375,92749
49223,,obecemyt-jcj,46375,46376,92751
49224,,w8kyqwzl474j,46376,46377,92753
49225,,u0ffocgkl1ij,46377,46378,92755
49226,,10fi7xnq3faj,46378,46379,92757
49227,,x6m1l4ghiywj,46379,46380,92759
49228,,lqbmpq053taj,46380,46381,92761
49229,,tpdxgg-lr20j,46381,46382,92763
49230,,vvaiqexfxyaj,46382,46383,92765
49231,,atmh7hi0kgij,46383,46384,92767
49232,,eboenxlsbz8j,46384,46385,92769
49233,,hc2rfhrp120j,46385,46386,92771
49234,,chrut-azmbuj,46386,46387,92773
49235,,s5wkc854qaej,46387,46388,92775
49236,,f3jx9sirp40j,46388,46389,92777
49237,,url:http://www.csa.com/partners/viewrecord.php3frequester3dgs26collection3dtrd26recid3da8622979ah,46389,46390,92779
49238,,unqvp9sfjf8j,46390,46391,92781
49239,,zgosuntzvwyj,46391,46392,92783
49240,,lyafuxxila4j,46392,46393,92785
49241,,pwloepwyydwj,46393,46394,92787
49242,,qgfsjc7unwwj,46394,46395,92789
49243,,yd9cr1ifbdyj,46395,46396,92791
49244,,zkp8-mw7by8j,46396,46397,92793
49245,,url:http://www.springerlink.com/index/q762581260122040.pdf,46397,46398,92795
49246,,2zt92yculkqj,46398,46399,92797
49247,,ywmpe5s-owgj,46399,46400,92799
49248,,kwz7dz1vvvwj,46400,46401,92801
49249,,gjiojpipnhuj,46401,46402,92803
49250,,vzg-6ayxknuj,46402,46403,92805
49251,,gy-0y7q1ib8j,46403,46404,92807
49252,,crkwd-dyxiej,46404,46405,92809
49253,,5jzwoff649cj,46405,46406,92811
49254,,ajqbkqurl9ij,46406,46407,92813
49255,,39gbaesev1mj,46407,46408,92815
49256,,p-e8gddsxtgj,46408,46409,92817
49257,,gpqjs5w7j9cj,46409,46410,92819
49258,,m7ia59vei2wj,46410,46411,92821
49259,,url:http://portal.acm.org/ft_gateway.cfm3fid3d109959926type3dpdf,46411,46412,92823
49260,,rn9zbguqohwj,46412,46413,92825
49261,,_l7bdisxofgj,46413,46414,92827
49262,,ypmhajkghvaj,46414,46415,92829
49263,,sum_xa80p_uj,46415,46416,92831
49264,,gllzh88comcj,46416,46417,92833
49265,,dalrcpg3-dqj,46417,46418,92835
49266,,8hcya5ihfvaj,46418,46419,92837
49267,,xcvyt78mj84j,46419,46420,92839
49268,,wglqvj1kncij,46420,46421,92841
49269,,ww5orcjrzh8j,46421,46422,92843
49270,,wsd3pj9rwhkj,46422,46423,92845
49271,,jbszzl476qoj,46423,46424,92847
49272,,7_37yhod37uj,46424,46425,92849
49273,,zt8-dtz7xowj,46425,46426,92851
49274,,s8veooxex0sj,46427,46428,92855
49275,,sw3wp_yaycaj,46428,46429,92857
49276,,8a9nxxe4xiwj,46429,46430,92859
49277,,13nbtnanfiej,46430,46431,92861
49278,,ftrap39lksaj,46431,46432,92863
49279,,ho_7mgcawq4j,46432,46433,92865
49280,,azcrwym4hv4j,46433,46434,92867
49281,,ggva2pgfhiqj,46435,46436,92871
49282,,hkirmyh9booj,46436,46437,92873
49283,,nrmyfngiv8cj,46437,46438,92875
49284,,ndr4-cvtbd8j,46438,46439,92877
49285,,ivlxs82-psmj,46439,46440,92879
49286,,imasakfuksyj,46440,46441,92881
49287,,7tirn0-g8u0j,46441,46442,92883
49288,,9871xrkpcnkj,46442,46443,92885
49289,,eczpw2rzarkj,46443,46444,92887
49290,,ec-wxcbcatuj,46444,46445,92889
49291,,uqokctimcgkj,46445,46446,92891
49292,,rkxdeyms_lsj,46446,46447,92893
49293,,fgfliec-ajaj,46447,46448,92895
49294,,p4x2qt5_1pkj,46448,46449,92897
49295,,fhoge_yopswj,46449,46450,92899
49296,,pkhezhy3nzoj,46450,46451,92901
49297,,tcqanlgqdcyj,46451,46452,92903
49298,,ly-spr1tey4j,46452,46453,92905
49299,,ewgd5rclkucj,46454,46455,92909
49300,,zgg1snrc_wcj,46456,46457,92913
49301,,r7nhtkylnggj,46457,46458,92915
49302,,umcugl6zq3kj,46458,46459,92917
49303,,tqaabok4zlqj,46459,46460,92919
49304,,plvjwz3m3d0j,46460,46461,92921
49305,,ehwcsagr6zyj,46461,46462,92923
49306,,xoqk-c9uiiqj,46462,46463,92925
49307,,ypm3utugsaij,46463,46464,92927
49308,,idmyomvnjkij,46464,46465,92929
49309,,url:http://www.kluweronline.com/article.asp3fpips3d26214326pdf3d1,46465,46466,92931
49310,,url:http://portal.acm.org/ft_gateway.cfm3fid3d109973026type3dpdf,46466,46467,92933
49311,,cwgngfx97zaj,46467,46468,92935
49312,,holr3xoxxduj,46468,46469,92937
49313,,db9pjqzt1iej,46469,46470,92939
49314,,hins_zwcwlgj,46470,46471,92941
49315,,q1lr2c3pk1cj,46471,46472,92943
49316,,qchujpssinmj,46472,46473,92945
49317,,pvpyozcw2joj,46473,46474,92947
49318,,cnzg5sgaiymj,46474,46475,92949
49319,,rkoujsl6btkj,46475,46476,92951
49320,,4sxfogcxtecj,46476,46477,92953
49321,,9rd0ke5ku8aj,46477,46478,92955
49322,,eata97lcqiwj,46478,46479,92957
49323,,re_vvoxjglwj,46479,46480,92959
49324,,ru5zccaihiej,46480,46481,92961
49325,,vsueserfwnsj,46481,46482,92963
49326,,lqcppxk-vlkj,46482,46483,92965
49327,,,46483,46484,92967
49328,,d_ud6qqo1coj,46484,46485,92969
49329,,lwy2grwhjxyj,46485,46486,92971
49330,,p-smv4s3e4qj,46486,46487,92973
49331,,fsi5qvl7scaj,46487,46488,92975
49332,,kmdmjn5j7caj,46489,46490,92979
49333,,ffaf1tjounoj,46490,46491,92981
49334,,2khukb0x3c0j,46491,46492,92983
49335,,nvm3q8av6c8j,46492,46493,92985
49336,,cxb7ublwnv4j,46493,46494,92987
49337,,hdisxseym-qj,46494,46495,92989
49338,,pqq8rd3akyij,46495,46496,92991
49339,,ubyruy1tit0j,46496,46497,92993
49340,,rab_gmhg718j,46497,46498,92995
49341,,1egyai3qp3ej,46498,46499,92997
49342,,uijktiag2wkj,46499,46500,92999
49343,,sb1iid-yb8oj,46500,46501,93001
49344,,kziyxror0umj,46501,46502,93003
49345,,lpejbwhw8fqj,46502,46503,93005
49346,,gyfeb75yp5gj,46503,46504,93007
49347,,1wld03qi-osj,46504,46505,93009
49348,,evxmey_jcvuj,46505,46506,93011
49349,,1iktgfzvalsj,46506,46507,93013
49350,,qhz4e16ckxgj,46507,46508,93015
49351,,gztfmfjw2n0j,46508,46509,93017
49352,,sn8au2mv4pmj,46510,46511,93021
49353,,swqlb6sv2icj,46511,46512,93023
49354,,q9iesuhvqkwj,46512,46513,93025
49355,,fggitu1s1nkj,46513,46514,93027
49356,,cfd6fs2cfqcj,46514,46515,93029
49357,,93ypqrzhtn8j,46515,46516,93031
49358,,3oi5s9ujz3uj,46516,46517,93033
49359,,cofpi57x0naj,46517,46518,93035
49360,,ikuruzasi68j,46518,46519,93037
49361,,qlsjh4g1-4kj,46519,46520,93039
49362,,cl0q4zxie8ij,46520,46521,93041
49363,,ltqvfhtxxtaj,46521,46522,93043
49364,,wazzd5lhjvcj,46522,46523,93045
49365,,mzyg-o6a0roj,46523,46524,93047
49366,,1ybpv9qdchyj,46524,46525,93049
49367,,url:http://portal.acm.org/citation.cfm3fid3d54176.54179,46525,46526,93051
49368,,ye5gcl4plkgj,46526,46527,93053
49369,,3ivrjjmjvwuj,46527,46528,93055
49370,,_3suojcwhgcj,46528,46529,93057
49371,,uk8njdspvn8j,46529,46530,93059
49372,,uoeerk7xjuej,46530,46531,93061
49373,,swjbq2yujjoj,46531,46532,93063
49374,,aya8al-wxjmj,46532,46533,93065
49375,,tl1cnalhdpmj,46533,46534,93067
49376,,_c3ekj7bcoaj,46534,46535,93069
49377,,tl5fgizwddcj,46535,46536,93071
49378,,frgs7vdadwkj,46536,46537,93073
49379,,c5ljwiozuigj,46537,46538,93075
49380,,whmbo-sfdi0j,46538,46539,93077
49381,,qmig--fagqsj,46539,46540,93079
49382,,tmvfcm3ivbuj,46540,46541,93081
49383,,obr8ehsxazoj,46541,46542,93083
49384,,pkyixfl06jej,46542,46543,93085
49385,,6azkrfridcyj,46543,46544,93087
49386,,6njkvk5orzaj,46544,46545,93089
49387,,unq9j4wabaaj,46545,46546,93091
49388,,t2fm7wb1ak4j,46546,46547,93093
49389,,opzqolosfnsj,46547,46548,93095
49390,,url:http://doi.wiley.com/10.1002/he.97,46548,46549,93097
49391,,0r1wsa3cgccj,46549,46550,93099
49392,,url:http://links.jstor.org/sici3fsici3d0146-4949(196523)6253a3253c368253ac1(253e2.0.co253b2-i,46550,46551,93101
49393,,qtnsi26m-xej,46551,46552,93103
49394,,hsfrydor0wwj,46552,46553,93105
49395,,eidyppi09wcj,46553,46554,93107
49396,,thpcowwcaesj,46554,46555,93109
49397,,url:http://portal.acm.org/ft_gateway.cfm3fid3d102776526type3dpdf,46555,46556,93111
49398,,8qmwyrpv_yej,46556,46557,93113
49399,,ydcuapeqkiyj,46557,46558,93115
49400,,pbrjuee9xtyj,46558,46559,93117
49401,,6tcr1tewcqmj,46560,46561,93121
49402,,dko1y6okjf4j,46561,46562,93123
49403,,4_csxm873zaj,46562,46563,93125
49404,,5su466r4w1mj,46563,46564,93127
49405,,url:http://portal.acm.org/ft_gateway.cfm3fid3d94573926type3dpdf26dl3dguide26dl3dacm26cfid3d1111111126cftoken3d2222222,46564,46565,93129
49406,,gtmtavrv_x4j,46565,46566,93131
49407,,w-ymsbnz0uuj,46566,46567,93133
49408,,zskudiqjnaij,46567,46568,93135
49409,,q7szc66xv_yj,46568,46569,93137
49410,,z7fhkqztfv0j,46569,46570,93139
49411,,jfiewpv4w8kj,46570,46571,93141
49412,,wfd3qacnc1ej,46571,46572,93143
49413,,r1dxvdrhxeij,46572,46573,93145
49414,,url:http://portal.acm.org/ft_gateway.cfm3fid3d108379726type3dpdf,46573,46574,93147
49415,,yisrs36vp-0j,46574,46575,93149
49416,,ixnwnm-mebij,46575,46576,93151
49417,,url:http://www.springerlink.com/index/jwgumv8ydl893e3v.pdf,46576,46577,93153
49418,,nhu_8o_9sy0j,46577,46578,93155
49419,,2qb6xpzafbmj,46578,46579,93157
49420,,kbtcq9wh3g4j,46579,46580,93159
49421,,irpaxafli2uj,46580,46581,93161
49422,,e7gpftwkq7qj,46581,46582,93163
49423,,6okfobebs5oj,46582,46583,93165
49424,,yhun_yiwiouj,46583,46584,93167
49425,,fscpm85qfccj,46584,46585,93169
49426,,z4_tr_rhvouj,46585,46586,93171
49427,,url:http://www.springerlink.com/index/j367l81p37l3x40m.pdf,46586,46587,93173
49428,,stk4aaolgpqj,46587,46588,93175
49429,,url:http://portal.acm.org/ft_gateway.cfm3fid3d106626826type3dpdf,46588,46589,93177
49430,,qsch5skmxr0j,46589,46590,93179
49431,,ilgslphnrimj,46590,46591,93181
49432,,uhwegmyjgauj,46591,46592,93183
49433,,ozl1xlsrvo4j,46592,46593,93185
49434,,q_6vosbogq4j,46593,46594,93187
49435,,97o54f1eupcj,46594,46595,93189
49436,,b7b2l4nhq3cj,46595,46596,93191
49437,,r2a4osfrt9qj,46596,46597,93193
49438,,fcvofue8c9aj,46597,46598,93195
49439,,gfhzihfsigej,46598,46599,93197
49440,,7qrq6rchoquj,46599,46600,93199
49441,,l4ujf_-z2uej,46600,46601,93201
49442,,p7jagu7k2-ij,46601,46602,93203
49443,,zt5isbwprf8j,46602,46603,93205
49444,,uq-pffsnbusj,46603,46604,93207
49445,,ebvqpxwjzt0j,46604,46605,93209
49446,,,46605,46606,93211
49447,,dnvfuzgbx0yj,46606,46607,93213
49448,,o_pqmi8xphej,46608,46609,93217
49449,,djxsxlusnk4j,46610,46611,93221
49450,,url:http://www.csa.com/partners/viewrecord.php3frequester3dgs26collection3dtrd26recid3d1841299ci,46611,46612,93223
49451,,wpnohycoabmj,46612,46613,93225
49452,,e9vn_ty3oiqj,46614,46615,93229
49453,,q__v4o7rj5gj,46615,46616,93231
49454,,ubd5_94qodyj,46616,46617,93233
49455,,1zjyhvv0chyj,46617,46618,93235
49456,,tzuxfh8dd9sj,46618,46619,93237
49457,,lbxftnl391aj,46619,46620,93239
49458,,0xwjlzhvmdmj,46620,46621,93241
49459,,xsopi5s-v0gj,46621,46622,93243
49460,,q53pxqv0zqcj,46622,46623,93245
49461,,g8diqo47rwaj,46623,46624,93247
49462,,url:http://portal.acm.org/ft_gateway.cfm3fid3d101603126type3dpdf,46624,46625,93249
49463,,erd-jz3y8m8j,46626,46627,93253
49464,,fz49cduxcu0j,46627,46628,93255
49465,,,46628,46629,93257
49466,,rcwtd_hfdiyj,46629,46630,93259
49467,,dqje8vu7w4yj,46630,46631,93261
49468,,url:http://www.springerlink.com/index/x37082h836r285j3.pdf,46632,46633,93265
49469,,5ca6wob3x-wj,46633,46634,93267
49470,,dwfh-vqfjtkj,46634,46635,93269
49471,,q2hnlqdfpowj,46635,46636,93271
49472,,ra1tqrq91lgj,46636,46637,93273
49473,,ekmuvrcp29qj,46637,46638,93275
49474,,1iztztkr3q0j,46638,46639,93277
49475,,jth_6g5743ej,46639,46640,93279
49476,,wtvrxhhq4jyj,46640,46641,93281
49477,,zw67mz8avaoj,46642,46643,93285
49478,,8egraddu7ycj,46643,46644,93287
49479,,,46644,46645,93289
49480,,jvtgllff5poj,46646,46647,93293
49481,,8elhciztiskj,46647,46648,93295
49482,,8sfbmxelvcsj,46648,46649,93297
49483,,4_hxm4m-accj,46649,46650,93299
49484,,,46650,46651,93301
49485,,url:http://www.csa.com/partners/viewrecord.php3frequester3dgs26collection3dtrd26recid3d20021212033327mt26recid3da7212160ah,46651,46652,93303
49486,,qwzd2r17fnkj,46652,46653,93305
49487,,nsamaxqdnvij,46653,46654,93307
49488,,h6r5rxre-_qj,46654,46655,93309
49489,,_3qqpjjtixwj,46655,46656,93311
49490,,1qof8f7robyj,46656,46657,93313
49491,,uwogoqlmvyoj,46657,46658,93315
49492,,jcs7o6vqijmj,46658,46659,93317
49493,,mechs7gpm08j,46659,46660,93319
49494,,m7juhzspgxwj,46660,46661,93321
49495,,1zgxzviqblkj,46661,46662,93323
49496,,szmrat79cf0j,46662,46663,93325
49497,,xg5igdb3e4cj,46663,46664,93327
49498,,w1uld1trj-ij,46664,46665,93329
49499,,n0eay0ebk-8j,46665,46666,93331
49500,,n3oivfow0oej,46666,46667,93333
49501,,lozptbrqcaaj,46667,46668,93335
49502,,emteilcdiiej,46668,46669,93337
49503,,lda0jhj5xfaj,46669,46670,93339
49504,,ucttjpoxcyej,46670,46671,93341
49505,,52tu1ooqlmsj,46671,46672,93343
49506,,zyjadd7tfcwj,46672,46673,93345
49507,,ri3eweyhkmwj,46673,46674,93347
49508,,sbjxev8ws7aj,46674,46675,93349
49509,,rpag_wow_f8j,46675,46676,93351
49510,,7dhy_ctbtrcj,46676,46677,93353
49511,,5-ghofxjm3wj,46677,46678,93355
49512,,obqmcftbpk0j,46678,46679,93357
49513,,gkaq1kc32awj,46679,46680,93359
49514,,_hk3p6wnej0j,46680,46681,93361
49515,,kcjyidfyjlsj,46681,46682,93363
49516,,mi9edwaviqkj,46682,46683,93365
49517,,t9kc_uufipsj,46684,46685,93369
49518,,mu6fdtzhqowj,46686,46687,93373
49519,,url:http://portal.acm.org/ft_gateway.cfm3fid3d35320726type3dpdf26dl3dguide26dl3dacm26cfid3d1111111126cftoken3d2222222,46687,46688,93375
49520,,uavymkyitjaj,46688,46689,93377
49521,,1h1o_ye_338j,46689,46690,93379
49522,,wxx-mjcparqj,46690,46691,93381
49523,,jmq_siixnsej,46691,46692,93383
49524,,2yaauc8tc9mj,46692,46693,93385
49525,,nlb102ug0nsj,46693,46694,93387
49526,,f0q2ptecssuj,46694,46695,93389
49527,,o_e94ncorwkj,46695,46696,93391
49528,,bshl4melagqj,46696,46697,93393
49529,,mopntgu-kwoj,46697,46698,93395
49530,,pyxzkdzbrvaj,46698,46699,93397
49531,,a-yt8vj4simj,46699,46700,93399
49532,,5ae7xtuvarkj,46700,46701,93401
49533,,lyxti5i2dcyj,46701,46702,93403
49534,,yhtrkw9ciluj,46702,46703,93405
49535,,wg-saaqaxscj,46703,46704,93407
49536,,lwbtbxj5ukij,46704,46705,93409
49537,,7jdggei7xwej,46705,46706,93411
49538,,biz0m_6rtp0j,46706,46707,93413
49539,,ci71yd2ue8oj,46707,46708,93415
49540,,mkxguzbc7baj,46708,46709,93417
49541,,hrtxufuiubmj,46709,46710,93419
49542,,q65_ulq8rkcj,46710,46711,93421
49543,,pek3lo6cp24j,46711,46712,93423
49544,,hoq-clkdjr4j,46712,46713,93425
49545,,qzkw0fnejgqj,46713,46714,93427
49546,,w7sgq64dqv4j,46714,46715,93429
49547,,r7mz_7uekakj,46715,46716,93431
49548,,25mpy39dwl8j,46716,46717,93433
49549,,5hct9llkammj,46717,46718,93435
49550,,m9pddnur0goj,46718,46719,93437
49551,,wk30w01f6msj,46719,46720,93439
49552,,ondfp_x1ugaj,46720,46721,93441
49553,,qad_tih7zaoj,46721,46722,93443
49554,,n_w5hnwjak4j,46722,46723,93445
49555,,p99v6jvhrguj,46723,46724,93447
49556,,w9x1gwd4uuej,46724,46725,93449
49557,,wz715jhhthqj,46725,46726,93451
49558,,q6sq3tqyqfej,46726,46727,93453
49559,,zr9jdw6bk0gj,46727,46728,93455
49560,,ftoaurhh_vyj,46728,46729,93457
49561,,,46729,46730,93459
49562,,bmzpt85kiqoj,46730,46731,93461
49563,,gj4sej0x8b4j,46731,46732,93463
49564,,hdfqfpy_0doj,46732,46733,93465
49565,,eiuqbqmkzksj,46733,46734,93467
49566,,upgpoxj1tnej,46734,46735,93469
49567,,pqu6mb6pc1aj,46735,46736,93471
49568,,s8qqn7jj5ayj,46736,46737,93473
49569,,si0p_2q_svqj,46737,46738,93475
49570,,pkt9injraryj,46738,46739,93477
49571,,ojvgblxisiqj,46739,46740,93479
49572,,pwwjg7p6pjqj,46741,46742,93483
49573,,mxcvj8zajqcj,46742,46743,93485
49574,,ait_t-q07fij,46743,46744,93487
49575,,mn50niecvpgj,46744,46745,93489
49576,,ebfgw3sbt6cj,46745,46746,93491
49577,,whwa6vbvwj0j,46746,46747,93493
49578,,qeqlzcazoymj,46747,46748,93495
49579,,cyegqwadbxmj,46748,46749,93497
49580,,i9v2yb4y69cj,46750,46751,93501
49581,,88e0dfrxrrsj,46751,46752,93503
49582,,ekvoyu2cf5mj,46752,46753,93505
49583,,wnzkfsh-iuaj,46753,46754,93507
49584,,1kgv2luq_oaj,46754,46755,93509
49585,,zbmpvs5i_osj,46755,46756,93511
49586,,l66zx_gabcuj,46756,46757,93513
49587,,bybuxz2lrm0j,46757,46758,93515
49588,,url:http://www.springerlink.com/index/axrtpdypvjqhadpx.pdf,46758,46759,93517
49589,,91g9nkuwizej,46759,46760,93519
49590,,fra3cl3fqf4j,46760,46761,93521
49591,,v1j7ssmd06mj,46761,46762,93523
49592,,8dmntzt05h8j,46762,46763,93525
49593,,02rqjhqakvaj,46763,46764,93527
49594,,kdtwwriqsruj,46764,46765,93529
49595,,1hpcna1q35mj,46765,46766,93531
49596,,e11edwy1oaoj,46766,46767,93533
49597,,7-j_ejr-0ycj,46767,46768,93535
49598,,njd9indsy_ej,46768,46769,93537
49599,,6y9er-083rij,46769,46770,93539
49600,,a4lu0axx1d0j,46770,46771,93541
49601,,vzfn64sa5w8j,46771,46772,93543
49602,,wtgwo3r7c-sj,46772,46773,93545
49603,,rrud5k5duuoj,46773,46774,93547
49604,,ersswtlza1sj,46774,46775,93549
49605,,x7up4tci140j,46775,46776,93551
49606,,pxt5midtnloj,46776,46777,93553
49607,,xt90atucckej,46777,46778,93555
49608,,iyivdgrttqoj,46778,46779,93557
49609,,erh1fbouzkmj,46779,46780,93559
49610,,8xz3v-rlswqj,46780,46781,93561
49611,,k3ce_d_5z1wj,46781,46782,93563
49612,,guxhb17o7jej,46783,46784,93567
49613,,mhkrmyna60sj,46784,46785,93569
49614,,wlnauskogn4j,46785,46786,93571
49615,,zje4gz7ijiuj,46786,46787,93573
49616,,url:http://www.csa.com/partners/viewrecord.php3frequester3dgs26collection3dtrd26recid3dn9210382ah,46787,46788,93575
49617,,aewreg_nd2cj,46788,46789,93577
49618,,rj5urndi1qkj,46789,46790,93579
49619,,nz8qzxb4rwcj,46791,46792,93583
49620,,rr_fcf2vfqyj,46792,46793,93585
49621,,hjx3ae6azs0j,46793,46794,93587
49622,,llovpdrxdjoj,46794,46795,93589
49623,,rbagzl0il7sj,46795,46796,93591
49624,,d9x3wad2yqij,46796,46797,93593
49625,,cseycjglldaj,46797,46798,93595
49626,,ppmaimdbdxkj,46798,46799,93597
49627,,miktkoq0jigj,46799,46800,93599
49628,,t3vwndl68yoj,46800,46801,93601
49629,,url:http://doi.wiley.com/10.1002/ev.1266,46801,46802,93603
49630,,yomjd7tkrwgj,46802,46803,93605
49631,,m8vy5zp_--gj,46803,46804,93607
49632,,8zd1gd4k7y4j,46804,46805,93609
49633,,arvivfvd99qj,46805,46806,93611
49634,,gpajqutmkrqj,46806,46807,93613
49635,,-93fcochhqqj,46807,46808,93615
49636,,9q5h8xknrzmj,46808,46809,93617
49637,,xilqsks5ogoj,46809,46810,93619
49638,,vg5xzrobkyuj,46810,46811,93621
49639,,yzkqtnaqw7kj,46811,46812,93623
49640,,igjxrw4h-iwj,46812,46813,93625
49641,,ssz9p5ec_eyj,46813,46814,93627
49642,,epu8llrozywj,46814,46815,93629
49643,,,46815,46816,93631
49644,,giur8uexctmj,46816,46817,93633
49645,,vvhx_4tkyt4j,46817,46818,93635
49646,,jkdcnh97t_wj,46818,46819,93637
49647,,4uudj8d45owj,46819,46820,93639
49648,,url:http://www.csa.com/partners/viewrecord.php3frequester3dgs26collection3denv26recid3d8913251,46820,46821,93641
49649,,9ydmzdk1aeuj,46821,46822,93643
49650,,5crxuuwv5ggj,46822,46823,93645
49651,,mdlgpc5ebuej,46823,46824,93647
49652,,lv0hwh9qluqj,46824,46825,93649
49653,,zqns5oghb5ij,46825,46826,93651
49654,,bjqg9ueshemj,46826,46827,93653
49655,,sem5d3er9bmj,46827,46828,93655
49656,,kpnz5k5qdnaj,46828,46829,93657
49657,,g3c5sitglwej,46829,46830,93659
49658,,gw4igv2kolaj,46831,46832,93663
49659,,w-pjo8hwsroj,46832,46833,93665
49660,,gbom-kbsgjkj,46833,46834,93667
49661,,9kvfclykjw8j,46834,46835,93669
49662,,gv07whpprvgj,46835,46836,93671
49663,,fta4fpjga1ij,46836,46837,93673
49664,,hmznje-btgkj,46837,46838,93675
49665,,nviad_q2clgj,46838,46839,93677
49666,,cbr1v2bxpgaj,46839,46840,93679
49667,,6-7pvzk9chij,46840,46841,93681
49668,,hjjyv6cbf1sj,46841,46842,93683
49669,,ebxkin6znw0j,46842,46843,93685
49670,,vbsrifqgnxcj,46843,46844,93687
49671,,77fdioco8naj,46844,46845,93689
49672,,cvwqu-x23gqj,46845,46846,93691
49673,,fpdir0spkc4j,46846,46847,93693
49674,,1sgncmwlv3oj,46847,46848,93695
49675,,1c8_wntasvaj,46848,46849,93697
49676,,k2inujbvwvoj,46849,46850,93699
49677,,zodluihjmymj,46850,46851,93701
49678,,ixzcjtjav2mj,46851,46852,93703
49679,,qtfr7ufmc6cj,46852,46853,93705
49680,,uh84z2rleiuj,46854,46855,93709
49681,,vgk4bgeykvqj,46855,46856,93711
49682,,melmtunypfwj,46856,46857,93713
49683,,vwyuc9zbgcmj,46857,46858,93715
49684,,onllkkgfyluj,46858,46859,93717
49685,,,46859,46860,93719
49686,,bc0lng2_qnqj,46860,46861,93721
49687,,zd1ktpjis-oj,46862,46863,93725
49688,,uxsv-peqeogj,46863,46864,93727
49689,,url:http://www.geography.org.uk/journals/journals.asp3farticleid3d73,46864,46865,93729
49690,,hdq_omtbgmgj,46865,46866,93731
49691,,1bnf_i4mhd0j,46866,46867,93733
49692,,u6d5axpkny4j,46867,46868,93735
49693,,oh9v3kczlayj,46868,46869,93737
49694,,hjispprlp6gj,46870,46871,93741
49695,,url:http://ieeexplore.ieee.org/iel4/5812/15497/00718123.pdf3farnumber3d718123,46871,46872,93743
49696,,url:http://www.csa.com/partners/viewrecord.php3frequester3dgs26collection3dtrd26recid3dn9210533ah,46872,46873,93745
49697,,hw8iardkcaaj,46873,46874,93747
49698,,v3zc4at8nr4j,46874,46875,93749
49699,,axpijgr6hcoj,46875,46876,93751
49700,,irhjaqups74j,46876,46877,93753
49701,,nu4ypbikzpsj,46877,46878,93755
49702,,olsmkby0b2oj,46878,46879,93757
49703,,xrrbbkvrzv8j,46879,46880,93759
49704,,a85d2sjkfkej,46880,46881,93761
49705,,rucjbu_hcjuj,46881,46882,93763
49706,,wwggquerrtgj,46882,46883,93765
49707,,jafxondhirij,46883,46884,93767
49708,,cbdxcx5fzoyj,46884,46885,93769
49709,,ar7odetp7ksj,46885,46886,93771
49710,,1ovxogtbuhuj,46886,46887,93773
49711,,grkopqyssbsj,46887,46888,93775
49712,,95sahapr-mej,46888,46889,93777
49713,,po7xczpal1ej,46889,46890,93779
49714,,2uspfdvxbxuj,46890,46891,93781
49715,,brwghsdqdiwj,46891,46892,93783
49716,,asu30jpqiomj,46892,46893,93785
49717,,5le8kazcshuj,46893,46894,93787
49718,,_udnt63wdiej,46894,46895,93789
49719,,wylyak98wegj,46895,46896,93791
49720,,482nzg01odoj,46896,46897,93793
49721,,mtlymfpwliuj,46897,46898,93795
49722,,8qw5iquaseoj,46898,46899,93797
49723,,yafpq21lfmqj,46899,46900,93799
49724,,,46900,46901,93801
49725,,knltn4lzkioj,46903,46904,93807
49726,,8clo3vcyveuj,46904,46905,93809
49727,,umv0le83cqoj,46905,46906,93811
49728,,jcwnajxyvosj,46906,46907,93813
49729,,mfaa0hmrgtuj,46907,46908,93815
49730,,z3nqt34aydoj,46908,46909,93817
49731,,9mdq5hfjnf0j,46909,46910,93819
49732,,hnpqexkyjemj,46910,46911,93821
49733,,lqqtbqei0ayj,46911,46912,93823
49734,,gkmw8q5ofucj,46912,46913,93825
49735,,p8o5aqoof7gj,46913,46914,93827
49736,,nnndkozennej,46914,46915,93829
49737,,9fr46wnmsv4j,46915,46916,93831
49738,,npkq7k8vue8j,46916,46917,93833
49739,,5kbnkoheukij,46917,46918,93835
49740,,4qnm7f3mzlkj,46918,46919,93837
49741,,qcasofpk2iej,46919,46920,93839
49742,,lbfngx3ydouj,46920,46921,93841
49743,,url:http://www.kluweronline.com/article.asp3fpips3d525848226pdf3d1,46921,46922,93843
49744,,19t6bcmy2nuj,46922,46923,93845
49745,,qb-jf_sq_5kj,46923,46924,93847
49746,,x6m0rokfmvkj,46924,46925,93849
49747,,_t9foffxspej,46925,46926,93851
49748,,koqlnpudjmsj,46926,46927,93853
49749,,rsywwl2en2aj,46927,46928,93855
49750,,url:http://www.csa.com/partners/viewrecord.php3frequester3dgs26collection3denv26recid3d9062,46928,46929,93857
49751,,yicd9qg7hlaj,46929,46930,93859
49752,,4f4l907jbbcj,46930,46931,93861
49753,,zge0cgmmdqsj,46931,46932,93863
49754,,7h61acim640j,46932,46933,93865
49755,,7iskilv90mgj,46934,46935,93869
49756,,09hxue5pcxuj,46935,46936,93871
49757,,0dix01oalz4j,46937,46938,93875
49758,,pcuwyxzzwpqj,46938,46939,93877
49759,,nehdmq2gdb0j,46939,46940,93879
49760,,url:http://links.jstor.org/sici3fsici3d0146-4949(196624252f21)7253a1253c125253atnnsaa253e2.0.co253b2-y,46940,46941,93881
49761,,wvnepd1-9maj,46941,46942,93883
49762,,iqww40yf0ucj,46942,46943,93885
49763,,lzjnikyuwxej,46943,46944,93887
49764,,abjzallwdzwj,46944,46945,93889
49765,,rlwnsoidbkej,46945,46946,93891
49766,,u2u9iqxho7aj,46946,46947,93893
49767,,yhcbi8dhilaj,46947,46948,93895
49768,,url:http://doi.wiley.com/10.1002/tl.7702,46948,46949,93897
49769,,cv4jdtkdb78j,46949,46950,93899
49770,,ukiu5k61z0gj,46951,46952,93903
49771,,j33ngajiq2sj,46952,46953,93905
49772,,eybfrwpztmoj,46953,46954,93907
49773,,xtchuhxddtcj,46954,46955,93909
49774,,8hbi9ik4lwyj,46955,46956,93911
49775,,hjc-bttkpssj,46956,46957,93913
49776,,mf-ixfwqmqoj,46957,46958,93915
49777,,_gefynajjiqj,46958,46959,93917
49778,,gwez2zm3kdqj,46959,46960,93919
49779,,url:http://portal.acm.org/ft_gateway.cfm3fid3d29060426type3dpdf26coll3dguide26dl3dacm26cfid3d1111111126cftoken3d2222222,46960,46961,93921
49780,,zz_jxfzkk1gj,46961,46962,93923
49781,,diz7pebdxdgj,46962,46963,93925
49782,,mdf_d24qy5uj,46963,46964,93927
49783,,url:http://portal.acm.org/ft_gateway.cfm3fid3d1583826type3dpdf,46964,46965,93929
49784,,zklymtugc4kj,46965,46966,93931
49785,,fbqrtsroyygj,46966,46967,93933
49786,,0ww6wbtoaa4j,46967,46968,93935
49787,,zxrvtpo8ioij,46968,46969,93937
49788,,xnzmewrwnacj,46969,46970,93939
49789,,mugimjtoty4j,46970,46971,93941
49790,,zvcga0eemzkj,46971,46972,93943
49791,,brcut9e862sj,46972,46973,93945
49792,,m9bne3mymsaj,46973,46974,93947
49793,,,46974,46975,93949
49794,,1y6w4qkerxmj,46975,46976,93951
49795,,jonhsuv6yfyj,46976,46977,93953
49796,,pckkilr6lvsj,46977,46978,93955
49797,,cj72qjiv3-yj,46978,46979,93957
49798,,q6lsujzciosj,46979,46980,93959
49799,,cja1mzuauvcj,46980,46981,93961
49800,,acjq07vwbgej,46981,46982,93963
49801,,j993u-tajdaj,46982,46983,93965
49802,,v6qydrmrmxaj,46983,46984,93967
49803,,ebflolnlyfqj,46984,46985,93969
49804,,oap-w0wi4ncj,46985,46986,93971
49805,,qjz6o0cyri4j,46986,46987,93973
49806,,pwo1z2m3odmj,46987,46988,93975
49807,,ss_xhkklelmj,46988,46989,93977
49808,,faglfcz1vqyj,46989,46990,93979
49809,,ejvbx21wae4j,46990,46991,93981
49810,,bmjr8lwrh2cj,46991,46992,93983
49811,,v32j9mehc0mj,46992,46993,93985
49812,,upowyvcpe74j,46993,46994,93987
49813,,ornfmfxohbkj,46994,46995,93989
49814,,xn9h7skwtpgj,46995,46996,93991
49815,,qytjfva7e28j,46996,46997,93993
49816,,dtydqdpt-eaj,46997,46998,93995
49817,,url:http://portal.acm.org/citation.cfm3fid3d320434.32043626dl3dguide26dl3dacm26idx3dj77726part3dperiodical26wanttype3dperiodical26title3dacm2520transactions2520on2520database2520systems2520(tods)26cfid3d1111111126cftoken3d2222222,46998,46999,93997
49818,,wbohtbnkvyij,46999,47000,93999
49819,,tuea5trdg3qj,47000,47001,94001
49820,,x6irtgwxlncj,47001,47002,94003
49821,,fvowpwn972sj,47002,47003,94005
49822,,blco5rbp2wmj,47003,47004,94007
49823,,url:http://www.ingentaconnect.com/search/expand3fpub3dinfobike://els/13891286/2002/00000040/00000001/art0026226unc3d,47004,47005,94009
49824,,url:http://portal.acm.org/ft_gateway.cfm3fid3d13034026type3dpdf26dl3dportal26dl3dacm26cfid3d1111111126cftoken3d2222222,47005,47006,94011
49825,,wiea230c9qaj,47006,47007,94013
49826,,,47007,47008,94015
49827,,k1r1mqdjkg8j,47008,47009,94017
49828,,9r2ugxbxvq0j,47009,47010,94019
49829,,rjk-xb-kkr8j,47010,47011,94021
49830,,vguhmueiksej,47011,47012,94023
49831,,73f60ipfi-wj,47013,47014,94027
49832,,7fktytkfeaqj,47014,47015,94029
49833,,cfa7wfqyl6ej,47015,47016,94031
49834,,xdn_ljuxv5wj,47016,47017,94033
49835,,6ou49ed76ryj,47017,47018,94035
49836,,aq8utuzz7toj,47018,47019,94037
49837,,wuhkytlyfzsj,47019,47020,94039
49838,,tjozi-h6txcj,47020,47021,94041
49839,,nujqicosfusj,47021,47022,94043
49840,,sxdre-nopiyj,47022,47023,94045
49841,,qggifcm-zvyj,47023,47024,94047
49842,,h5ktuodcm-oj,47024,47025,94049
49843,,xsj_kugfn_yj,47025,47026,94051
49844,,jqq5rublusij,47026,47027,94053
49845,,vyoxy-p01jwj,47027,47028,94055
49846,,url:http://portal.acm.org/ft_gateway.cfm3fid3d30612426type3dpdf26dl3dguide26dl3dacm26cfid3d1111111126cftoken3d2222222,47028,47029,94057
49847,,ztruoisrvb0j,47029,47030,94059
49848,,2d9kwe3rlt4j,47030,47031,94061
49849,,,47031,47032,94063
49850,,0dz-dlos5l4j,47032,47033,94065
49851,,yjat0znrtg4j,47033,47034,94067
49852,,g70lbyo7ksaj,47034,47035,94069
49853,,_4dbqhdugrmj,47035,47036,94071
49854,,url:http://portal.acm.org/citation.cfm3fid3d50225,47036,47037,94073
49855,,ntlat1nyamsj,47037,47038,94075
49856,,h1qziu5cr1sj,47038,47039,94077
49857,,xlq52rgkqqgj,47039,47040,94079
49858,,3reg1drv9ksj,47040,47041,94081
49859,,agmdwemzbmoj,47041,47042,94083
49860,,t9f2eh-zqogj,47042,47043,94085
49861,,slpmqxla5fij,47043,47044,94087
49862,,jmzcbcautrij,47044,47045,94089
49863,,mkbu9kirc6oj,47045,47046,94091
49864,,wtd34b68xeuj,47046,47047,94093
49865,,cxbpyakuvbaj,47047,47048,94095
49866,,wmbq-mwa-b8j,47048,47049,94097
49867,,ohhmgza7sl8j,47049,47050,94099
49868,,jigz7pbvutmj,47050,47051,94101
49869,,4h5qj8tvocgj,47051,47052,94103
49870,,url:http://www.csa.com/partners/viewrecord.php3frequester3dgs26collection3dtrd26recid3d1030223ci,47052,47053,94105
49871,,37x5vr_rv98j,47053,47054,94107
49872,,ormlnq3s9xij,47054,47055,94109
49873,,t49scm3c0nej,47055,47056,94111
49874,,1w32rjsdq44j,47056,47057,94113
49875,,,47057,47058,94115
49876,,ufganbqezuoj,47058,47059,94117
49877,,pwoxlhvy-cwj,47059,47060,94119
49878,,url:http://links.jstor.org/sici3fsici3d0146-4949(196624252f21)7253a1253c47253aarl253e2.0.co253b2-x,47061,47062,94123
49879,,gbeuku4fc18j,47062,47063,94125
49880,,vi1lyedzoi0j,47063,47064,94127
49881,,sqecohthvaaj,47064,47065,94129
49882,,rxr3ytd37ykj,47065,47066,94131
49883,,udoz6_y__h0j,47066,47067,94133
49884,,qwuw1kbzj40j,47067,47068,94135
49885,,eyvkntv3kmyj,47068,47069,94137
49886,,vcsu2b6bmwgj,47069,47070,94139
49887,,osga8-vypxyj,47070,47071,94141
49888,,pxwaffbsapyj,47071,47072,94143
49889,,n_jsubbcv7kj,47072,47073,94145
49890,,pr49xescbwsj,47073,47074,94147
49891,,iuqgflxi8quj,47074,47075,94149
49892,,url:http://doi.wiley.com/10.1002/ace.102,47075,47076,94151
49893,,3183a_lhvmqj,47076,47077,94153
49894,,bcgfgczwxaij,47077,47078,94155
49895,,swbza_nxjm8j,47078,47079,94157
49896,,rr-e0fkaniqj,47079,47080,94159
49897,,9mdzofv3l3mj,47080,47081,94161
49898,,p51bfilb1-qj,47081,47082,94163
49899,,3yu3bjmklg4j,47082,47083,94165
49900,,dcdcvmyvvsej,47083,47084,94167
49901,,ckwlekxc25wj,47084,47085,94169
49902,,sj0p8g88tgyj,47085,47086,94171
49903,,haruwrv0oucj,47086,47087,94173
49904,,g-z-zak4hw8j,47087,47088,94175
49905,,geb8jhjfingj,47088,47089,94177
49906,,7cnpzttejysj,47089,47090,94179
49907,,yy56iljgkh8j,47090,47091,94181
49908,,hj--lz3dzwkj,47091,47092,94183
49909,,3xaof045hwkj,47092,47093,94185
49910,,b3q2e7etjmkj,47093,47094,94187
49911,,7utwfpk0foaj,47094,47095,94189
49912,,uxiqn5sh1moj,47095,47096,94191
49913,,ejhvtrwzuiwj,47096,47097,94193
49914,,0qlslat-gjmj,47097,47098,94195
49915,,4j8fh4q5kfej,47098,47099,94197
49916,,uuvqa1l36mmj,47099,47100,94199
49917,,4zgbimzkfh4j,47100,47101,94201
49918,,5rupfwbwaz0j,47101,47102,94203
49919,,stv8twd25zej,47102,47103,94205
49920,,qqpied0qczmj,47103,47104,94207
49921,,d_bibp1xti4j,47104,47105,94209
49922,,hapthpha1w0j,47105,47106,94211
49923,,apakgjmctlaj,47106,47107,94213
49924,,5lfmsd-p-jej,47107,47108,94215
49925,,2ljvvwhfv3cj,47108,47109,94217
49926,,kbw2xjry_dij,47109,47110,94219
49927,,7vsmgcomxjej,47110,47111,94221
49928,,url:http://links.jstor.org/sici3fsici3d0146-4949(196324)4253a1253c21253atpwatn253e2.0.co253b2-m,47111,47112,94223
49929,,,47112,47113,94225
49930,,mmc_ybxjf_mj,47113,47114,94227
49931,,oz2sznu3zmaj,47114,47115,94229
49932,,8wgmas8bbscj,47115,47116,94231
49933,,endgjpii_bgj,47116,47117,94233
49934,,5q9-jr76vj0j,47118,47119,94237
49935,,wu95cdypvlkj,47119,47120,94239
49936,,vh7viudlslcj,47120,47121,94241
49937,,fsx80kse-w4j,47121,47122,94243
49938,,b2udty0ozdqj,47122,47123,94245
49939,,ojecoqczdkmj,47123,47124,94247
49940,,lbekxau-dwij,47124,47125,94249
49941,,pcttfkcmrn8j,47125,47126,94251
49942,,f3xkqltcel8j,47126,47127,94253
49943,,st_lmkcwtpmj,47127,47128,94255
49944,,ioc-mhhb4gyj,47128,47129,94257
49945,,5erjc_5rxzgj,47129,47130,94259
49946,,coo6dqkelgkj,47130,47131,94261
49947,,8tjwgtvbuk0j,47131,47132,94263
49948,,url:http://pubs.acs.org/cgi-bin/abstract.cgi/achre4/2005/38/i05/abs/ar030277e.html,47132,47133,94265
49949,,in1pwhwyumkj,47133,47134,94267
49950,,xi0zf25jt4sj,47134,47135,94269
49951,,agwrgbja5pcj,47135,47136,94271
49952,,hhvwd1qphqsj,47136,47137,94273
49953,,pe-q5brlfagj,47137,47138,94275
49954,,eynb24qnm4ij,47138,47139,94277
49955,,gzaucmex9luj,47139,47140,94279
49956,,2sblwx3wo-kj,47140,47141,94281
49957,,xkbw3rjbgi4j,47141,47142,94283
49958,,lupn_puhpnaj,47142,47143,94285
49959,,jsc5feau4f4j,47143,47144,94287
49960,,zd4ru49ymrgj,47144,47145,94289
49961,,xurm_pcyadcj,47145,47146,94291
49962,,vz6rr_u2h0oj,47146,47147,94293
49963,,7kommhvb8j4j,47147,47148,94295
49964,,dbp_b1k1hksj,47148,47149,94297
49965,,d9lozeenjacj,47149,47150,94299
49966,,qilygnotzkaj,47150,47151,94301
49967,,j0l6nit_qqyj,47151,47152,94303
49968,,8jrpo7v_pjij,47152,47153,94305
49969,,hylevhvu8lij,47153,47154,94307
49970,,_q3qe8mywasj,47154,47155,94309
49971,,qz2ad8n58paj,47155,47156,94311
49972,,h2lfva_m_mij,47156,47157,94313
49973,,rvxh3dim47uj,47157,47158,94315
49974,,57n49yqnyiaj,47158,47159,94317
49975,,jwiu3a24g2kj,47159,47160,94319
49976,,dwad7rqeuwaj,47160,47161,94321
49977,,ejmwas0gco8j,47161,47162,94323
49978,,0bk2sei5o14j,47162,47163,94325
49979,,yeectavkbkqj,47163,47164,94327
49980,,,47164,47165,94329
49981,,url:http://doi.wiley.com/10.1002/he.77,47165,47166,94331
49982,,mvizme9lv-0j,47166,47167,94333
49983,,xnrh_4lemi8j,47167,47168,94335
49984,,vzyupk_apncj,47168,47169,94337
49985,,url_oxzvbbuj,47169,47170,94339
49986,,kyo1p49ldlej,47170,47171,94341
49987,,bwdlnv_0xayj,47171,47172,94343
49988,,j2mi5b81il0j,47172,47173,94345
49989,,oz9wjkfdoqoj,47173,47174,94347
49990,,0bnxhtgnfymj,47174,47175,94349
49991,,lbvpna5b8gmj,47175,47176,94351
49992,,kn_zyt5bwsyj,47176,47177,94353
49993,,qxrfpgy43q0j,47177,47178,94355
49994,,g3bpvfabrzgj,47178,47179,94357
49995,,r3vrcwg8-a0j,47179,47180,94359
49996,,url:http://portal.acm.org/ft_gateway.cfm3fid3d95701426type3dpdf26dl3dguide26dl3dacm26cfid3d1111111126cftoken3d2222222,47180,47181,94361
49997,,8sc5avfcltmj,47181,47182,94363
49998,,z_u25f56i8uj,47182,47183,94365
49999,,xy-jatey9m8j,47183,47184,94367
50000,,kscmvr7zv1qj,47184,47185,94369
50001,,yiwdj3txoioj,47185,47186,94371
50002,,e3-gclllcdyj,47186,47187,94373
50003,,2ntqrxs0ebej,47187,47188,94375
50004,,p5qjtrg6aooj,47188,47189,94377
50005,,s6trj0ludzuj,47189,47190,94379
50006,,zkbm732cifgj,47190,47191,94381
50007,,_xdknndnolmj,47191,47192,94383
50008,,url:http://portal.acm.org/ft_gateway.cfm3fid3d4153026type3dpdf26dl3dguide26dl3dacm26cfid3d1111111126cftoken3d2222222,47192,47193,94385
50009,,d6ee0iw5dfsj,47193,47194,94387
50010,,nvtxpic_jdyj,47194,47195,94389
50011,,,47195,47196,94391
50012,,zyob9i5xrs0j,47196,47197,94393
50013,,b-izhu52_6gj,47197,47198,94395
50014,,olyxzhutwhmj,47198,47199,94397
50015,,zpsr5_wca-gj,47199,47200,94399
50016,,xkusc7imkjuj,47200,47201,94401
50017,,url:http://portal.acm.org/citation.cfm3fid3d144111.144140,47201,47202,94403
50018,,url:http://www.csa.com/partners/viewrecord.php3frequester3dgs26collection3dtrd26recid3d0990225ci,47202,47203,94405
50019,,ddmeqlceknoj,47203,47204,94407
50020,,v3fmry4iij4j,47204,47205,94409
50021,,pzotill_-ryj,47205,47206,94411
50022,,k21otxwuxwmj,47206,47207,94413
50023,,mygoalyrwamj,47207,47208,94415
50024,,vgqnuf0es44j,47208,47209,94417
50025,,8jngariepuyj,47209,47210,94419
50026,,6bhqe6mow1cj,47210,47211,94421
50027,,2cvl0i8nfhqj,47211,47212,94423
50028,,kfxxzcp2uygj,47212,47213,94425
50029,,q7vznb6zkhuj,47213,47214,94427
50030,,e9i_jpeblv0j,47214,47215,94429
50031,,yngkumklumqj,47215,47216,94431
50032,,hju-6mwwlgyj,47216,47217,94433
50033,,yr0urkgc3buj,47217,47218,94435
50034,,ef1o38xdokyj,47218,47219,94437
50035,,miblsggg72mj,47219,47220,94439
50036,,qajaky5_qamj,47220,47221,94441
50037,,wb7u4enhagcj,47221,47222,94443
50038,,st44rw4u1roj,47222,47223,94445
50039,,py6sipgad-uj,47223,47224,94447
50040,,fi15_osh_0mj,47224,47225,94449
50041,,wrrbiugemdej,47225,47226,94451
50042,,url:http://portal.acm.org/ft_gateway.cfm3fid3d10108126type3dpdf26coll3dguide26dl3dacm26cfid3d1111111126cftoken3d2222222,47226,47227,94453
50043,,v9suq9edmywj,47227,47228,94455
50044,,e4e1tkrcejyj,47228,47229,94457
50045,,thgn8j8smuij,47229,47230,94459
50046,,993usejd55oj,47230,47231,94461
50047,,_tukqiwzmwqj,47231,47232,94463
50048,,4ri4ehnzrrej,47232,47233,94465
50049,,bpfbcm20naqj,47233,47234,94467
50050,,5dhm80dyge4j,47234,47235,94469
50051,,k71dsi4hekuj,47236,47237,94473
50052,,qdz8xazadkqj,47237,47238,94475
50053,,oh4o3duevwqj,47238,47239,94477
50054,,_e57x_xp6csj,47239,47240,94479
50055,,5_6dosqhqnkj,47240,47241,94481
50056,,ldiqgdc5avyj,47241,47242,94483
50057,,bnluk_pzxysj,47243,47244,94487
50058,,uspkw00efjkj,47244,47245,94489
50059,,epcser2ldjgj,47245,47246,94491
50060,,jprynebu9bwj,47246,47247,94493
50061,,iv1r6nrbmbyj,47247,47248,94495
50062,,zq74almy5q0j,47248,47249,94497
50063,,qw3y4vfaoxij,47249,47250,94499
50064,,vn2ftm4m50sj,47250,47251,94501
50065,,lwhzd29rqduj,47251,47252,94503
50066,,vokikjyjecoj,47252,47253,94505
50067,,w2t442ao0k0j,47253,47254,94507
50068,,_kgogjwzkx0j,47254,47255,94509
50069,,kzsacjrtylsj,47255,47256,94511
50070,,gaqbbow3icqj,47256,47257,94513
50071,,cltiabzhp1ij,47257,47258,94515
50072,,m5-s8wtpmycj,47258,47259,94517
50073,,rc6okooia94j,47259,47260,94519
50074,,ondoxqejwicj,47260,47261,94521
50075,,s-o9dosgt5yj,47261,47262,94523
50076,,idbvvrhwj7yj,47262,47263,94525
50077,,xgctztiip6qj,47263,47264,94527
50078,,uaromw2wuv0j,47264,47265,94529
50079,,0qylxuc5c7cj,47265,47266,94531
50080,,1fvrmphegs8j,47266,47267,94533
50081,,24w5elzb_1sj,47267,47268,94535
50082,,tqoci2cl0v4j,47268,47269,94537
50083,,9wg-czbouukj,47269,47270,94539
50084,,okmjp9oalnoj,47270,47271,94541
50085,,i6c_er3mxc8j,47271,47272,94543
50086,,url:http://www.csa.com/partners/viewrecord.php3frequester3dgs26collection3dtrd26recid3d199502720073md26recid3d199502g2c0037ec26recid3d199502g2d0037ed26recid3d199502g2p0037ep,47272,47273,94545
50087,,objjuavoodyj,47273,47274,94547
50088,,vizqunnyl-cj,47274,47275,94549
50089,,mymhk6gavuij,47275,47276,94551
50090,,2y_g8dmz1qkj,47276,47277,94553
50091,,p8widyqvnvuj,47277,47278,94555
50092,,j3i4idlbpicj,47278,47279,94557
50093,,zhyvm93yfmuj,47279,47280,94559
50094,,k1rfanbb0y8j,47280,47281,94561
50095,,etkaqhsj9uaj,47281,47282,94563
50096,,p1xfy0mvxtij,47282,47283,94565
50097,,vt16odhfruaj,47283,47284,94567
50098,,9cdehc-xcg0j,47284,47285,94569
50099,,kwwh3bowfuqj,47285,47286,94571
50100,,aiy-hm-bz30j,47286,47287,94573
50101,,hbsup8l6n7qj,47287,47288,94575
50102,,xqbdizc8obmj,47288,47289,94577
50103,,ccvdmgzmntyj,47289,47290,94579
50104,,url:http://portal.acm.org/citation.cfm3fid3d38713.38716,47290,47291,94581
50105,,ao_camtprbaj,47291,47292,94583
50106,,dh_wc5a1i6ej,47292,47293,94585
50107,,teijuzxhbeyj,47293,47294,94587
50108,,_3vsl1fb_bgj,47294,47295,94589
50109,,dfjrvdpf0ucj,47295,47296,94591
50110,,tq6lasrfmiuj,47296,47297,94593
50111,,4jlp54qgdmkj,47297,47298,94595
50112,,eklgrlzmis4j,47298,47299,94597
50113,,6hizlr8fmluj,47299,47300,94599
50114,,snw_9p2undyj,47300,47301,94601
50115,,ygiwjoygkasj,47301,47302,94603
50116,,3anvlvcgou8j,47302,47303,94605
50117,,esv7sy65as4j,47303,47304,94607
50118,,url:http://portal.acm.org/ft_gateway.cfm3fid3d15163726type3dpdf26dl3dguide26dl3dacm26cfid3d1111111126cftoken3d2222222,47304,47305,94609
50119,,k4le6va5om8j,47305,47306,94611
50120,,fbzw8n-gojuj,47306,47307,94613
50121,,dycz24ft99wj,47307,47308,94615
50122,,7ffam8lkibwj,47308,47309,94617
50123,,aeufmlh9b2ej,47309,47310,94619
50124,,7mh8843xumqj,47310,47311,94621
50125,,en78zvwp0d8j,47311,47312,94623
50126,,url:http://portal.acm.org/citation.cfm3fid3d509252.509279,47312,47313,94625
50127,,vtgrv9xinouj,47313,47314,94627
50128,,qnzf_xlfifmj,47314,47315,94629
50129,,p5rki1adwvwj,47315,47316,94631
50130,,url:http://portal.acm.org/ft_gateway.cfm3fid3d32028726type3dpdf26dl3dguide26dl3dacm26cfid3d1111111126cftoken3d2222222,47316,47317,94633
50131,,k9qbh3habcmj,47317,47318,94635
50132,,ipbeehrvg9sj,47318,47319,94637
50133,,xqezptj6nb4j,47319,47320,94639
50134,,8nevpokeo5gj,47320,47321,94641
50135,,qzhf5rphjxsj,47321,47322,94643
50136,,url:http://www.csa.com/partners/viewrecord.php3frequester3dgs26collection3dtrd26recid3dn9210482ah,47322,47323,94645
50137,,94fwrqdbx90j,47323,47324,94647
50138,,akhkf9x-pbej,47324,47325,94649
50139,,ehsjmvshtmmj,47325,47326,94651
50140,,cfdbu9br9ioj,47326,47327,94653
50141,,nrew54x9fasj,47327,47328,94655
50142,,url:http://links.jstor.org/sici3fsici3d0146-4949(196024)1253a1253c25253anmtayn253e2.0.co253b2-c,47328,47329,94657
50143,,d0d-pykru44j,47329,47330,94659
50144,,qtd7ijqb9n8j,47330,47331,94661
50145,,znfbb9wugg0j,47331,47332,94663
50146,,url:http://portal.acm.org/ft_gateway.cfm3fid3d60427126type3dpdf26dl3dguide26dl3dacm26cfid3d1111111126cftoken3d2222222,47332,47333,94665
50147,,url:http://portal.acm.org/citation.cfm3fid3d984409.98441226coll3dguide26dl3dacm26idx3dj68926part3dperiodical26wanttype3dperiodical26title3dacm2520sigmod2520record26cfid3d1111111126cftoken3d2222222,47333,47334,94667
50148,,azicrolbksqj,47334,47335,94669
50149,,aldgjrms2s4j,47335,47336,94671
50150,,cw99a616uq0j,47336,47337,94673
50151,,l0grf4a5gmuj,47337,47338,94675
50152,,uieiyov0e6aj,47338,47339,94677
50153,,n0lcavmzsvmj,47339,47340,94679
50154,,url:http://www.ncbi.nlm.nih.gov/entrez/query.fcgi3fcmd3dretrieve26db3dpubmed26list_uids3d34663626dopt3dcitation,47340,47341,94681
50155,,two2xwqrquij,47341,47342,94683
50156,,oyxwcleuvnmj,47342,47343,94685
50157,,6ofjsmb4vocj,47343,47344,94687
50158,,bubo9tfwpnmj,47344,47345,94689
50159,,url:http://portal.acm.org/ft_gateway.cfm3fid3d102470226type3dpdf,47345,47346,94691
50160,,ypobzve586kj,47346,47347,94693
50161,,84gkilxkojqj,47347,47348,94695
50162,,s9r7k3vee3wj,47348,47349,94697
50163,,mo4b9npjsssj,47349,47350,94699
50164,,znyvifnkwzyj,47350,47351,94701
50165,,,47351,47352,94703
50166,,url:http://portal.acm.org/citation.cfm3fid3d983028.98303326coll3dguide26dl3dacm26idx3dj68926part3dperiodical26wanttype3dperiodical26title3dacm2520sigmod2520record26cfid3d1111111126cftoken3d2222222,47352,47353,94705
50167,,puilmx35tbgj,47353,47354,94707
50168,,s5fqw-u_hx8j,47354,47355,94709
50169,,xj4zpx7pqr4j,47355,47356,94711
50170,,onqdf-xtweej,47356,47357,94713
50171,,tfehwhtyf4uj,47357,47358,94715
50172,,pnqy8ctpzycj,47358,47359,94717
50173,,usgebdjhb8gj,47359,47360,94719
50174,,ilxealgbvouj,47360,47361,94721
50175,,1bzyi3tgsa4j,47361,47362,94723
50176,,kwzxv1001gkj,47362,47363,94725
50177,,asqwwnnzgacj,47364,47365,94729
50178,,p26upvtulicj,47365,47366,94731
50179,,vly-xu2erkoj,47366,47367,94733
50180,,f30guu7ihacj,47367,47368,94735
50181,,vwqv9gs1ogwj,47368,47369,94737
50182,,tr2rmjni9hwj,47369,47370,94739
50183,,0f8j6jwild4j,47370,47371,94741
50184,,g3mgcvg6jloj,47371,47372,94743
50185,,kwnkdphuau8j,47372,47373,94745
50186,,xn05cjchfoaj,47373,47374,94747
50187,,cqy5y4g4plmj,47374,47375,94749
50188,,pka5bod-rr4j,47375,47376,94751
50189,,3_ubzem9dqaj,47376,47377,94753
50190,,hgxxloqsdcej,47377,47378,94755
50191,,epboebkyrwsj,47378,47379,94757
50192,,fwwmpe4jzfwj,47379,47380,94759
50193,,bdwcrmno1fij,47380,47381,94761
50194,,uoefn1hp0igj,47381,47382,94763
50195,,tfe0fjhye2mj,47382,47383,94765
50196,,raoj-ogsqsgj,47383,47384,94767
50197,,dl8ed7fozqwj,47384,47385,94769
50198,,url:http://pubs.acs.org/cgi-bin/abstract.cgi/achre4/2005/38/i09/abs/ar040244e.html,47385,47386,94771
50199,,bkweywu-s2ej,47386,47387,94773
50200,,btjexc-1wf4j,47387,47388,94775
50201,,fuk75oznoj4j,47388,47389,94777
50202,,l_bgiq8ftxwj,47389,47390,94779
50203,,vugfpgxddjaj,47390,47391,94781
50204,,bmyrart5vxaj,47391,47392,94783
50205,,8rwbdjjocqkj,47392,47393,94785
50206,,bo5lu6t9x0wj,47393,47394,94787
50207,,njwtets64pwj,47394,47395,94789
50208,,url:http://portal.acm.org/citation.cfm3fid3d81403.81406,47395,47396,94791
50209,,21tsgj8axiyj,47396,47397,94793
50210,,7a2m_fpuinoj,47397,47398,94795
50211,,ivewetoafoqj,47398,47399,94797
50212,,slxn7pkohf4j,47399,47400,94799
50213,,zg8bqczaccij,47400,47401,94801
50214,,pua18qkrhucj,47401,47402,94803
50215,,9agatq2w4pqj,47402,47403,94805
50216,,dfdyijvkf6mj,47403,47404,94807
50217,,plehdha9k-oj,47404,47405,94809
50218,,bxt2jjq17vsj,47405,47406,94811
50219,,qyxxxdr8ncej,47406,47407,94813
50220,,25hgipzcmqoj,47407,47408,94815
50221,,lse8hhlwoc0j,47408,47409,94817
50222,,xvys8ajgnqsj,47409,47410,94819
50223,,eqlzfde7gjmj,47410,47411,94821
50224,,uq1xuwzj3k0j,47411,47412,94823
50225,,4sgup62kyt0j,47412,47413,94825
50226,,he4knwmxlcoj,47413,47414,94827
50227,,ulcosm8zmawj,47414,47415,94829
50228,,km--pas4xcej,47415,47416,94831
50229,,arw9v3csy4cj,47416,47417,94833
50230,,jrmml7rz49sj,47417,47418,94835
50231,,bnanm9dr-fqj,47418,47419,94837
50232,,lf9jbn__jpgj,47419,47420,94839
50233,,lph_z2s5bfsj,47420,47421,94841
50234,,lszvinifvlcj,47421,47422,94843
50235,,ehhfld5ina0j,47422,47423,94845
50236,,t-54twzqwiwj,47423,47424,94847
50237,,lep8htvnc3sj,47424,47425,94849
50238,,3k1egmzoat4j,47425,47426,94851
50239,,lmhkvir9z84j,47426,47427,94853
50240,,mjojmn8bs_yj,47427,47428,94855
50241,,rzdkzja6braj,47429,47430,94859
50242,,whbhsqnhzmgj,47431,47432,94863
50243,,eu5otrgqnmaj,47432,47433,94865
50244,,1tqtzmrdw18j,47433,47434,94867
50245,,f4wcl3csn4aj,47434,47435,94869
50246,,mxpwrle8dzwj,47435,47436,94871
50247,,apqqhmnbas8j,47436,47437,94873
50248,,lv2dkctincwj,47437,47438,94875
50249,,uuq4b-w6qjcj,47438,47439,94877
50250,,url:http://www.springerlink.com/index/g8866731q352355l.pdf,47439,47440,94879
50251,,4qm-1issurmj,47440,47441,94881
50252,,,47441,47442,94883
50253,,8bltlh4otrkj,47442,47443,94885
50254,,akpj0yg7eqmj,47443,47444,94887
50255,,egyku-bwfbaj,47444,47445,94889
50256,,q5npqgbqjjkj,47445,47446,94891
50257,,dac7hcdx8aij,47446,47447,94893
50258,,5ss8jrke8psj,47447,47448,94895
50259,,7opupugg2x4j,47448,47449,94897
50260,,1e77i5dyzuyj,47449,47450,94899
50261,,m1c9pk3eqnyj,47450,47451,94901
50262,,5meurmfst0aj,47451,47452,94903
50263,,uii0lv1uaa8j,47452,47453,94905
50264,,xq_ouy3eqz4j,47453,47454,94907
50265,,dfghukua6dgj,47454,47455,94909
50266,,cqfsaeo9ec8j,47455,47456,94911
50267,,5w5ldhxj6qsj,47456,47457,94913
50268,,2ba-zg5f9cmj,47457,47458,94915
50269,,url:http://www.ingentaconnect.com/search/expand3fpub3dinfobike://pep/jae/2001/00000215/00000006/art0000126unc3d,47458,47459,94917
50270,,2zjebnt-rvqj,47459,47460,94919
50271,,czjmrc_4tz4j,47460,47461,94921
50272,,o8bkerlimnaj,47461,47462,94923
50273,,x2hvsurlabyj,47462,47463,94925
50274,,igkos8f6vtij,47463,47464,94927
50275,,url:http://www.csa.com/partners/viewrecord.php3frequester3dgs26collection3dtrd26recid3d2664364ci,47464,47465,94929
50276,,e-nygvgiikkj,47465,47466,94931
50277,,jg1hx9xf6waj,47466,47467,94933
50278,,2xmwy6pw-yuj,47467,47468,94935
50279,,mtsbkblbxwqj,47468,47469,94937
50280,,c_hkvzfdgrij,47469,47470,94939
50281,,wn_3xosz1puj,47470,47471,94941
50282,,bbpacnwse8mj,47471,47472,94943
50283,,p3cfourfye0j,47472,47473,94945
50284,,4u-oyiq9pzgj,47474,47475,94949
50285,,7sa7wmxqmrkj,47475,47476,94951
50286,,url:http://portal.acm.org/ft_gateway.cfm3fid3d102770926type3dpdf,47476,47477,94953
50287,,lc-f9_1f_vkj,47477,47478,94955
50288,,fcjhvktfoi0j,47478,47479,94957
50289,,xv4vwiwr28mj,47479,47480,94959
50290,,bclth1vfolgj,47480,47481,94961
50291,,ifgrp8gtvlej,47481,47482,94963
50292,,uv71cfkybwgj,47482,47483,94965
50293,,c_zaxeno5tcj,47483,47484,94967
50294,,f2yil9laczmj,47484,47485,94969
50295,,lv6lopi0u7qj,47485,47486,94971
50296,,xo8iramyqsij,47486,47487,94973
50297,,ts4sskxu7jaj,47487,47488,94975
50298,,t1tq6skoej4j,47488,47489,94977
50299,,fvk1sqiy5rkj,47489,47490,94979
50300,,wndsqhlapiyj,47490,47491,94981
50301,,ymwgtry4rlaj,47491,47492,94983
50302,,fd2rqsixag0j,47492,47493,94985
50303,,ovjeirrogvoj,47493,47494,94987
50304,,url:http://www.ingentaconnect.com/search/expand3fpub3dinfobike://els/13891286/2001/00000036/00000001/art0014926unc3d,47494,47495,94989
50305,,0hlmhepjrh4j,47495,47496,94991
50306,,burozdaqjugj,47496,47497,94993
50307,,url:http://adsabs.harvard.edu/abs/1980phdt........61s,47497,47498,94995
50308,,ko9e8ch2si4j,47498,47499,94997
50309,,dh6azyctwcsj,47500,47501,95001
50310,,xpqe2xqdscwj,47502,47503,95005
50311,,iafebzbcy4uj,47503,47504,95007
50312,,mdwm2jqbnguj,47504,47505,95009
50313,,pxg_sub4pbsj,47505,47506,95011
50314,,mmx33pd-hqaj,47506,47507,95013
50315,,evhrvr7bxk0j,47507,47508,95015
50316,,xlge1g48w6cj,47508,47509,95017
50317,,vgxirjbmvh4j,47509,47510,95019
50318,,vdxfntlv0iwj,47510,47511,95021
50319,,ywmriho_ckej,47511,47512,95023
50320,,mduvymv8jnyj,47512,47513,95025
50321,,j2am9gtypgij,47513,47514,95027
50322,,itmgcsol2skj,47514,47515,95029
50323,,btmqm-gfdumj,47515,47516,95031
50324,,pia2m3_wdkaj,47516,47517,95033
50325,,upwdc0f__44j,47517,47518,95035
50326,,6sjpge9wumoj,47518,47519,95037
50327,,n71-jwjquocj,47519,47520,95039
50328,,url:http://www.ingentaconnect.com/content/ben/mgb/2005/00000001/00000001/art00025,47520,47521,95041
50329,,s53lfd4tc1kj,47521,47522,95043
50330,,z1csj57svumj,47522,47523,95045
50331,,b3aoihi2j4aj,47523,47524,95047
50332,,luknmskcnqij,47524,47525,95049
50333,,iy4pe7vg8roj,47525,47526,95051
50334,,nmsmtpn05kuj,47526,47527,95053
50335,,gw-lhk9kyauj,47527,47528,95055
50336,,olfbrdvhkoyj,47528,47529,95057
50337,,teha3b77ieyj,47529,47530,95059
50338,,rr80mhtltlqj,47530,47531,95061
50339,,igjo7r41a38j,47531,47532,95063
50340,,9_znncoxi4wj,47532,47533,95065
50341,,oilkfqdn_a8j,47533,47534,95067
50342,,pqogssugnjqj,47534,47535,95069
50343,,url:http://portal.acm.org/ft_gateway.cfm3fid3d109963126type3dpdf,47535,47536,95071
50344,,162h0_iqauuj,47536,47537,95073
50345,,ee6wmyogofkj,47537,47538,95075
50346,,ze4ldrc2cncj,47538,47539,95077
50347,,url:http://links.jstor.org/sici3fsici3d0146-4949(196223)3253a3253c45253atbwwe253e2.0.co253b2-l,47539,47540,95079
50348,,71pbb7d3n14j,47540,47541,95081
50349,,wwbrptu3594j,47541,47542,95083
50350,,2amuggzjl8uj,47542,47543,95085
50351,,ip6bcsetdrcj,47543,47544,95087
50352,,lxuykkxbysgj,47544,47545,95089
50353,,tdn1kwy6xd4j,47545,47546,95091
50354,,url:http://www.kluweronline.com/article.asp3fpips3d38397826pdf3d1,47546,47547,95093
50355,,iid4adyvnqoj,47547,47548,95095
50356,,gpgg0czxsqcj,47548,47549,95097
50357,,vcmqkrczh_ej,47549,47550,95099
50358,,t8bxay6z6kkj,47550,47551,95101
50359,,b005puklsraj,47551,47552,95103
50360,,4jmelxqohngj,47552,47553,95105
50361,,4qn3gnsp-acj,47553,47554,95107
50362,,zzrmyekhsawj,47554,47555,95109
50363,,url:http://portal.acm.org/citation.cfm3fid3d22301926coll3dportal26dl3dacm,47555,47556,95111
50364,,musrwwyjmzsj,47556,47557,95113
50365,,9wwzm55cnu0j,47557,47558,95115
50366,,url:http://ieeexplore.ieee.org/xpl/abs_free.jsp3farnumber3d1318565,47558,47559,95117
50367,,ejusl62clh0j,47559,47560,95119
50368,,j751el4x9ckj,47560,47561,95121
50369,,eurnpl89zuij,47561,47562,95123
50370,,z8dgn068pcij,47562,47563,95125
50371,,wz8n4xrslsij,47563,47564,95127
50372,,url:http://www.csa.com/partners/viewrecord.php3frequester3dgs26collection3dtrd26recid3d20021211018628mt26recid3da8012622ah,47564,47565,95129
50373,,mhfb_p5lmbmj,47565,47566,95131
50374,,peyhwp2oob4j,47566,47567,95133
50375,,xsd6d_o2p1sj,47567,47568,95135
50376,,fsltpuulbcgj,47568,47569,95137
50377,,d8qpiga_qqcj,47569,47570,95139
50378,,url:http://portal.acm.org/citation.cfm3fid3d171926.171957,47570,47571,95141
50379,,qyfcrwsta54j,47571,47572,95143
50380,,url:http://www.csa.com/partners/viewrecord.php3frequester3dgs26collection3dtrd26recid3d200111010714mt26recid3da0032650ah,47572,47573,95145
50381,,qzt4uxgsg98j,47573,47574,95147
50382,,rolcocsxha0j,47574,47575,95149
50383,,url:http://portal.acm.org/ft_gateway.cfm3fid3d109965926type3dpdf,47575,47576,95151
50384,,vse27pskkxcj,47576,47577,95153
50385,,url:http://www.springerlink.com/index/n146w1741qj32134.pdf,47577,47578,95155
50386,,ei132lzpjgej,47578,47579,95157
50387,,vah1_e8ntq8j,47579,47580,95159
50388,,qx_j6vb2bmkj,47581,47582,95163
50389,,xxn3_4a7ojaj,47582,47583,95165
50390,,e-gvf3kwywej,47583,47584,95167
50391,,1k9vah3leqoj,47584,47585,95169
50392,,3pssr1bf9awj,47585,47586,95171
50393,,cevzwjhmqf8j,47586,47587,95173
50394,,zlg9qihuxmyj,47587,47588,95175
50395,,1dtxown-xfej,47588,47589,95177
50396,,cpazq0ci7hwj,47589,47590,95179
50397,,jb42cibd_jkj,47590,47591,95181
50398,,tyj-eq-pdkij,47591,47592,95183
50399,,qpmy_a4j6hkj,47592,47593,95185
50400,,fmkhpl60pj8j,47593,47594,95187
50401,,m34gk6xeonkj,47594,47595,95189
50402,,3midn6bxwk4j,47595,47596,95191
50403,,asnml_si9xyj,47596,47597,95193
50404,,rah3enuneewj,47597,47598,95195
50405,,gylkhu7aj7sj,47598,47599,95197
50406,,,47599,47600,95199
50407,,laepntvq0yaj,47600,47601,95201
50408,,odm9mty9h4cj,47601,47602,95203
50409,,url:http://portal.acm.org/ft_gateway.cfm3fid3d22762426type3dpdf26dl3dguide26dl3dacm26cfid3d1111111126cftoken3d2222222,47602,47603,95205
50410,,jp_6k8fan7gj,47603,47604,95207
50411,,ctczghdjzusj,47604,47605,95209
50412,,psvrcbbx0fej,47605,47606,95211
50413,,ddgswz4d8rsj,47606,47607,95213
50414,,v-dgkmocouij,47607,47608,95215
50415,,ntg3hwvzwhgj,47608,47609,95217
50416,,b22ngq_weo8j,47609,47610,95219
50417,,etu5t1oyhz0j,47610,47611,95221
50418,,5fv-a6qzcxgj,47611,47612,95223
50419,,fguwk45zt6yj,47612,47613,95225
50420,,lkuwdue90guj,47613,47614,95227
50421,,fhxqr_8inwqj,47614,47615,95229
50422,,1ycge7icreqj,47615,47616,95231
50423,,nuxjzx9vhwsj,47616,47617,95233
50424,,ygychazecakj,47617,47618,95235
50425,,1z87xqz4cegj,47618,47619,95237
50426,,asvf8pkxko0j,47619,47620,95239
50427,,5cw83myqyrmj,47620,47621,95241
50428,,gnbq6yjmlroj,47621,47622,95243
50429,,lposj5h0bi4j,47622,47623,95245
50430,,2euaetnuproj,47623,47624,95247
50431,,cwzg-hrtqzij,47624,47625,95249
50432,,65jsws5f-hoj,47625,47626,95251
50433,,5lemgr1_eqwj,47626,47627,95253
50434,,n2h1mw8b_8ij,47627,47628,95255
50435,,aiucy52zsjoj,47628,47629,95257
50436,,luxilynwllyj,47629,47630,95259
50437,,m00t7rbwu3yj,47630,47631,95261
50438,,k4b--mxdc0ej,47631,47632,95263
50439,,zdiehaowzimj,47632,47633,95265
50440,,-c3khx3hvomj,47633,47634,95267
50441,,ejkwdarm_hmj,47634,47635,95269
50442,,url:http://www.csa.com/partners/viewrecord.php3frequester3dgs26collection3dtrd26recid3d200111010675mt26recid3da0032578ah,47635,47636,95271
50443,,2dx2qkja1umj,47636,47637,95273
50444,,r9nvy_js4n4j,47637,47638,95275
50445,,ua2hkrkiu6cj,47638,47639,95277
50446,,2dbl3p4mglkj,47639,47640,95279
50447,,fxupxpqlyeej,47640,47641,95281
50448,,qnhx2vokr6uj,47641,47642,95283
50449,,url:http://portal.acm.org/citation.cfm3fid3d592093.592142,47642,47643,95285
50450,,wpqsc_lezrcj,47643,47644,95287
50451,,6ocapvgq9nqj,47644,47645,95289
50452,,t2lfcr2pmpaj,47645,47646,95291
50453,,wzwy4umq0fkj,47646,47647,95293
50454,,7dhaywz48uuj,47647,47648,95295
50455,,t-prxku5no4j,47648,47649,95297
50456,,miamglbwsguj,47649,47650,95299
50457,,qsmo94ilmrej,47650,47651,95301
50458,,zuvbr8zn4xcj,47651,47652,95303
50459,,bnbojrrgd90j,47652,47653,95305
50460,,okkephtmcqsj,47653,47654,95307
50461,,dzsonhhj2d0j,47654,47655,95309
50462,,kcj_yy11b_wj,47655,47656,95311
50463,,ogtbyjnqdswj,47656,47657,95313
50464,,oyip8lssctej,47657,47658,95315
50465,,rrae3fgmvxej,47658,47659,95317
50466,,eq_9q3y6qaqj,47659,47660,95319
50467,,r4udx79bx3qj,47660,47661,95321
50468,,6qrztktr24wj,47661,47662,95323
50469,,czaafnxkas8j,47662,47663,95325
50470,,w1wqm0f1kukj,47663,47664,95327
50471,,qmw18wajuqyj,47664,47665,95329
50472,,url:http://portal.acm.org/ft_gateway.cfm3fid3d105815926type3dpdf,47665,47666,95331
50473,,,47666,47667,95333
50474,,chd7ueweblsj,47667,47668,95335
50475,,xpwoldxc9rej,47668,47669,95337
50476,,tmfpj3wajqij,47669,47670,95339
50477,,kyvvn6ldubsj,47670,47671,95341
50478,,qspxm6zhtecj,47671,47672,95343
50479,,by_xuz-21t4j,47672,47673,95345
50480,,ov4uibdiax4j,47673,47674,95347
50481,,e5v-nxgxnqyj,47674,47675,95349
50482,,dcbp3i_wugej,47675,47676,95351
50483,,zudkekdvjp4j,47676,47677,95353
50484,,oiorrnnboc0j,47677,47678,95355
50485,,qzhuv7yxmq4j,47678,47679,95357
50486,,brs4lbm7wp0j,47679,47680,95359
50487,,pursnqtdtcgj,47680,47681,95361
50488,,3h0tvukqfc4j,47681,47682,95363
50489,,juuyl4fkokij,47682,47683,95365
50490,,,47683,47684,95367
50491,,q5jir62egtsj,47684,47685,95369
50492,,w6frxhy2ok4j,47685,47686,95371
50493,,url:http://adsabs.harvard.edu/abs/1985basi...13....1n,47686,47687,95373
50494,,zebworxjscmj,47687,47688,95375
50495,,xogmqxjsqnaj,47688,47689,95377
50496,,kifjbto3jtoj,47689,47690,95379
50497,,upk7zt1ylkoj,47690,47691,95381
50498,,sgipap28yqwj,47691,47692,95383
50499,,ionecwnazfkj,47692,47693,95385
50500,,diqpdbeimn8j,47693,47694,95387
50501,,jgvu3jlosouj,47694,47695,95389
50502,,url:http://doi.wiley.com/10.1002/ace.125,47695,47696,95391
50503,,p8cap3zzrtgj,47696,47697,95393
50504,,kjp7jgi7yjmj,47697,47698,95395
50505,,s3wtv7wnewaj,47698,47699,95397
50506,,jw4fc_sxazkj,47699,47700,95399
50507,,url:http://doi.wiley.com/10.1002/ace.8609,47700,47701,95401
50508,,wteiiilqnawj,47701,47702,95403
50509,,03sfvw5viwgj,47702,47703,95405
50510,,,47703,47704,95407
50511,,w2w3fqz4m7ij,47704,47705,95409
50512,,mognm6t6l3mj,47705,47706,95411
50513,,ghydiug026yj,47706,47707,95413
50514,,67vrevhucraj,47707,47708,95415
50515,,0ym6hhvu23ij,47708,47709,95417
50516,,url:http://doi.wiley.com/10.1002/he.126,47709,47710,95419
50517,,,47710,47711,95421
50518,,kjs4hx_k2o0j,47711,47712,95423
50519,,vy9l-dzrcjyj,47712,47713,95425
50520,,ba01enojplqj,47713,47714,95427
50521,,pux9-hjjlqej,47714,47715,95429
50522,,ae8jiunbpcqj,47715,47716,95431
50523,,2ruxy5iiamoj,47716,47717,95433
50524,,smfy0qzwe_cj,47718,47719,95437
50525,,w958sp8speaj,47719,47720,95439
50526,,n1wk0rnnd5gj,47720,47721,95441
50527,,9-jsg08kipsj,47721,47722,95443
50528,,gfye5_etzucj,47722,47723,95445
50529,,41vmcdg2qfwj,47723,47724,95447
50530,,9kxbgufp8m8j,47724,47725,95449
50531,,brcgwoyjj7ij,47725,47726,95451
50532,,rvfocrty9faj,47726,47727,95453
50533,,5rpfkhuqnokj,47727,47728,95455
50534,,yxcrcmzossqj,47728,47729,95457
50535,,kayznz7zsjkj,47729,47730,95459
50536,,drwf-i-4-x0j,47730,47731,95461
50537,,zypplp7wbqij,47731,47732,95463
50538,,x2uroomjjv4j,47732,47733,95465
50539,,rorrqfonfrsj,47733,47734,95467
50540,,7f5biz74r3ej,47734,47735,95469
50541,,fydzhf-_jwyj,47735,47736,95471
50542,,itz9x25csyyj,47737,47738,95475
50543,,sfjohqb_2aej,47738,47739,95477
50544,,_sp6uthcpl8j,47739,47740,95479
50545,,g3cojnx2elyj,47740,47741,95481
50546,,jyhlt6mtfhij,47741,47742,95483
50547,,p6n2qhfkogqj,47742,47743,95485
50548,,uikmcqvd200j,47744,47745,95489
50549,,l4cj92b-i6aj,47745,47746,95491
50550,,xh4qs2fpvq4j,47746,47747,95493
50551,,bqadkqpmeigj,47747,47748,95495
50552,,url:http://portal.acm.org/ft_gateway.cfm3fid3d108371526type3dpdf,47748,47749,95497
50553,,iyhwac-obo0j,47749,47750,95499
50554,,u7nvpeit-jqj,47750,47751,95501
50555,,zpfrp0vprzkj,47751,47752,95503
50556,,otmv_mf6gqaj,47752,47753,95505
50557,,0npucmm-6jej,47753,47754,95507
50558,,url:http://www.csa.com/partners/viewrecord.php3frequester3dgs26collection3dtrd26recid3d8204540538md,47754,47755,95509
50559,,34t5iwe0atoj,47755,47756,95511
50560,,nxei9oj9qimj,47756,47757,95513
50561,,7c8v_ronr8yj,47757,47758,95515
50562,,qgovkpglpqwj,47758,47759,95517
50563,,hbzqpsacnjsj,47759,47760,95519
50564,,pbexcpc-lomj,47760,47761,95521
50565,,nnlyjxq0dl4j,47761,47762,95523
50566,,3toqlel1g64j,47762,47763,95525
50567,,vpafomamuxaj,47763,47764,95527
50568,,lcdvvz_0hsej,47764,47765,95529
50569,,20-0krhkejqj,47765,47766,95531
50570,,cew00azy4g0j,47766,47767,95533
50571,,i4jkxayhdb4j,47767,47768,95535
50572,,a7przggwp2oj,47768,47769,95537
50573,,kiio2himjqkj,47769,47770,95539
50574,,bsubao-wedyj,47770,47771,95541
50575,,sdyrntttpicj,47771,47772,95543
50576,,va0llvagjwsj,47772,47773,95545
50577,,f9bb1lsvlegj,47773,47774,95547
50578,,8oodjkb65a4j,47774,47775,95549
50579,,8b1agpnw7kcj,47775,47776,95551
50580,,zdxan1f259ej,47776,47777,95553
50581,,lkie34a0lukj,47777,47778,95555
50582,,aoir89dluq8j,47778,47779,95557
50583,,t2b4eamkqnaj,47779,47780,95559
50584,,chogntejzhuj,47780,47781,95561
50585,,blkwbo-kzdkj,47781,47782,95563
50586,,oqcdmswdbkoj,47782,47783,95565
50587,,kojp9mhycbuj,47783,47784,95567
50588,,yd50n0wp-rej,47784,47785,95569
50589,,ywxgwwjmiwoj,47785,47786,95571
50590,,zm9selgbz2wj,47786,47787,95573
50591,,t8sd2pnncaqj,47787,47788,95575
50592,,pd3rhg-0jiej,47788,47789,95577
50593,,nind9mepiawj,47789,47790,95579
50594,,a3s7km1odzyj,47790,47791,95581
50595,,wrfxqb1t-9wj,47791,47792,95583
50596,,url:http://portal.acm.org/ft_gateway.cfm3fid3d102770426type3dpdf,47792,47793,95585
50597,,y1g0bmrh37mj,47793,47794,95587
50598,,qnou6vq8_ymj,47794,47795,95589
50599,,icravdlxsswj,47795,47796,95591
50600,,dsalscq2m8uj,47796,47797,95593
50601,,url:http://portal.acm.org/ft_gateway.cfm3fid3d109966826type3dpdf,47797,47798,95595
50602,,rxjux25i8owj,47798,47799,95597
50603,,ax0yrsl_uiqj,47799,47800,95599
50604,,bpxficuyrxyj,47800,47801,95601
50605,,nhuklglqr54j,47801,47802,95603
50606,,kjvhj4ruw6sj,47802,47803,95605
50607,,hiagtw7vjkcj,47803,47804,95607
50608,,url:http://links.jstor.org/sici3fsici3d0146-4949(196223)3253a3253c54253ackkmod253e2.0.co253b2-j,47804,47805,95609
50609,,fhhhqpoo3n0j,47805,47806,95611
50610,,i93pulntasaj,47806,47807,95613
50611,,wji1p7pbvgaj,47807,47808,95615
50612,,r-tkmynzjgaj,47808,47809,95617
50613,,jpap96km7soj,47809,47810,95619
50614,,r5gwlvht67gj,47810,47811,95621
50615,,ig8jxfxf0tyj,47811,47812,95623
50616,,d9yggjzeoayj,47812,47813,95625
50617,,abtf57w_9oaj,47813,47814,95627
50618,,nax5hl27mjgj,47814,47815,95629
50619,,url:http://www.csa.com/partners/viewrecord.php3frequester3dgs26collection3dtrd26recid3d155947ws26recid3d199301560032md26recid3d199302p60020ai,47815,47816,95631
50620,,url:http://ieeexplore.ieee.org/iel1/2206/1762/00046639.pdf3farnumber3d46639,47816,47817,95633
50621,,5mm4rpgyenoj,47817,47818,95635
50622,,uccws2juhc8j,47818,47819,95637
50623,,bjiokgtz90uj,47819,47820,95639
50624,,wcm2hnzdd78j,47820,47821,95641
50625,,syv3r4_a5esj,47821,47822,95643
50626,,5s_hispsfsij,47822,47823,95645
50627,,url:http://portal.acm.org/citation.cfm3fid3d154766.15538226dl3dguide26dl3dacm26type3dseries26idx3d15476626part3dproceedings26wanttype3dproceedings26title3dhistory2520of2520programming2520languages26cfid3d1111111126cftoken3d2222222,47823,47824,95647
50628,,_ist1wk1_nqj,47824,47825,95649
50629,,qjlqayut49kj,47825,47826,95651
50630,,4b1ytqoqeyij,47826,47827,95653
50631,,_fybovobdmyj,47827,47828,95655
50632,,bc1jb9q4o08j,47828,47829,95657
50633,,djovjjlua58j,47829,47830,95659
50634,,rwuapb_k5-0j,47830,47831,95661
50635,,w91ico7e4noj,47831,47832,95663
50636,,rtfpwujqdboj,47832,47833,95665
50637,,exopapjzpekj,47833,47834,95667
50638,,zjnzw7mkizmj,47834,47835,95669
50639,,,47835,47836,95671
50640,,omvl9wx8ki4j,47836,47837,95673
50641,,zp1fytsbeaej,47837,47838,95675
50642,,siw_not7gvmj,47838,47839,95677
50643,,cxehgcembvoj,47839,47840,95679
50644,,wkcfosv_egij,47840,47841,95681
50645,,o1855xz95wij,47843,47844,95687
50646,,nkyhwjqlbnqj,47844,47845,95689
50647,,o10ufo3_n3kj,47845,47846,95691
50648,,81ukypjfmywj,47846,47847,95693
50649,,fyql3gpnjb0j,47847,47848,95695
50650,,k1nbpkn1ibsj,47848,47849,95697
50651,,03amxpqlfgaj,47849,47850,95699
50652,,aup_dq6r-bkj,47850,47851,95701
50653,,ms1aiuiw3u0j,47851,47852,95703
50654,,4xsxsda4pmmj,47852,47853,95705
50655,,beg3_pqdpkyj,47854,47855,95709
50656,,smnjiydlsrkj,47855,47856,95711
50657,,mswbtmzcm0ej,47856,47857,95713
50658,,qcmydg61yq8j,47857,47858,95715
50659,,8uv05ky2lakj,47858,47859,95717
50660,,bjd4xnpoqtij,47859,47860,95719
50661,,g_sqth4s_7ij,47860,47861,95721
50662,,68_oy7gkasqj,47861,47862,95723
50663,,jxp-0xymrumj,47862,47863,95725
50664,,7igs5pjhhwgj,47863,47864,95727
50665,,zgkpcx-lgxkj,47864,47865,95729
50666,,algzv1qmzbuj,47865,47866,95731
50667,,,47866,47867,95733
50668,,op_myya6u0gj,47867,47868,95735
50669,,o0bvcw-vpa4j,47868,47869,95737
50670,,hpu3v12aa3aj,47869,47870,95739
50671,,t7ifnupakjij,47870,47871,95741
50672,,qfxgwpi0lq8j,47872,47873,95745
50673,,t7e3r_acrv0j,47873,47874,95747
50674,,w7ll3ggovqyj,47874,47875,95749
50675,,q_myuzye5soj,47875,47876,95751
50676,,ld0mi2wuvmgj,47876,47877,95753
50677,,zhdvf1ahb-cj,47877,47878,95755
50678,,khmitfa6gb0j,47878,47879,95757
50679,,uvik4nmnrpsj,47879,47880,95759
50680,,nnrdqcyryagj,47880,47881,95761
50681,,ju2xqkb3xxkj,47881,47882,95763
50682,,rr8n1hkoe5wj,47882,47883,95765
50683,,ivkndjrle-yj,47883,47884,95767
50684,,59d5hild3jcj,47884,47885,95769
50685,,nnbcskk0e2aj,47885,47886,95771
50686,,0hicbwfi-q4j,47886,47887,95773
50687,,ptpnpap9mm4j,47887,47888,95775
50688,,avn1sahkq8mj,47888,47889,95777
50689,,ctpw02bbhywj,47889,47890,95779
50690,,k7mfvchc3noj,47890,47891,95781
50691,,_eenifhhjkwj,47891,47892,95783
50692,,dbdzdq9kkbej,47892,47893,95785
50693,,fvabd9iwaeuj,47893,47894,95787
50694,,sxvjrbrynlyj,47894,47895,95789
50695,,jh4kdtsunlqj,47895,47896,95791
50696,,xf1sp2ccpb0j,47896,47897,95793
50697,,9vwp2bats24j,47897,47898,95795
50698,,35slbdun6fyj,47898,47899,95797
50699,,y94yja36iqgj,47899,47900,95799
50700,,url:http://www.csa.com/partners/viewrecord.php3frequester3dgs26collection3dtrd26recid3da7340038ah,47900,47901,95801
50701,,url:http://www.springerlink.com/index/r468574m4302g285.pdf,47901,47902,95803
50702,,vgdtpos-mt8j,47902,47903,95805
50703,,wi7fp7dm8bcj,47903,47904,95807
50704,,oadtyo3ajrcj,47904,47905,95809
50705,,3httwcaa4_gj,47905,47906,95811
50706,,s3m3t-osyquj,47906,47907,95813
50707,,,47907,47908,95815
50708,,3bz_zghj0xkj,47908,47909,95817
50709,,ulnl0h8qybaj,47909,47910,95819
50710,,7_tp2johfoyj,47910,47911,95821
50711,,pq6wwdvstjyj,47911,47912,95823
50712,,xeqpeuzj0myj,47912,47913,95825
50713,,url:http://www.csa.com/partners/viewrecord.php3frequester3dgs26collection3dtrd26recid3dn8332711ah,47914,47915,95829
50714,,zrzhcljgzwuj,47915,47916,95831
50715,,4cituvahukmj,47916,47917,95833
50716,,gzs33axipscj,47917,47918,95835
50717,,hwsbajqjgxoj,47918,47919,95837
50718,,ffs_nltyxwsj,47919,47920,95839
50719,,c7b2kl3b5vqj,47920,47921,95841
50720,,jbvwqyeuqxmj,47921,47922,95843
50721,,x0ymxa82tgkj,47922,47923,95845
50722,,h0kxxd2yi5uj,47923,47924,95847
50723,,nc1lmx13tagj,47924,47925,95849
50724,,tsrmwqpufd0j,47925,47926,95851
50725,,9ft0bsj3fqmj,47926,47927,95853
50726,,vnnrbizhoakj,47927,47928,95855
50727,,pk-pn3bqihuj,47928,47929,95857
50728,,iugh81t3l3gj,47929,47930,95859
50729,,ees2cksayqmj,47930,47931,95861
50730,,xsjzfaoby40j,47931,47932,95863
50731,,fbmlenmmrtoj,47932,47933,95865
50732,,m-1nbw1n-pqj,47933,47934,95867
50733,,x2yszoda6vej,47934,47935,95869
50734,,ydlkedkwzpwj,47935,47936,95871
50735,,1fe0exv61xwj,47936,47937,95873
50736,,rfgyki2qzxuj,47937,47938,95875
50737,,ewmss8mbbc4j,47938,47939,95877
50738,,vaok1x8ja30j,47939,47940,95879
50739,,o2x4iubiqlmj,47940,47941,95881
50740,,tjfiilpwpymj,47941,47942,95883
50741,,yet35cp0byej,47942,47943,95885
50742,,eevfr0ejuzsj,47943,47944,95887
50743,,dznt5iau7foj,47944,47945,95889
50744,,ad5napgwiiuj,47945,47946,95891
50745,,zftk-fnbdygj,47946,47947,95893
50746,,lnqceoolwv8j,47947,47948,95895
50747,,8asrrowivpyj,47948,47949,95897
50748,,mwqkn-xh-4kj,47949,47950,95899
50749,,3gvx_vqaixej,47950,47951,95901
50750,,815zv6egv4yj,47951,47952,95903
50751,,dibnweli53cj,47953,47954,95907
50752,,url:http://doi.wiley.com/10.1002/tl.52,47954,47955,95909
50753,,rsag4ovwdncj,47955,47956,95911
50754,,odcddgiyweij,47956,47957,95913
50755,,url:http://portal.acm.org/citation.cfm3fid3d1101149.1101176,47957,47958,95915
50756,,pt4du1aacdyj,47958,47959,95917
50757,,ip4hpo8wwisj,47959,47960,95919
50758,,alsvjbwd_4wj,47960,47961,95921
50759,,mzfrjsbydqoj,47961,47962,95923
50760,,oef4eebfv-uj,47962,47963,95925
50761,,i5hxw10g_sej,47963,47964,95927
50762,,oskggq5ucwsj,47964,47965,95929
50763,,bdwm824vpu8j,47965,47966,95931
50764,,6qooqgazsaaj,47966,47967,95933
50765,,kt3nsl2wescj,47967,47968,95935
50766,,vyy_a_1jazkj,47968,47969,95937
50767,,nymsnaxqcnej,47969,47970,95939
50768,,k70wm8jzinmj,47970,47971,95941
50769,,zk5gllddjuej,47971,47972,95943
50770,,ygx6qhxltryj,47972,47973,95945
50771,,k7g6ytiwafij,47973,47974,95947
50772,,fwnhb8mlj0ej,47974,47975,95949
50773,,uoq2dvb8meyj,47975,47976,95951
50774,,vbpeo_jsln8j,47976,47977,95953
50775,,url:http://portal.acm.org/citation.cfm3fid3d197425,47977,47978,95955
50776,,b-qf6wxqshij,47978,47979,95957
50777,,2ui1o_u2orqj,47979,47980,95959
50778,,emtw8emcn3mj,47980,47981,95961
50779,,civnxvkhi7gj,47981,47982,95963
50780,,_z_a_6zzj2gj,47982,47983,95965
50781,,wkxnlrzpnikj,47983,47984,95967
50782,,rwv86q1yiwqj,47984,47985,95969
50783,,3aeau5x_fncj,47985,47986,95971
50784,,0eyj4bca57sj,47986,47987,95973
50785,,url:http://portal.acm.org/citation.cfm3fid3d592191.592216,47987,47988,95975
50786,,rdobsykvromj,47988,47989,95977
50787,,w9pelnvv6xsj,47989,47990,95979
50788,,ylgi06yyfcoj,47990,47991,95981
50789,,url:http://www.csa.com/partners/viewrecord.php3frequester3dgs26collection3dtrd26recid3d0902271ci,47991,47992,95983
50790,,rrj__1x5eqmj,47992,47993,95985
50791,,a43iltqxkn0j,47993,47994,95987
50792,,1nzcorqtqzoj,47994,47995,95989
50793,,rykw_umj0ewj,47995,47996,95991
50794,,e8ovb2gjiqoj,47996,47997,95993
50795,,htbmys9tqyqj,47997,47998,95995
50796,,81y_mi2hzouj,47998,47999,95997
50797,,she2jnygdswj,47999,48000,95999
50798,,bghau7tq6u4j,48000,48001,96001
50799,,wnyvibh8fxuj,48001,48002,96003
50800,,98171du8bowj,48002,48003,96005
50801,,,48003,48004,96007
50802,,k1hjuqd-whyj,48004,48005,96009
50803,,srw9oorllsej,48005,48006,96011
50804,,rin20xqxpkuj,48006,48007,96013
50805,,ex5aqer35jmj,48007,48008,96015
50806,,ndqdrnp4vzuj,48008,48009,96017
50807,,yxgdafft1jyj,48009,48010,96019
50808,,uhbvat8wfd0j,48010,48011,96021
50809,,ipprdmirajwj,48011,48012,96023
50810,,sovsvpwpzmoj,48012,48013,96025
50811,,lbceyokhjsgj,48013,48014,96027
50812,,aic8-c8cmj4j,48014,48015,96029
50813,,k5qivljvtyaj,48015,48016,96031
50814,,bgiwivpo0jwj,48016,48017,96033
50815,,b2s0aqucdoaj,48017,48018,96035
50816,,bkjikulzcyoj,48018,48019,96037
50817,,karmosjpmdsj,48019,48020,96039
50818,,4qhlhuaelimj,48020,48021,96041
50819,,vioekrh0diqj,48021,48022,96043
50820,,oz7xz7_oc2mj,48022,48023,96045
50821,,dhxxhcqfthsj,48024,48025,96049
50822,,i3jlwsytudqj,48025,48026,96051
50823,,ibzbrrsg5cqj,48026,48027,96053
50824,,vfkwjgexddmj,48027,48028,96055
50825,,wkvpzpk2rdqj,48028,48029,96057
50826,,xycznqbcvhqj,48029,48030,96059
50827,,4frdqu4wdcej,48030,48031,96061
50828,,r0bskh0onr4j,48031,48032,96063
50829,,2kye3-xoboyj,48032,48033,96065
50830,,lecvmbmfxiej,48034,48035,96069
50831,,msb6crwm_v8j,48035,48036,96071
50832,,wempae_1afmj,48036,48037,96073
50833,,n0llj-v2xjqj,48037,48038,96075
50834,,m1xqrodaqaoj,48038,48039,96077
50835,,vtyiy7svjksj,48039,48040,96079
50836,,url:http://ieeexplore.ieee.org/iel3/3990/11481/00547906.pdf3farnumber3d547906,48040,48041,96081
50837,,dqkob2yeawyj,48041,48042,96083
50838,,scsgyyl-z5mj,48042,48043,96085
50839,,gl7-r3hpsowj,48043,48044,96087
50840,,yyrxv_wb9a4j,48044,48045,96089
50841,,ehwbn1ylsocj,48045,48046,96091
50842,,bhc65zaop1wj,48046,48047,96093
50843,,hlp8_dr7nlaj,48047,48048,96095
50844,,-0exbtkumdkj,48048,48049,96097
50845,,pvcfat2yhruj,48049,48050,96099
50846,,mjoxkzq4aw4j,48050,48051,96101
50847,,lrbuun0r8ugj,48051,48052,96103
50848,,qv1cmbyl9okj,48052,48053,96105
50849,,eqple8gg-mij,48053,48054,96107
50850,,bwyknqrflsgj,48054,48055,96109
50851,,iaub_nd9cewj,48055,48056,96111
50852,,keu2v2ksmtsj,48056,48057,96113
50853,,6bg925orivkj,48057,48058,96115
50854,,hg5utdwhfgej,48058,48059,96117
50855,,t8llxfzncowj,48059,48060,96119
50856,,rairdf7nogkj,48060,48061,96121
50857,,oxbhrmb26rkj,48061,48062,96123
50858,,79nkryc6caoj,48062,48063,96125
50859,,ln4k8x1qygmj,48063,48064,96127
50860,,rrrt0v_j7tkj,48064,48065,96129
50861,,qdtqwrbqalaj,48065,48066,96131
50862,,rexmc2sez1oj,48066,48067,96133
50863,,lprwg8y5feuj,48067,48068,96135
50864,,lmcf4ylwetwj,48068,48069,96137
50865,,wh-qkymkvuoj,48069,48070,96139
50866,,b3st4nruijgj,48070,48071,96141
50867,,q7ntdzvhpecj,48071,48072,96143
50868,,qemp-saafauj,48072,48073,96145
50869,,tae6c6ukqawj,48073,48074,96147
50870,,vtoucc6j9lij,48074,48075,96149
50871,,2auignpu7vcj,48075,48076,96151
50872,,url:http://adsabs.harvard.edu/abs/1979phdt........49l,48076,48077,96153
50873,,uv4ttk_odjmj,48077,48078,96155
50874,,pzkvpzw8btyj,48078,48079,96157
50875,,oibpcdjnm6ej,48079,48080,96159
50876,,aab6n5c42o8j,48080,48081,96161
50877,,adkwat_x-igj,48081,48082,96163
50878,,peca3dr4-bqj,48082,48083,96165
50879,,7mho44xgzaej,48083,48084,96167
50880,,pswywfheoacj,48084,48085,96169
50881,,itcznzmjxlgj,48085,48086,96171
50882,,etkes3fi82aj,48086,48087,96173
50883,,bhtqqsiewd0j,48087,48088,96175
50884,,url:http://www.springerlink.com/index/h807211833323674.pdf,48088,48089,96177
50885,,ntxrksvjvhaj,48089,48090,96179
50886,,tdh9x4elbwoj,48090,48091,96181
50887,,dzdi_i6am9yj,48091,48092,96183
50888,,p-g5bhta2aaj,48092,48093,96185
50889,,56txwmw8khwj,48093,48094,96187
50890,,dnknb86iziqj,48094,48095,96189
50891,,v34_zfx7kzyj,48095,48096,96191
50892,,,48096,48097,96193
50893,,1rjkqrdlqmoj,48097,48098,96195
50894,,4iuab6jkas4j,48098,48099,96197
50895,,7tp-wufmahij,48099,48100,96199
50896,,zbf7xkflbe4j,48100,48101,96201
50897,,url:http://doi.wiley.com/10.1002/ace.8806,48101,48102,96203
50898,,twk7ozhhjfij,48102,48103,96205
50899,,cubzoxvihy8j,48103,48104,96207
50900,,2swwpk5unkwj,48104,48105,96209
50901,,vmcxnntyftqj,48105,48106,96211
50902,,1hxiq13uosaj,48106,48107,96213
50903,,n-ogl8lhx5mj,48107,48108,96215
50904,,tomtygkazo4j,48108,48109,96217
50905,,inerrgoxuaoj,48109,48110,96219
50906,,d--ffisllmwj,48110,48111,96221
50907,,yid3e8k2tqqj,48111,48112,96223
50908,,y1bb9dlt64ej,48112,48113,96225
50909,,d4lx5i0ldqej,48113,48114,96227
50910,,wkrdygbf31wj,48114,48115,96229
50911,,y6tlkwy7kcsj,48115,48116,96231
50912,,eyfiwee8phej,48116,48117,96233
50913,,bnnvtoc6qvgj,48117,48118,96235
50914,,29xbc5zbtxsj,48118,48119,96237
50915,,,48119,48120,96239
50916,,doal-qbn_3cj,48120,48121,96241
50917,,7w56ijtun7yj,48121,48122,96243
50918,,buxs07smwksj,48122,48123,96245
50919,,_gflj9u6td8j,48123,48124,96247
50920,,jvrabrqxsuqj,48124,48125,96249
50921,,djfe8wselfaj,48125,48126,96251
50922,,khdo6cdtwdij,48126,48127,96253
50923,,nav9izlt90cj,48127,48128,96255
50924,,xgv4ky50qeuj,48128,48129,96257
50925,,p0tlpzs0k4oj,48129,48130,96259
50926,,hq6ii8u2czwj,48130,48131,96261
50927,,_yjeusg_1lcj,48131,48132,96263
50928,,z6hkvc_mo6cj,48132,48133,96265
50929,,0xzypelzuv8j,48134,48135,96269
50930,,url:http://www.csa.com/partners/viewrecord.php3frequester3dgs26collection3dtrd26recid3da8622973ah,48135,48136,96271
50931,,ahvfyoqgq6gj,48136,48137,96273
50932,,grvb68a6nngj,48137,48138,96275
50933,,klg8vi3psycj,48138,48139,96277
50934,,isaikk5cssyj,48139,48140,96279
50935,,w4utkb9bhgaj,48140,48141,96281
50936,,c8ph-tsxbiyj,48141,48142,96283
50937,,cj7ikact_paj,48142,48143,96285
50938,,yl2srwspvmaj,48143,48144,96287
50939,,kkk9ktvxwicj,48144,48145,96289
50940,,url:http://www.csa.com/partners/viewrecord.php3frequester3dgs26collection3dtrd26recid3da7430431ah,48146,48147,96293
50941,,c8wun4wl3ngj,48147,48148,96295
50942,,jaqn-p0bwpaj,48148,48149,96297
50943,,2dnx3xqykacj,48149,48150,96299
50944,,qgmqt9pq564j,48150,48151,96301
50945,,v0oo0tpo6cwj,48151,48152,96303
50946,,pj9ju33yesij,48152,48153,96305
50947,,prmpwenxywwj,48153,48154,96307
50948,,hwn7jdz0-bmj,48154,48155,96309
50949,,iwmnayw-frij,48155,48156,96311
50950,,url:http://portal.acm.org/citation.cfm3fid3d988598.988601,48156,48157,96313
50951,,iyzqwmdnsvwj,48157,48158,96315
50952,,rjnfywazp18j,48158,48159,96317
50953,,,48159,48160,96319
50954,,siq0ne3poo0j,48160,48161,96321
50955,,p9w7yv23wfsj,48161,48162,96323
50956,,ludsn6uz5rkj,48163,48164,96327
50957,,s38ugvwoqkuj,48164,48165,96329
50958,,nxzi2-lbiiaj,48165,48166,96331
50959,,nyqr22sw804j,48166,48167,96333
50960,,xohdx4hfchoj,48167,48168,96335
50961,,uhg6pxe7dw4j,48168,48169,96337
50962,,pqucr7qziw8j,48169,48170,96339
50963,,x1fgs2r31dcj,48170,48171,96341
50964,,_awxg70smuoj,48171,48172,96343
50965,,,48172,48173,96345
50966,,yekv04vfcowj,48173,48174,96347
50967,,aph7vfqoqv4j,48174,48175,96349
50968,,whqkh0dgugwj,48175,48176,96351
50969,,url:http://adsabs.harvard.edu/abs/1976infph..16..145s,48176,48177,96353
50970,,-5ydo-9cxqej,48177,48178,96355
50971,,smo9tpw9ja0j,48178,48179,96357
50972,,kfowmh1lkqmj,48179,48180,96359
50973,,lml1fe56_byj,48180,48181,96361
50974,,qovwttqms-sj,48181,48182,96363
50975,,xxpe-sqwc0oj,48182,48183,96365
50976,,mtkt8sjrcfmj,48183,48184,96367
50977,,s_c9q7x63zcj,48184,48185,96369
50978,,url:http://portal.acm.org/ft_gateway.cfm3fid3d108372126type3dpdf,48185,48186,96371
50979,,ruvmva1bhouj,48186,48187,96373
50980,,ygyyg3tcpecj,48187,48188,96375
50981,,behh1pe5c2ij,48188,48189,96377
50982,,7janipngjrij,48189,48190,96379
50983,,6vzt6pc38uqj,48190,48191,96381
50984,,geqlkbbldgcj,48191,48192,96383
50985,,rpe0qsvvqngj,48192,48193,96385
50986,,dopamliddqoj,48193,48194,96387
50987,,34oqwjdvf2sj,48194,48195,96389
50988,,url:http://www.ingentaconnect.com/content/els/09505849/1998/00000040/00000005/art00033,48195,48196,96391
50989,,jos9_rtkqz4j,48196,48197,96393
50990,,oxqmzdkil9uj,48197,48198,96395
50991,,c4on0q1mzhsj,48198,48199,96397
50992,,a7mnubx8r_sj,48199,48200,96399
50993,,a7ygpi5h574j,48200,48201,96401
50994,,n0lpgyiugmsj,48201,48202,96403
50995,,e86jcdhgiouj,48202,48203,96405
50996,,mf5tw4zmjcwj,48203,48204,96407
50997,,-3jqfrzsy8wj,48204,48205,96409
50998,,mqccjabgry0j,48205,48206,96411
50999,,jpytfh81eqoj,48206,48207,96413
51000,,nhm8caxojzgj,48207,48208,96415
51001,,vjckkmcktjyj,48208,48209,96417
51002,,urnh8in2nwsj,48209,48210,96419
51003,,d0y5yzxy4fqj,48210,48211,96421
51004,,cwegrmmcxwaj,48211,48212,96423
51005,,bbzqzhfem5mj,48212,48213,96425
51006,,jm8vbwijowkj,48213,48214,96427
51007,,,48214,48215,96429
51008,,ilqrsixnfo0j,48215,48216,96431
51009,,hutyffw-kjcj,48216,48217,96433
51010,,lq9hckobk5qj,48217,48218,96435
51011,,vjbmfd6ais0j,48218,48219,96437
51012,,joxz8xhtt7qj,48219,48220,96439
51013,,_t3qx2fm1-sj,48220,48221,96441
51014,,url:http://doi.ieeecomputersociety.org/10.1109/tkde.2004.32,48221,48222,96443
51015,,6waxkwrpxtaj,48222,48223,96445
51016,,vgcgozdws50j,48223,48224,96447
51017,,fxf3bgbmouaj,48224,48225,96449
51018,,3czjnrggqkuj,48225,48226,96451
51019,,zykakjh5jpaj,48226,48227,96453
51020,,lgdcyxo6ph0j,48227,48228,96455
51021,,limughnagjmj,48228,48229,96457
51022,,vlduc66xwcij,48229,48230,96459
51023,,gviekonygxmj,48230,48231,96461
51024,,kozczbpyzgqj,48231,48232,96463
51025,,gmsfwh6cbxgj,48232,48233,96465
51026,,vviscjwtnbwj,48233,48234,96467
51027,,tdx3nlcpwlwj,48234,48235,96469
51028,,anmaanwpkcgj,48235,48236,96471
51029,,e1furtsugyyj,48236,48237,96473
51030,,url:http://www.springerlink.com/index/lkq3617q0tr21776.pdf,48237,48238,96475
51031,,dmyxjikienyj,48238,48239,96477
51032,,lhp3s0uyn6ij,48239,48240,96479
51033,,w7wc_l6opymj,48240,48241,96481
51034,,3nggeba3hrsj,48241,48242,96483
51035,,gyh7_iiyxnmj,48242,48243,96485
51036,,m4bjgwb_b7oj,48243,48244,96487
51037,,6fa1lj5hxeej,48244,48245,96489
51038,,url:http://portal.acm.org/ft_gateway.cfm3fid3d110200326type3dpdf,48245,48246,96491
51039,,q3u-l0ndjxgj,48246,48247,96493
51040,,ptlknp9u7yij,48247,48248,96495
51041,,41b5nueflpsj,48248,48249,96497
51042,,yfwnixcnlz0j,48249,48250,96499
51043,,9r5dl8b5l7oj,48250,48251,96501
51044,,tnsgevc4migj,48251,48252,96503
51045,,url:http://doi.wiley.com/10.1002/he.33,48252,48253,96505
51046,,tqrfojddqraj,48253,48254,96507
51047,,pzvdv7jooqoj,48254,48255,96509
51048,,iioabgsn0qaj,48255,48256,96511
51049,,d7i3y9xtqhoj,48256,48257,96513
51050,,ak5pawfw89cj,48257,48258,96515
51051,,url:http://portal.acm.org/ft_gateway.cfm3fid3d110195826type3dpdf,48258,48259,96517
51052,,p3rpon1k15gj,48259,48260,96519
51053,,url:http://ieeexplore.ieee.org/iel5/7304/19758/00914846.pdf3farnumber3d914846,48260,48261,96521
51054,,fzufvp5mwgoj,48261,48262,96523
51055,,bmnop3alwfqj,48262,48263,96525
51056,,sl-goobrydsj,48263,48264,96527
51057,,vu4sqnobonoj,48264,48265,96529
51058,,fu7v72ur2gqj,48265,48266,96531
51059,,ihaqxlfz-q4j,48266,48267,96533
51060,,on98ieekezcj,48267,48268,96535
51061,,gglqho-8tl8j,48268,48269,96537
51062,,5d95i0g_mssj,48269,48270,96539
51063,,1p3-z1w9wguj,48270,48271,96541
51064,,j_0njamtjuij,48271,48272,96543
51065,,3ruutgbh3pkj,48272,48273,96545
51066,,khiu_xualrmj,48273,48274,96547
51067,,pdd4i1p7gccj,48274,48275,96549
51068,,zbjcin7m9qqj,48275,48276,96551
51069,,st7jrdt1vbmj,48276,48277,96553
51070,,9fcvbncwf3uj,48277,48278,96555
51071,,ew1mglqvcvuj,48278,48279,96557
51072,,cjvocqu3cjgj,48279,48280,96559
51073,,cgvvtfbgswuj,48280,48281,96561
51074,,ohx3d2dlgwoj,48281,48282,96563
51075,,a0t4yttdfl8j,48282,48283,96565
51076,,1yjspdzu3i4j,48283,48284,96567
51077,,l1kewtwuuhej,48284,48285,96569
51078,,at9tmsi18uwj,48285,48286,96571
51079,,url:http://www.csa.com/partners/viewrecord.php3frequester3dgs26collection3dtrd26recid3d200111010688mt26recid3da0032606ah,48286,48287,96573
51080,,mitl2ypcnk0j,48287,48288,96575
51081,,xxznfyqorx4j,48288,48289,96577
51082,,ejzglygemtcj,48289,48290,96579
51083,,zu7zlc_bhdmj,48290,48291,96581
51084,,url:http://www.csa.com/partners/viewrecord.php3frequester3dgs26collection3dtrd26recid3d8604720117md,48291,48292,96583
51085,,uvw8d-oscaej,48292,48293,96585
51086,,dhswt5y84o8j,48293,48294,96587
51087,,tidhrdtlmlej,48294,48295,96589
51088,,zlqjzhhsupgj,48295,48296,96591
51089,,tjkzub2gpbwj,48296,48297,96593
51090,,6fwdgiar8_kj,48297,48298,96595
51091,,url:http://adsabs.harvard.edu/abs/1976phdt........21e,48298,48299,96597
51092,,txkqlui-trwj,48299,48300,96599
51093,,k-momutylnkj,48300,48301,96601
51094,,g2gy46prhfmj,48301,48302,96603
51095,,ckiudhmf2muj,48302,48303,96605
51096,,c1rk0vhh7eqj,48303,48304,96607
51097,,4yjufsgfnpkj,48304,48305,96609
51098,,orsbt9vgqbwj,48305,48306,96611
51099,,ajpkrr6bo7sj,48306,48307,96613
51100,,lyiusadrx0mj,48307,48308,96615
51101,,45ey9yurxqcj,48308,48309,96617
51102,,lcw-7q4lbsyj,48309,48310,96619
51103,,lxfh32qjimuj,48310,48311,96621
51104,,url:http://www.csa.com/partners/viewrecord.php3frequester3dgs26collection3dtrd26recid3d0762151ci,48311,48312,96623
51105,,amxmiq26vgej,48312,48313,96625
51106,,_f8phdbukvij,48313,48314,96627
51107,,ndgvpw75avgj,48314,48315,96629
51108,,4jf4vt_rhj8j,48315,48316,96631
51109,,qtvwhj_vrq0j,48316,48317,96633
51110,,ey0lstkgnkqj,48317,48318,96635
51111,,sk7j_7jomtuj,48318,48319,96637
51112,,fm-nyvw9bquj,48319,48320,96639
51113,,x-c1yjfoutwj,48320,48321,96641
51114,,fgyhk9zsjwyj,48321,48322,96643
51115,,19okli6eiwmj,48322,48323,96645
51116,,dcpifwxoew0j,48323,48324,96647
51117,,kcqcg98sscij,48324,48325,96649
51118,,nyu82ghb2tgj,48325,48326,96651
51119,,yeiz5e4fzh4j,48326,48327,96653
51120,,uopajrbz2igj,48327,48328,96655
51121,,js3lxgruxyej,48328,48329,96657
51122,,idcwx-bimakj,48329,48330,96659
51123,,wicqj1cqwuwj,48330,48331,96661
51124,,0b65dakbnbuj,48331,48332,96663
51125,,mcs9zp8tx_uj,48332,48333,96665
51126,,ocribsleidoj,48333,48334,96667
51127,,1tckher85gij,48334,48335,96669
51128,,5r3f_e96y58j,48335,48336,96671
51129,,w-g8rpkfnvaj,48336,48337,96673
51130,,qfwqymvgci0j,48337,48338,96675
51131,,bt-qqlsywuyj,48338,48339,96677
51132,,_y00eac7-xyj,48339,48340,96679
51133,,w1f54m8pwl4j,48340,48341,96681
51134,,epeh8ucc_ogj,48341,48342,96683
51135,,qtdukofes_uj,48342,48343,96685
51136,,0cwfbfmtoqwj,48343,48344,96687
51137,,cdwtiw8atqmj,48344,48345,96689
51138,,lpmy4qawityj,48345,48346,96691
51139,,ya2jduwj5gqj,48346,48347,96693
51140,,,48347,48348,96695
51141,,phrxvvvb45gj,48348,48349,96697
51142,,gsstayhotswj,48349,48350,96699
51143,,jv8msrko0yij,48350,48351,96701
51144,,eklznhxaseej,48351,48352,96703
51145,,u5ticoxvykij,48352,48353,96705
51146,,j_yqnul1jz8j,48353,48354,96707
51147,,us2p93q_0ycj,48354,48355,96709
51148,,wjibcs-afwij,48355,48356,96711
51149,,fym4126k7myj,48356,48357,96713
51150,,klcbzlka12mj,48357,48358,96715
51151,,3ibxhqjb-p4j,48358,48359,96717
51152,,cmzvqagk7pij,48359,48360,96719
51153,,tobpp5lib20j,48360,48361,96721
51154,,4-itfyv1ak8j,48361,48362,96723
51155,,p0nbmi1yxuij,48362,48363,96725
51156,,0b1xrtz8chkj,48363,48364,96727
51157,,rqyu6lndtrij,48364,48365,96729
51158,,e_q5ybg_4c4j,48365,48366,96731
51159,,p25_yh3lbhoj,48366,48367,96733
51160,,9r49zxtheayj,48367,48368,96735
51161,,hnhmgoj5qfqj,48368,48369,96737
51162,,o884x5l22mej,48369,48370,96739
51163,,osbjeycgyuqj,48370,48371,96741
51164,,jtgd1x7h2gkj,48371,48372,96743
51165,,b67macoktusj,48372,48373,96745
51166,,f6hqxla_3b4j,48373,48374,96747
51167,,cnat69t9ngij,48374,48375,96749
51168,,md6gfkee1gwj,48375,48376,96751
51169,,pawhb-fdugyj,48376,48377,96753
51170,,zmbf0jqfxmij,48377,48378,96755
51171,,4bfiuxjz7fwj,48378,48379,96757
51172,,fqu7aylhklaj,48379,48380,96759
51173,,lccqye7ornsj,48380,48381,96761
51174,,d8na9kumxpoj,48381,48382,96763
51175,,i_fbr9d6_8sj,48382,48383,96765
51176,,ua35n6j5nlkj,48383,48384,96767
51177,,url:http://doi.wiley.com/10.1002/tl.83,48384,48385,96769
51178,,xrj7anyyujyj,48385,48386,96771
51179,,obmujy3dv_sj,48386,48387,96773
51180,,n6smdg-xu2uj,48387,48388,96775
51181,,azbnsmv03raj,48388,48389,96777
51182,,cgtsxxyd8_uj,48389,48390,96779
51183,,url:http://portal.acm.org/ft_gateway.cfm3fid3d106619626type3dpdf,48390,48391,96781
51184,,cc65tjkqvnuj,48391,48392,96783
51185,,et0xpjsaxzij,48392,48393,96785
51186,,gy-uajascqqj,48393,48394,96787
51187,,yxtiejmeueyj,48394,48395,96789
51188,,tv_cbclonvej,48395,48396,96791
51189,,ma1qk2dzrfyj,48396,48397,96793
51190,,urassfxhda8j,48397,48398,96795
51191,,,48398,48399,96797
51192,,fkidbjl6wxqj,48399,48400,96799
51193,,llkf_jtuvimj,48400,48401,96801
51194,,cbxiiy55efkj,48401,48402,96803
51195,,swn9_fqlxvmj,48402,48403,96805
51196,,,48403,48404,96807
51197,,cngpst2hgiuj,48404,48405,96809
51198,,bsc0d2qreroj,48405,48406,96811
51199,,iubtofzrojuj,48406,48407,96813
51200,,mexl2imbvwmj,48407,48408,96815
51201,,pcq6r9xtrhij,48408,48409,96817
51202,,url:http://portal.acm.org/citation.cfm3fid3d89482.89487,48409,48410,96819
51203,,obdfts9a7a4j,48410,48411,96821
51204,,s_eti_2fp-oj,48411,48412,96823
51205,,f5vra2qownqj,48412,48413,96825
51206,,wqpglnim3mkj,48413,48414,96827
51207,,kuwu3-umxqwj,48414,48415,96829
51208,,w8smfon2coej,48415,48416,96831
51209,,8xvk7p0brjaj,48416,48417,96833
51210,,_iaeyhpa4x0j,48417,48418,96835
51211,,vvjchmh_v3ej,48418,48419,96837
51212,,r9aigq4evmqj,48419,48420,96839
51213,,enyu7p7cboaj,48420,48421,96841
51214,,op6yjlv8t8cj,48421,48422,96843
51215,,yifqpy-rjhaj,48422,48423,96845
51216,,mgpjal8bytoj,48423,48424,96847
51217,,vd3h69ll-0wj,48424,48425,96849
51218,,alsuh-tgmhcj,48425,48426,96851
51219,,crhymx7q0bqj,48426,48427,96853
51220,,bnxocq2ydr0j,48428,48429,96857
51221,,2c_fdgmsly0j,48429,48430,96859
51222,,td9nzodcftsj,48430,48431,96861
51223,,zifvbi9r4-oj,48431,48432,96863
51224,,,48432,48433,96865
51225,,qmewqna7w_aj,48433,48434,96867
51226,,url:http://www.csa.com/partners/viewrecord.php3frequester3dgs26collection3dtrd26recid3dn8217902ah,48434,48435,96869
51227,,epr1bbk_snwj,48435,48436,96871
51228,,_bb09-ihk18j,48436,48437,96873
51229,,dsxljfcu4-uj,48437,48438,96875
51230,,,48438,48439,96877
51231,,hmpul2ixtkwj,48439,48440,96879
51232,,yu8jjxw-uvcj,48440,48441,96881
51233,,pd2ztylhxd0j,48441,48442,96883
51234,,manu9dech1sj,48442,48443,96885
51235,,4a3f02nnlrij,48443,48444,96887
51236,,lutbfnb4gkgj,48444,48445,96889
51237,,url:http://www.csa.com/partners/viewrecord.php3frequester3dgs26collection3dtrd26recid3d018802530041ai,48445,48446,96891
51238,,gdlhdl-s4tij,48446,48447,96893
51239,,oetq6g-0vyqj,48447,48448,96895
51240,,brghmyax2r4j,48448,48449,96897
51241,,ttzh8m7ewvaj,48449,48450,96899
51242,,in7p2jkm_syj,48450,48451,96901
51243,,3mdbqpd4r_cj,48451,48452,96903
51244,,fbafy8dfrqoj,48452,48453,96905
51245,,bl4jbjecdb0j,48453,48454,96907
51246,,ljowsosfqvgj,48454,48455,96909
51247,,e7ovq-5vyqsj,48455,48456,96911
51248,,p9gxqzhaihwj,48456,48457,96913
51249,,n2aznm8cjbqj,48457,48458,96915
51250,,ioxtnjbc4sej,48458,48459,96917
51251,,exzdg9xwp-mj,48459,48460,96919
51252,,3pmivzyi3boj,48460,48461,96921
51253,,onfdnu53ct4j,48461,48462,96923
51254,,wfzqqxs_dt4j,48462,48463,96925
51255,,aqzkyjyl1vqj,48463,48464,96927
51256,,n-fdylows3ej,48464,48465,96929
51257,,zrswop5l-z8j,48465,48466,96931
51258,,eqlfzy6lmykj,48466,48467,96933
51259,,hb6tuqdybegj,48467,48468,96935
51260,,oxr4cmstnz0j,48468,48469,96937
51261,,wdjy8jvihouj,48469,48470,96939
51262,,buvdvsawo-oj,48470,48471,96941
51263,,,48471,48472,96943
51264,,1r1gchs7me8j,48472,48473,96945
51265,,liyojjfaoxmj,48473,48474,96947
51266,,56sxohfyurgj,48474,48475,96949
51267,,,48475,48476,96951
51268,,i0crdgd5efqj,48476,48477,96953
51269,,5mjfygfrk2uj,48477,48478,96955
51270,,6gevthhrq0oj,48478,48479,96957
51271,,cvnkiwufx5oj,48479,48480,96959
51272,,sg8q4oaht5kj,48480,48481,96961
51273,,o4tbxh0pa3sj,48481,48482,96963
51274,,c1qbmqimoomj,48483,48484,96967
51275,,bsfkn0iq_b4j,48484,48485,96969
51276,,7o95ki0iivsj,48485,48486,96971
51277,,l-j6ztvfdlaj,48486,48487,96973
51278,,ouygiyv0mi8j,48487,48488,96975
51279,,1elydbfgu9wj,48488,48489,96977
51280,,l2rtfkdpuiuj,48489,48490,96979
51281,,-4vzqqz_mxqj,48490,48491,96981
51282,,s3rdsi64krej,48491,48492,96983
51283,,6wh1wjjm2ymj,48492,48493,96985
51284,,wlpifx65ckwj,48493,48494,96987
51285,,qbielg442e4j,48494,48495,96989
51286,,hbtkaohj7ooj,48495,48496,96991
51287,,ets4pc2barkj,48496,48497,96993
51288,,01qk-8zek58j,48497,48498,96995
51289,,j4o7xm4yprmj,48498,48499,96997
51290,,ebezd-smh_4j,48499,48500,96999
51291,,pj0arik85aqj,48500,48501,97001
51292,,d8ydflqwgdkj,48501,48502,97003
51293,,l7cnvwv1dlej,48502,48503,97005
51294,,url:http://www.csa.com/partners/viewrecord.php3frequester3dgs26collection3dtrd26recid3d7311331986md26recid3d017310550113xai,48503,48504,97007
51295,,url:http://doi.wiley.com/10.1002/(sici)1521-3978(200005)48:5/7253c473::aid-prop473253e3.0.co3b2-g,48504,48505,97009
51296,,ioemwdzxkoyj,48505,48506,97011
51297,,4t1a74d6dgaj,48506,48507,97013
51298,,ng9lbxb8ccoj,48507,48508,97015
51299,,os1lmodbeqej,48508,48509,97017
51300,,url:http://portal.acm.org/ft_gateway.cfm3fid3d110750326type3dpdf,48509,48510,97019
51301,,npchqhb66yuj,48510,48511,97021
51302,,lj2fe390lsaj,48511,48512,97023
51303,,workuairgn4j,48512,48513,97025
51304,,w6ectvuhxy8j,48513,48514,97027
51305,,m5ru513vodgj,48514,48515,97029
51306,,jy1vgu_xajyj,48515,48516,97031
51307,,tbvl29ryhyqj,48516,48517,97033
51308,,osu478mzlqmj,48517,48518,97035
51309,,zvnkwli12kkj,48518,48519,97037
51310,,ydxgz-bxfkmj,48519,48520,97039
51311,,f_ir3hj9u4gj,48521,48522,97043
51312,,hf0571sq0xwj,48522,48523,97045
51313,,43l5iqlrimij,48523,48524,97047
51314,,url:http://www.ncbi.nlm.nih.gov/entrez/query.fcgi3fcmd3dretrieve26db3dpubmed26list_uids3d432790326dopt3dcitation,48524,48525,97049
51315,,nsi_6npkojej,48525,48526,97051
51316,,dkdze1vg71sj,48526,48527,97053
51317,,8t-lbaluiacj,48527,48528,97055
51318,,rjwssb0ti4mj,48528,48529,97057
51319,,url:http://www.csa.com/partners/viewrecord.php3frequester3dgs26collection3dtrd26recid3dn9210514ah,48529,48530,97059
51320,,nf85nvn-p9cj,48530,48531,97061
51321,,gvvmmo_de0ej,48531,48532,97063
51322,,ew3sswnykjoj,48532,48533,97065
51323,,bikpilkxmmsj,48533,48534,97067
51324,,6hxcfit1fsij,48534,48535,97069
51325,,ixixquvfz20j,48535,48536,97071
51326,,qpcdiu1ezj8j,48536,48537,97073
51327,,url:http://ieeexplore.ieee.org/iel4/4876/13450/00653653.pdf3farnumber3d653653,48537,48538,97075
51328,,psstmyiap6uj,48538,48539,97077
51329,,femqkjm63naj,48539,48540,97079
51330,,mvhkvnwmhw8j,48540,48541,97081
51331,,akriqwsifa0j,48541,48542,97083
51332,,ehdjf-5o6yej,48542,48543,97085
51333,,pomyuzbifx8j,48543,48544,97087
51334,,pizw-fcyvyej,48544,48545,97089
51335,,1n-1xj-lflaj,48545,48546,97091
51336,,aerjpsee2vuj,48546,48547,97093
51337,,too-2iqybpkj,48547,48548,97095
51338,,akp2fsk_4muj,48548,48549,97097
51339,,rvt_8y5sqgqj,48549,48550,97099
51340,,br-fek0kiimj,48550,48551,97101
51341,,url:http://ieeexplore.ieee.org/iel5/9217/29235/01320094.pdf3farnumber3d1320094,48551,48552,97103
51342,,baimizvvunej,48552,48553,97105
51343,,eukyw6tfu4wj,48553,48554,97107
51344,,whchjdzkge4j,48554,48555,97109
51345,,e3gveefl_aij,48555,48556,97111
51346,,u6tmbqn-o4oj,48556,48557,97113
51347,,l9z6othtawqj,48557,48558,97115
51348,,9_fej_7nhx0j,48558,48559,97117
51349,,1s7_wvblz7oj,48559,48560,97119
51350,,3fpebo3t6hsj,48560,48561,97121
51351,,edkv7zep0pij,48561,48562,97123
51352,,,48562,48563,97125
51353,,qqm7pp9xk2kj,48563,48564,97127
51354,,biilzduoyc4j,48564,48565,97129
51355,,olcgwyqovgqj,48565,48566,97131
51356,,saz0fdjhamoj,48566,48567,97133
51357,,4k1a34ycofaj,48567,48568,97135
51358,,ewwwi9eexlij,48568,48569,97137
51359,,msqznc2ox4ij,48569,48570,97139
51360,,url:http://doi.wiley.com/10.1002/ace.7303,48570,48571,97141
51361,,hocniodybhqj,48571,48572,97143
51362,,u4w7cbo9ejaj,48572,48573,97145
51363,,djhxzf4ao28j,48573,48574,97147
51364,,-0ygjn_cp84j,48574,48575,97149
51365,,dxtmerdlcjcj,48576,48577,97153
51366,,mmjbmhpzflkj,48577,48578,97155
51367,,ymriod0e23gj,48578,48579,97157
51368,,qw4cyy6mnp4j,48579,48580,97159
51369,,txsaivq2z3wj,48580,48581,97161
51370,,iwdac52ss8yj,48581,48582,97163
51371,,l-ip5jnfj5wj,48582,48583,97165
51372,,7taw_3cc3mwj,48584,48585,97169
51373,,,48585,48586,97171
51374,,cjqx2idcm9wj,48586,48587,97173
51375,,,48588,48589,97177
51376,,puvh4j5ojluj,48589,48590,97179
51377,,qfqixvkowzwj,48590,48591,97181
51378,,url:http://portal.acm.org/ft_gateway.cfm3fid3d24861226type3dpdf26dl3dguide26dl3dacm26cfid3d1111111126cftoken3d2222222,48591,48592,97183
51379,,dryl2wa6nbcj,48592,48593,97185
51380,,9wdsbuaezt8j,48593,48594,97187
51381,,nfylyp2cfxwj,48594,48595,97189
51382,,z8tupdmhy0wj,48595,48596,97191
51383,,xtvrdxynbwaj,48596,48597,97193
51384,,l3d8_szidtuj,48597,48598,97195
51385,,y1jwaajymqmj,48598,48599,97197
51386,,vjmqnzv42j8j,48599,48600,97199
51387,,kaywgixekjmj,48600,48601,97201
51388,,07kumtktl0gj,48601,48602,97203
51389,,url:http://www.ingentaconnect.com/content/els/09505849/1995/00000037/00000010/art90928,48602,48603,97205
51390,,7qhejrbqh_ej,48603,48604,97207
51391,,muvarmgc_hcj,48604,48605,97209
51392,,tdnjq9qxzykj,48605,48606,97211
51393,,hmvjhgdvrvmj,48606,48607,97213
51394,,8mvuzlrjgsij,48607,48608,97215
51395,,av97ndxyx1kj,48608,48609,97217
51396,,9c3tqn1r5iaj,48609,48610,97219
51397,,do_obm-mq4cj,48610,48611,97221
51398,,toxklufmivej,48611,48612,97223
51399,,khd8kexp_ogj,48612,48613,97225
51400,,k8nobrjpe8ej,48613,48614,97227
51401,,rlj1sqzg0auj,48614,48615,97229
51402,,b23qbfgixfej,48615,48616,97231
51403,,3mwyq_rpfa4j,48617,48618,97235
51404,,zclp3bw_fuuj,48618,48619,97237
51405,,0v6xauce4yyj,48619,48620,97239
51406,,yyg5d_ywyfoj,48620,48621,97241
51407,,wdxyaak4s88j,48621,48622,97243
51408,,6nmudbnfwk8j,48622,48623,97245
51409,,_tartinezkij,48623,48624,97247
51410,,url:http://portal.acm.org/ft_gateway.cfm3fid3d108369126type3dpdf,48624,48625,97249
51411,,_dq-9qerbxyj,48625,48626,97251
51412,,kfjtxb-xmn0j,48627,48628,97255
51413,,49kh1ozmsnsj,48628,48629,97257
51414,,6cxvqjqpv9ej,48629,48630,97259
51415,,qxgszlku0sgj,48630,48631,97261
51416,,ix8lbzbegswj,48632,48633,97265
51417,,c3pmgdpvsdaj,48633,48634,97267
51418,,2wgzi7lwxigj,48634,48635,97269
51419,,dfqhi6rk_msj,48635,48636,97271
51420,,v9hwlxlshrsj,48636,48637,97273
51421,,hac2r0yv0hcj,48637,48638,97275
51422,,qfi51pr4_swj,48638,48639,97277
51423,,ca6jy6bgmqej,48640,48641,97281
51424,,edvdfghsncij,48641,48642,97283
51425,,cpgfbll9t_qj,48642,48643,97285
51426,,ou2eewrf5lcj,48643,48644,97287
51427,,h5v2lq31x0mj,48644,48645,97289
51428,,rdiz-ms6onkj,48645,48646,97291
51429,,lhyq2upeenwj,48646,48647,97293
51430,,t9o_ssxxmpsj,48647,48648,97295
51431,,g4d72han0q4j,48648,48649,97297
51432,,iwz0_0ypwp8j,48649,48650,97299
51433,,102kn1obdwcj,48650,48651,97301
51434,,gzyemwytdumj,48651,48652,97303
51435,,zsn8ewtoxiuj,48652,48653,97305
51436,,p57u5pr-uvij,48653,48654,97307
51437,,a1bw4d-2e3qj,48654,48655,97309
51438,,1ooookhons8j,48655,48656,97311
51439,,u9tdrbbucsyj,48656,48657,97313
51440,,cwb5lsiwxzyj,48657,48658,97315
51441,,x5gvyo-bitqj,48658,48659,97317
51442,,vyxqze4qqgcj,48659,48660,97319
51443,,fs8smtcdclej,48660,48661,97321
51444,,ioreqckwc-uj,48661,48662,97323
51445,,mgoc_iqppxqj,48662,48663,97325
51446,,i5jhquyugboj,48663,48664,97327
51447,,3cicctaagtcj,48664,48665,97329
51448,,hibme_nytgcj,48665,48666,97331
51449,,kxjmcqccz6yj,48666,48667,97333
51450,,3fbmdihmto0j,48667,48668,97335
51451,,url:http://doi.wiley.com/10.1002/ace.169,48668,48669,97337
51452,,ykfqeimpiraj,48669,48670,97339
51453,,url:http://portal.acm.org/citation.cfm3fid3d234286.1057835,48670,48671,97341
51454,,mvoezmi1py0j,48671,48672,97343
51455,,8jys3sab3d8j,48672,48673,97345
51456,,qkvypshc-daj,48674,48675,97349
51457,,kugwrx0c7csj,48675,48676,97351
51458,,q620d4skkj0j,48676,48677,97353
51459,,53k2quofkx0j,48677,48678,97355
51460,,ygdbsy4q_iyj,48678,48679,97357
51461,,o57-n-viohqj,48679,48680,97359
51462,,6dkrsbh3nuij,48680,48681,97361
51463,,fi77ekzfmsoj,48681,48682,97363
51464,,zfr0y8-xegsj,48682,48683,97365
51465,,xlm8eezyc3wj,48683,48684,97367
51466,,pqzxxtil5cmj,48684,48685,97369
51467,,wa14zxlnbf8j,48685,48686,97371
51468,,gonl8xqsidyj,48686,48687,97373
51469,,lxdmghaxwu4j,48687,48688,97375
51470,,cywzpbf5i-cj,48688,48689,97377
51471,,zcjwv_vaomsj,48689,48690,97379
51472,,_filoshi-rkj,48690,48691,97381
51473,,lje-li-oouwj,48691,48692,97383
51474,,uu58cvx4rq0j,48692,48693,97385
51475,,xa82v6iihhgj,48693,48694,97387
51476,,wrt8k06tyiyj,48694,48695,97389
51477,,5aujkpl9evwj,48695,48696,97391
51478,,r7dxnowovcaj,48696,48697,97393
51479,,vemlkak2y_gj,48697,48698,97395
51480,,31xqvpvor8qj,48698,48699,97397
51481,,v9presws6yuj,48699,48700,97399
51482,,r8hxwllexfmj,48700,48701,97401
51483,,2zwi8z7wreij,48701,48702,97403
51484,,luejt38wwh8j,48702,48703,97405
51485,,u6gudhxxizej,48703,48704,97407
51486,,lh2ccp5ipdwj,48704,48705,97409
51487,,oepwacnqlwwj,48705,48706,97411
51488,,4j5cvdombmsj,48706,48707,97413
51489,,url:http://doi.wiley.com/10.1002/ace.177,48707,48708,97415
51490,,5cxqtakgk6ij,48708,48709,97417
51491,,audl37tvcocj,48709,48710,97419
51492,,u_mp78oixigj,48710,48711,97421
51493,,4onln7qklqaj,48711,48712,97423
51494,,09yj3fnyqzcj,48712,48713,97425
51495,,bwcrff-snpyj,48713,48714,97427
51496,,3ru7e1tdkl0j,48714,48715,97429
51497,,cxd6hg35evij,48715,48716,97431
51498,,id-h2cohybaj,48716,48717,97433
51499,,4q7eh66kpq8j,48717,48718,97435
51500,,c3re_w4tonyj,48718,48719,97437
51501,,nqms75qi6_aj,48719,48720,97439
51502,,s3zl31yhbyaj,48720,48721,97441
51503,,smzcgv97cdmj,48721,48722,97443
51504,,_ie4vapahbmj,48723,48724,97447
51505,,p4wjudjwcmmj,48724,48725,97449
51506,,vcfz2a0q1dsj,48725,48726,97451
51507,,bjoxvzybjtkj,48726,48727,97453
51508,,sr1f8jbpepaj,48727,48728,97455
51509,,uacg3rny5h4j,48728,48729,97457
51510,,_cnnb6udemaj,48729,48730,97459
51511,,gagrp8zttwoj,48730,48731,97461
51512,,0qjntpc4ua0j,48731,48732,97463
51513,,h_gt_-2nqvoj,48732,48733,97465
51514,,708w4f1ep44j,48733,48734,97467
51515,,lgrt1amroywj,48734,48735,97469
51516,,2di5npodxhej,48735,48736,97471
51517,,url:http://www.ingentaconnect.com/search/expand3fpub3dinfobike://els/09505849/1996/00000038/00000002/art0105626unc3d,48736,48737,97473
51518,,d88ynoaxeu8j,48737,48738,97475
51519,,zzhq-sltz34j,48738,48739,97477
51520,,kurlsp6bmpwj,48739,48740,97479
51521,,cks4ebzj9z0j,48740,48741,97481
51522,,guu7zviohkwj,48741,48742,97483
51523,,steeft926e8j,48742,48743,97485
51524,,pcqlhjmeorkj,48743,48744,97487
51525,,wbx2uqug4pkj,48744,48745,97489
51526,,yrsksaxrxxej,48745,48746,97491
51527,,zyx_apptjikj,48746,48747,97493
51528,,5dkap73v7fqj,48747,48748,97495
51529,,cik07swjagcj,48748,48749,97497
51530,,8yf0cuodybcj,48749,48750,97499
51531,,hsvwkc5n1v4j,48750,48751,97501
51532,,aldc_37djvoj,48751,48752,97503
51533,,cohstaycs74j,48752,48753,97505
51534,,s3creww1160j,48753,48754,97507
51535,,irb2anuz3osj,48754,48755,97509
51536,,zctgltec2vij,48755,48756,97511
51537,,yv2sigdjbzuj,48756,48757,97513
51538,,l4pka08fgeij,48757,48758,97515
51539,,vqvvyy38-waj,48758,48759,97517
51540,,sdr0ypxpuawj,48759,48760,97519
51541,,dqbc1ymo9caj,48760,48761,97521
51542,,bxmouazaj1uj,48761,48762,97523
51543,,x0k2onj7_o0j,48762,48763,97525
51544,,nshkzfa2qqoj,48763,48764,97527
51545,,keg9trac-z0j,48764,48765,97529
51546,,l57ejaffatqj,48765,48766,97531
51547,,_btw5e30acuj,48766,48767,97533
51548,,iijr520czuij,48767,48768,97535
51549,,jgxk9k6jb7uj,48768,48769,97537
51550,,url:http://www.csa.com/partners/viewrecord.php3frequester3dgs26collection3dtrd26recid3d0235380ci,48769,48770,97539
51551,,url:http://www.blackwell-synergy.com/links/doi/10.1111/j.0033-0124.1967.00355.x/abs/,48770,48771,97541
51552,,lzzmtylzcxoj,48771,48772,97543
51553,,qi6xati-mvej,48772,48773,97545
51554,,osdxqxyqnryj,48773,48774,97547
51555,,iyfqdr1bujwj,48774,48775,97549
51556,,x98qkvpwkyyj,48775,48776,97551
51557,,em2trad_rf8j,48776,48777,97553
51558,,re88e4bs2paj,48777,48778,97555
51559,,old7v222ujkj,48778,48779,97557
51560,,url:http://portal.acm.org/citation.cfm3fid3d306781,48779,48780,97559
51561,,4trqxcy9b40j,48780,48781,97561
51562,,1x9pilh03c0j,48781,48782,97563
51563,,ksmqzf7yazsj,48782,48783,97565
51564,,1t2tkbukejmj,48783,48784,97567
51565,,gg7jp0-rx1cj,48784,48785,97569
51566,,kuwujjupslsj,48785,48786,97571
51567,,url:http://portal.acm.org/ft_gateway.cfm3fid3d110122526type3dpdf,48786,48787,97573
51568,,wihzt6rqy2wj,48787,48788,97575
51569,,64dy2hoveaqj,48788,48789,97577
51570,,c6ypihirmqgj,48789,48790,97579
51571,,3o4t-svhqfcj,48790,48791,97581
51572,,dhbejyv20wmj,48791,48792,97583
51573,,,48792,48793,97585
51574,,er1mhpgyt98j,48793,48794,97587
51575,,nfuvy29qjmqj,48794,48795,97589
51576,,d2yprbpijfyj,48796,48797,97593
51577,,4o63wqyxcywj,48797,48798,97595
51578,,omoq_6wuegkj,48798,48799,97597
51579,,nuqjxvcofyej,48799,48800,97599
51580,,i_he5brnhjmj,48800,48801,97601
51581,,4erm5qh6lbqj,48802,48803,97605
51582,,doioj3fg0eoj,48803,48804,97607
51583,,ehpjjc3wwp8j,48804,48805,97609
51584,,oafexjmqlgcj,48805,48806,97611
51585,,-2t6izpdiw0j,48806,48807,97613
51586,,motpl_6vwrsj,48807,48808,97615
51587,,y6quqewj3icj,48808,48809,97617
51588,,pfdzesne3qgj,48809,48810,97619
51589,,2anbg9hq7wcj,48810,48811,97621
51590,,url:http://www.csa.com/partners/viewrecord.php3frequester3dgs26collection3dtrd26recid3dn9210541ah,48811,48812,97623
51591,,m9um3zou1gej,48812,48813,97625
51592,,kibxl_e8m-aj,48813,48814,97627
51593,,ewcg3j-bm2uj,48814,48815,97629
51594,,plqppqtd_rmj,48815,48816,97631
51595,,5gane-mqs3oj,48816,48817,97633
51596,,f0nikzndd0oj,48817,48818,97635
51597,,hicfddlhcr8j,48818,48819,97637
51598,,0itcuz16qj4j,48820,48821,97641
51599,,dild9bbkc5mj,48821,48822,97643
51600,,rvzwnzal4oyj,48822,48823,97645
51601,,uwdeewp3x7ij,48823,48824,97647
51602,,aaysflcreysj,48824,48825,97649
51603,,ibtvdt5pswaj,48825,48826,97651
51604,,9be3ok0ff0kj,48826,48827,97653
51605,,sgjfl8-bnhmj,48827,48828,97655
51606,,2-ag0y1kmimj,48828,48829,97657
51607,,xxrilp87njuj,48829,48830,97659
51608,,wdzpf5ppajqj,48830,48831,97661
51609,,kss8ddnqlioj,48831,48832,97663
51610,,hnrxvxvjneoj,48833,48834,97667
51611,,vnmedj_6p7gj,48834,48835,97669
51612,,lc59e81ciwkj,48835,48836,97671
51613,,uh0doh2twhmj,48837,48838,97675
51614,,xdcnyanhj9aj,48838,48839,97677
51615,,bbwzigkxl3sj,48839,48840,97679
51616,,m3xmp_8b77cj,48840,48841,97681
51617,,6fpooz0fjzwj,48841,48842,97683
51618,,f4hl6yvzmlaj,48842,48843,97685
51619,,gsr1gkxub6gj,48843,48844,97687
51620,,6mjlbqnj7ckj,48844,48845,97689
51621,,efgisvhmycej,48845,48846,97691
51622,,a-zz7wfua2cj,48846,48847,97693
51623,,01iwvr6rau8j,48847,48848,97695
51624,,54jusm8ptnkj,48848,48849,97697
51625,,x4phhw-scxmj,48849,48850,97699
51626,,heaktvqn880j,48850,48851,97701
51627,,ci0tto6cooaj,48851,48852,97703
51628,,ryl2kvuqwcgj,48853,48854,97707
51629,,z2xgky71qqwj,48854,48855,97709
51630,,nvejsxvyuwyj,48855,48856,97711
51631,,fh3lch5ageuj,48856,48857,97713
51632,,433ysitbnwgj,48857,48858,97715
51633,,,48858,48859,97717
51634,,q2zf-a_jbooj,48859,48860,97719
51635,,t_ctvuaddncj,48860,48861,97721
51636,,url:http://portal.acm.org/ft_gateway.cfm3fid3d110124726type3dpdf,48861,48862,97723
51637,,yzlys0oqkt8j,48862,48863,97725
51638,,8fklarbrkhyj,48863,48864,97727
51639,,todetytx98cj,48864,48865,97729
51640,,qageucjjjpaj,48865,48866,97731
51641,,1bsptuushfmj,48866,48867,97733
51642,,bawpootezvij,48867,48868,97735
51643,,xebpoylsuiej,48868,48869,97737
51644,,ynwmvsfexuej,48869,48870,97739
51645,,1oq2ds7ub-8j,48870,48871,97741
51646,,tecr1510ur0j,48871,48872,97743
51647,,p9ecci4vpqyj,48872,48873,97745
51648,,3uyxiahwxa0j,48873,48874,97747
51649,,sxa51ymukbcj,48874,48875,97749
51650,,94tpenxpz28j,48875,48876,97751
51651,,bizmjfsk0qej,48876,48877,97753
51652,,swhzycb5rq0j,48877,48878,97755
51653,,a4tucdtortaj,48878,48879,97757
51654,,u0jhb6vkstuj,48879,48880,97759
51655,,90qry26o3wsj,48880,48881,97761
51656,,ocg9kijmqlwj,48881,48882,97763
51657,,url:http://www.ingentaconnect.com/content/els/09505849/1997/00000039/00000004/art01141,48882,48883,97765
51658,,xawnq-a4ju0j,48883,48884,97767
51659,,url:http://portal.acm.org/ft_gateway.cfm3fid3d102770326type3dpdf,48884,48885,97769
51660,,ak7medvmekaj,48885,48886,97771
51661,,iwty2geerymj,48886,48887,97773
51662,,url:http://adsabs.harvard.edu/abs/1974phdt........46w,48887,48888,97775
51663,,ahxg9bignxmj,48888,48889,97777
51664,,,48889,48890,97779
51665,,d-wuf5cupz4j,48890,48891,97781
51666,,-gk8_gusm-4j,48891,48892,97783
51667,,qavrn9wnwbqj,48892,48893,97785
51668,,pegmtt8tmngj,48893,48894,97787
51669,,2ezev_uwj-8j,48894,48895,97789
51670,,nc9oovzm27mj,48895,48896,97791
51671,,a7w0gohcddgj,48896,48897,97793
51672,,supp_hmq5ukj,48897,48898,97795
51673,,hja41qtexaej,48898,48899,97797
51674,,650zrczzevwj,48899,48900,97799
51675,,cftoypk4_kkj,48900,48901,97801
51676,,kv2iqoulor0j,48901,48902,97803
51677,,qf-vmqd11v0j,48902,48903,97805
51678,,w3tiwvmo4l0j,48903,48904,97807
51679,,tncyf02bdosj,48904,48905,97809
51680,,3mi-epmcsxoj,48905,48906,97811
51681,,5n7vl_9uwd0j,48906,48907,97813
51682,,ah3entvwmj4j,48907,48908,97815
51683,,rqqwsjwcw8mj,48908,48909,97817
51684,,mzmdbijantcj,48909,48910,97819
51685,,hmflrnds9ysj,48910,48911,97821
51686,,dfz5hu-q0bij,48911,48912,97823
51687,,ssziunjxcpoj,48912,48913,97825
51688,,3ea_rtj0suwj,48913,48914,97827
51689,,ty_qpp3stxgj,48914,48915,97829
51690,,isxhqd28npyj,48915,48916,97831
51691,,msxig_9ln4kj,48916,48917,97833
51692,,hbzka1xol4ej,48917,48918,97835
51693,,uh7ccwok7xyj,48918,48919,97837
51694,,kcgzlrb4uo4j,48919,48920,97839
51695,,bw6yeqd4-gwj,48920,48921,97841
51696,,w3l-susxqrwj,48921,48922,97843
51697,,xygs7tireesj,48922,48923,97845
51698,,oao74aolstoj,48923,48924,97847
51699,,x4us1kgseu8j,48924,48925,97849
51700,,hfazo1frt8gj,48925,48926,97851
51701,,et9qowfevvqj,48926,48927,97853
51702,,lx6woyonencj,48927,48928,97855
51703,,236scppmi5aj,48928,48929,97857
51704,,tvu2h9vx34yj,48929,48930,97859
51705,,61xmsiaqgzwj,48930,48931,97861
51706,,3f7zfswbjagj,48931,48932,97863
51707,,ass0qgt-aa4j,48933,48934,97867
51708,,dxt_ne1d1j8j,48934,48935,97869
51709,,cwsbmunistkj,48935,48936,97871
51710,,pizkhnzey0gj,48936,48937,97873
51711,,9w-hdssvcyoj,48937,48938,97875
51712,,jtmxnpp4j3qj,48938,48939,97877
51713,,ozt0yalh_wej,48939,48940,97879
51714,,6t_n5axem7cj,48940,48941,97881
51715,,twaq-tizwqgj,48941,48942,97883
51716,,lhoihfpys8mj,48942,48943,97885
51717,,fvzgzgzg2hyj,48943,48944,97887
51718,,b6irbn7nbqwj,48944,48945,97889
51719,,pmhedcykgboj,48945,48946,97891
51720,,uoio49qz6xej,48946,48947,97893
51721,,j0s4tpyq3hwj,48947,48948,97895
51722,,lfuq7ulhnrqj,48948,48949,97897
51723,,z8dgzcws1koj,48949,48950,97899
51724,,9ozudqrcl2oj,48950,48951,97901
51725,,zlyletdmt1uj,48951,48952,97903
51726,,fnderok9rxaj,48952,48953,97905
51727,,87nsguw8huqj,48953,48954,97907
51728,,yhcwrghqy-aj,48954,48955,97909
51729,,hdswbbjsjn0j,48955,48956,97911
51730,,yid-hyeedeij,48956,48957,97913
51731,,pdckqybco4qj,48957,48958,97915
51732,,url:http://doi.ieeecomputersociety.org/10.1109/tkde.2004.74,48958,48959,97917
51733,,qalimoy7kpkj,48959,48960,97919
51734,,0sx0ii3yybaj,48960,48961,97921
51735,,4fio4dhgfsqj,48961,48962,97923
51736,,w_1izll4qmkj,48962,48963,97925
51737,,3fwu0jqpe88j,48963,48964,97927
51738,,f--tuk_dkayj,48964,48965,97929
51739,,jndq-eliljyj,48965,48966,97931
51740,,c04qppep3zyj,48966,48967,97933
51741,,jvtvn90kd5aj,48967,48968,97935
51742,,mjk-za-rvpgj,48968,48969,97937
51743,,bjdmuiq4hsej,48969,48970,97939
51744,,8flpuue8dwmj,48970,48971,97941
51745,,url:http://www.springerlink.com/index/mtg50320748621v7.pdf,48971,48972,97943
51746,,ukmzgc4ef2ej,48972,48973,97945
51747,,di_ncyrcdocj,48973,48974,97947
51748,,jafy1rtkxz8j,48974,48975,97949
51749,,mc4k54jcxm4j,48975,48976,97951
51750,,cgaa1qwckrgj,48976,48977,97953
51751,,ovumbul8deej,48977,48978,97955
51752,,okzks__mu10j,48978,48979,97957
51753,,7xzt-yfo-tyj,48979,48980,97959
51754,,qncl93mktdij,48980,48981,97961
51755,,wrrocw2zlhaj,48981,48982,97963
51756,,r1um7d3ckayj,48982,48983,97965
51757,,rebrhujejpij,48983,48984,97967
51758,,ehoxblpixbmj,48984,48985,97969
51759,,onfdabaostmj,48985,48986,97971
51760,,mp23glzohoij,48986,48987,97973
51761,,fu0v6we4ww8j,48987,48988,97975
51762,,url:http://www.csa.com/partners/viewrecord.php3frequester3dgs26collection3dtrd26recid3d0928107ci,48988,48989,97977
51763,,hnx9eetrqz0j,48989,48990,97979
51764,,teqtuquijgej,48990,48991,97981
51765,,rj-gyifsaicj,48991,48992,97983
51766,,jrryq_i3ercj,48993,48994,97987
51767,,82o_1geqnsqj,48994,48995,97989
51768,,dmwx_22lupej,48995,48996,97991
51769,,hgeb3uusbygj,48997,48998,97995
51770,,nxfgornukvmj,48998,48999,97997
51771,,ouqqrsn4tm4j,48999,49000,97999
51772,,kwty8r3owb8j,49000,49001,98001
51773,,jvlu_p30iamj,49001,49002,98003
51774,,oaesnlc1484j,49002,49003,98005
51775,,lf1u4dibdosj,49003,49004,98007
51776,,1xqsuzinyiqj,49004,49005,98009
51777,,9ya1vsaw3noj,49005,49006,98011
51778,,kl3jweiawpej,49006,49007,98013
51779,,tqikjmzhwb0j,49007,49008,98015
51780,,bbdecz2vgtij,49009,49010,98019
51781,,tjswp-g8qbaj,49010,49011,98021
51782,,2dbfj5o29vwj,49011,49012,98023
51783,,ev5mrzrpdzsj,49012,49013,98025
51784,,izphpkmeob8j,49013,49014,98027
51785,,cznkvvwdlt8j,49014,49015,98029
51786,,url:http://portal.acm.org/ft_gateway.cfm3fid3d98307726type3dpdf26dl3dportal26dl3dacm26cfid3d1111111126cftoken3d2222222,49015,49016,98031
51787,,url:http://www.ingentaconnect.com/search/expand3fpub3dinfobike://pep/jae/2002/00000216/00000012/art0000626unc3d,49016,49017,98033
51788,,phqbeadebomj,49017,49018,98035
51789,,okr1etfjhduj,49018,49019,98037
51790,,ovfkvwcgoc0j,49019,49020,98039
51791,,uchladdsmakj,49020,49021,98041
51792,,9ca0twbrhyij,49021,49022,98043
51793,,fkdgyy8yreqj,49022,49023,98045
51794,,iwq-mgoire4j,49023,49024,98047
51795,,7tnk4262ozwj,49024,49025,98049
51796,,_ixlzqkucsoj,49025,49026,98051
51797,,xtiyedk03esj,49026,49027,98053
51798,,aofjcxei5zcj,49027,49028,98055
51799,,d1jml34nei0j,49028,49029,98057
51800,,i9kuxnpo3ioj,49029,49030,98059
51801,,pb4ydzfeekyj,49030,49031,98061
51802,,jytezxcayncj,49031,49032,98063
51803,,ps2ww6irqhwj,49032,49033,98065
51804,,jpl1suvqjsoj,49033,49034,98067
51805,,url:http://doi.wiley.com/10.1002/tl.174,49034,49035,98069
51806,,vt6dk4iklpej,49035,49036,98071
51807,,p-4rsfflhkej,49036,49037,98073
51808,,url:http://portal.acm.org/citation.cfm3fid3d58232026dl3dacm26coll3dguide26cfid3d1111111126cftoken3d2222222,49037,49038,98075
51809,,6kwtlib2yu0j,49038,49039,98077
51810,,tu8ept5_ec4j,49039,49040,98079
51811,,rclsmwofugwj,49040,49041,98081
51812,,f4ockqwwqtaj,49041,49042,98083
51813,,_lklmdqqrmsj,49042,49043,98085
51814,,rnq-v5oro8mj,49043,49044,98087
51815,,url:http://www.csa.com/partners/viewrecord.php3frequester3dgs26collection3dtrd26recid3dn9210412ah,49044,49045,98089
51816,,hg_zwdnjzhmj,49045,49046,98091
51817,,rl_v8exrpj8j,49046,49047,98093
51818,,y6uaq1rrtx0j,49047,49048,98095
51819,,xsxqnfxyygsj,49048,49049,98097
51820,,qg-o04mbpumj,49049,49050,98099
51821,,6guhdvfgu_uj,49050,49051,98101
51822,,url:http://links.jstor.org/sici3fsici3d0146-4949(196721)8253a2253c310253asbonw253e2.0.co253b2-e,49051,49052,98103
51823,,url:http://www.springerlink.com/index/u6316029163623g5.pdf,49052,49053,98105
51824,,0vfwptm90yyj,49053,49054,98107
51825,,j1peckyih74j,49054,49055,98109
51826,,url:http://www.springerlink.com/index/kv1012v14743h231.pdf,49055,49056,98111
51827,,puyx41b4a40j,49056,49057,98113
51828,,uzluo4g0wagj,49057,49058,98115
51829,,r37mz14rwx4j,49058,49059,98117
51830,,url:http://portal.acm.org/ft_gateway.cfm3fid3d108369526type3dpdf,49059,49060,98119
51831,,7ca9ql-p-7oj,49061,49062,98123
51832,,bvbod3z-m3gj,49062,49063,98125
51833,,fnabkezuk2oj,49063,49064,98127
51834,,qk2pwjjmpz8j,49064,49065,98129
51835,,hlucwkx4b9aj,49065,49066,98131
51836,,ntgrcbk3rbqj,49066,49067,98133
51837,,url:http://www.csa.com/partners/viewrecord.php3frequester3dgs26collection3dtrd26recid3d1663590ci,49067,49068,98135
51838,,wbt-samajmcj,49068,49069,98137
51839,,vpxp4nbvifmj,49069,49070,98139
51840,,gz82zhsbaloj,49070,49071,98141
51841,,5caivzjshaej,49071,49072,98143
51842,,yv3zyl-vezqj,49072,49073,98145
51843,,ycwlpv4o5wqj,49073,49074,98147
51844,,4ovkuz_vclsj,49074,49075,98149
51845,,o-2uj65aza8j,49075,49076,98151
51846,,uiz0khkvtqgj,49076,49077,98153
51847,,agjp7ym1lwqj,49077,49078,98155
51848,,tebjm5z-ntqj,49078,49079,98157
51849,,1nbntp4ldrej,49079,49080,98159
51850,,x83njaikwwuj,49080,49081,98161
51851,,najcls6mbw4j,49081,49082,98163
51852,,7lpa3rqmgkcj,49082,49083,98165
51853,,gwj6k80h3ayj,49083,49084,98167
51854,,xvrugpchqkej,49084,49085,98169
51855,,o0ftsm2zt04j,49085,49086,98171
51856,,qlkg45g33vgj,49086,49087,98173
51857,,lugpq9a7pqaj,49087,49088,98175
51858,,af4sj7hhajej,49088,49089,98177
51859,,sqxftojf1x0j,49089,49090,98179
51860,,url:http://portal.acm.org/citation.cfm3fid3d11344026dl3dacm26coll3dportal26cfid3d1111111126cftoken3d2222222,49090,49091,98181
51861,,mi8kpid-iawj,49091,49092,98183
51862,,3lmr6hpoorkj,49092,49093,98185
51863,,docpyhvgfi4j,49093,49094,98187
51864,,url:http://adsabs.harvard.edu/abs/1974phdt........29f,49094,49095,98189
51865,,qtfmenqdgpcj,49095,49096,98191
51866,,i6xecararnuj,49096,49097,98193
51867,,qufmggbpxeaj,49097,49098,98195
51868,,7-suml1gqbqj,49098,49099,98197
51869,,a_qw0l0vv_mj,49099,49100,98199
51870,,nbiaqlpsue4j,49100,49101,98201
51871,,sudtzkh-q-0j,49101,49102,98203
51872,,e4bjgms1ivyj,49102,49103,98205
51873,,zsuluhq4wauj,49103,49104,98207
51874,,5hro6vrtcxaj,49104,49105,98209
51875,,tv-l_wsw2gaj,49105,49106,98211
51876,,a5kwurmyg38j,49106,49107,98213
51877,,ioebmc-fobwj,49107,49108,98215
51878,,8esvynk-zzaj,49108,49109,98217
51879,,zkati-wuzk8j,49109,49110,98219
51880,,sdxrkiefut4j,49110,49111,98221
51881,,lo0i0midfbqj,49111,49112,98223
51882,,5i2crhuhabsj,49112,49113,98225
51883,,bxvkgriufmqj,49113,49114,98227
51884,,goagqdm5fzsj,49114,49115,98229
51885,,2qwvp677wsej,49115,49116,98231
51886,,s1f0sncrpeqj,49116,49117,98233
51887,,pdsvunadcvoj,49117,49118,98235
51888,,ln9lab18pwkj,49118,49119,98237
51889,,ilvjyag86ggj,49119,49120,98239
51890,,orm9pctemsoj,49120,49121,98241
51891,,yvg_jdskctuj,49121,49122,98243
51892,,ksuwmtn69ygj,49122,49123,98245
51893,,,49123,49124,98247
51894,,1_s7fkizfzqj,49124,49125,98249
51895,,qt7x6a0cq7mj,49125,49126,98251
51896,,jeu9dukreoaj,49126,49127,98253
51897,,jxqpctslo8ej,49127,49128,98255
51898,,wquz74su0e4j,49128,49129,98257
51899,,yccn9ytiqzej,49129,49130,98259
51900,,url:http://portal.acm.org/ft_gateway.cfm3fid3d109973726type3dpdf,49130,49131,98261
51901,,uoxm9cb58yuj,49131,49132,98263
51902,,cquo8y8s4lsj,49132,49133,98265
51903,,6ig0qnk0mqwj,49133,49134,98267
51904,,h2dr3scxvoej,49134,49135,98269
51905,,anoxkyufxwij,49135,49136,98271
51906,,uuan_mzdwa8j,49136,49137,98273
51907,,qthi8g4kjzuj,49137,49138,98275
51908,,cq3locpxht8j,49138,49139,98277
51909,,rh5lg8la8esj,49139,49140,98279
51910,,ydpombul3yij,49140,49141,98281
51911,,ydpcbpwui0kj,49141,49142,98283
51912,,oviegkexphmj,49142,49143,98285
51913,,bnzuppozricj,49143,49144,98287
51914,,ugpw5hpre3qj,49144,49145,98289
51915,,1w14wiw2-muj,49145,49146,98291
51916,,jakw_8kp3lyj,49146,49147,98293
51917,,adjs2mlocqcj,49147,49148,98295
51918,,url:http://doi.wiley.com/10.1002/tl.3,49148,49149,98297
51919,,7yw2p8zswg4j,49150,49151,98301
51920,,pvwnjz7kqvqj,49151,49152,98303
51921,,yeeehpbcwnaj,49152,49153,98305
51922,,wvxqiz18bw8j,49153,49154,98307
51923,,rr74vzzehf4j,49154,49155,98309
51924,,k2ybrmc0khwj,49155,49156,98311
51925,,ezfhqswyeooj,49156,49157,98313
51926,,tv3icf_ljquj,49157,49158,98315
51927,,vop7vj6nyyoj,49158,49159,98317
51928,,fmh3bcq_qtmj,49159,49160,98319
51929,,yptkabpts0oj,49160,49161,98321
51930,,1rlthwj-wysj,49161,49162,98323
51931,,4lsyhv6xukqj,49162,49163,98325
51932,,_zytvdvitxwj,49163,49164,98327
51933,,ektmz-vlknoj,49164,49165,98329
51934,,lhr1qunsyymj,49165,49166,98331
51935,,o9ghyp60ujqj,49166,49167,98333
51936,,,49167,49168,98335
51937,,7yzwzga0rigj,49168,49169,98337
51938,,minbltbh-cuj,49169,49170,98339
51939,,feanojy5bqsj,49170,49171,98341
51940,,egmpkeuzlnoj,49171,49172,98343
51941,,zqt7tjsgxeaj,49172,49173,98345
51942,,tyzr6w2r9hgj,49173,49174,98347
51943,,il_n-qocwuyj,49174,49175,98349
51944,,h6hob4ksmxwj,49175,49176,98351
51945,,xpa_7eekxxcj,49177,49178,98355
51946,,9ajenls9eboj,49178,49179,98357
51947,,npxc3pfk7aaj,49179,49180,98359
51948,,m1qlxacmgu4j,49180,49181,98361
51949,,yjtbcutuaz4j,49181,49182,98363
51950,,knfux9pxwsyj,49182,49183,98365
51951,,ztgrpc4bvn8j,49183,49184,98367
51952,,68jxnfxkovyj,49184,49185,98369
51953,,0nf8dgxqqgyj,49185,49186,98371
51954,,qmdn6enj0vgj,49186,49187,98373
51955,,jaioecrqd9wj,49187,49188,98375
51956,,cfpc4qua96aj,49188,49189,98377
51957,,xewij6bhz80j,49189,49190,98379
51958,,,49190,49191,98381
51959,,6z0ytwvtcsqj,49191,49192,98383
51960,,iftprlsneioj,49192,49193,98385
51961,,4wfwyntubxgj,49193,49194,98387
51962,,c1f0fwu8liij,49194,49195,98389
51963,,xxzwq6hcipyj,49195,49196,98391
51964,,ym5wlt2fudsj,49196,49197,98393
51965,,0augooxypa0j,49197,49198,98395
51966,,d0e8_2y96hqj,49198,49199,98397
51967,,url:http://www.csa.com/partners/viewrecord.php3frequester3dgs26collection3dtrd26recid3d0583547ci,49199,49200,98399
51968,,rghvy98g0oij,49200,49201,98401
51969,,q-ccekgdnduj,49201,49202,98403
51970,,url:http://www.csa.com/partners/viewrecord.php3frequester3dgs26collection3dtrd26recid3da8622962ah,49202,49203,98405
51971,,seytm2ucqggj,49203,49204,98407
51972,,3yh0xter-f4j,49204,49205,98409
51973,,yccikhd8fzaj,49205,49206,98411
51974,,rrg4v_p3ofqj,49206,49207,98413
51975,,url:http://ieeexplore.ieee.org/iel2/575/5225/00202204.pdf3farnumber3d202204,49207,49208,98415
51976,,yc-s4pdcqmgj,49208,49209,98417
51977,,npp7kjhwgoaj,49209,49210,98419
51978,,ibjbb2eeovej,49210,49211,98421
51979,,uvufzga16iuj,49211,49212,98423
51980,,nhprn_v_mtsj,49212,49213,98425
51981,,nsxto7_-rggj,49213,49214,98427
51982,,n4n0fk0gxxuj,49214,49215,98429
51983,,1qr1k5m7wx8j,49215,49216,98431
51984,,pfbiendy0fwj,49216,49217,98433
51985,,5v6qdhtzg0cj,49217,49218,98435
51986,,nrcomut11gej,49218,49219,98437
51987,,url:http://www.csa.com/partners/viewrecord.php3frequester3dgs26collection3denv26recid3d8913237,49219,49220,98439
51988,,zq4kawp72_uj,49220,49221,98441
51989,,fw_4ceoofqgj,49221,49222,98443
51990,,t48zt18a0zkj,49222,49223,98445
51991,,m7lnhdgpyi8j,49223,49224,98447
51992,,c4t8deznbjmj,49224,49225,98449
51993,,rsssefu6tmwj,49225,49226,98451
51994,,5qp0doqo6vwj,49226,49227,98453
51995,,jqzrog6tbysj,49227,49228,98455
51996,,etnv04h-79oj,49229,49230,98459
51997,,zwt6xvlipb0j,49230,49231,98461
51998,,eu67ssij9gyj,49231,49232,98463
51999,,x0is8v0vmrsj,49232,49233,98465
52000,,nnkv1h9mryej,49233,49234,98467
52001,,5zmdizvf1kgj,49234,49235,98469
52002,,i5o_nrk_vnkj,49235,49236,98471
52003,,okceymrbyqcj,49236,49237,98473
52004,,ip7dwu2joraj,49237,49238,98475
52005,,pi3lqcctntgj,49238,49239,98477
52006,,gqi0ik5dl00j,49239,49240,98479
52007,,nlmrtoxrumkj,49240,49241,98481
52008,,_uf0afqir94j,49241,49242,98483
52009,,url:http://doi.wiley.com/10.1002/ace.149,49242,49243,98485
52010,,k6pcaibewhcj,49243,49244,98487
52011,,uowprxom5tej,49244,49245,98489
52012,,toxr2plr0lsj,49245,49246,98491
52013,,8ajoglbplisj,49246,49247,98493
52014,,xuymkel-xjmj,49247,49248,98495
52015,,muuoktvilaej,49248,49249,98497
52016,,lool6ltmxbqj,49249,49250,98499
52017,,sl4rhq8jhfwj,49250,49251,98501
52018,,kikzq25peogj,49251,49252,98503
52019,,ad0xg1dp_r0j,49252,49253,98505
52020,,6kfozoam-kij,49253,49254,98507
52021,,igaepc8ulvyj,49254,49255,98509
52022,,vdnl9d59ghmj,49255,49256,98511
52023,,rxapyrdqhbej,49256,49257,98513
52024,,,49257,49258,98515
52025,,sp1tdmpbmo0j,49258,49259,98517
52026,,_oijpjtv4d0j,49259,49260,98519
52027,,bglei8hllfsj,49260,49261,98521
52028,,rl8lrhubqiqj,49261,49262,98523
52029,,2i29lyvxaoaj,49262,49263,98525
52030,,ojnazs-tkukj,49263,49264,98527
52031,,6_d9xirjqkyj,49264,49265,98529
52032,,zdxhj3tpimij,49265,49266,98531
52033,,qljc0czw5nmj,49266,49267,98533
52034,,1a0h031luxaj,49267,49268,98535
52035,,aly38ohr8p8j,49268,49269,98537
52036,,dl6orwzxc8oj,49269,49270,98539
52037,,url:http://portal.acm.org/ft_gateway.cfm3fid3d104143426type3dpdf,49271,49272,98543
52038,,ypl_qjuxinuj,49272,49273,98545
52039,,lxcv_emglcij,49273,49274,98547
52040,,lce1y8bxlz0j,49274,49275,98549
52041,,7y71geww4e8j,49275,49276,98551
52042,,nfeegcvjuiij,49276,49277,98553
52043,,_dikuijutuej,49277,49278,98555
52044,,6dafqslzyqkj,49279,49280,98559
52045,,37_iwo5nlgwj,49280,49281,98561
52046,,baz_umgvxw0j,49283,49284,98567
52047,,ql3mj0xuchsj,49284,49285,98569
52048,,_vniag6vxhqj,49285,49286,98571
52049,,8uroy0jcn60j,49286,49287,98573
52050,,eunywv7ubtwj,49287,49288,98575
52051,,fhufhkgjxi0j,49288,49289,98577
52052,,9q51ldq_f0mj,49289,49290,98579
52053,,nbwnsoewlw8j,49291,49292,98583
52054,,iavaznigsc8j,49292,49293,98585
52055,,7ybf9f3oc8yj,49293,49294,98587
52056,,url:http://www.csa.com/partners/viewrecord.php3frequester3dgs26collection3dtrd26recid3d20021214033588mt26recid3da7642808ah,49295,49296,98591
52057,,ur4itijmiuij,49296,49297,98593
52058,,3vxtvdv_j2sj,49297,49298,98595
52059,,2ygnu4epcwcj,49298,49299,98597
52060,,z0ejyh7zw34j,49299,49300,98599
52061,,aijyp7y-boij,49300,49301,98601
52062,,url:http://www.ingentaconnect.com/content/bpl/area/2001/00000033/00000004/art00042,49301,49302,98603
52063,,imkmdqqndfqj,49302,49303,98605
52064,,sdxdyffgnzij,49303,49304,98607
52065,,qqwcu74aghij,49304,49305,98609
52066,,i1tr74su8b0j,49305,49306,98611
52067,,dn1d6dqpba4j,49306,49307,98613
52068,,wxkrfa6hebkj,49307,49308,98615
52069,,_mqxtgalkxmj,49308,49309,98617
52070,,c6bj7qqyyjwj,49309,49310,98619
52071,,vnjstlqxupmj,49310,49311,98621
52072,,_wdfqfsixekj,49311,49312,98623
52073,,jkcdrvataf8j,49312,49313,98625
52074,,yu5robfopysj,49313,49314,98627
52075,,kpewxsv5fy8j,49314,49315,98629
52076,,me0afn2otkej,49315,49316,98631
52077,,qqvfxwpdzhqj,49316,49317,98633
52078,,ys2nqwyzyl0j,49317,49318,98635
52079,,oijl8-ygktij,49318,49319,98637
52080,,uz-0jbnqptuj,49319,49320,98639
52081,,bdmy-vzhzdaj,49320,49321,98641
52082,,svt9u79mfdmj,49321,49322,98643
52083,,2pkhlvn0jdej,49322,49323,98645
52084,,dvasjn1lzquj,49323,49324,98647
52085,,cxh5syg5uv4j,49324,49325,98649
52086,,0i4rq7j4xn0j,49325,49326,98651
52087,,,49326,49327,98653
52088,,zaup7andy4sj,49327,49328,98655
52089,,jq_f3lcmtaij,49328,49329,98657
52090,,b-xkr3g7ingj,49329,49330,98659
52091,,_dv8ceh8xvaj,49330,49331,98661
52092,,ypemwqsi4eqj,49331,49332,98663
52093,,m0mitsrhn0oj,49332,49333,98665
52094,,axv1nrvbpbsj,49333,49334,98667
52095,,lh9vzvvdcf8j,49334,49335,98669
52096,,bb8bqxexss8j,49335,49336,98671
52097,,imxhv9-vu1aj,49336,49337,98673
52098,,syxarlavv6wj,49337,49338,98675
52099,,jlpjf9qavxcj,49339,49340,98679
52100,,url:http://portal.acm.org/citation.cfm3fid3d974133,49340,49341,98681
52101,,url:http://portal.acm.org/citation.cfm3fid3d318898.318920,49341,49342,98683
52102,,dwnxf0houvej,49342,49343,98685
52103,,ioaxte4b6nij,49343,49344,98687
52104,,i_8zcu3xmduj,49344,49345,98689
52105,,xtococa0jvgj,49345,49346,98691
52106,,v2ogpnlacx8j,49346,49347,98693
52107,,1tpiy-odnryj,49347,49348,98695
52108,,hizokqddrzgj,49348,49349,98697
52109,,tqs6k4b7az4j,49349,49350,98699
52110,,lbu152pk918j,49350,49351,98701
52111,,yl0tdeqwa-ej,49351,49352,98703
52112,,url:http://doi.wiley.com/10.1002/he.10906,49352,49353,98705
52113,,nupmhfft1f4j,49353,49354,98707
52114,,p6hf2o_nldij,49354,49355,98709
52115,,gqfwaup3ifqj,49355,49356,98711
52116,,zpnl6pykrruj,49356,49357,98713
52117,,lqsjxctjxksj,49357,49358,98715
52118,,5e5gcm0xpfaj,49358,49359,98717
52119,,v__w6o558caj,49359,49360,98719
52120,,uiznfy8id7ij,49360,49361,98721
52121,,ryxjs6tp6t0j,49361,49362,98723
52122,,,49362,49363,98725
52123,,gcoifhcjwrej,49363,49364,98727
52124,,y7ctbgwimxuj,49364,49365,98729
52125,,b2yekt7xpu4j,49365,49366,98731
52126,,gahb3tlharkj,49366,49367,98733
52127,,_94mjrfiku8j,49367,49368,98735
52128,,4vodwqjainuj,49368,49369,98737
52129,,zmnlsfrnkrqj,49369,49370,98739
52130,,,49370,49371,98741
52131,,v1zi62nfet4j,49371,49372,98743
52132,,url:http://www.csa.com/partners/viewrecord.php3frequester3dgs26collection3dtrd26recid3d0837204ci,49372,49373,98745
52133,,bimuwnft-sij,49373,49374,98747
52134,,,49374,49375,98749
52135,,o5dsriunsuuj,49375,49376,98751
52136,,url:http://www.csa.com/partners/viewrecord.php3frequester3dgs26collection3dtrd26recid3d017501540005ai,49376,49377,98753
52137,,jrc5re_-mzyj,49377,49378,98755
52138,,url:http://www.ingentaconnect.com/content/els/08830355/2001/00000035/00000004/art00036,49378,49379,98757
52139,,m7gfvcuu_duj,49379,49380,98759
52140,,ovfjyqtyajij,49380,49381,98761
52141,,v3lzdq417gsj,49381,49382,98763
52142,,ltey5lzlznyj,49382,49383,98765
52143,,y_nw84zighsj,49383,49384,98767
52144,,fdazv1ll_cmj,49384,49385,98769
52145,,ih4sydw7h2ij,49385,49386,98771
52146,,tx47lw1kyz0j,49386,49387,98773
52147,,kzjsx9-lqxoj,49387,49388,98775
52148,,ckscfha8hpkj,49388,49389,98777
52149,,av-fhbv8avsj,49389,49390,98779
52150,,yldlqt_guuyj,49390,49391,98781
52151,,6nmkc7fjaoej,49391,49392,98783
52152,,gdcisefvjukj,49392,49393,98785
52153,,2ukytw6vqfej,49393,49394,98787
52154,,a_u78gcgrbij,49394,49395,98789
52155,,gb5iztbcddaj,49395,49396,98791
52156,,kszukjzpxlij,49396,49397,98793
52157,,thoke4oylt4j,49397,49398,98795
52158,,cto_vmogsvyj,49398,49399,98797
52159,,e8vkzytppzaj,49399,49400,98799
52160,,8rs065ttce8j,49400,49401,98801
52161,,ib1kj4orxjej,49401,49402,98803
52162,,ulbtnoh4hfij,49402,49403,98805
52163,,giahnnl-rgej,49403,49404,98807
52164,,fzu0rb_gecwj,49404,49405,98809
52165,,tr-pvrkv5daj,49405,49406,98811
52166,,ciwyxinrtxij,49406,49407,98813
52167,,3pinuu87q-kj,49407,49408,98815
52168,,url:http://www.csa.com/partners/viewrecord.php3frequester3dgs26collection3dtrd26recid3d2084203ci,49408,49409,98817
52169,,i2qu_aqa2toj,49409,49410,98819
52170,,txrxlkoe2taj,49410,49411,98821
52171,,mzllawhfv04j,49411,49412,98823
52172,,1bckeosw50mj,49414,49415,98829
52173,,vx5kbgaodnmj,49415,49416,98831
52174,,url:http://portal.acm.org/ft_gateway.cfm3fid3d35323126type3dpdf26dl3dguide26dl3dacm26cfid3d1111111126cftoken3d2222222,49416,49417,98833
52175,,xdjw__b1sucj,49417,49418,98835
52176,,4tvanhgcsbcj,49418,49419,98837
52177,,zb9aw-1c-kwj,49419,49420,98839
52178,,ccy3bzslssej,49420,49421,98841
52179,,rc8uciczdrij,49421,49422,98843
52180,,w2cm5haivnwj,49422,49423,98845
52181,,ndz955woxk8j,49423,49424,98847
52182,,3qsbuaf9wcwj,49424,49425,98849
52183,,nhen4_0nk2ij,49425,49426,98851
52184,,2gf98gnkmssj,49426,49427,98853
52185,,13mnqofid2oj,49427,49428,98855
52186,,4rtchwkfoxgj,49428,49429,98857
52187,,1urlrx5xc3mj,49429,49430,98859
52188,,ytmvuln2xayj,49430,49431,98861
52189,,qqqnpomes_ej,49431,49432,98863
52190,,oyc4effleg0j,49432,49433,98865
52191,,a18ut6xqvsej,49433,49434,98867
52192,,cq7dj3xmqrij,49434,49435,98869
52193,,y3nejqsvknuj,49435,49436,98871
52194,,,49436,49437,98873
52195,,upyyrf0ofuuj,49437,49438,98875
52196,,e5udsoth788j,49438,49439,98877
52197,,y0i8njrm5gsj,49439,49440,98879
52198,,votvivt6syoj,49440,49441,98881
52199,,nnrud1afzoyj,49441,49442,98883
52200,,ui5dxm-mcn8j,49442,49443,98885
52201,,rl4mw4gcdiij,49443,49444,98887
52202,,h0xhfhspaaij,49444,49445,98889
52203,,url:http://www.csa.com/partners/viewrecord.php3frequester3dgs26collection3dtrd26recid3d200111010672mt26recid3da0032575ah,49445,49446,98891
52204,,8umvkck0wp8j,49446,49447,98893
52205,,auqrm48bg6qj,49447,49448,98895
52206,,xfzya38mljmj,49448,49449,98897
52207,,nj8sjbitw6kj,49449,49450,98899
52208,,grtgnugvd9ij,49450,49451,98901
52209,,fxsdvton8gmj,49451,49452,98903
52210,,vbqxalikuk8j,49452,49453,98905
52211,,bqy_npp7nocj,49453,49454,98907
52212,,,49454,49455,98909
52213,,wyoaqgs3bauj,49455,49456,98911
52214,,jqpdcj4kkb8j,49456,49457,98913
52215,,7wz-unjdy1kj,49457,49458,98915
52216,,hpvqahczxxuj,49458,49459,98917
52217,,gjhkxbmkjekj,49459,49460,98919
52218,,e6xiuqxa5j4j,49460,49461,98921
52219,,izmflv-lx04j,49461,49462,98923
52220,,evmyw16u6rij,49462,49463,98925
52221,,url:http://www.springerlink.com/index/m421871538132q56.pdf,49463,49464,98927
52222,,url:http://www.csa.com/partners/viewrecord.php3frequester3dgs26collection3dtrd26recid3dn9210575ah,49464,49465,98929
52223,,hk0h65llikgj,49465,49466,98931
52224,,kl54duoii8qj,49466,49467,98933
52225,,wvkpl_lngnuj,49467,49468,98935
52226,,ddevv4np8f4j,49468,49469,98937
52227,,url:http://ieeexplore.ieee.org/iel5/9217/29235/01320050.pdf3farnumber3d1320050,49469,49470,98939
52228,,lykrcbljmtmj,49470,49471,98941
52229,,xrtcyfoswhmj,49471,49472,98943
52230,,wllzrwlr8myj,49472,49473,98945
52231,,v2my4v7k79kj,49473,49474,98947
52232,,ooapobbdan8j,49474,49475,98949
52233,,jma3p4fdqu8j,49475,49476,98951
52234,,zaeslytxgisj,49476,49477,98953
52235,,2jeoy01wvqej,49477,49478,98955
52236,,rclktuaajmoj,49478,49479,98957
52237,,if36psjnum8j,49479,49480,98959
52238,,zpne-rnpcqcj,49480,49481,98961
52239,,yodjyxjzsogj,49481,49482,98963
52240,,avfvvzuom0gj,49482,49483,98965
52241,,oktbpb8xiayj,49483,49484,98967
52242,,tpo47w6ahpmj,49484,49485,98969
52243,,r7ftrcwihkcj,49485,49486,98971
52244,,f88-rvzss3ij,49486,49487,98973
52245,,ivp_f9pjgkqj,49487,49488,98975
52246,,bc-wigjsjkaj,49488,49489,98977
52247,,isktlm4_6smj,49489,49490,98979
52248,,url:http://www.springerlink.com/index/mx55711106028504.pdf,49490,49491,98981
52249,,pmkxyt-kckuj,49491,49492,98983
52250,,b8cbn8m3wfmj,49492,49493,98985
52251,,ixezrwyoa7ej,49493,49494,98987
52252,,rhnsqqpqr1uj,49494,49495,98989
52253,,vlztxo3edjwj,49495,49496,98991
52254,,qcvxlxmb6j8j,49496,49497,98993
52255,,wrudchkwgoej,49497,49498,98995
52256,,jk0wf8hrmmmj,49498,49499,98997
52257,,vgc-wjevmzwj,49499,49500,98999
52258,,p16p61ee_uyj,49500,49501,99001
52259,,,49501,49502,99003
52260,,vtzhaedjjuaj,49502,49503,99005
52261,,mrynzbn6j-uj,49503,49504,99007
52262,,j3gymdbbrnoj,49504,49505,99009
52263,,4ruiucmy4cgj,49505,49506,99011
52264,,xwioqscldwaj,49506,49507,99013
52265,,gqdhk1gms60j,49507,49508,99015
52266,,c92hfztg4rij,49508,49509,99017
52267,,,49509,49510,99019
52268,,_xwxf1ymbpcj,49510,49511,99021
52269,,_zsgi-uial0j,49511,49512,99023
52270,,vpbf6lnncwqj,49512,49513,99025
52271,,vyqpfkt2ncwj,49513,49514,99027
52272,,qy5fkqcfnkcj,49514,49515,99029
52273,,qjv2kaj1mi0j,49515,49516,99031
52274,,j3svl4um60cj,49516,49517,99033
52275,,opxu9orposij,49517,49518,99035
52276,,inh1mu_k3uaj,49518,49519,99037
52277,,usxyfgafirkj,49519,49520,99039
52278,,gwy3jdxmlkij,49521,49522,99043
52279,,flzwyglicggj,49522,49523,99045
52280,,ohze7nhnfn4j,49523,49524,99047
52281,,url:http://portal.acm.org/ft_gateway.cfm3fid3d110123226type3dpdf,49524,49525,99049
52282,,a8cmeaylivyj,49525,49526,99051
52283,,v4grmldyavyj,49526,49527,99053
52284,,zc4o0dbvfxgj,49527,49528,99055
52285,,s4sdhrbcgfkj,49528,49529,99057
52286,,adu4gkhmcg8j,49529,49530,99059
52287,,url:http://portal.acm.org/ft_gateway.cfm3fid3d110133826type3dpdf,49530,49531,99061
52288,,azrrwmaio7yj,49533,49534,99067
52289,,ttssb5ca43wj,49534,49535,99069
52290,,jore8jn6vkej,49535,49536,99071
52291,,ls3mn3gsacwj,49536,49537,99073
52292,,7xfmo0htum4j,49537,49538,99075
52293,,n4oozw5sgvej,49538,49539,99077
52294,,870bwrjgeosj,49539,49540,99079
52295,,qmwmwrzor0qj,49540,49541,99081
52296,,7mhmwrcjgsqj,49541,49542,99083
52297,,kr8ejs48wacj,49542,49543,99085
52298,,ycy5dauqij8j,49543,49544,99087
52299,,6sufqzxmi9ej,49544,49545,99089
52300,,f-7ttz_qcukj,49545,49546,99091
52301,,j2zzee5fqvqj,49546,49547,99093
52302,,evtpd2rqcxuj,49548,49549,99097
52303,,o2a2kotq_dsj,49549,49550,99099
52304,,ald_2twzmfoj,49550,49551,99101
52305,,ytlgavyuozmj,49552,49553,99105
52306,,1m7dkocklg4j,49553,49554,99107
52307,,url:http://www.ncbi.nlm.nih.gov/entrez/query.fcgi3fcmd3dretrieve26db3dpubmed26list_uids3d68270426dopt3dcitation,49554,49555,99109
52308,,4wedysmwmswj,49555,49556,99111
52309,,b-kvork14ncj,49556,49557,99113
52310,,cmvlg2oniqgj,49557,49558,99115
52311,,3dtdkkow_iij,49558,49559,99117
52312,,n_gkbqlib3aj,49559,49560,99119
52313,,5cj9yummfy0j,49560,49561,99121
52314,,upcxgroiuysj,49561,49562,99123
52315,,hnjx8bcepwuj,49562,49563,99125
52316,,url:http://ieeexplore.ieee.org/iel1/2206/2194/00060334.pdf3farnumber3d60334,49564,49565,99129
52317,,24p3bo6_bqqj,49565,49566,99131
52318,,4lwvqlttbtoj,49566,49567,99133
52319,,lw0vloydlwaj,49567,49568,99135
52320,,kdcvtdmln4kj,49568,49569,99137
52321,,55v33etvcmmj,49569,49570,99139
52322,,nm4427vqadij,49570,49571,99141
52323,,6crhbxzsxjuj,49571,49572,99143
52324,,oempdy2fi5oj,49572,49573,99145
52325,,url:http://doi.wiley.com/10.1002/tl.123,49573,49574,99147
52326,,igc62qvndsoj,49574,49575,99149
52327,,dc63euzuvboj,49575,49576,99151
52328,,euqctcmk0mkj,49576,49577,99153
52329,,zfiky3tkunmj,49577,49578,99155
52330,,y-f42hjfh5aj,49578,49579,99157
52331,,2uwyxdhltrmj,49579,49580,99159
52332,,weshqd6fa_oj,49580,49581,99161
52333,,wlr0sguntp8j,49582,49583,99165
52334,,oph1kwjv4gij,49583,49584,99167
52335,,05hataoxwrij,49584,49585,99169
52336,,p6svxvymmbgj,49585,49586,99171
52337,,zjqwn4bwgu4j,49586,49587,99173
52338,,,49587,49588,99175
52339,,d3jqxotpuqqj,49588,49589,99177
52340,,1bssfrhbi18j,49589,49590,99179
52341,,tb42mtqkmhkj,49590,49591,99181
52342,,pmembfnwkzsj,49591,49592,99183
52343,,td4mvb1wrnij,49592,49593,99185
52344,,kpxldjmn02aj,49593,49594,99187
52345,,xa_haoduktmj,49594,49595,99189
52346,,u0erm0bapbuj,49595,49596,99191
52347,,s5amfut9eoyj,49596,49597,99193
52348,,txb8g18pggej,49597,49598,99195
52349,,ovbo251jji0j,49598,49599,99197
52350,,5m7_dutdkqij,49599,49600,99199
52351,,aubgn-rkekoj,49600,49601,99201
52352,,drwhgrv9qfcj,49601,49602,99203
52353,,nsisef3pjquj,49602,49603,99205
52354,,r2b-nae2awgj,49603,49604,99207
52355,,vjiehdq7xuaj,49604,49605,99209
52356,,r7wsydxqq5sj,49605,49606,99211
52357,,c9kcvyku9esj,49606,49607,99213
52358,,7zva9zqtrfuj,49607,49608,99215
52359,,xapjy-tmlmej,49608,49609,99217
52360,,4qbxyahvetij,49609,49610,99219
52361,,8m4x_fcbdf0j,49610,49611,99221
52362,,krdmebgfdcuj,49611,49612,99223
52363,,nzhcjdwmwjmj,49612,49613,99225
52364,,url:http://portal.acm.org/citation.cfm3fid3d48338.48342,49613,49614,99227
52365,,m3urqflhiu4j,49614,49615,99229
52366,,fiqj-t1ktoij,49615,49616,99231
52367,,gamszexacyqj,49616,49617,99233
52368,,2cgpgez2zwaj,49618,49619,99237
52369,,xsi1p_wjsp8j,49620,49621,99241
52370,,kw_vhkubdg8j,49621,49622,99243
52371,,wipuiikdpgej,49622,49623,99245
52372,,in4zdee2vsqj,49623,49624,99247
52373,,wcuscvej3wkj,49624,49625,99249
52374,,dgi8z9q2okoj,49625,49626,99251
52375,,qwabt-ujrnwj,49626,49627,99253
52376,,hhgqkstq2pqj,49627,49628,99255
52377,,fdaeczyxb4kj,49628,49629,99257
52378,,t0yelvdsgn8j,49629,49630,99259
52379,,tvd27j2y_fkj,49630,49631,99261
52380,,9foabrgdssuj,49631,49632,99263
52381,,m5rgzega3fcj,49632,49633,99265
52382,,npepm4jsxukj,49633,49634,99267
52383,,url:http://ieeexplore.ieee.org/iel1/2206/3160/00101346.pdf3farnumber3d101346,49634,49635,99269
52384,,y-0rxo71l74j,49635,49636,99271
52385,,uwyanuub2bej,49636,49637,99273
52386,,m4rm4es30pmj,49637,49638,99275
52387,,yoqcu0cgy_sj,49638,49639,99277
52388,,v8-9l7uibqyj,49639,49640,99279
52389,,s7wrwywa38ej,49640,49641,99281
52390,,5wseotm1piij,49641,49642,99283
52391,,evqwpxdctnyj,49642,49643,99285
52392,,02btkzctoqcj,49643,49644,99287
52393,,gteb_lspqzkj,49644,49645,99289
52394,,zgtttagxa5gj,49645,49646,99291
52395,,ex4yjgyehpcj,49646,49647,99293
52396,,gj98j9ycej8j,49647,49648,99295
52397,,3b9qsqdzvf0j,49648,49649,99297
52398,,pr2tt82wx1ij,49649,49650,99299
52399,,35thxdyeldsj,49650,49651,99301
52400,,hvplaqefxpej,49651,49652,99303
52401,,plzypabrgiej,49652,49653,99305
52402,,bhqcdozfcl8j,49653,49654,99307
52403,,z512ck6_yacj,49654,49655,99309
52404,,6syclra0qk8j,49655,49656,99311
52405,,umhanmaohxwj,49656,49657,99313
52406,,sltkrj1dskaj,49657,49658,99315
52407,,kkgzfm2rxeij,49658,49659,99317
52408,,jngjw1jp8bkj,49659,49660,99319
52409,,lubtdthpakkj,49660,49661,99321
52410,,,49661,49662,99323
52411,,vhz1zhij-s4j,49662,49663,99325
52412,,pvrvgereaekj,49663,49664,99327
52413,,yjjxsnfi5wuj,49664,49665,99329
52414,,txslvcdrugcj,49665,49666,99331
52415,,nwaeshdfd4yj,49666,49667,99333
52416,,wors3tjbuoyj,49667,49668,99335
52417,,,49668,49669,99337
52418,,pfxtzptuw7kj,49669,49670,99339
52419,,dwx1oyiqqccj,49670,49671,99341
52420,,zjynpcdnjnuj,49671,49672,99343
52421,,qzi0ujlfa5aj,49672,49673,99345
52422,,of3ghllfdlcj,49673,49674,99347
52423,,qhnbqcnvrouj,49674,49675,99349
52424,,dh4h90esrpej,49675,49676,99351
52425,,xoyc5jxoiwoj,49676,49677,99353
52426,,agxt13utujkj,49677,49678,99355
52427,,1wrufoimv8aj,49678,49679,99357
52428,,s-qibt2mboyj,49679,49680,99359
52429,,xgzdcfpelfkj,49680,49681,99361
52430,,sughlakig4qj,49681,49682,99363
52431,,z8hce1s0ftcj,49682,49683,99365
52432,,ss3kwbs3gecj,49683,49684,99367
52433,,htwddfotkc8j,49684,49685,99369
52434,,1gg_hizarnaj,49685,49686,99371
52435,,7fqwbn64ejaj,49686,49687,99373
52436,,3tmjmk6pfruj,49687,49688,99375
52437,,whmkcptrvwkj,49688,49689,99377
52438,,url:http://www.springerlink.com/index/w7524279l43u8517.pdf,49689,49690,99379
52439,,cbfnjmcfgdwj,49690,49691,99381
52440,,kayau-pvac0j,49691,49692,99383
52441,,jinvgghtcjaj,49692,49693,99385
52442,,9m_fjw3cppqj,49693,49694,99387
52443,,_zwzuqp3lucj,49694,49695,99389
52444,,w3fy3w-pm0gj,49695,49696,99391
52445,,9gl0-t0c-yej,49696,49697,99393
52446,,xr7qaw6bsuoj,49697,49698,99395
52447,,gufoz5-h6cwj,49698,49699,99397
52448,,,49699,49700,99399
52449,,q16w4xjdb6gj,49700,49701,99401
52450,,0rvizf2yxmaj,49701,49702,99403
52451,,6fm-eg2hxb8j,49702,49703,99405
52452,,airsukb-qfqj,49703,49704,99407
52453,,gjrksyodycwj,49704,49705,99409
52454,,zowax2ctcsij,49705,49706,99411
52455,,2pjsklboxqij,49706,49707,99413
52456,,1aaogeqeuzuj,49707,49708,99415
52457,,mgykboelns4j,49708,49709,99417
52458,,dre5p-xgsm0j,49709,49710,99419
52459,,ytmk58qyr1ej,49710,49711,99421
52460,,jbqdsjvfxycj,49711,49712,99423
52461,,q6r2784ahq0j,49712,49713,99425
52462,,49aahbq9hzij,49713,49714,99427
52463,,af19rjxzoq0j,49714,49715,99429
52464,,qf5wtfluzpkj,49715,49716,99431
52465,,avlng4rmsimj,49716,49717,99433
52466,,ymyakqy_eicj,49717,49718,99435
52467,,qw36qcimy40j,49718,49719,99437
52468,,q9uivhetmecj,49719,49720,99439
52469,,5p4u8n9efyaj,49720,49721,99441
52470,,aoibz0qttnaj,49721,49722,99443
52471,,1oxy7iysb2mj,49722,49723,99445
52472,,rvjyzizv1buj,49723,49724,99447
52473,,g4vu3bpzdqij,49724,49725,99449
52474,,9sws6qtihdoj,49725,49726,99451
52475,,bpoi_wcqfcij,49726,49727,99453
52476,,whaer7dbdtuj,49727,49728,99455
52477,,bc_pn-qop7cj,49728,49729,99457
52478,,gcjz3qsq_dgj,49729,49730,99459
52479,,hacgdltmwsej,49730,49731,99461
52480,,3m120p5mivmj,49731,49732,99463
52481,,mcfjfc1jhtkj,49732,49733,99465
52482,,8mep5q0dpngj,49733,49734,99467
52483,,duistz4rexwj,49734,49735,99469
52484,,bnyk93otufgj,49735,49736,99471
52485,,9druolsa-nuj,49736,49737,99473
52486,,ephfq5jkvy0j,49737,49738,99475
52487,,wjzlvzqdsi4j,49738,49739,99477
52488,,j_hnzycvgryj,49739,49740,99479
52489,,url:http://portal.acm.org/ft_gateway.cfm3fid3d95908626type3dpdf26dl3dguide26dl3dacm26cfid3d1111111126cftoken3d2222222,49740,49741,99481
52490,,z2hb8zmt1vmj,49741,49742,99483
52491,,i-lcoiqwrg4j,49742,49743,99485
52492,,ynvude_59b0j,49743,49744,99487
52493,,aos-c4bmlrqj,49744,49745,99489
52494,,amdrr39lviij,49745,49746,99491
52495,,aoxjuq9h2cwj,49746,49747,99493
52496,,slyb8-oqd-ij,49747,49748,99495
52497,,msuvohmskuyj,49748,49749,99497
52498,,nndomy8tvcij,49749,49750,99499
52499,,e-umwsetcuej,49750,49751,99501
52500,,nuobsrait3oj,49751,49752,99503
52501,,0b8ujvvo_maj,49752,49753,99505
52502,,cldlpsmxaqwj,49753,49754,99507
52503,,y9g1btyjuf8j,49754,49755,99509
52504,,bnyokjxxvduj,49755,49756,99511
52505,,0rkn_oehxd4j,49756,49757,99513
52506,,l30flypogowj,49757,49758,99515
52507,,n-avzem6gvkj,49758,49759,99517
52508,,url:http://portal.acm.org/ft_gateway.cfm3fid3d60386926type3dpdf26dl3dguide26dl3dacm26cfid3d1111111126cftoken3d2222222,49759,49760,99519
52509,,79hycek2aeuj,49760,49761,99521
52510,,px59_x9yb3yj,49761,49762,99523
52511,,tzptme4t2oej,49762,49763,99525
52512,,hxhqzgsa-raj,49763,49764,99527
52513,,url:http://www.csa.com/partners/viewrecord.php3frequester3dgs26collection3dtrd26recid3d0972175ci,49764,49765,99529
52514,,wdrmuyefej8j,49765,49766,99531
52515,,jmb7bjdmg_0j,49766,49767,99533
52516,,noffy0c7na4j,49768,49769,99537
52517,,7bj8megcwp0j,49769,49770,99539
52518,,xipfv8kgqumj,49771,49772,99543
52519,,qy-12yfwvkgj,49772,49773,99545
52520,,ls8e4tlxr6mj,49773,49774,99547
52521,,sq1bwmm_hzqj,49774,49775,99549
52522,,m2lvwyqc55yj,49775,49776,99551
52523,,qoybsq2pjyqj,49776,49777,99553
52524,,dmrirjr_kaaj,49777,49778,99555
52525,,rfthsw3oaocj,49779,49780,99559
52526,,dzi3koqmdfwj,49780,49781,99561
52527,,7b3owsrntlqj,49781,49782,99563
52528,,hube11hhqg8j,49782,49783,99565
52529,,7qnzy_5-dfoj,49783,49784,99567
52530,,hwfmd230y08j,49784,49785,99569
52531,,teawrvnkvi0j,49785,49786,99571
52532,,frtb6dhi05ij,49786,49787,99573
52533,,rcvyvnikkzcj,49787,49788,99575
52534,,urmyqbkcfayj,49788,49789,99577
52535,,emnniqx4oqej,49789,49790,99579
52536,,ogqe-qyf4rcj,49790,49791,99581
52537,,px5fnzuvkkkj,49791,49792,99583
52538,,z8cj_s0rcqsj,49793,49794,99587
52539,,wk34lmymtdoj,49794,49795,99589
52540,,752lkzkw3asj,49795,49796,99591
52541,,4otyva90jxkj,49796,49797,99593
52542,,jki5lgm6d7ej,49797,49798,99595
52543,,kzgbgt2imlcj,49798,49799,99597
52544,,bjsreuiiy7yj,49799,49800,99599
52545,,rjdlkchr6ccj,49800,49801,99601
52546,,bvy5ln4ldp4j,49801,49802,99603
52547,,o87yqfl34oyj,49802,49803,99605
52548,,url:http://links.jstor.org/sici3fsici3d0146-4949(196522)6253a2253c243253aiaohc253e2.0.co253b2-0,49803,49804,99607
52549,,4cw8vk0u_d0j,49804,49805,99609
52550,,slduapmlstmj,49805,49806,99611
52551,,gdr-ve8wn1oj,49806,49807,99613
52552,,tnwdnrx-awwj,49807,49808,99615
52553,,hqzuy_hwzr8j,49808,49809,99617
52554,,ivsaepw1peaj,49809,49810,99619
52555,,1octwvc32jkj,49810,49811,99621
52556,,tgki4xhsfi4j,49811,49812,99623
52557,,zwiefffwmeqj,49812,49813,99625
52558,,pky1yaxpzhcj,49813,49814,99627
52559,,pupagdivbhmj,49815,49816,99631
52560,,oytdaupfjvyj,49816,49817,99633
52561,,duvgutcdjyqj,49817,49818,99635
52562,,1jajvju5yqqj,49818,49819,99637
52563,,kkicl1rq0r4j,49819,49820,99639
52564,,osu0j4xekeaj,49820,49821,99641
52565,,3mlmqvmyakcj,49821,49822,99643
52566,,bfmhz7xe-nmj,49822,49823,99645
52567,,,49823,49824,99647
52568,,hcgxkudb-wyj,49824,49825,99649
52569,,url:http://www.csa.com/partners/viewrecord.php3frequester3dgs26collection3dtrd26recid3dn9210480ah,49825,49826,99651
52570,,daxurzrpje0j,49826,49827,99653
52571,,nnnahnid4jkj,49827,49828,99655
52572,,kcbimjhevcmj,49828,49829,99657
52573,,sikoq5obipmj,49829,49830,99659
52574,,huaxoft85zmj,49830,49831,99661
52575,,nycnjh4zlfaj,49831,49832,99663
52576,,pcz4fpqitrsj,49832,49833,99665
52577,,gnxcz0fu8vsj,49833,49834,99667
52578,,ipgqr-uv4oqj,49834,49835,99669
52579,,njxr_e3jnayj,49835,49836,99671
52580,,izfxebhcuhgj,49836,49837,99673
52581,,3fhv2vvpkqwj,49837,49838,99675
52582,,ierhzerc3mqj,49838,49839,99677
52583,,l1e_euqneocj,49840,49841,99681
52584,,e94crnyepo4j,49841,49842,99683
52585,,q9q2aaznqlqj,49842,49843,99685
52586,,af5sz9hcqgcj,49843,49844,99687
52587,,mrs1pjasgugj,49844,49845,99689
52588,,2jmwz2fz_xej,49845,49846,99691
52589,,ogvdyzbrldsj,49846,49847,99693
52590,,yknu6062xqaj,49847,49848,99695
52591,,n0lfrcdgxgqj,49848,49849,99697
52592,,rvthxifsmasj,49849,49850,99699
52593,,pe06n3v_uwgj,49850,49851,99701
52594,,gwksbrabodqj,49851,49852,99703
52595,,ezq7ogi9dgej,49852,49853,99705
52596,,url:http://www.springerlink.com/index/k077u03702375wv7.pdf,49853,49854,99707
52597,,u0z6821ccgqj,49854,49855,99709
52598,,dojnm_tkwomj,49856,49857,99713
52599,,url:http://portal.acm.org/citation.cfm3fid3d1027688,49857,49858,99715
52600,,ju9oy63zfuwj,49858,49859,99717
52601,,cph0qysopv4j,49859,49860,99719
52602,,d4mikrac-rej,49860,49861,99721
52603,,jt1uxcqlufuj,49861,49862,99723
52604,,wyg-ybctoqgj,49862,49863,99725
52605,,url:http://portal.acm.org/ft_gateway.cfm3fid3d102768326type3dpdf,49863,49864,99727
52606,,pdia-rmpkqmj,49864,49865,99729
52607,,grj0ojllsw8j,49866,49867,99733
52608,,o4xsuozknmuj,49867,49868,99735
52609,,6bn9v--5znaj,49868,49869,99737
52610,,l1jpdgfsp3ej,49869,49870,99739
52611,,jme5ghbze8cj,49870,49871,99741
52612,,v5rwghqo86sj,49871,49872,99743
52613,,75-4_-c7whmj,49872,49873,99745
52614,,ebcirm1rfkej,49873,49874,99747
52615,,kmvsckczwcmj,49874,49875,99749
52616,,uykmuuljdmej,49875,49876,99751
52617,,qjftfze8t5cj,49876,49877,99753
52618,,easqqthexqkj,49877,49878,99755
52619,,3avkbvfxhg0j,49878,49879,99757
52620,,url:http://doi.wiley.com/10.1002/tl.152,49879,49880,99759
52621,,67v1d_fj6dkj,49880,49881,99761
52622,,_znhpfoab64j,49881,49882,99763
52623,,3lukhuownaaj,49882,49883,99765
52624,,ad5kksf_-mmj,49883,49884,99767
52625,,rsluflav4vej,49884,49885,99769
52626,,4-qaquepgagj,49885,49886,99771
52627,,alrxyeqsataj,49886,49887,99773
52628,,6qozrix089oj,49887,49888,99775
52629,,_aby4e02zk0j,49888,49889,99777
52630,,coqunkmb8gcj,49889,49890,99779
52631,,kq4kmuq32euj,49890,49891,99781
52632,,tk1_3wguihsj,49891,49892,99783
52633,,d2hxivzkvnaj,49892,49893,99785
52634,,,49893,49894,99787
52635,,4qgjpbblypoj,49894,49895,99789
52636,,ovuked3wghej,49895,49896,99791
52637,,qni-oiqw3sij,49896,49897,99793
52638,,url:http://portal.acm.org/ft_gateway.cfm3fid3d109969226type3dpdf,49897,49898,99795
52639,,et5cy08elhuj,49898,49899,99797
52640,,yrf5pkriij8j,49899,49900,99799
52641,,zmjnmjk4hmgj,49900,49901,99801
52642,,vrxd72o2pdoj,49901,49902,99803
52643,,hwx0hynfybkj,49902,49903,99805
52644,,grwrkcqgysqj,49903,49904,99807
52645,,pxhudw_vg-aj,49904,49905,99809
52646,,ns4lt2rpzxij,49905,49906,99811
52647,,0apkw8xmvwsj,49906,49907,99813
52648,,31szwxnbqsgj,49907,49908,99815
52649,,,49908,49909,99817
52650,,6ywll43o3yoj,49909,49910,99819
52651,,xb-6-fetof4j,49910,49911,99821
52652,,mynqgosuxmaj,49911,49912,99823
52653,,zw7bsuw1jn4j,49913,49914,99827
52654,,udhsledyrfoj,49914,49915,99829
52655,,hrnqgmr9dxqj,49915,49916,99831
52656,,lzolhfugy1sj,49916,49917,99833
52657,,url:http://www.ingentaconnect.com/search/expand3fpub3dinfobike://els/09505849/1999/00000041/00000006/art0006926unc3d,49917,49918,99835
52658,,yige3lv-s-ej,49918,49919,99837
52659,,url:http://portal.acm.org/ft_gateway.cfm3fid3d50734026type3dpdf26dl3dguide26dl3dacm26cfid3d1111111126cftoken3d2222222,49919,49920,99839
52660,,url:http://doi.wiley.com/10.1002/ev.1260,49920,49921,99841
52661,,eowhbqqfhvej,49921,49922,99843
52662,,dgwa7hzhdzwj,49922,49923,99845
52663,,boxxevoy4jcj,49923,49924,99847
52664,,pf7m2fyu0iuj,49924,49925,99849
52665,,ba1wrwkjghuj,49925,49926,99851
52666,,mqqzrarivq8j,49926,49927,99853
52667,,fcx9oz7jn0kj,49927,49928,99855
52668,,onechd5hpmqj,49928,49929,99857
52669,,ypm7jhnokwkj,49929,49930,99859
52670,,url:http://adsabs.harvard.edu/abs/1991ge26ae..31...34g,49930,49931,99861
52671,,ln4vykijvxoj,49931,49932,99863
52672,,efd6cai25kqj,49932,49933,99865
52673,,9mufrhkffggj,49933,49934,99867
52674,,dm0dvyvls24j,49934,49935,99869
52675,,he1ukqu3nskj,49935,49936,99871
52676,,4jnlwwk6ybqj,49936,49937,99873
52677,,tlxo8prwu9kj,49937,49938,99875
52678,,w6qm6srhbvcj,49938,49939,99877
52679,,zrl7rsm5nxcj,49939,49940,99879
52680,,aiaeit4oyr0j,49940,49941,99881
52681,,3qintykc-waj,49941,49942,99883
52682,,4xxru4cpidmj,49942,49943,99885
52683,,q3rmlo4ncnwj,49943,49944,99887
52684,,url:http://portal.acm.org/ft_gateway.cfm3fid3d110199326type3dpdf,49944,49945,99889
52685,,h-0cxr7icz0j,49945,49946,99891
52686,,pnyu5f02z0kj,49946,49947,99893
52687,,bduqoi83vimj,49947,49948,99895
52688,,xtjsjxfcqi0j,49948,49949,99897
52689,,xvabmif6elyj,49949,49950,99899
52690,,rqvh5gqcyhij,49950,49951,99901
52691,,agcb5wejtq0j,49951,49952,99903
52692,,jtnfx_safjwj,49952,49953,99905
52693,,1xsk_dtpzfoj,49953,49954,99907
52694,,fws-zp1aqq4j,49954,49955,99909
52695,,8wrooodetkaj,49955,49956,99911
52696,,flr5mrq2jdaj,49956,49957,99913
52697,,xfzhitkeb8aj,49957,49958,99915
52698,,zdxjxvj3ntgj,49958,49959,99917
52699,,wukcrcgt2lej,49959,49960,99919
52700,,mfmahqwop6aj,49960,49961,99921
52701,,z7lner4jfd4j,49961,49962,99923
52702,,axr_ux57ingj,49962,49963,99925
52703,,kszqw3st4raj,49963,49964,99927
52704,,epss2xn7rzoj,49964,49965,99929
52705,,5c-dxljpp8aj,49965,49966,99931
52706,,smnyrycxoz0j,49967,49968,99935
52707,,61_n5kumhtoj,49968,49969,99937
52708,,vtpzvysttjyj,49969,49970,99939
52709,,sp4fiezvpcyj,49971,49972,99943
52710,,yvff1gnocjyj,49972,49973,99945
52711,,nbwpr5jplt8j,49974,49975,99949
52712,,rlvorikzlw8j,49975,49976,99951
52713,,kvblhzkfuryj,49976,49977,99953
52714,,v_jacqe5g3uj,49977,49978,99955
52715,,fed-ir3upcgj,49978,49979,99957
52716,,pjr2b-uapkqj,49979,49980,99959
52717,,_iqvzrmu3mcj,49980,49981,99961
52718,,kavdy1wsgz0j,49981,49982,99963
52719,,2sc-yzwoovsj,49982,49983,99965
52720,,mn-fozmuqxsj,49983,49984,99967
52721,,ykypwem8wfwj,49984,49985,99969
52722,,jutvdmazqskj,49985,49986,99971
52723,,j46ygnuas-ij,49986,49987,99973
52724,,heqkmuwmovej,49987,49988,99975
52725,,9lg-wrmaghkj,49988,49989,99977
52726,,muar7cy_v6ij,49989,49990,99979
52727,,rbdcajjqxyoj,49990,49991,99981
52728,,f1iyr34byumj,49991,49992,99983
52729,,jrulzz43bamj,49992,49993,99985
52730,,osh2y2fp0bej,49993,49994,99987
52731,,ptfl5t0eycwj,49994,49995,99989
52732,,bzx3e1_fnk0j,49995,49996,99991
52733,,drwkqj0cofsj,49996,49997,99993
52734,,blih9e4x7wwj,49997,49998,99995
52735,,abylko8tkgwj,49998,49999,99997
52736,,nvdvgadv_eyj,49999,50000,99999
52737,,hr4korw7_d4j,50000,50001,100001
52738,,pxoqfng6pvoj,50001,50002,100003
52739,,url:http://www.ingentaconnect.com/content/els/08830355/2001/00000035/00000002/art00016,50003,50004,100007
52740,,ymx00_iklr4j,50004,50005,100009
52741,,uso9f5v-4kcj,50005,50006,100011
52742,,fox7z4j1wdsj,50006,50007,100013
52743,,b3venvrsgjuj,50007,50008,100015
52744,,tn1ssrdzizmj,50008,50009,100017
52745,,amdlbr-hnysj,50009,50010,100019
52746,,mczkeqjzrpaj,50010,50011,100021
52747,,s-o62zfeqh8j,50011,50012,100023
52748,,ldwddp5ltpmj,50012,50013,100025
52749,,zzvvavckbssj,50013,50014,100027
52750,,ycgistw1lu0j,50014,50015,100029
52751,,shytwo2v-laj,50015,50016,100031
52752,,upku69hoefsj,50016,50017,100033
52753,,lsgrpb5edlej,50017,50018,100035
52754,,50nckobijaqj,50018,50019,100037
52755,,2qfds-ovfswj,50019,50020,100039
52756,,298lam-idbmj,50021,50022,100043
52757,,momkz07v4yoj,50022,50023,100045
52758,,url:http://www.csa.com/partners/viewrecord.php3frequester3dgs26collection3dtrd26recid3d20021214044996mt26recid3da7212127ah,50023,50024,100047
52759,,gz5kmoyufqkj,50024,50025,100049
52760,,pdawcm7fe7qj,50025,50026,100051
52761,,5tuja_iwmkij,50026,50027,100053
52762,,f-vgkqbzsnij,50027,50028,100055
52763,,lbcacewu5lkj,50028,50029,100057
52764,,2j8tqkeqnagj,50029,50030,100059
52765,,v_4v2w7gnbkj,50030,50031,100061
52766,,7voutabxj1qj,50031,50032,100063
52767,,ksyxzlsnbhaj,50032,50033,100065
52768,,enlfbrcix3mj,50033,50034,100067
52769,,kx-j-c9fxluj,50034,50035,100069
52770,,cbxdoqgypxcj,50035,50036,100071
52771,,bp1bkteusyij,50036,50037,100073
52772,,fheb19wcaxej,50038,50039,100077
52773,,9ng1nyhwrzcj,50039,50040,100079
52774,,ztqmtt4zvsmj,50040,50041,100081
52775,,e93gxaz6nucj,50041,50042,100083
52776,,n3zp3nmps54j,50042,50043,100085
52777,,omvki31uyrej,50043,50044,100087
52778,,n0a3ns_aw1ej,50044,50045,100089
52779,,vxpl2dhfongj,50045,50046,100091
52780,,url:http://links.jstor.org/sici3fsici3d0146-4949(196722)8253a3253c365253ahbarif253e2.0.co253b2-y,50046,50047,100093
52781,,srl-d7_8tfwj,50047,50048,100095
52782,,gowa_bkqen8j,50048,50049,100097
52783,,s6kpnh1xxb0j,50049,50050,100099
52784,,df3vbgvqusmj,50050,50051,100101
52785,,wbbgny_ogzwj,50051,50052,100103
52786,,r5lntnmjgl0j,50052,50053,100105
52787,,klofyn_x1ekj,50053,50054,100107
52788,,ewnfnez1h8kj,50054,50055,100109
52789,,url:http://portal.acm.org/citation.cfm3fid3d171926.171947,50055,50056,100111
52790,,url:http://portal.acm.org/citation.cfm3fid3d599612.599645,50056,50057,100113
52791,,ena3vdfr6kyj,50057,50058,100115
52792,,4klvu7zuqrwj,50058,50059,100117
52793,,yb6i04kabfij,50059,50060,100119
52794,,04c2rc_shbij,50060,50061,100121
52795,,jx47weq3fsej,50061,50062,100123
52796,,wpqcrzqfcg0j,50062,50063,100125
52797,,1kp7nbuhh4oj,50063,50064,100127
52798,,xotfmnkmllwj,50064,50065,100129
52799,,url:http://portal.acm.org/ft_gateway.cfm3fid3d110115726type3dpdf,50065,50066,100131
52800,,grqansktzj4j,50066,50067,100133
52801,,j2f7qkxr4xkj,50067,50068,100135
52802,,l7i8xjbz-y4j,50068,50069,100137
52803,,_3pjsenflwoj,50069,50070,100139
52804,,m03kfxhd4c8j,50070,50071,100141
52805,,tlcyk_uvlkij,50071,50072,100143
52806,,hvtr9cqi8rej,50072,50073,100145
52807,,pqwojqungg8j,50073,50074,100147
52808,,4egr95itzdij,50074,50075,100149
52809,,vbrmwtuzhrwj,50075,50076,100151
52810,,yjiy2thsx9ij,50076,50077,100153
52811,,ntrvudt84bcj,50077,50078,100155
52812,,url:http://adsabs.harvard.edu/abs/1993mit..repts....l,50078,50079,100157
52813,,untt_ze5c9oj,50079,50080,100159
52814,,9iwlqdm1g78j,50080,50081,100161
52815,,ou5yl9nqsvmj,50081,50082,100163
52816,,_whoy3sr91ej,50082,50083,100165
52817,,jbm2tgumsxij,50083,50084,100167
52818,,url:http://portal.acm.org/ft_gateway.cfm3fid3d102756826type3dpdf,50084,50085,100169
52819,,_cz3bfbblfgj,50085,50086,100171
52820,,mwce1mpx1xkj,50086,50087,100173
52821,,ebl--grcmjkj,50087,50088,100175
52822,,e6kvienhwtkj,50088,50089,100177
52823,,troiachnyqej,50089,50090,100179
52824,,owe20vdyyo4j,50090,50091,100181
52825,,url:http://www.csa.com/partners/viewrecord.php3frequester3dgs26collection3dtrd26recid3dn9210443ah,50091,50092,100183
52826,,gbkstq_4fgij,50092,50093,100185
52827,,ce_bahqo8ekj,50093,50094,100187
52828,,dprcfuxdua8j,50094,50095,100189
52829,,url:http://adsabs.harvard.edu/abs/1986phdt.........1a,50095,50096,100191
52830,,2gomzlym8zoj,50096,50097,100193
52831,,m5wfoisagboj,50097,50098,100195
52832,,4bzbsp8db68j,50098,50099,100197
52833,,k1npoe0_h3aj,50099,50100,100199
52834,,u7grx2xqyjsj,50100,50101,100201
52835,,_z-fyph7r7gj,50102,50103,100205
52836,,qy3v-z3xvnej,50103,50104,100207
52837,,4pztycg8hfmj,50104,50105,100209
52838,,z3hu6upm8eqj,50105,50106,100211
52839,,qgmpkwt9cjsj,50106,50107,100213
52840,,url:http://portal.acm.org/citation.cfm3fid3d192593.19738726dl3dportal26dl3dacm26type3dseries26idx3d19259326part3dproceedings26wanttype3dproceedings26title3dinternational2520multimedia2520conference26cfid3d1111111126cftoken3d2222222,50107,50108,100215
52841,,tj0gser4hnqj,50109,50110,100219
52842,,itsmaavfimuj,50111,50112,100223
52843,,o0werpq7gtqj,50112,50113,100225
52844,,v9u41irvqs0j,50113,50114,100227
52845,,bt-mopg2jdwj,50114,50115,100229
52846,,oqyze7mup6sj,50115,50116,100231
52847,,lkmy4yeevw4j,50116,50117,100233
52848,,if-dbyzxdwuj,50117,50118,100235
52849,,d-ds---bdcej,50118,50119,100237
52850,,kriz5frgfiqj,50119,50120,100239
52851,,zjuifaq0kmgj,50120,50121,100241
52852,,ty6bmljmqtaj,50121,50122,100243
52853,,za_0tkypkd4j,50122,50123,100245
52854,,yegbjlyb6i0j,50123,50124,100247
52855,,lvjhm5ra6ygj,50124,50125,100249
52856,,ybqg0nfs4hcj,50125,50126,100251
52857,,w7f7kt0_jhyj,50126,50127,100253
52858,,s5tx06kbpguj,50127,50128,100255
52859,,_jccougkvgij,50128,50129,100257
52860,,ef7qhcdhkuuj,50129,50130,100259
52861,,790n-opj5ocj,50130,50131,100261
52862,,zptunie2to4j,50131,50132,100263
52863,,tvikhtmtoloj,50132,50133,100265
52864,,hy-jiddcop4j,50133,50134,100267
52865,,_oq_dfsys8aj,50135,50136,100271
52866,,r9khnpixnvcj,50136,50137,100273
52867,,nfj3haf-j_8j,50137,50138,100275
52868,,_081igye-hwj,50138,50139,100277
52869,,nax9oxpbcdaj,50140,50141,100281
52870,,lp9yixb3jbkj,50141,50142,100283
52871,,,50142,50143,100285
52872,,gp0mvu37heij,50143,50144,100287
52873,,url:http://portal.acm.org/citation.cfm3fid3d1041429,50144,50145,100289
52874,,neqa6jryev0j,50145,50146,100291
52875,,zve2r2wrai0j,50146,50147,100293
52876,,rij1tsrt_poj,50147,50148,100295
52877,,nqfqa6qvpzcj,50149,50150,100299
52878,,sbverkh0fqmj,50150,50151,100301
52879,,kgboyxuvqlaj,50151,50152,100303
52880,,gpvmoyqksdsj,50152,50153,100305
52881,,9arambk4o5ij,50153,50154,100307
52882,,fb5sp7-fvjgj,50154,50155,100309
52883,,2oqatzyy5q4j,50155,50156,100311
52884,,uxzxfqgn4doj,50156,50157,100313
52885,,yxp5u1du7vkj,50157,50158,100315
52886,,mu9ogwbc9fij,50158,50159,100317
52887,,zfio1hfe5c0j,50159,50160,100319
52888,,cyx7a-hwor4j,50160,50161,100321
52889,,2t0mz6cf2eyj,50161,50162,100323
52890,,vc7tzaas1k8j,50162,50163,100325
52891,,up7fa-0iifcj,50164,50165,100329
52892,,nlstpaithwmj,50165,50166,100331
52893,,url:http://doi.wiley.com/10.1002/mus.880020316,50166,50167,100333
52894,,2zyf-1vgikej,50167,50168,100335
52895,,bjrkiwldzdcj,50168,50169,100337
52896,,kth39n_xtk0j,50169,50170,100339
52897,,,50170,50171,100341
52898,,qlckrcsneqkj,50171,50172,100343
52899,,q-d5eqq2f2mj,50172,50173,100345
52900,,kbswq1rftzsj,50173,50174,100347
52901,,url:http://www.springerlink.com/index/u1rn1587r711w7w1.pdf,50174,50175,100349
52902,,opy1w_v2nnwj,50175,50176,100351
52903,,nwkxsxmwlm0j,50176,50177,100353
52904,,cvaajyudqm0j,50177,50178,100355
52905,,bwa_akkbbn8j,50178,50179,100357
52906,,-5pclipfxdgj,50179,50180,100359
52907,,hgqfq0eyaraj,50180,50181,100361
52908,,yazre7ou_aij,50181,50182,100363
52909,,ipwxrbtdb_4j,50182,50183,100365
52910,,url:http://portal.acm.org/citation.cfm3fid3d1031570.1031579,50183,50184,100367
52911,,jhxulwuvbmsj,50184,50185,100369
52912,,ah9zhq8bdkcj,50185,50186,100371
52913,,bukf5rgwx3ij,50186,50187,100373
52914,,el6nkxkl2fij,50187,50188,100375
52915,,url:http://portal.acm.org/ft_gateway.cfm3fid3d108371326type3dpdf,50188,50189,100377
52916,,lz3_p-jr2oij,50189,50190,100379
52917,,5zzdzuwszusj,50190,50191,100381
52918,,hlyiim9cua4j,50191,50192,100383
52919,,d1m4a3dmz5mj,50192,50193,100385
52920,,xoqbns5y8kaj,50193,50194,100387
52921,,nip5l8nflrcj,50195,50196,100391
52922,,xqsjgl3oluij,50196,50197,100393
52923,,04tqvwambvij,50197,50198,100395
52924,,ew5iyq5pcecj,50198,50199,100397
52925,,lqif1y9ehagj,50199,50200,100399
52926,,fkhkiikauomj,50200,50201,100401
52927,,orcurcfnjdaj,50201,50202,100403
52928,,pm9z2wkzm2wj,50202,50203,100405
52929,,3lydljxntimj,50203,50204,100407
52930,,cw2rwt8trkij,50205,50206,100411
52931,,,50206,50207,100413
52932,,txp275l71oqj,50207,50208,100415
52933,,p3vs2jjpeyuj,50208,50209,100417
52934,,f5gkkdnqdg0j,50209,50210,100419
52935,,desy9k7leb4j,50210,50211,100421
52936,,dhxu6uhar6qj,50211,50212,100423
52937,,tbpct2c8bgyj,50212,50213,100425
52938,,bnkq8pa_pnsj,50213,50214,100427
52939,,r-rxe3jrgfkj,50214,50215,100429
52940,,q1vnjn8oxzsj,50215,50216,100431
52941,,abea8uyjz6sj,50216,50217,100433
52942,,,50217,50218,100435
52943,,0lon2ypmr9oj,50218,50219,100437
52944,,wnmzjfgvyvqj,50219,50220,100439
52945,,ekhoq7bk1voj,50220,50221,100441
52946,,7dkycjphvo4j,50221,50222,100443
52947,,thrrydehybaj,50222,50223,100445
52948,,5gjl6j42gx8j,50223,50224,100447
52949,,yk7v1kwd4dqj,50224,50225,100449
52950,,xhtf-nl-a6wj,50225,50226,100451
52951,,cmr7qen25m8j,50226,50227,100453
52952,,byfntiui5n0j,50227,50228,100455
52953,,,50228,50229,100457
52954,,ga8wb_jqsymj,50229,50230,100459
52955,,,50230,50231,100461
52956,,qf7gmoehtncj,50231,50232,100463
52957,,nhkudg-hkt8j,50232,50233,100465
52958,,h2an4n_jtj0j,50233,50234,100467
52959,,g0vy_tp2bi0j,50234,50235,100469
52960,,f6sehud25xwj,50235,50236,100471
52961,,2wq_h7m1rfyj,50236,50237,100473
52962,,fkx3p-z0x6kj,50237,50238,100475
52963,,irdddoimjf0j,50238,50239,100477
52964,,g5pmfbusleej,50239,50240,100479
52965,,cbettet34s0j,50240,50241,100481
52966,,url:http://portal.acm.org/ft_gateway.cfm3fid3d6215026type3dpdf26dl3dportal26dl3dacm26cfid3d1111111126cftoken3d2222222,50241,50242,100483
52967,,3fabxvgekroj,50242,50243,100485
52968,,aigrbmofplej,50243,50244,100487
52969,,url:http://portal.acm.org/citation.cfm3fid3d1027527.1027768,50245,50246,100491
52970,,f6rnbivpxmqj,50246,50247,100493
52971,,7v5oglbmlh0j,50247,50248,100495
52972,,cxjxffjudbsj,50248,50249,100497
52973,,2crqguzhomij,50249,50250,100499
52974,,qpeeaqk4ibsj,50250,50251,100501
52975,,85etb5xahlmj,50251,50252,100503
52976,,7xu32gfkhu4j,50252,50253,100505
52977,,ipwei_rut9ej,50253,50254,100507
52978,,ir5aky3rdimj,50254,50255,100509
52979,,xuabqnvu9l8j,50255,50256,100511
52980,,6qfqogruzxaj,50256,50257,100513
52981,,ykqwzt3n-saj,50257,50258,100515
52982,,7-qs7c0-xvej,50258,50259,100517
52983,,8kogoadkcjoj,50259,50260,100519
52984,,url:http://www.csa.com/partners/viewrecord.php3frequester3dgs26collection3dtrd26recid3d0014636ci,50260,50261,100521
52985,,278dpsvljioj,50261,50262,100523
52986,,,50262,50263,100525
52987,,3b9qccapukaj,50263,50264,100527
52988,,oyvo1dnthnaj,50264,50265,100529
52989,,3wbbwo9pfsmj,50265,50266,100531
52990,,a5trbrprmwmj,50266,50267,100533
52991,,qrvksueca94j,50267,50268,100535
52992,,m1_cafh7opyj,50268,50269,100537
52993,,xxnqccdsk7aj,50269,50270,100539
52994,,ydast5iqmdwj,50270,50271,100541
52995,,yqvzn6tplagj,50271,50272,100543
52996,,wqltbsbfpgaj,50272,50273,100545
52997,,8hpoluhvomuj,50273,50274,100547
52998,,vrgcv1rchbkj,50275,50276,100551
52999,,wfzkrtcjo9kj,50276,50277,100553
53000,,url:http://portal.acm.org/ft_gateway.cfm3fid3d108372926type3dpdf,50277,50278,100555
53001,,mnvdtv7a2gij,50278,50279,100557
53002,,m9jzb1nk0z0j,50279,50280,100559
53003,,jwgxs6uijoaj,50280,50281,100561
53004,,72tgxhrvjg8j,50281,50282,100563
53005,,f9mq-_26c6qj,50282,50283,100565
53006,,ghyjhoin2-gj,50283,50284,100567
53007,,lkuo1fygzqcj,50284,50285,100569
53008,,hwl0puttdocj,50285,50286,100571
53009,,_k3q5btdr48j,50286,50287,100573
53010,,6wrhdyeord8j,50287,50288,100575
53011,,xlrbr3rkf1mj,50288,50289,100577
53012,,wys9qztnc8kj,50289,50290,100579
53013,,dorkkfwnfuuj,50290,50291,100581
53014,,fbsagfalp9aj,50291,50292,100583
53015,,nd58fbg13soj,50292,50293,100585
53016,,url:http://portal.acm.org/ft_gateway.cfm3fid3d108625626type3dpdf,50293,50294,100587
53017,,lgimvuyqermj,50294,50295,100589
53018,,zsotbetluqej,50295,50296,100591
53019,,jvr5x4fco4yj,50296,50297,100593
53020,,zckrtjh6iboj,50297,50298,100595
53021,,0elv8cgp33sj,50298,50299,100597
53022,,6njxvjhunz4j,50299,50300,100599
53023,,dwom6oab32yj,50300,50301,100601
53024,,url:http://portal.acm.org/citation.cfm3fcoll3dguide26dl3dguide26id3d276377,50301,50302,100603
53025,,gcvklceewnej,50302,50303,100605
53026,,xted1wfrzisj,50303,50304,100607
53027,,,50304,50305,100609
53028,,url:http://portal.acm.org/citation.cfm3fid3d115863,50305,50306,100611
53029,,uqbh72kgmygj,50306,50307,100613
53030,,ujwzncj2qkgj,50307,50308,100615
53031,,,50308,50309,100617
53032,,yeecsyyajq8j,50309,50310,100619
53033,,gqdbjwaiseaj,50311,50312,100623
53034,,ipwjvj7utsuj,50312,50313,100625
53035,,vjplu4muiu4j,50313,50314,100627
53036,,qntsqwxuew0j,50314,50315,100629
53037,,dpvmgg2hyoej,50315,50316,100631
53038,,bnmjtvely9qj,50316,50317,100633
53039,,xighlcp0ozyj,50317,50318,100635
53040,,kki-nuydkdqj,50318,50319,100637
53041,,m1dbsyqwuk8j,50319,50320,100639
53042,,n76djbnjrvqj,50321,50322,100643
53043,,u2rzqrhmxeoj,50322,50323,100645
53044,,mju8hvyacouj,50323,50324,100647
53045,,yvblyipdijgj,50324,50325,100649
53046,,9se246kxddgj,50325,50326,100651
53047,,cugjtsuk_moj,50326,50327,100653
53048,,_x6cbvgrz14j,50327,50328,100655
53049,,eree9p9oaicj,50328,50329,100657
53050,,mleqxyijkw8j,50329,50330,100659
53051,,hrb61qhlfd0j,50330,50331,100661
53052,,rawswxntpq0j,50331,50332,100663
53053,,biqj-gxuezaj,50332,50333,100665
53054,,ln40ip-ksrgj,50333,50334,100667
53055,,r3td_k_a2j4j,50334,50335,100669
53056,,8ou_9_w8_6ej,50335,50336,100671
53057,,ou0xxyttd28j,50336,50337,100673
53058,,eraujmqexp8j,50337,50338,100675
53059,,owcbrt8xoiqj,50338,50339,100677
53060,,url:http://www.csa.com/partners/viewrecord.php3frequester3dgs26collection3dtrd26recid3d20021214021622mt26recid3da8012623ah,50339,50340,100679
53061,,xstwddjss0kj,50340,50341,100681
53062,,m0m3fbxnztkj,50341,50342,100683
53063,,j7pjreb9hxcj,50342,50343,100685
53064,,wjknsqwl5zoj,50343,50344,100687
53065,,vvf3fw696d0j,50344,50345,100689
53066,,oqtxpa_0pcyj,50345,50346,100691
53067,,mcqvpfy-vk4j,50346,50347,100693
53068,,a5untnvmdsij,50347,50348,100695
53069,,w4s5xognkdcj,50348,50349,100697
53070,,uabnm1nq79yj,50349,50350,100699
53071,,sz5sskr5gfwj,50350,50351,100701
53072,,jyltmhhevaij,50351,50352,100703
53073,,hyyh2aslqkej,50352,50353,100705
53074,,wttep3_0jeoj,50353,50354,100707
53075,,vqyvpfyna38j,50354,50355,100709
53076,,url:http://portal.acm.org/ft_gateway.cfm3fid3d102768426type3dpdf,50355,50356,100711
53077,,2guwicktwtuj,50356,50357,100713
53078,,0nlshywdsroj,50357,50358,100715
53079,,160sgee04u8j,50358,50359,100717
53080,,29btu5ospbaj,50359,50360,100719
53081,,46ks6wkj7gej,50360,50361,100721
53082,,o1slbgl9cb0j,50361,50362,100723
53083,,giydxqlh9uoj,50362,50363,100725
53084,,owcjmt0mv2ij,50363,50364,100727
53085,,xqety2vbfq4j,50364,50365,100729
53086,,jfw-ftdkd-kj,50365,50366,100731
53087,,9dnxgo7ssyoj,50366,50367,100733
53088,,im2ffjpdgcuj,50367,50368,100735
53089,,6eozlv0zxiqj,50368,50369,100737
53090,,dxobjqbtyl4j,50369,50370,100739
53091,,lriboj6zgnaj,50370,50371,100741
53092,,ys_fbnumjtoj,50371,50372,100743
53093,,qp1wjtvx-wqj,50372,50373,100745
53094,,60xh_dsz3sij,50373,50374,100747
53095,,g9iudqebcwoj,50374,50375,100749
53096,,3hspmptl2msj,50375,50376,100751
53097,,url:http://portal.acm.org/ft_gateway.cfm3fid3d108374726type3dpdf,50376,50377,100753
53098,,ofmpksqvceuj,50377,50378,100755
53099,,qrwv4dpyzbuj,50378,50379,100757
53100,,9qa6fwjufmmj,50379,50380,100759
53101,,ppogjyb7rxaj,50380,50381,100761
53102,,fqtts2ywhfuj,50381,50382,100763
53103,,zesgvqmrfiyj,50382,50383,100765
53104,,woecho0v-kcj,50383,50384,100767
53105,,usivd2vvw4ij,50384,50385,100769
53106,,ovnkaycrexwj,50385,50386,100771
53107,,wc8dlzh2tyqj,50386,50387,100773
53108,,6ajpn-tvrdij,50387,50388,100775
53109,,xqkrdny6lt0j,50388,50389,100777
53110,,url:http://www.csa.com/partners/viewrecord.php3frequester3dgs26collection3dtrd26recid3da7715728ah,50389,50390,100779
53111,,ztzdxpdlegaj,50390,50391,100781
53112,,l3n0e0db1g8j,50391,50392,100783
53113,,nvb6glnioswj,50392,50393,100785
53114,,xfwgb928ufcj,50393,50394,100787
53115,,svsbdgg-gs4j,50394,50395,100789
53116,,zngrm_hn3_mj,50395,50396,100791
53117,,dh_74pkthhqj,50396,50397,100793
53118,,uajhpwznn3aj,50397,50398,100795
53119,,vemz6jni48mj,50398,50399,100797
53120,,qc9wqerhetoj,50399,50400,100799
53121,,un-jazffs4qj,50400,50401,100801
53122,,viffipfcmh0j,50401,50402,100803
53123,,umtkmackhssj,50402,50403,100805
53124,,rknz6ryzkzqj,50403,50404,100807
53125,,fb2xvdlmttwj,50404,50405,100809
53126,,wr6hjv8139aj,50405,50406,100811
53127,,inswbyxtcsej,50406,50407,100813
53128,,u3unybakzakj,50407,50408,100815
53129,,0xofev9gjgmj,50408,50409,100817
53130,,swbr75v6h7ej,50409,50410,100819
53131,,gzd3xdkqszqj,50410,50411,100821
53132,,djm5csag5vqj,50411,50412,100823
53133,,e3wq5nhphkoj,50412,50413,100825
53134,,krvu11x93hmj,50413,50414,100827
53135,,nlnurpn8oh4j,50414,50415,100829
53136,,fwwjsfy8wmwj,50415,50416,100831
53137,,x2sdrsb3yyuj,50416,50417,100833
53138,,bsfsn1ntuomj,50417,50418,100835
53139,,ih64fgu_j2ej,50418,50419,100837
53140,,ppjwznz-cscj,50419,50420,100839
53141,,plll08xn4luj,50420,50421,100841
53142,,mzstp4-ekvej,50421,50422,100843
53143,,_845xbfrwqcj,50422,50423,100845
53144,,1ywqq5qdzg0j,50423,50424,100847
53145,,2gevrojrovyj,50424,50425,100849
53146,,qcro2ko3dzqj,50425,50426,100851
53147,,9wrgteqzxlej,50426,50427,100853
53148,,3ynbi88pvygj,50427,50428,100855
53149,,ennfvrfjeywj,50428,50429,100857
53150,,us43gvhj3jqj,50429,50430,100859
53151,,7iqmxncuknqj,50430,50431,100861
53152,,v-ggohdnadej,50431,50432,100863
53153,,jh6heq5bf70j,50432,50433,100865
53154,,url:http://doi.wiley.com/10.1002/ace.133,50433,50434,100867
53155,,url:http://portal.acm.org/citation.cfm3fid3d1027641,50434,50435,100869
53156,,csxqdjupzoej,50435,50436,100871
53157,,8roiwavqvx4j,50436,50437,100873
53158,,erck5mwn4eij,50437,50438,100875
53159,,zophrcwosr4j,50438,50439,100877
53160,,bgs7g2z18t0j,50439,50440,100879
53161,,msyylocyid8j,50440,50441,100881
53162,,0akiv2k9j1gj,50441,50442,100883
53163,,w8ddfezklg4j,50442,50443,100885
53164,,url:http://portal.acm.org/citation.cfm3fid3d54176.54178,50443,50444,100887
53165,,oil_t7xlpskj,50444,50445,100889
53166,,39aoire9qsqj,50445,50446,100891
53167,,e5x9ur7ud8oj,50446,50447,100893
53168,,dgsoogljtw0j,50447,50448,100895
53169,,kqs7jgld-lgj,50448,50449,100897
53170,,w9zg97zdhisj,50449,50450,100899
53171,,kxni2sthflkj,50450,50451,100901
53172,,hokb3bfsvvkj,50451,50452,100903
53173,,z7s05ghrjqsj,50452,50453,100905
53174,,cej81uc3g6wj,50453,50454,100907
53175,,jobiquqdmz0j,50454,50455,100909
53176,,xenk7nhsxnuj,50455,50456,100911
53177,,dkxqxzcfd8gj,50457,50458,100915
53178,,xhhch6o_taej,50458,50459,100917
53179,,a-blqwowgfuj,50459,50460,100919
53180,,tvopszwhfayj,50460,50461,100921
53181,,4lmv4leezwcj,50461,50462,100923
53182,,,50462,50463,100925
53183,,za149iudkrqj,50463,50464,100927
53184,,nlzhiwguxsij,50464,50465,100929
53185,,f1zezxk-gtqj,50465,50466,100931
53186,,9vmpesixhcgj,50466,50467,100933
53187,,w-x9cvfdraaj,50467,50468,100935
53188,,pvjrtkcitwgj,50468,50469,100937
53189,,jzlasmlp0zkj,50469,50470,100939
53190,,url:http://portal.acm.org/ft_gateway.cfm3fid3d109968526type3dpdf,50470,50471,100941
53191,,h8suoic6a5oj,50472,50473,100945
53192,,0tipdqxcrouj,50473,50474,100947
53193,,cjq3y3oywpkj,50474,50475,100949
53194,,0lh5mwekhyyj,50475,50476,100951
53195,,xt5rv136xsgj,50476,50477,100953
53196,,fhpvfzp7t0wj,50477,50478,100955
53197,,,50478,50479,100957
53198,,tt2mljgqxzkj,50479,50480,100959
53199,,my381pgcdokj,50480,50481,100961
53200,,efkkjuk3tfuj,50481,50482,100963
53201,,url:http://portal.acm.org/ft_gateway.cfm3fid3d16663926type3dpdf26coll3dguide26dl3dacm26cfid3d1111111126cftoken3d2222222,50482,50483,100965
53202,,e-ukz-8if0cj,50483,50484,100967
53203,,url:http://doi.wiley.com/10.1002/ace.182,50484,50485,100969
53204,,qvpdafisk_qj,50486,50487,100973
53205,,feq1izm8dkqj,50487,50488,100975
53206,,afndg_pqy38j,50488,50489,100977
53207,,6g61s5wovv4j,50489,50490,100979
53208,,jllcqsr_ufgj,50490,50491,100981
53209,,0mtmx5qbojkj,50491,50492,100983
53210,,url:http://www.csa.com/partners/viewrecord.php3frequester3dgs26collection3dtrd26recid3d0153831ci,50492,50493,100985
53211,,raleo-hh00cj,50493,50494,100987
53212,,qb5fyepx04aj,50494,50495,100989
53213,,rpjewewtp1sj,50495,50496,100991
53214,,kyd5-jlmrmuj,50496,50497,100993
53215,,2cmoira6-dsj,50497,50498,100995
53216,,r8n1cmv4xn0j,50498,50499,100997
53217,,91_uxrzrcqkj,50499,50500,100999
53218,,eumgc1khe6uj,50500,50501,101001
53219,,qgdazvftps0j,50501,50502,101003
53220,,d4sgsylonikj,50502,50503,101005
53221,,url:http://www.springerlink.com/index/h086n4h866403248.pdf,50503,50504,101007
53222,,4k4fubwnv8uj,50504,50505,101009
53223,,65rv4xqwniij,50505,50506,101011
53224,,hvp6eyl30igj,50506,50507,101013
53225,,attgrfhlokkj,50507,50508,101015
53226,,rirdaaxfiqgj,50508,50509,101017
53227,,vvapsyxpefoj,50509,50510,101019
53228,,rbjjhzi_ussj,50510,50511,101021
53229,,oxgf5d22wx0j,50511,50512,101023
53230,,_b6dkx2bblsj,50512,50513,101025
53231,,p86jdlpbgi8j,50513,50514,101027
53232,,url:http://portal.acm.org/ft_gateway.cfm3fid3d109964426type3dpdf,50514,50515,101029
53233,,url:http://ieeexplore.ieee.org/iel1/2/580/00016226.pdf3farnumber3d16226,50515,50516,101031
53234,,tetdcfe0wroj,50516,50517,101033
53235,,b68ik9samvcj,50517,50518,101035
53236,,ocl-2cor_6mj,50518,50519,101037
53237,,z_gnvq2l4rgj,50520,50521,101041
53238,,byolmn-0l70j,50521,50522,101043
53239,,_t4ohjxsg6oj,50522,50523,101045
53240,,r9e82znaecgj,50523,50524,101047
53241,,53royhql8buj,50524,50525,101049
53242,,url:http://www.ingentaconnect.com/search/expand3fpub3dinfobike://els/09505849/1999/00000041/00000014/art0009226unc3d,50525,50526,101051
53243,,0bjwgojb9pmj,50526,50527,101053
53244,,5jm9s5cvqhuj,50528,50529,101057
53245,,svhumvcpsamj,50529,50530,101059
53246,,f5waml7ajd4j,50530,50531,101061
53247,,obrwiiy5r24j,50531,50532,101063
53248,,eo--laizqgcj,50532,50533,101065
53249,,dkxyz8xpqs0j,50533,50534,101067
53250,,og4f6mckqe4j,50534,50535,101069
53251,,3ykjqu4zj34j,50535,50536,101071
53252,,xtippere4nqj,50536,50537,101073
53253,,qozigunhpt4j,50537,50538,101075
53254,,hzdslulyiykj,50538,50539,101077
53255,,8-mfrfxxf2kj,50539,50540,101079
53256,,5mkc8aqzthuj,50540,50541,101081
53257,,ki8qadhykbqj,50541,50542,101083
53258,,url:http://portal.acm.org/ft_gateway.cfm3fid3d105668826type3dpdf,50542,50543,101085
53259,,url:http://portal.acm.org/ft_gateway.cfm3fid3d108379926type3dpdf,50543,50544,101087
53260,,8e2vjinz7iqj,50544,50545,101089
53261,,mukpcqjyv2ij,50545,50546,101091
53262,,vjomflxitvgj,50546,50547,101093
53263,,dettj3l5shij,50547,50548,101095
53264,,fz0psmf37kgj,50549,50550,101099
53265,,tipoevrqzswj,50550,50551,101101
53266,,zaxxlyfh-guj,50551,50552,101103
53267,,pzfjc2mejaej,50552,50553,101105
53268,,26boilvocksj,50553,50554,101107
53269,,tjxc17skxamj,50554,50555,101109
53270,,r6jc_jnzxeuj,50555,50556,101111
53271,,e2l6abipnnoj,50556,50557,101113
53272,,g6nmsaumoq8j,50557,50558,101115
53273,,uzq66mvxbcuj,50558,50559,101117
53274,,fftmfkevgpcj,50559,50560,101119
53275,,mcgxrnrb3hkj,50560,50561,101121
53276,,b_91qg4ryq8j,50561,50562,101123
53277,,wfw8wxu-hx8j,50562,50563,101125
53278,,gr2vzvzlztuj,50563,50564,101127
53279,,mol9fpa_klmj,50564,50565,101129
53280,,orfznbm6lskj,50565,50566,101131
53281,,mbn3zzl8swmj,50566,50567,101133
53282,,7gx4fchp6y4j,50567,50568,101135
53283,,w4g5lkmceq4j,50568,50569,101137
53284,,afouhbx0hfoj,50569,50570,101139
53285,,c6uhrzf-k58j,50570,50571,101141
53286,,nk8zjpawc5yj,50571,50572,101143
53287,,z1ejxsu4sqkj,50572,50573,101145
53288,,jc2qikvqc08j,50573,50574,101147
53289,,jm_qtolla9qj,50574,50575,101149
53290,,jajd7b6eiucj,50576,50577,101153
53291,,2jtgezmghokj,50577,50578,101155
53292,,mmivvpwgbxoj,50578,50579,101157
53293,,hw42xtmw08yj,50579,50580,101159
53294,,mfknbbrg_90j,50580,50581,101161
53295,,l44nsdiq2s8j,50581,50582,101163
53296,,2teyomhhat4j,50582,50583,101165
53297,,u_eytl-exwqj,50583,50584,101167
53298,,g6tonclfhj0j,50584,50585,101169
53299,,t3vlgjthnsyj,50585,50586,101171
53300,,gw3rfhcmmzwj,50586,50587,101173
53301,,r8a4x8ujs_0j,50587,50588,101175
53302,,yaiizvp1ww0j,50588,50589,101177
53303,,vgpsmovljogj,50589,50590,101179
53304,,xhug7yb2y7oj,50590,50591,101181
53305,,bcssm6zmougj,50591,50592,101183
53306,,lsr3sygievkj,50592,50593,101185
53307,,jx2jenqyw-aj,50593,50594,101187
53308,,92qhhhwpuwsj,50594,50595,101189
53309,,uwg7hdtct9kj,50595,50596,101191
53310,,r8b1lf8zh2kj,50596,50597,101193
53311,,dnic5opwneqj,50597,50598,101195
53312,,xrgxxmqz4g8j,50598,50599,101197
53313,,v0svgvhw3igj,50599,50600,101199
53314,,ew9btdfdihaj,50600,50601,101201
53315,,xn4xqmtc7wij,50601,50602,101203
53316,,pc1ncf5tbaaj,50602,50603,101205
53317,,vv6jnka_skqj,50603,50604,101207
53318,,0cl5xne9scmj,50604,50605,101209
53319,,8dxqau6qzv0j,50605,50606,101211
53320,,4uejgwn0cqcj,50606,50607,101213
53321,,d8i0jn_jgwsj,50607,50608,101215
53322,,pcf-_a85vk0j,50608,50609,101217
53323,,7iu4zzykguyj,50609,50610,101219
53324,,hfpyruikygoj,50610,50611,101221
53325,,vdoiq6wlct8j,50611,50612,101223
53326,,hgrwapsnm_ij,50612,50613,101225
53327,,ci2-4e6d-40j,50613,50614,101227
53328,,um664nmw3iaj,50614,50615,101229
53329,,5wy5bzfjulyj,50615,50616,101231
53330,,z9t3drbmdquj,50616,50617,101233
53331,,ldzlera8jc8j,50617,50618,101235
53332,,n3dptxtnkimj,50619,50620,101239
53333,,946ocniilwej,50620,50621,101241
53334,,iguismywmy8j,50621,50622,101243
53335,,dpu0e5tb0foj,50622,50623,101245
53336,,fimsgmmsxioj,50623,50624,101247
53337,,t7ilzfuvikaj,50624,50625,101249
53338,,e4ek7erfdiwj,50625,50626,101251
53339,,frep5yuizfoj,50626,50627,101253
53340,,hcwokelbfbij,50627,50628,101255
53341,,mwpzh6vwztkj,50628,50629,101257
53342,,94lx7sovuo8j,50629,50630,101259
53343,,rezpilwiusgj,50630,50631,101261
53344,,30oexkfv04uj,50631,50632,101263
53345,,2b5590nrrquj,50632,50633,101265
53346,,url:http://portal.acm.org/citation.cfm3fid3d47157,50633,50634,101267
53347,,9wcjaw5wukgj,50634,50635,101269
53348,,kjxgpsjslggj,50635,50636,101271
53349,,4f4cpe_efuwj,50636,50637,101273
53350,,ooqim7gnhqcj,50637,50638,101275
53351,,mymtr6jjt2ej,50638,50639,101277
53352,,fnmjbewkki8j,50640,50641,101281
53353,,4ogjqrwzvpuj,50641,50642,101283
53354,,eyf20oauvq8j,50642,50643,101285
53355,,trmek5ltdwkj,50643,50644,101287
53356,,rd5egi-nomoj,50644,50645,101289
53357,,axutskyfltsj,50645,50646,101291
53358,,i1jsgix5kvkj,50646,50647,101293
53359,,q16rnvrrmvsj,50647,50648,101295
53360,,,50648,50649,101297
53361,,9ufcthv88qkj,50649,50650,101299
53362,,4vg81bi8_isj,50650,50651,101301
53363,,dazjpkhh8luj,50651,50652,101303
53364,,rkm9xmblbqcj,50652,50653,101305
53365,,ptzpitp7i5wj,50653,50654,101307
53366,,mrp3t5hmekmj,50654,50655,101309
53367,,ogfqhumdvhqj,50655,50656,101311
53368,,jftjdwal9ooj,50656,50657,101313
53369,,moygulmg-uyj,50657,50658,101315
53370,,woodxkw7ukcj,50658,50659,101317
53371,,,50659,50660,101319
53372,,aqrnzgwhwz4j,50660,50661,101321
53373,,e4lbno2glwuj,50661,50662,101323
53374,,44wbidpqftgj,50662,50663,101325
53375,,gjpwbyskyqgj,50663,50664,101327
53376,,gwv15nckt9ij,50664,50665,101329
53377,,daufl4bnn0gj,50665,50666,101331
53378,,url:http://www.csa.com/partners/viewrecord.php3frequester3dgs26collection3dtrd26recid3d0971657ci,50666,50667,101333
53379,,hbnswk0kt0sj,50667,50668,101335
53380,,s2orb6bdm8gj,50668,50669,101337
53381,,arhcah7i_bkj,50669,50670,101339
53382,,hu2agr7wy_ej,50670,50671,101341
53383,,l8ke73nhsuaj,50671,50672,101343
53384,,wohxnqdnmzoj,50672,50673,101345
53385,,4z2ukdtxnm4j,50673,50674,101347
53386,,rebqhxscihij,50674,50675,101349
53387,,ig6jkyx9-ssj,50675,50676,101351
53388,,yykh8cn-ycgj,50676,50677,101353
53389,,ltnqbpbua5sj,50677,50678,101355
53390,,-3roppdxtl0j,50678,50679,101357
53391,,cwt2l-tlfxgj,50679,50680,101359
53392,,cetp23-ywlaj,50680,50681,101361
53393,,ufvketmrxkaj,50681,50682,101363
53394,,6c0p0fxm23ij,50682,50683,101365
53395,,c4cpfgs2iwmj,50683,50684,101367
53396,,b9gtxccfowsj,50684,50685,101369
53397,,3hpdzdal-qqj,50685,50686,101371
53398,,unjisosz7oqj,50686,50687,101373
53399,,uyx2pu1mgqsj,50687,50688,101375
53400,,glssgxwr5mqj,50688,50689,101377
53401,,afcipmw4918j,50689,50690,101379
53402,,zguzwsul3nkj,50690,50691,101381
53403,,4ouprlmhtiwj,50691,50692,101383
53404,,adm7qwgi-baj,50692,50693,101385
53405,,bpiuip43ikmj,50694,50695,101389
53406,,o_qegsgi-caj,50695,50696,101391
53407,,p6hnnxs6ne4j,50696,50697,101393
53408,,lrei2a_sdagj,50697,50698,101395
53409,,gqf3jywnmuqj,50698,50699,101397
53410,,3c9zmca6uaoj,50699,50700,101399
53411,,kygpdsbr1wmj,50700,50701,101401
53412,,,50701,50702,101403
53413,,i9jkeihda0mj,50702,50703,101405
53414,,,50703,50704,101407
53415,,0m03vxpxfiuj,50704,50705,101409
53416,,jggufx4woyaj,50705,50706,101411
53417,,bowthvjy5y8j,50706,50707,101413
53418,,lbwssnao7ggj,50707,50708,101415
53419,,jyhylh_uizuj,50708,50709,101417
53420,,x6ywsgmuzawj,50709,50710,101419
53421,,zk2s9ceyeeej,50710,50711,101421
53422,,kvv1xbm1docj,50711,50712,101423
53423,,v18cljp_f8qj,50712,50713,101425
53424,,22ztae8fnuij,50713,50714,101427
53425,,kjhlzqw_-bkj,50714,50715,101429
53426,,vimdeopczhyj,50715,50716,101431
53427,,-ypu5b-7y9yj,50716,50717,101433
53428,,pb5z50hfsssj,50717,50718,101435
53429,,7-kypwa4qemj,50718,50719,101437
53430,,quuael0xmw4j,50719,50720,101439
53431,,ozypx_t0i7yj,50720,50721,101441
53432,,yhhxacunfhaj,50721,50722,101443
53433,,k8mdretbmloj,50722,50723,101445
53434,,url:http://www.csa.com/partners/viewrecord.php3frequester3dgs26collection3dtrd26recid3da7423816ah,50723,50724,101447
53435,,3_gtpmzms40j,50724,50725,101449
53436,,qaglh5cpqugj,50725,50726,101451
53437,,t0wd_yw4n3cj,50726,50727,101453
53438,,c-rs9bzcyzoj,50728,50729,101457
53439,,gihe1ygtoeij,50729,50730,101459
53440,,url:http://links.jstor.org/sici3fsici3d0146-4949(196324)4253a1253c48253atswojd253e2.0.co253b2-z,50730,50731,101461
53441,,0emlkp5vbgkj,50731,50732,101463
53442,,brdgcbplqicj,50732,50733,101465
53443,,pfhk85qhzrgj,50733,50734,101467
53444,,gz9_vcewoh0j,50734,50735,101469
53445,,zcfyfjelmccj,50735,50736,101471
53446,,pk0ykkzdpzyj,50736,50737,101473
53447,,g05x57yhcbej,50737,50738,101475
53448,,w7k-012yylqj,50738,50739,101477
53449,,7o4d_iu0crkj,50739,50740,101479
53450,,fbibydq53xyj,50740,50741,101481
53451,,jeho0ljwqgyj,50741,50742,101483
53452,,jyadv8odipuj,50742,50743,101485
53453,,ikemqxz__ecj,50743,50744,101487
53454,,75ijk_o1e30j,50744,50745,101489
53455,,tqjguq1mmv4j,50745,50746,101491
53456,,8nicpz0qfbwj,50746,50747,101493
53457,,xxemjhv34asj,50747,50748,101495
53458,,ihueohcbba0j,50749,50750,101499
53459,,ydqumltb2ocj,50750,50751,101501
53460,,doc8qgr-p3qj,50751,50752,101503
53461,,url:http://www.springerlink.com/index/5g6l5cvd7na9hcjj.pdf,50752,50753,101505
53462,,6sobi8dxzjwj,50753,50754,101507
53463,,gcsps_1fwmyj,50754,50755,101509
53464,,kgrbcofgajyj,50755,50756,101511
53465,,b-jardcdx24j,50756,50757,101513
53466,,38o-zrhphjuj,50757,50758,101515
53467,,4kv8va2_nyyj,50758,50759,101517
53468,,bklkjv2bndoj,50759,50760,101519
53469,,l07pbst1c5uj,50760,50761,101521
53470,,_7vocsbrltej,50761,50762,101523
53471,,wdu3xbezdncj,50762,50763,101525
53472,,3ph--zwkzo8j,50763,50764,101527
53473,,lmizoj0apwsj,50764,50765,101529
53474,,4qhixvulkhqj,50765,50766,101531
53475,,aeuuvifdorcj,50766,50767,101533
53476,,jdvjbr07gwgj,50767,50768,101535
53477,,yknfefqwnmyj,50768,50769,101537
53478,,mqvlzgzswowj,50769,50770,101539
53479,,xmtvealdc84j,50770,50771,101541
53480,,njohwdp-nb8j,50771,50772,101543
53481,,i55v8gibsbuj,50772,50773,101545
53482,,inubdxkx-1wj,50773,50774,101547
53483,,lymj5wkbnj0j,50774,50775,101549
53484,,ftsz1qfdreoj,50775,50776,101551
53485,,hhu-mj_l3fgj,50777,50778,101555
53486,,url:http://portal.acm.org/ft_gateway.cfm3fid3d97475626type3dpdf26dl3dacm26dl3dacm26cfid3d1111111126cftoken3d2222222,50778,50779,101557
53487,,6dxtqgab-lcj,50779,50780,101559
53488,,i24shqnblbkj,50780,50781,101561
53489,,7uadi0jcc2aj,50781,50782,101563
53490,,o4ftpwv33asj,50782,50783,101565
53491,,28bj0kwnrhaj,50783,50784,101567
53492,,0szklin70ugj,50784,50785,101569
53493,,um0b0amrmyej,50785,50786,101571
53494,,6s7v6ppmmcyj,50786,50787,101573
53495,,mjqr1jtja64j,50788,50789,101577
53496,,wxdgccn2yi0j,50789,50790,101579
53497,,sdgd7k8qd04j,50790,50791,101581
53498,,ufqcs6n_oraj,50791,50792,101583
53499,,67iirtq38zwj,50792,50793,101585
53500,,4eig04d2vguj,50793,50794,101587
53501,,mgjvo0h9owqj,50794,50795,101589
53502,,url:http://www.csa.com/partners/viewrecord.php3frequester3dgs26collection3dtrd26recid3d1780638ci,50795,50796,101591
53503,,e0_inl_086kj,50796,50797,101593
53504,,0rxnp2ftd6cj,50797,50798,101595
53505,,w8uge-zzjv0j,50798,50799,101597
53506,,hhdt_u80z5yj,50799,50800,101599
53507,,g3mgvah8kz4j,50800,50801,101601
53508,,x0qgbnasqomj,50801,50802,101603
53509,,tu9ew0fyrtej,50803,50804,101607
53510,,nlxzs29oz8aj,50804,50805,101609
53511,,whtkp5wasdwj,50805,50806,101611
53512,,agpgguthfgsj,50806,50807,101613
53513,,1jqobitvm18j,50807,50808,101615
53514,,pgypbypyt3sj,50808,50809,101617
53515,,bomaclerhtaj,50809,50810,101619
53516,,4uo2fqdmdmej,50810,50811,101621
53517,,url:http://doi.wiley.com/10.1002/ace.178,50812,50813,101625
53518,,sahx94aoqycj,50813,50814,101627
53519,,url:http://portal.acm.org/ft_gateway.cfm3fid3d103157926type3dpdf,50814,50815,101629
53520,,dismd8uj4uqj,50815,50816,101631
53521,,whketfio1mkj,50816,50817,101633
53522,,nqgolzy8_uij,50817,50818,101635
53523,,baaruie-vp8j,50818,50819,101637
53524,,yxnwaajoc6ej,50819,50820,101639
53525,,rggskkkarqsj,50820,50821,101641
53526,,q-mwjrsgnuwj,50821,50822,101643
53527,,ck3xmp93hqej,50822,50823,101645
53528,,cg6jihlylkcj,50823,50824,101647
53529,,cksaag-ayywj,50824,50825,101649
53530,,gayinim__eaj,50826,50827,101653
53531,,epp9ovrkqsmj,50827,50828,101655
53532,,8pfnkpccyv0j,50828,50829,101657
53533,,0yez3nukzzaj,50829,50830,101659
53534,,t7wvpldgzpoj,50830,50831,101661
53535,,8z_mbdwmhiij,50831,50832,101663
53536,,eev36yuo4wuj,50833,50834,101667
53537,,qqy9elvfctej,50834,50835,101669
53538,,xr-xquumqp4j,50835,50836,101671
53539,,hyknf7uneauj,50836,50837,101673
53540,,9onmyioa6qkj,50837,50838,101675
53541,,tu3ksdznwnaj,50838,50839,101677
53542,,sq4lnop-qooj,50839,50840,101679
53543,,s2sux3auztwj,50840,50841,101681
53544,,j16cnm-kzewj,50841,50842,101683
53545,,cseknvckb3sj,50842,50843,101685
53546,,sul6tf0eom4j,50843,50844,101687
53547,,s_ejmvyii6wj,50844,50845,101689
53548,,tx8hqj2xsvwj,50846,50847,101693
53549,,ygse9deuzsaj,50847,50848,101695
53550,,j6o_spptz2qj,50848,50849,101697
53551,,uiozi4dulk4j,50849,50850,101699
53552,,rf3dx64jcfqj,50850,50851,101701
53553,,pourdoej3uej,50851,50852,101703
53554,,kn6964n3erej,50852,50853,101705
53555,,laocbgfxhyuj,50853,50854,101707
53556,,c1vsm-kah_gj,50854,50855,101709
53557,,juoxb3gphiqj,50855,50856,101711
53558,,uagq4mxkydcj,50856,50857,101713
53559,,u2-jx37urmaj,50857,50858,101715
53560,,ywhv_k-s3hej,50858,50859,101717
53561,,s1cdmqll7mij,50859,50860,101719
53562,,6ltt9fflshmj,50860,50861,101721
53563,,ivj8moetq10j,50861,50862,101723
53564,,qxzus34xm-ej,50862,50863,101725
53565,,uzgumpi2axuj,50863,50864,101727
53566,,h0zckj-npe8j,50864,50865,101729
53567,,gzvrn47djmmj,50865,50866,101731
53568,,kyuxzfpxzwij,50866,50867,101733
53569,,sztgtgynezyj,50867,50868,101735
53570,,b0v85x3oh0yj,50868,50869,101737
53571,,482d3gf-lkwj,50869,50870,101739
53572,,hh0ean9vxnkj,50871,50872,101743
53573,,gqnweqyi3bej,50872,50873,101745
53574,,url:http://www.csa.com/partners/viewrecord.php3frequester3dgs26collection3dtrd26recid3d20021214039901mt26recid3da7423807ah,50873,50874,101747
53575,,e0wrgo_pefqj,50874,50875,101749
53576,,cuymfggdjigj,50875,50876,101751
53577,,9eegjgpiyqqj,50876,50877,101753
53578,,6osfwqmx0xij,50877,50878,101755
53579,,xl_tg38dujqj,50878,50879,101757
53580,,gluf8krufg0j,50879,50880,101759
53581,,,50880,50881,101761
53582,,xrrymyd9bjij,50881,50882,101763
53583,,nvs_rdpscp0j,50883,50884,101767
53584,,42chufxjwgqj,50885,50886,101771
53585,,zrvmw2tklgcj,50886,50887,101773
53586,,khmp2li_ooyj,50887,50888,101775
53587,,zjjgn2ftmi8j,50888,50889,101777
53588,,qslkarqovjwj,50889,50890,101779
53589,,s6uw6k462umj,50890,50891,101781
53590,,i_-3aaao7nkj,50891,50892,101783
53591,,r9tpzp8c0xsj,50892,50893,101785
53592,,31lyrjgihakj,50893,50894,101787
53593,,jjob6_ygjsqj,50894,50895,101789
53594,,lqfend7gt-uj,50896,50897,101793
53595,,msf_3sqxsacj,50897,50898,101795
53596,,tytqw5nermyj,50898,50899,101797
53597,,z0nmekbow3mj,50899,50900,101799
53598,,hls7om-rqmuj,50900,50901,101801
53599,,yxxvwk2rnpaj,50901,50902,101803
53600,,tewgcloijkmj,50902,50903,101805
53601,,,50904,50905,101809
53602,,yby_ezkjmxsj,50905,50906,101811
53603,,jutyqmuucf0j,50906,50907,101813
53604,,twnkizv7ofwj,50907,50908,101815
53605,,1pt2e-xwjgaj,50908,50909,101817
53606,,40x2gb4ymwaj,50909,50910,101819
53607,,t_hle-mxf74j,50910,50911,101821
53608,,1vwoxpii9huj,50911,50912,101823
53609,,g2tzj5s8o9yj,50912,50913,101825
53610,,t9mhgoged8aj,50913,50914,101827
53611,,iw-mpmuqnosj,50914,50915,101829
53612,,mrfe473yazaj,50915,50916,101831
53613,,suvixhgjt1qj,50916,50917,101833
53614,,qvbh7cfmjiaj,50917,50918,101835
53615,,oo2mr5fbmggj,50918,50919,101837
53616,,agbzohfmqusj,50919,50920,101839
53617,,mleezdqx8cuj,50920,50921,101841
53618,,v3hwnjlepbgj,50921,50922,101843
53619,,h0zzlm77gecj,50922,50923,101845
53620,,qoviyore_fwj,50923,50924,101847
53621,,aiyxfr75abej,50924,50925,101849
53622,,zhwef_i63pgj,50925,50926,101851
53623,,dfsa1or_b-ej,50926,50927,101853
53624,,eyp6zb2j2uwj,50927,50928,101855
53625,,nu7ykw_ngiuj,50928,50929,101857
53626,,url:http://portal.acm.org/ft_gateway.cfm3fid3d35309026type3dpdf26dl3dguide26dl3dacm26cfid3d1111111126cftoken3d2222222,50929,50930,101859
53627,,rnwqtt8ib5cj,50930,50931,101861
53628,,t4zyjvy9gdcj,50931,50932,101863
53629,,o4vqgnugmfsj,50932,50933,101865
53630,,pjezwxfskl0j,50933,50934,101867
53631,,nv6vqtwa3zoj,50934,50935,101869
53632,,8yjkmdvqi2qj,50935,50936,101871
53633,,wky-vgnproaj,50936,50937,101873
53634,,nvk_no-cmq4j,50937,50938,101875
53635,,1_z_svr939ij,50938,50939,101877
53636,,lu7zjt6p1ycj,50939,50940,101879
53637,,k8oklujfwiej,50940,50941,101881
53638,,url:http://www.csa.com/partners/viewrecord.php3frequester3dgs26collection3dtrd26recid3dn9523962ah,50941,50942,101883
53639,,su70p5wjay0j,50942,50943,101885
53640,,1vodmz0u3jsj,50943,50944,101887
53641,,eho_ozozmj0j,50944,50945,101889
53642,,byh0f5vjeluj,50945,50946,101891
53643,,kzg37m76v5sj,50946,50947,101893
53644,,qtqpr30v18oj,50947,50948,101895
53645,,whwou1ebcc8j,50948,50949,101897
53646,,8p0ad6weqcej,50949,50950,101899
53647,,9trmrhwuwr4j,50950,50951,101901
53648,,v91s49copdoj,50951,50952,101903
53649,,kbktkmn1qsaj,50952,50953,101905
53650,,hvptga1boy4j,50953,50954,101907
53651,,,50954,50955,101909
53652,,esfxdpfc55oj,50956,50957,101913
53653,,uu6dtaddmkaj,50957,50958,101915
53654,,k7qsu-h_llmj,50959,50960,101919
53655,,hpsurgyac_gj,50960,50961,101921
53656,,p0icrini61cj,50961,50962,101923
53657,,pou7len8sgmj,50962,50963,101925
53658,,nzeibr3pebaj,50963,50964,101927
53659,,rbhg9cl-kzoj,50964,50965,101929
53660,,mzdy8ci7gouj,50965,50966,101931
53661,,28ucm2ixhc8j,50966,50967,101933
53662,,url:http://doi.wiley.com/10.1002/ace.159,50967,50968,101935
53663,,ac-8qspy24wj,50968,50969,101937
53664,,qkyxmep2bwsj,50970,50971,101941
53665,,rotkpafeupsj,50971,50972,101943
53666,,bcp8b1wutoej,50972,50973,101945
53667,,jlaev2gh64qj,50973,50974,101947
53668,,ev0mvpk_d0uj,50975,50976,101951
53669,,url:http://doi.wiley.com/10.1002/he.116,50976,50977,101953
53670,,10svnlnss5ij,50977,50978,101955
53671,,bicvtsqdpqgj,50978,50979,101957
53672,,p17sr6lpnecj,50979,50980,101959
53673,,jmb_awvfml8j,50980,50981,101961
53674,,url:http://www.springerlink.com/index/w066864336226062.pdf,50981,50982,101963
53675,,fasmyfhiohmj,50982,50983,101965
53676,,bctysar3axuj,50983,50984,101967
53677,,nqnnw8hxqcwj,50984,50985,101969
53678,,juzl3svdr18j,50985,50986,101971
53679,,url:http://portal.acm.org/ft_gateway.cfm3fid3d102769326type3dpdf,50986,50987,101973
53680,,xabpu2wsrwoj,50987,50988,101975
53681,,uxvf-eixbyyj,50988,50989,101977
53682,,nuczalxp_n0j,50989,50990,101979
53683,,ntbfkkjr8mij,50990,50991,101981
53684,,eqync3op9c0j,50991,50992,101983
53685,,5bqf9hzkqwqj,50992,50993,101985
53686,,wdmdwyit7lqj,50993,50994,101987
53687,,ydaxqrjsmasj,50994,50995,101989
53688,,vt0ojbgvfosj,50995,50996,101991
53689,,bpbh1-vyqaij,50996,50997,101993
53690,,ewavfeupfkcj,50997,50998,101995
53691,,doh4suoqj_0j,50998,50999,101997
53692,,nzwltztbq4ej,50999,51000,101999
53693,,ttll3stlnjmj,51000,51001,102001
53694,,hadarm8mp0cj,51001,51002,102003
53695,,k7cad3adpaaj,51002,51003,102005
53696,,5ltpjootbnij,51003,51004,102007
53697,,ip-ixv8qiwgj,51004,51005,102009
53698,,yjoecapecmaj,51005,51006,102011
53699,,5v4nxyu0dgyj,51006,51007,102013
53700,,nxeeijlfavaj,51007,51008,102015
53701,,irdbub1dxqkj,51008,51009,102017
53702,,vzgdb1hfyr4j,51009,51010,102019
53703,,apozza1a_vuj,51010,51011,102021
53704,,7j8akux4qv4j,51011,51012,102023
53705,,hhmtk6mgsfgj,51012,51013,102025
53706,,ucngu86uncqj,51013,51014,102027
53707,,ccb7nb8jqqgj,51014,51015,102029
53708,,tyu_7ga-dtuj,51015,51016,102031
53709,,6fpcawvccy4j,51016,51017,102033
53710,,iq4vqdnlewsj,51017,51018,102035
53711,,hlm33akfcwgj,51018,51019,102037
53712,,dv_ktszjrlqj,51019,51020,102039
53713,,7ls7xrbafwqj,51020,51021,102041
53714,,5_sx_6-oak4j,51021,51022,102043
53715,,xi5ythyhqz0j,51022,51023,102045
53716,,gwpc573207yj,51023,51024,102047
53717,,ni-bcqgewvsj,51025,51026,102051
53718,,xlfpxdwqpdkj,51026,51027,102053
53719,,59npju7swoaj,51027,51028,102055
53720,,mph2nrhrgayj,51028,51029,102057
53721,,kog9kzy2ohij,51029,51030,102059
53722,,p2ripdbxkngj,51030,51031,102061
53723,,zngra4qoajej,51031,51032,102063
53724,,r2seekjkfhoj,51032,51033,102065
53725,,ztmvovo6nrmj,51033,51034,102067
53726,,qlmr0dccl58j,51035,51036,102071
53727,,bfwr5wdld28j,51036,51037,102073
53728,,zfx1q5_fogkj,51037,51038,102075
53729,,_97ihvhdq-yj,51038,51039,102077
53730,,ao6grnlzt2wj,51039,51040,102079
53731,,eyqcdiokmacj,51040,51041,102081
53732,,url:http://portal.acm.org/citation.cfm3fid3d319587.319612,51041,51042,102083
53733,,q8f7qf6jybkj,51043,51044,102087
53734,,9wshhoru77ij,51044,51045,102089
53735,,ye7v7o4wnvqj,51045,51046,102091
53736,,ksglkkxr0owj,51046,51047,102093
53737,,omrinzmgbzij,51047,51048,102095
53738,,ifs6wgrxbaoj,51048,51049,102097
53739,,xtjoedq6lm0j,51049,51050,102099
53740,,r9amtfvrdk0j,51050,51051,102101
53741,,uxpapqduujaj,51051,51052,102103
53742,,huf7vpth36sj,51052,51053,102105
53743,,rnhnbmvgwyyj,51053,51054,102107
53744,,wglazjaezgmj,51054,51055,102109
53745,,8h7ejh2jw3uj,51055,51056,102111
53746,,mok-x_xbolqj,51056,51057,102113
53747,,zwmlvqkz9vwj,51057,51058,102115
53748,,fbo5hvbo-xwj,51058,51059,102117
53749,,kt8ptnt9q_yj,51059,51060,102119
53750,,nlp2zgtaly8j,51060,51061,102121
53751,,vydcmxumxl8j,51061,51062,102123
53752,,a3vpc2rphwyj,51062,51063,102125
53753,,3gllfytlq6uj,51063,51064,102127
53754,,swt8d25mweej,51064,51065,102129
53755,,_4r21mflaroj,51065,51066,102131
53756,,qlh6x0e6vr0j,51066,51067,102133
53757,,yixz-4ga6vyj,51067,51068,102135
53758,,wdhlimg3besj,51068,51069,102137
53759,,xh1xikpoctij,51069,51070,102139
53760,,18h1fj3qooyj,51070,51071,102141
53761,,8aourkrgeg4j,51071,51072,102143
53762,,g3tadjrcjnaj,51072,51073,102145
53763,,url:http://ieeexplore.ieee.org/xpl/abs_free.jsp3farnumber3d914832,51073,51074,102147
53764,,,51074,51075,102149
53765,,c7e9uxzwnn4j,51075,51076,102151
53766,,1tdld-h50xwj,51076,51077,102153
53767,,gwiqcoxtxd8j,51077,51078,102155
53768,,jx9lokzq_owj,51078,51079,102157
53769,,rhn5x_94iqaj,51079,51080,102159
53770,,ydtb5vszxdcj,51080,51081,102161
53771,,o-m4pvpylpmj,51081,51082,102163
53772,,rukwklfnlhmj,51082,51083,102165
53773,,8mcgjlnf_0uj,51083,51084,102167
53774,,vnhl4ruznc0j,51084,51085,102169
53775,,f-2gpyj4hl0j,51085,51086,102171
53776,,eku4joedgywj,51087,51088,102175
53777,,axir79j1gh0j,51088,51089,102177
53778,,9x7s7ikuth4j,51089,51090,102179
53779,,08mj_ezctuej,51090,51091,102181
53780,,fnmspfnqvnkj,51091,51092,102183
53781,,yldp-3dpucwj,51092,51093,102185
53782,,zyi93q1a2u4j,51093,51094,102187
53783,,oeytuogmtaqj,51094,51095,102189
53784,,0tnj5d1tfkej,51095,51096,102191
53785,,7buzguchnm0j,51096,51097,102193
53786,,qh2eqypsrlgj,51097,51098,102195
53787,,tdgqhn1oqbsj,51098,51099,102197
53788,,j9jnnnuers8j,51099,51100,102199
53789,,jmzmhajjzcyj,51100,51101,102201
53790,,url:http://portal.acm.org/citation.cfm3fid3d957013.957136,51101,51102,102203
53791,,rvn0qgtqmbmj,51102,51103,102205
53792,,yqs2gjehggyj,51103,51104,102207
53793,,jlv0frb2shgj,51104,51105,102209
53794,,pluimxts4psj,51105,51106,102211
53795,,rnvokpb4ovcj,51106,51107,102213
53796,,qgpev98jhmkj,51107,51108,102215
53797,,url:http://portal.acm.org/ft_gateway.cfm3fid3d109955726type3dpdf,51108,51109,102217
53798,,7ghycabftwcj,51109,51110,102219
53799,,nqh8qsy7lnej,51110,51111,102221
53800,,lzji09pnoosj,51111,51112,102223
53801,,e24lyrdxcdyj,51112,51113,102225
53802,,a_2aip05w_kj,51113,51114,102227
53803,,qikrqifb9y8j,51114,51115,102229
53804,,wytmy6v_glyj,51115,51116,102231
53805,,gd0tufjjt6cj,51116,51117,102233
53806,,acb2gbqs6c4j,51117,51118,102235
53807,,0-lirt34fywj,51118,51119,102237
53808,,url:http://portal.acm.org/citation.cfm3fid3d171926.172018,51119,51120,102239
53809,,6awrtb_3rrsj,51120,51121,102241
53810,,r3hmzlkg_hmj,51121,51122,102243
53811,,f7_u5v3qqzmj,51122,51123,102245
53812,,eudbcqtpypkj,51123,51124,102247
53813,,oaifzdhmzj4j,51124,51125,102249
53814,,gc9e7htdt7uj,51125,51126,102251
53815,,emofjntrm2qj,51126,51127,102253
53816,,baquanlmpm8j,51127,51128,102255
53817,,isb6oz7l4vqj,51128,51129,102257
53818,,obkfnooutkaj,51129,51130,102259
53819,,klnjcd1otuuj,51130,51131,102261
53820,,angmvxo5_v0j,51131,51132,102263
53821,,o2vnhxcsofyj,51132,51133,102265
53822,,ezb1rvxlwnkj,51133,51134,102267
53823,,ribhvc53uoyj,51134,51135,102269
53824,,au7xltpoxrgj,51135,51136,102271
53825,,bgbf0x-tvbij,51136,51137,102273
53826,,qlunha74g-yj,51137,51138,102275
53827,,y4zzx5aj3muj,51138,51139,102277
53828,,r29xsfsjzdij,51139,51140,102279
53829,,nmqeshipe-yj,51140,51141,102281
53830,,fs_n5yacq0sj,51141,51142,102283
53831,,hehhzcb18toj,51142,51143,102285
53832,,5xx69x1kg5mj,51143,51144,102287
53833,,m5cm6ltcgiqj,51144,51145,102289
53834,,lqpuacwel-wj,51145,51146,102291
53835,,3n2bdg4v6oij,51146,51147,102293
53836,,ywoniu2rzigj,51147,51148,102295
53837,,8nctxlsy66aj,51148,51149,102297
53838,,url:http://portal.acm.org/citation.cfm3fid3d1101149.1101376,51149,51150,102299
53839,,pkhk5b2m9uqj,51150,51151,102301
53840,,bkecg5ln-lij,51151,51152,102303
53841,,vtt0ocv6omcj,51152,51153,102305
53842,,url:http://www.csa.com/partners/viewrecord.php3frequester3dgs26collection3dtrd26recid3d0739440ci26recid3d0739440ea,51153,51154,102307
53843,,j4izqfs00_aj,51154,51155,102309
53844,,vdqb4ulma28j,51155,51156,102311
53845,,zihslitxywkj,51156,51157,102313
53846,,url:http://doi.wiley.com/10.1002/ev.1257,51157,51158,102315
53847,,kgupj2hqbkyj,51158,51159,102317
53848,,kvohus_avqyj,51159,51160,102319
53849,,n7qtff7obecj,51160,51161,102321
53850,,gg_iscbcrzuj,51161,51162,102323
53851,,6qyuibvikpqj,51162,51163,102325
53852,,gqkrnsh5mggj,51163,51164,102327
53853,,fd0uyxqktrgj,51164,51165,102329
53854,,w5kckrhky_yj,51165,51166,102331
53855,,wgoxk1ganwaj,51166,51167,102333
53856,,4chsugjroskj,51167,51168,102335
53857,,url:http://doi.wiley.com/10.1002/ace.154,51168,51169,102337
53858,,2upmdqx__tyj,51169,51170,102339
53859,,cdads3eo11wj,51170,51171,102341
53860,,ed2ifrzfg-8j,51171,51172,102343
53861,,xzidahbzpaaj,51172,51173,102345
53862,,7taf29bpo9kj,51173,51174,102347
53863,,-3p_4nxdixgj,51174,51175,102349
53864,,k3qk9cnljq4j,51175,51176,102351
53865,,sby_d_cz0puj,51176,51177,102353
53866,,url:http://portal.acm.org/citation.cfm3fid3d35454626coll3dportal26dl3dacm,51177,51178,102355
53867,,x6r-sdx0wnyj,51178,51179,102357
53868,,il9phtvstlij,51179,51180,102359
53869,,asuxopkhv9uj,51180,51181,102361
53870,,rvc45yk8beij,51181,51182,102363
53871,,kuivemin9k0j,51182,51183,102365
53872,,sllumgyq2x0j,51183,51184,102367
53873,,0bcbpvs-6qsj,51184,51185,102369
53874,,7skpiosic5ij,51185,51186,102371
53875,,oqaeluuzdgej,51186,51187,102373
53876,,hgruf-easnij,51187,51188,102375
53877,,73qgb4deq4wj,51188,51189,102377
53878,,gate5mnq190j,51189,51190,102379
53879,,fa4xot1wwxmj,51190,51191,102381
53880,,bcjqv36t-coj,51191,51192,102383
53881,,url:http://doi.wiley.com/10.1002/tl.103,51192,51193,102385
53882,,6mpygc30qcoj,51193,51194,102387
53883,,nfm9sy_scfaj,51194,51195,102389
53884,,m7z388v8d2qj,51195,51196,102391
53885,,jnkqs08eq5wj,51196,51197,102393
53886,,9dyg3jhviiyj,51197,51198,102395
53887,,7egps8ojyf8j,51198,51199,102397
53888,,izdrreac690j,51199,51200,102399
53889,,rqaz5lwhyoij,51200,51201,102401
53890,,vfh0eiz8zaqj,51201,51202,102403
53891,,mbttnql-vroj,51202,51203,102405
53892,,ilcz2zbpynsj,51203,51204,102407
53893,,whq9kbws4eoj,51204,51205,102409
53894,,daeleayxs6cj,51205,51206,102411
53895,,4eqrwt-y0vwj,51206,51207,102413
53896,,so21ba_xeiij,51207,51208,102415
53897,,v8csbo5eeg0j,51208,51209,102417
53898,,bonwd2u_lqkj,51209,51210,102419
53899,,ivx_-tfz1gsj,51210,51211,102421
53900,,h5qvpoaxopaj,51211,51212,102423
53901,,4szbxucftbaj,51212,51213,102425
53902,,r_upgjict94j,51213,51214,102427
53903,,oj-z1gtxscsj,51214,51215,102429
53904,,url:http://www.csa.com/partners/viewrecord.php3frequester3dgs26collection3dtrd26recid3d200111010691mt26recid3da0032610ah,51215,51216,102431
53905,,ge-j-wtiibwj,51216,51217,102433
53906,,jk2ztjqr5lwj,51217,51218,102435
53907,,p9kag1be0uej,51218,51219,102437
53908,,uwwyw4cbj5yj,51219,51220,102439
53909,,96iiwri0hp4j,51220,51221,102441
53910,,he2payjqyjoj,51221,51222,102443
53911,,zoubunqeoqqj,51222,51223,102445
53912,,qjuow9pvigij,51223,51224,102447
53913,,uwtthtt2xfij,51224,51225,102449
53914,,ousviwuchdgj,51225,51226,102451
53915,,jru1gnfh1syj,51226,51227,102453
53916,,tuq51aslni0j,51227,51228,102455
53917,,fgbbpdxqaw0j,51228,51229,102457
53918,,ysu1bjcsnl4j,51229,51230,102459
53919,,9xtjnpijamwj,51230,51231,102461
53920,,caewpdrgxz8j,51231,51232,102463
53921,,fdvqyts0eiwj,51232,51233,102465
53922,,llrjnhajmy0j,51233,51234,102467
53923,,snndxqqqjokj,51234,51235,102469
53924,,u2bdkpjm82yj,51235,51236,102471
53925,,zo191jei13sj,51236,51237,102473
53926,,ztbiopwbplgj,51237,51238,102475
53927,,qksxh129hecj,51238,51239,102477
53928,,url:http://portal.acm.org/citation.cfm3fid3d234286.1057817,51239,51240,102479
53929,,uecvrix4tboj,51240,51241,102481
53930,,url:http://adsabs.harvard.edu/abs/1985qb523.k37......,51241,51242,102483
53931,,qqehor91ehgj,51242,51243,102485
53932,,50bcju3uiuoj,51243,51244,102487
53933,,ys3icxrowyuj,51244,51245,102489
53934,,eii-bfrpjcaj,51245,51246,102491
53935,,c8zzr4fiq2aj,51246,51247,102493
53936,,3n2zarwdbfsj,51247,51248,102495
53937,,qzxes4rqahwj,51248,51249,102497
53938,,c7h-fkgivqgj,51249,51250,102499
53939,,fz-znjooobkj,51250,51251,102501
53940,,wrdeaysiefcj,51251,51252,102503
53941,,tqahkgftyc0j,51252,51253,102505
53942,,x_xgbtdnxfej,51253,51254,102507
53943,,uksz6qxt3ekj,51254,51255,102509
53944,,xwvkf69-gyaj,51255,51256,102511
53945,,spf7ur4uobmj,51256,51257,102513
53946,,i6zwjxwunw0j,51257,51258,102515
53947,,zdiah4hwmtoj,51258,51259,102517
53948,,zvowc7cm4rgj,51259,51260,102519
53949,,ssn-aunwztij,51260,51261,102521
53950,,url:http://portal.acm.org/ft_gateway.cfm3fid3d109973426type3dpdf,51261,51262,102523
53951,,qcfzvymx94sj,51262,51263,102525
53952,,lp4xret2t2aj,51263,51264,102527
53953,,zdh7tk30n3yj,51264,51265,102529
53954,,9uojlyd5_gij,51265,51266,102531
53955,,c3egjjwhwyij,51266,51267,102533
53956,,jtmjaipfycej,51267,51268,102535
53957,,yzeyai8rmswj,51268,51269,102537
53958,,zvrpivhywj4j,51269,51270,102539
53959,,m1eccpppue8j,51270,51271,102541
53960,,oakifhyluk0j,51271,51272,102543
53961,,pvxkqtnh688j,51272,51273,102545
53962,,yr6oesfa-vmj,51273,51274,102547
53963,,2jgrsqeteiyj,51274,51275,102549
53964,,h6d2a4fieewj,51275,51276,102551
53965,,ermlarsbrt4j,51276,51277,102553
53966,,nnd4nlgkxnyj,51277,51278,102555
53967,,wf64lsn7nj4j,51278,51279,102557
53968,,dmovpk_tgyij,51279,51280,102559
53969,,hspwpv8nolyj,51280,51281,102561
53970,,ipvcq-cr-iyj,51281,51282,102563
53971,,azqj6a5vcu8j,51282,51283,102565
53972,,a_xlamrkuvuj,51283,51284,102567
53973,,n05hviaz8nwj,51284,51285,102569
53974,,isblxdymst8j,51285,51286,102571
53975,,pfpkefzfegsj,51286,51287,102573
53976,,hvkm9ryv-c4j,51287,51288,102575
53977,,8sqlaquhrrcj,51288,51289,102577
53978,,by1fcuvxgk8j,51289,51290,102579
53979,,it1gxgz3e18j,51290,51291,102581
53980,,12-entvswhmj,51291,51292,102583
53981,,mbqespqvqs4j,51292,51293,102585
53982,,zrquwdnos0oj,51293,51294,102587
53983,,iwxhzbiaizaj,51295,51296,102591
53984,,3jjkq2fb6kwj,51296,51297,102593
53985,,0l-12hb6_lkj,51297,51298,102595
53986,,cj3kznryl1ij,51298,51299,102597
53987,,url:http://doi.wiley.com/10.1002/ace.176,51299,51300,102599
53988,,l-t1pqep-_oj,51300,51301,102601
53989,,1bwvloyre7ij,51301,51302,102603
53990,,url:http://www.csa.com/partners/viewrecord.php3frequester3dgs26collection3dtrd26recid3dn9210468ah,51302,51303,102605
53991,,f9kzvndpcpuj,51303,51304,102607
53992,,5nlcd-t8p_oj,51305,51306,102611
53993,,ih9mfir3lxaj,51306,51307,102613
53994,,xfq0kgahv7sj,51307,51308,102615
53995,,5fjqzw9znqsj,51308,51309,102617
53996,,7oofwvnf-zaj,51309,51310,102619
53997,,x-xcm921utmj,51310,51311,102621
53998,,c3uhnp2dggcj,51311,51312,102623
53999,,dsicx1nqwusj,51312,51313,102625
54000,,taonifmfa7mj,51313,51314,102627
54001,,8awlsndzvjyj,51314,51315,102629
54002,,k-yswa33nvoj,51315,51316,102631
54003,,cucoksr65_mj,51316,51317,102633
54004,,0s68uzwlqogj,51317,51318,102635
54005,,l8qrgzooncij,51318,51319,102637
54006,,7xcbf-5ldvyj,51319,51320,102639
54007,,url:http://www.springerlink.com/index/w71536240k77n2v5.pdf,51320,51321,102641
54008,,falwyrysn7yj,51321,51322,102643
54009,,xvdvckyagcuj,51322,51323,102645
54010,,arqidz2cl0qj,51323,51324,102647
54011,,wc4ayrzikawj,51324,51325,102649
54012,,xwgxeu5vop0j,51325,51326,102651
54013,,xbjdvqzeua8j,51326,51327,102653
54014,,rzcfurkiwpaj,51327,51328,102655
54015,,9saguai9tc4j,51328,51329,102657
54016,,fvynzzuhyugj,51329,51330,102659
54017,,upontfltr3sj,51330,51331,102661
54018,,9lw0lgurwfuj,51331,51332,102663
54019,,i156zwnoupyj,51332,51333,102665
54020,,1gwseqsvjmoj,51334,51335,102669
54021,,url:http://portal.acm.org/citation.cfm3fid3d354542,51335,51336,102671
54022,,lcj_huwmykaj,51336,51337,102673
54023,,a08izm12vyuj,51337,51338,102675
54024,,gli8i7fbpmij,51338,51339,102677
54025,,xmtankne2euj,51339,51340,102679
54026,,z-4dgyw-tsyj,51340,51341,102681
54027,,mhiabbafuw4j,51341,51342,102683
54028,,_0q_dvixr7cj,51342,51343,102685
54029,,1vbw1tryvjaj,51343,51344,102687
54030,,x4zngzj42e4j,51344,51345,102689
54031,,v6aiceaacsuj,51345,51346,102691
54032,,roexh6bpl94j,51346,51347,102693
54033,,rhh7boxg52ij,51347,51348,102695
54034,,7ackl3x5omgj,51348,51349,102697
54035,,sprgwglynbcj,51349,51350,102699
54036,,a8zfj6qnreyj,51350,51351,102701
54037,,dq7nmza86n8j,51351,51352,102703
54038,,fzmlbavyhhuj,51352,51353,102705
54039,,rcb3golt96cj,51353,51354,102707
54040,,lya3sz6yqt0j,51354,51355,102709
54041,,4ixyz5xgv5wj,51355,51356,102711
54042,,mjpin7pt2faj,51356,51357,102713
54043,,npvufdu6deij,51357,51358,102715
54044,,e5sj3zgdwgej,51358,51359,102717
54045,,8l-mjup_vikj,51359,51360,102719
54046,,jp0fclzzjgej,51360,51361,102721
54047,,ryxayh3kcicj,51361,51362,102723
54048,,tlngd4qz0ugj,51362,51363,102725
54049,,rmxllad6fbej,51363,51364,102727
54050,,p8jgvmgu0f4j,51364,51365,102729
54051,,iyqqnh7gpgwj,51365,51366,102731
54052,,0-luhlclykaj,51366,51367,102733
54053,,j12zi0gk2fuj,51367,51368,102735
54054,,g1urgrpmnk0j,51368,51369,102737
54055,,3om51kessc8j,51369,51370,102739
54056,,p4_ssdcp3u8j,51370,51371,102741
54057,,url:http://ieeexplore.ieee.org/xpl/abs_free.jsp3farnumber3d1324635,51371,51372,102743
54058,,oskuqclhupqj,51372,51373,102745
54059,,tbbmp7xkumsj,51373,51374,102747
54060,,bvzp01lvvkej,51374,51375,102749
54061,,url:http://www.csa.com/partners/viewrecord.php3frequester3dgs26collection3dtrd26recid3d200163028700ce,51375,51376,102751
54062,,ak43qqowecoj,51376,51377,102753
54063,,isqmbkvmir8j,51377,51378,102755
54064,,1pl4s7ag_5wj,51378,51379,102757
54065,,wkeh_tmwqsmj,51379,51380,102759
54066,,5y3ifv7nhmej,51380,51381,102761
54067,,2wieroqvpcoj,51381,51382,102763
54068,,dcsik6agp4gj,51382,51383,102765
54069,,sqt4jh1ez7cj,51383,51384,102767
54070,,k4jb7jnkz0sj,51384,51385,102769
54071,,yllzrju3_s8j,51385,51386,102771
54072,,,51386,51387,102773
54073,,e1d-eqfeapoj,51387,51388,102775
54074,,jtx18sgcx-uj,51388,51389,102777
54075,,ypcjqxvsd-yj,51389,51390,102779
54076,,4pxxkoidnw0j,51390,51391,102781
54077,,w5tlfdyhdm8j,51391,51392,102783
54078,,ftgo7epjzpmj,51392,51393,102785
54079,,jbridrhyhwkj,51393,51394,102787
54080,,afyt1fs31buj,51394,51395,102789
54081,,j68nhtl7ofgj,51395,51396,102791
54082,,glpvk2iwp6aj,51396,51397,102793
54083,,785fjqmo-nkj,51397,51398,102795
54084,,lf_8o5luca8j,51398,51399,102797
54085,,rd_2iia1an8j,51399,51400,102799
54086,,mbqoyphe0v0j,51400,51401,102801
54087,,qp9yuguricij,51401,51402,102803
54088,,ou86tlnnnbgj,51402,51403,102805
54089,,tphn3moywi0j,51403,51404,102807
54090,,2irzldulsqsj,51404,51405,102809
54091,,zso5cenzsdyj,51405,51406,102811
54092,,fbkai2jl8l0j,51406,51407,102813
54093,,,51407,51408,102815
54094,,3_dxfm7na1kj,51408,51409,102817
54095,,e3u1mir4ipmj,51409,51410,102819
54096,,qc5wgdyrudoj,51410,51411,102821
54097,,mo2wyss5k2aj,51411,51412,102823
54098,,l4bjgjfjjqoj,51412,51413,102825
54099,,uphrodedjlej,51413,51414,102827
54100,,t2x_rgmyghaj,51414,51415,102829
54101,,goguwgh6d_uj,51415,51416,102831
54102,,t-ewahmbsigj,51416,51417,102833
54103,,_tshdet1ga8j,51417,51418,102835
54104,,sjjzlszjgdwj,51418,51419,102837
54105,,atrpvrbokvsj,51419,51420,102839
54106,,tlujnkhjmayj,51420,51421,102841
54107,,uwvwb-qdyjuj,51421,51422,102843
54108,,pslucvez250j,51422,51423,102845
54109,,pcmq0rt8i6mj,51423,51424,102847
54110,,ztpgvbclbugj,51424,51425,102849
54111,,9jkvcy7xed4j,51425,51426,102851
54112,,url:http://www.csa.com/partners/viewrecord.php3frequester3dgs26collection3dtrd26recid3dn9210368ah,51426,51427,102853
54113,,a_i4oxojme0j,51427,51428,102855
54114,,pmfkl44lkloj,51428,51429,102857
54115,,pq2hjrlxj-cj,51430,51431,102861
54116,,qpps_csmiuej,51431,51432,102863
54117,,url:http://www.csa.com/partners/viewrecord.php3frequester3dgs26collection3dtrd26recid3d20021212014825mt26recid3da8012647ah,51432,51433,102865
54118,,aonu8hsplhuj,51433,51434,102867
54119,,url:http://www.csa.com/partners/viewrecord.php3frequester3dgs26collection3dtrd26recid3dn9210511ah,51434,51435,102869
54120,,ysliyjd9msij,51435,51436,102871
54121,,485nykqss4sj,51436,51437,102873
54122,,og9zyuwyflgj,51437,51438,102875
54123,,g2himfgp4fmj,51438,51439,102877
54124,,uxevdkibzdqj,51439,51440,102879
54125,,9sfmsuk7oz8j,51440,51441,102881
54126,,url:http://www.csa.com/partners/viewrecord.php3frequester3dgs26collection3dtrd26recid3dn9210583ah,51441,51442,102883
54127,,lzlzdpm-y5gj,51442,51443,102885
54128,,guckyvuawtkj,51443,51444,102887
54129,,fkiaif6_yvij,51445,51446,102891
54130,,nzbhvmvekvuj,51446,51447,102893
54131,,s8i8q_pc4hmj,51447,51448,102895
54132,,qkzogfug40qj,51448,51449,102897
54133,,hs8rolhd4k4j,51449,51450,102899
54134,,y80-pcnnpjkj,51450,51451,102901
54135,,ap57vjmsvx4j,51451,51452,102903
54136,,89c3q7er-nqj,51452,51453,102905
54137,,0xywbfbtaimj,51453,51454,102907
54138,,2fagd-mswtmj,51454,51455,102909
54139,,8oyqjknuu14j,51455,51456,102911
54140,,9lund6toccqj,51456,51457,102913
54141,,4gpd01ceifej,51457,51458,102915
54142,,xd507tsfrnej,51458,51459,102917
54143,,l02dita6uqoj,51459,51460,102919
54144,,fzcpnlcphy4j,51460,51461,102921
54145,,hhms0t_cqycj,51461,51462,102923
54146,,url:http://www.csa.com/partners/viewrecord.php3frequester3dgs26collection3denv26recid3d2590289,51462,51463,102925
54147,,qu0qtglv9cuj,51463,51464,102927
54148,,dcid_zos8o4j,51464,51465,102929
54149,,chpvrw1hujij,51465,51466,102931
54150,,wz9zue65pgej,51466,51467,102933
54151,,wu8urfu8tu8j,51467,51468,102935
54152,,coo8qrlesncj,51468,51469,102937
54153,,5ee02nqlhbcj,51469,51470,102939
54154,,url:http://ieeexplore.ieee.org/iel2/3038/8631/00379938.pdf3farnumber3d379938,51470,51471,102941
54155,,akmut5fke8qj,51471,51472,102943
54156,,3ael408envwj,51472,51473,102945
54157,,gfgxgzstk08j,51473,51474,102947
54158,,se3rpfnxleaj,51474,51475,102949
54159,,,51475,51476,102951
54160,,c8iujpbud70j,51476,51477,102953
54161,,url:http://portal.acm.org/ft_gateway.cfm3fid3d106629826type3dpdf,51477,51478,102955
54162,,ocxyglt01iqj,51478,51479,102957
54163,,tykqgzxqxwoj,51479,51480,102959
54164,,gahlg02fa2uj,51480,51481,102961
54165,,xsmtyoaiimmj,51481,51482,102963
54166,,ahfdlz_l21kj,51482,51483,102965
54167,,ws8y8j6v0qij,51484,51485,102969
54168,,-0lnmtzuxaqj,51485,51486,102971
54169,,w7ohoqbphkaj,51486,51487,102973
54170,,kgnr3hokidaj,51487,51488,102975
54171,,lt2usljukjwj,51488,51489,102977
54172,,3zbpgi3yqxuj,51489,51490,102979
54173,,xl_lv19yfikj,51490,51491,102981
54174,,url:http://portal.acm.org/ft_gateway.cfm3fid3d110191026type3dpdf,51491,51492,102983
54175,,wwptbyxioaij,51492,51493,102985
54176,,omjtnapvqvcj,51493,51494,102987
54177,,j3tfnsps2bkj,51494,51495,102989
54178,,zdezyuz47auj,51495,51496,102991
54179,,tgjoydlwki4j,51496,51497,102993
54180,,dvbsiudhujmj,51497,51498,102995
54181,,gc8p85hd_ckj,51498,51499,102997
54182,,azjglhuohi8j,51499,51500,102999
54183,,mhclgxog-7kj,51500,51501,103001
54184,,90prgbrwntcj,51501,51502,103003
54185,,dqffk6pw1tyj,51502,51503,103005
54186,,zt_auoabbw0j,51503,51504,103007
54187,,zvucdjkum3yj,51504,51505,103009
54188,,jfsajvqghc4j,51505,51506,103011
54189,,awka-oxhujaj,51506,51507,103013
54190,,msa_3b3gnv4j,51508,51509,103017
54191,,zywqe2mrrw8j,51509,51510,103019
54192,,bbkhppaqasij,51510,51511,103021
54193,,kcwtovulpcyj,51511,51512,103023
54194,,iirnumihlguj,51512,51513,103025
54195,,zahm4lqzfmcj,51513,51514,103027
54196,,1hckxwgbrvmj,51514,51515,103029
54197,,bwaorjmxax0j,51515,51516,103031
54198,,r_mdt5auzlsj,51516,51517,103033
54199,,0fdztwdl1pgj,51517,51518,103035
54200,,2l5roaopqgmj,51518,51519,103037
54201,,fazom8gdq7wj,51519,51520,103039
54202,,mqvgwcgpcfaj,51520,51521,103041
54203,,2-hvfnsrhhyj,51521,51522,103043
54204,,nttcamdo9f8j,51522,51523,103045
54205,,bhu55cpxh6sj,51523,51524,103047
54206,,oic_goycwh4j,51524,51525,103049
54207,,tsfjfnl_bbmj,51525,51526,103051
54208,,ewrdexcomj8j,51526,51527,103053
54209,,4gluj1xsntgj,51527,51528,103055
54210,,gpyfkjtqggij,51528,51529,103057
54211,,tnk2ahqslfsj,51529,51530,103059
54212,,i2-lc6insy4j,51530,51531,103061
54213,,mqwk8csfbrej,51531,51532,103063
54214,,0e0pmj8n3z0j,51532,51533,103065
54215,,url:http://portal.acm.org/ft_gateway.cfm3fid3d37370826type3dpdf26dl3dguide26dl3dacm26cfid3d1111111126cftoken3d2222222,51533,51534,103067
54216,,dosvnzokpgaj,51534,51535,103069
54217,,ho6jnbkqfi8j,51535,51536,103071
54218,,url:http://pubs.acs.org/cgi-bin/abstract.cgi/achre4/2005/38/i04/abs/ar040176w.html,51536,51537,103073
54219,,yfqsf7glpzqj,51537,51538,103075
54220,,xokmsuw6e9mj,51538,51539,103077
54221,,zm2iuhyubnuj,51539,51540,103079
54222,,kg0uickszk8j,51540,51541,103081
54223,,xcgtlaowtvcj,51541,51542,103083
54224,,ttu3zzkopxmj,51542,51543,103085
54225,,wv43u9jqxsaj,51543,51544,103087
54226,,758diuvclf4j,51544,51545,103089
54227,,ppheu9zzlncj,51545,51546,103091
54228,,icaqa-fmkhmj,51546,51547,103093
54229,,emuj2tzyysij,51547,51548,103095
54230,,ykstcehl8o4j,51549,51550,103099
54231,,j2agubs0heij,51550,51551,103101
54232,,2fj5d5rbj0ej,51551,51552,103103
54233,,h8xfmrwjtvcj,51552,51553,103105
54234,,vbc-qak_teuj,51553,51554,103107
54235,,khf1s1atxwyj,51554,51555,103109
54236,,qmd6qhkhitqj,51555,51556,103111
54237,,c3auqh5kijaj,51556,51557,103113
54238,,elrfvq9x5a0j,51557,51558,103115
54239,,6ufvslgyh9oj,51558,51559,103117
54240,,r2ms28zfmxyj,51559,51560,103119
54241,,ydmrzl6cmq4j,51560,51561,103121
54242,,xpqdrxkc-lwj,51561,51562,103123
54243,,alo6ad8cukcj,51562,51563,103125
54244,,vltkuofad4cj,51563,51564,103127
54245,,ig6ny5f3oqkj,51564,51565,103129
54246,,w2czpwat7vij,51565,51566,103131
54247,,jqqikco3gayj,51566,51567,103133
54248,,yqfgbjy54fwj,51567,51568,103135
54249,,isdzurhsh-8j,51568,51569,103137
54250,,url:http://portal.acm.org/ft_gateway.cfm3fid3d110122626type3dpdf,51569,51570,103139
54251,,cyitqpd0fskj,51570,51571,103141
54252,,lvyglrjqtfij,51571,51572,103143
54253,,url:http://links.jstor.org/sici3fsici3d0146-4949(196723)8253a4253c568253asorfl253e2.0.co253b2-n,51572,51573,103145
54254,,aj6uqzcg-jij,51573,51574,103147
54255,,7p_0aim00ayj,51574,51575,103149
54256,,xd6j83sldjuj,51575,51576,103151
54257,,8ooxcgjaqp8j,51576,51577,103153
54258,,u9_y9yni_duj,51577,51578,103155
54259,,ideojksk9xgj,51578,51579,103157
54260,,_v1sl5uo6zgj,51580,51581,103161
54261,,eltneod90o4j,51581,51582,103163
54262,,qbffn1urfu4j,51582,51583,103165
54263,,8ibu_ob7mioj,51583,51584,103167
54264,,mqeuldjoqpsj,51584,51585,103169
54265,,qfdvnaj-tdyj,51585,51586,103171
54266,,am0gu9l2y7mj,51586,51587,103173
54267,,t9nan8zi3yqj,51587,51588,103175
54268,,bj0s4a3o6qkj,51588,51589,103177
54269,,qpw1rjfzyxoj,51589,51590,103179
54270,,41ma2udixakj,51590,51591,103181
54271,,pmrqzhkqcrij,51591,51592,103183
54272,,e-jk2hrj4bwj,51592,51593,103185
54273,,bzsaoy8sv1ij,51593,51594,103187
54274,,h7l27d2nzv8j,51594,51595,103189
54275,,cpq-xcdoqs4j,51595,51596,103191
54276,,,51596,51597,103193
54277,,url:http://adsabs.harvard.edu/abs/1989phdt.........4e,51597,51598,103195
54278,,k2e0ydz8oeej,51598,51599,103197
54279,,23cdioj-t_8j,51599,51600,103199
54280,,o0zzw5o6hnsj,51600,51601,103201
54281,,l7rntqdnelkj,51601,51602,103203
54282,,rttkqpjrhqyj,51602,51603,103205
54283,,9k4yk5-cqtmj,51603,51604,103207
54284,,y8prxypngzij,51604,51605,103209
54285,,yirqgc52qxqj,51606,51607,103213
54286,,xiys-hj0ljuj,51607,51608,103215
54287,,uxy4-lgge7ej,51608,51609,103217
54288,,aisoumlrvgyj,51609,51610,103219
54289,,vskubpy5ie4j,51610,51611,103221
54290,,url:http://links.jstor.org/sici3fsici3d0146-4949(196422)5253a2253c133253atag253e2.0.co253b2-h,51611,51612,103223
54291,,piavlvh-jfuj,51612,51613,103225
54292,,cocmtuofl6mj,51613,51614,103227
54293,,xe_xzxfq1nyj,51614,51615,103229
54294,,awzqtsz59gcj,51615,51616,103231
54295,,fegmugejtpsj,51616,51617,103233
54296,,f1osxwhddvaj,51617,51618,103235
54297,,url:http://www.csa.com/partners/viewrecord.php3frequester3dgs26collection3dtrd26recid3d0177775ci,51618,51619,103237
54298,,ghgjvptntwgj,51619,51620,103239
54299,,rm7nqiohdiij,51620,51621,103241
54300,,qwjrkzuimhsj,51621,51622,103243
54301,,altppl4tgkej,51622,51623,103245
54302,,3nkvdc0eoysj,51623,51624,103247
54303,,enj0ogu8gwgj,51625,51626,103251
54304,,rjsqmfschtij,51626,51627,103253
54305,,uv0yd6rsq98j,51627,51628,103255
54306,,dr9pitw3bzuj,51629,51630,103259
54307,,yow44nk6p88j,51630,51631,103261
54308,,p28bg_c6mr8j,51631,51632,103263
54309,,knvni_uvbwcj,51632,51633,103265
54310,,xiwfaf3khfmj,51633,51634,103267
54311,,pwp2te4njp4j,51634,51635,103269
54312,,tezga1ryk9sj,51635,51636,103271
54313,,l0xbgg9marij,51637,51638,103275
54314,,url:http://portal.acm.org/ft_gateway.cfm3fid3d109973526type3dpdf,51639,51640,103279
54315,,ecnz3mamq94j,51640,51641,103281
54316,,2qd3m9jvxdkj,51641,51642,103283
54317,,4iqqjeythzkj,51642,51643,103285
54318,,n6thjzvtflcj,51643,51644,103287
54319,,hli8z7cayfuj,51644,51645,103289
54320,,dpam9ca4rbmj,51645,51646,103291
54321,,17jrsxsnkwqj,51646,51647,103293
54322,,url:http://portal.acm.org/ft_gateway.cfm3fid3d102757826type3dpdf,51647,51648,103295
54323,,vtklv-wvoxcj,51648,51649,103297
54324,,jl9tu1x2rpgj,51649,51650,103299
54325,,xkmfdjqzn1ej,51650,51651,103301
54326,,w9-zpbu1mm8j,51651,51652,103303
54327,,lapfmi4ut2ej,51652,51653,103305
54328,,4lr-cgizucuj,51653,51654,103307
54329,,z-b6yw3byogj,51654,51655,103309
54330,,l0_qzs3ij2ej,51655,51656,103311
54331,,of-ihoirjlaj,51656,51657,103313
54332,,esckgygywc8j,51657,51658,103315
54333,,dfrmwfr16fmj,51658,51659,103317
54334,,url:http://portal.acm.org/citation.cfm3fid3d144111.144145,51659,51660,103319
54335,,r9giwvvy404j,51660,51661,103321
54336,,cuwratna5rij,51661,51662,103323
54337,,fabns2qyazyj,51662,51663,103325
54338,,ubykehuhfc0j,51663,51664,103327
54339,,z-8n0gmzqz0j,51664,51665,103329
54340,,zrmuc-fhmfej,51665,51666,103331
54341,,cqxhqf0pdw0j,51666,51667,103333
54342,,trdj-o_7gxcj,51667,51668,103335
54343,,bmt_jhi50xej,51668,51669,103337
54344,,u5n-48xkepoj,51669,51670,103339
54345,,hzq0zjfladgj,51670,51671,103341
54346,,5imn5_kgnqej,51671,51672,103343
54347,,0e3ppuvtz0mj,51673,51674,103347
54348,,3nmg4archakj,51674,51675,103349
54349,,ala1n4dd_tgj,51675,51676,103351
54350,,zhrylinoss4j,51676,51677,103353
54351,,ln0et_ionpcj,51677,51678,103355
54352,,zdlvssrvlpaj,51678,51679,103357
54353,,sryeyfxll9ij,51679,51680,103359
54354,,dnv7fxyyjyaj,51680,51681,103361
54355,,oeal9pakzyij,51681,51682,103363
54356,,q2ptfog8ga4j,51682,51683,103365
54357,,rktupghyat8j,51683,51684,103367
54358,,rvkhq737vrmj,51684,51685,103369
54359,,xo8cmrrdrswj,51685,51686,103371
54360,,7w_e4uz1p2yj,51686,51687,103373
54361,,fdvikwgij1yj,51687,51688,103375
54362,,wm8hdevhmdoj,51688,51689,103377
54363,,aayoqphbheej,51689,51690,103379
54364,,1ybzpecbdhgj,51690,51691,103381
54365,,url:http://doi.wiley.com/10.1002/ace.180,51691,51692,103383
54366,,ce_8jw5eyt8j,51692,51693,103385
54367,,zzrvveejae4j,51694,51695,103389
54368,,tcnjvkelfs0j,51695,51696,103391
54369,,h94dmb0r13uj,51696,51697,103393
54370,,kfwvasln3duj,51697,51698,103395
54371,,qy4xcy0lqjsj,51699,51700,103399
54372,,h8mwd8ysuvwj,51700,51701,103401
54373,,ayfgbaevzvcj,51701,51702,103403
54374,,aqi1u6sr5dgj,51702,51703,103405
54375,,url:http://adsabs.harvard.edu/abs/1987emc..symp.....g,51703,51704,103407
54376,,_8navwqp4_ij,51704,51705,103409
54377,,0tezpee9nnej,51706,51707,103413
54378,,m-pcovezuxgj,51707,51708,103415
54379,,1-bbpm7ls_4j,51708,51709,103417
54380,,rcrr_l_ampmj,51709,51710,103419
54381,,samxilhhwekj,51710,51711,103421
54382,,unxjcmemeyij,51711,51712,103423
54383,,nnedfbzuovkj,51712,51713,103425
54384,,lviugcbm9gij,51713,51714,103427
54385,,ej8ptlaxptwj,51714,51715,103429
54386,,j-ynfiz-bjwj,51715,51716,103431
54387,,08eoy047i8yj,51716,51717,103433
54388,,xi8wjacecusj,51717,51718,103435
54389,,nf5igetihwyj,51718,51719,103437
54390,,fhtufejwbykj,51719,51720,103439
54391,,url:http://portal.acm.org/ft_gateway.cfm3fid3d18745526type3dpdf26coll3dguide26dl3dacm26cfid3d1111111126cftoken3d2222222,51720,51721,103441
54392,,yzptlhyvie8j,51721,51722,103443
54393,,cxsoqrhx7iej,51722,51723,103445
54394,,chk1v34s50qj,51723,51724,103447
54395,,wlnmgayahp0j,51724,51725,103449
54396,,yp-u-g1ai50j,51725,51726,103451
54397,,pj38ofoeiymj,51726,51727,103453
54398,,c1iiga_voeej,51727,51728,103455
54399,,lrsprwj6i1qj,51728,51729,103457
54400,,y9z1theohyij,51730,51731,103461
54401,,z3zeygmq-qej,51731,51732,103463
54402,,a2oqauw2ohij,51732,51733,103465
54403,,tznnyvvig9cj,51733,51734,103467
54404,,cyuloixbsjsj,51734,51735,103469
54405,,url:http://portal.acm.org/ft_gateway.cfm3fid3d108379526type3dpdf,51735,51736,103471
54406,,if_0ex1up9ij,51736,51737,103473
54407,,2hkppms4btkj,51737,51738,103475
54408,,whwpikxbic8j,51738,51739,103477
54409,,c0alvdaqtsyj,51739,51740,103479
54410,,dr6rsifmg3sj,51740,51741,103481
54411,,bgukexe91zqj,51741,51742,103483
54412,,da9nuyvhexcj,51742,51743,103485
54413,,conuenlmwa4j,51744,51745,103489
54414,,_xautpsi8-sj,51746,51747,103493
54415,,n1asjxedjtgj,51747,51748,103495
54416,,uyxycobmvt8j,51748,51749,103497
54417,,biox2w-epfej,51749,51750,103499
54418,,88ln8rut9ykj,51750,51751,103501
54419,,brl3bfiiv10j,51751,51752,103503
54420,,htt08lzhmfsj,51752,51753,103505
54421,,cxxdianfr_4j,51753,51754,103507
54422,,4ucv5h3-yvmj,51754,51755,103509
54423,,jsdtcinshbuj,51755,51756,103511
54424,,zwtsdwfmm5mj,51756,51757,103513
54425,,c7yu79dhbquj,51757,51758,103515
54426,,uprajsue80oj,51758,51759,103517
54427,,0leumwvrggej,51759,51760,103519
54428,,jbommmsxq2aj,51760,51761,103521
54429,,afbcs0xyhekj,51761,51762,103523
54430,,vs6i4weiddmj,51762,51763,103525
54431,,kmyzpe7iubwj,51763,51764,103527
54432,,_bddb1jrrqkj,51764,51765,103529
54433,,shjjh2xztuuj,51765,51766,103531
54434,,0lobgsfpvkij,51766,51767,103533
54435,,kd8q2f4j2b8j,51767,51768,103535
54436,,f1iln5sau04j,51768,51769,103537
54437,,lxbo8vcomlij,51769,51770,103539
54438,,1ropiiqszs4j,51770,51771,103541
54439,,t60d0lwfgkaj,51771,51772,103543
54440,,wed2xsqhslej,51772,51773,103545
54441,,uh_qvt-wj0mj,51773,51774,103547
54442,,url:http://portal.acm.org/ft_gateway.cfm3fid3d102472626type3dpdf,51774,51775,103549
54443,,s3q8cwj6l_ej,51775,51776,103551
54444,,url:http://links.jstor.org/sici3fsici3d0146-4949(196723)8253a4253c556253atc253e2.0.co253b2-n,51776,51777,103553
54445,,74tvo1pztycj,51777,51778,103555
54446,,yo-vpdtrbzwj,51778,51779,103557
54447,,moejy5jojbij,51779,51780,103559
54448,,twl8xcckgxwj,51780,51781,103561
54449,,44diuej5kn0j,51781,51782,103563
54450,,a34co4bqc14j,51782,51783,103565
54451,,cvrtjuiet5cj,51783,51784,103567
54452,,5jjcf_agla8j,51784,51785,103569
54453,,fekvsx5y5eej,51785,51786,103571
54454,,djw4u5j8m6aj,51786,51787,103573
54455,,url:http://ieeexplore.ieee.org/iel2/575/5225/00202200.pdf3farnumber3d202200,51787,51788,103575
54456,,vm4z3d8mdyqj,51788,51789,103577
54457,,izh3wnaftv8j,51789,51790,103579
54458,,9xirk_nggugj,51790,51791,103581
54459,,clc8zqbcegej,51791,51792,103583
54460,,je-9izqgv8aj,51792,51793,103585
54461,,5mghjxz5ewkj,51793,51794,103587
54462,,iem_tmkbdk4j,51794,51795,103589
54463,,o43yhrrjuawj,51795,51796,103591
54464,,z5eb4e08ndoj,51796,51797,103593
54465,,,51797,51798,103595
54466,,i48hanu3or4j,51798,51799,103597
54467,,vuwrqhz3hhaj,51799,51800,103599
54468,,spyrsfrzqzkj,51800,51801,103601
54469,,zyts8pqt0zyj,51801,51802,103603
54470,,fe4qayetrkqj,51802,51803,103605
54471,,eicohtimyk4j,51803,51804,103607
54472,,url:http://www.csa.com/partners/viewrecord.php3frequester3dgs26collection3dtrd26recid3d1123233ci,51804,51805,103609
54473,,9brrq1afuyyj,51805,51806,103611
54474,,cn-o9hbk4rej,51806,51807,103613
54475,,bg0oif-woumj,51807,51808,103615
54476,,ckcvp7pj7fwj,51808,51809,103617
54477,,m3z9x8mgtkmj,51809,51810,103619
54478,,a8hg951ubm4j,51810,51811,103621
54479,,axaq-ib4ogwj,51811,51812,103623
54480,,xiwrmxvo-jij,51812,51813,103625
54481,,xfp9cwqdfmij,51813,51814,103627
54482,,h1_54vmxm_aj,51814,51815,103629
54483,,l_lrilc9klmj,51815,51816,103631
54484,,axuk8qe2--qj,51816,51817,103633
54485,,3x3109evssuj,51817,51818,103635
54486,,f5csks8ywxmj,51818,51819,103637
54487,,gp9772cnm4oj,51819,51820,103639
54488,,5s2u8k4c1pcj,51820,51821,103641
54489,,q-by6-bhy_mj,51821,51822,103643
54490,,fpymtzcqeamj,51822,51823,103645
54491,,rattdsios7ij,51823,51824,103647
54492,,s7djcgfbx-4j,51824,51825,103649
54493,,xv0zt25nsbwj,51825,51826,103651
54494,,gmfumylzotcj,51826,51827,103653
54495,,ugj8nafxgzyj,51827,51828,103655
54496,,rhk8tiibs2aj,51828,51829,103657
54497,,slv1ndotlnaj,51829,51830,103659
54498,,ckzqdjfvjj4j,51830,51831,103661
54499,,zy5acpbklscj,51831,51832,103663
54500,,ogeoiqwf9b8j,51832,51833,103665
54501,,vqngvdvkx1yj,51833,51834,103667
54502,,dyonij_yjtyj,51834,51835,103669
54503,,msqo85b1fjej,51835,51836,103671
54504,,ogjk1rbnirkj,51836,51837,103673
54505,,url:http://portal.acm.org/ft_gateway.cfm3fid3d102765426type3dpdf,51837,51838,103675
54506,,zznwcjxkgngj,51838,51839,103677
54507,,pe5hztr4hngj,51839,51840,103679
54508,,iqjyd8nrzr0j,51840,51841,103681
54509,,_vnjhuw-p2ej,51841,51842,103683
54510,,nrlw76s6-28j,51842,51843,103685
54511,,1a7hlvga9r0j,51843,51844,103687
54512,,olt5pqtqf3yj,51844,51845,103689
54513,,c1ssnou9z8oj,51845,51846,103691
54514,,6lvbos-xo3ej,51846,51847,103693
54515,,sx5vobgm1aij,51847,51848,103695
54516,,_tqrvz95svoj,51848,51849,103697
54517,,0o0gbw5g8dcj,51849,51850,103699
54518,,ywsoddto8pwj,51850,51851,103701
54519,,094mnlce5w4j,51851,51852,103703
54520,,erxurjmvtcsj,51852,51853,103705
54521,,smmqizms5k4j,51853,51854,103707
54522,,tsccg7ldlfuj,51854,51855,103709
54523,,ob5seyl5wdoj,51855,51856,103711
54524,,gff3xkuwy4ij,51856,51857,103713
54525,,z_smsrhse9gj,51857,51858,103715
54526,,_y59hu8fr_gj,51858,51859,103717
54527,,lcfsw3j1z2sj,51860,51861,103721
54528,,pvp7k-5hq5aj,51861,51862,103723
54529,,0behvgew9tmj,51862,51863,103725
54530,,rbwvmca0gmyj,51863,51864,103727
54531,,yxxtpadlkucj,51865,51866,103731
54532,,8d57iwx2juoj,51866,51867,103733
54533,,url:http://portal.acm.org/citation.cfm3fid3d234286.1057805,51867,51868,103735
54534,,oetxfuaelqej,51868,51869,103737
54535,,4d5xhc9eklaj,51869,51870,103739
54536,,5vyet2ydrsoj,51870,51871,103741
54537,,xvy3cinrxpqj,51871,51872,103743
54538,,spmpsdm5blwj,51872,51873,103745
54539,,cejtj8s8w_0j,51873,51874,103747
54540,,opj3ke_kx-gj,51874,51875,103749
54541,,abi92bi5il0j,51875,51876,103751
54542,,e-8sofjpts4j,51876,51877,103753
54543,,vfv6o8xmlnij,51877,51878,103755
54544,,e-fqstrvkhqj,51878,51879,103757
54545,,eqf_bwr1n0oj,51879,51880,103759
54546,,lghtr35zdpmj,51880,51881,103761
54547,,9malmnotenej,51881,51882,103763
54548,,gxvcsepiniwj,51882,51883,103765
54549,,r15fmmhb1xyj,51883,51884,103767
54550,,azvdrengncwj,51884,51885,103769
54551,,y0-ykstpnuij,51885,51886,103771
54552,,spmud0fyrvwj,51886,51887,103773
54553,,mtqrsdvvlfmj,51887,51888,103775
54554,,0-whwcgwtr8j,51888,51889,103777
54555,,kzax18aoqfqj,51889,51890,103779
54556,,ceigptkm4_aj,51890,51891,103781
54557,,cmulpfl1mg8j,51891,51892,103783
54558,,,51892,51893,103785
54559,,bipz9pkrfasj,51893,51894,103787
54560,,vylmkbtfoz8j,51894,51895,103789
54561,,ns38geqkmraj,51895,51896,103791
54562,,c7kkjsigrwwj,51896,51897,103793
54563,,zhoyu6knrzaj,51897,51898,103795
54564,,uvh2xul7pqsj,51898,51899,103797
54565,,u6jh2myq5hij,51899,51900,103799
54566,,prksak7aafyj,51900,51901,103801
54567,,eiyaxndxewgj,51901,51902,103803
54568,,k5uqhao26cij,51902,51903,103805
54569,,url:http://www.blackwell-synergy.com/links/doi/10.1111/1467-8411.00019/abs/,51903,51904,103807
54570,,8sgoq11xaxsj,51904,51905,103809
54571,,lszyhlw5lo0j,51905,51906,103811
54572,,grtb9l9zrkkj,51906,51907,103813
54573,,a-7uv1rdoiqj,51907,51908,103815
54574,,qgdjm4axcfaj,51908,51909,103817
54575,,url:http://www.geography.org.uk/journals/journals.asp3farticleid3d17,51909,51910,103819
54576,,jbu2g4dqz7kj,51910,51911,103821
54577,,url:http://www.csa.com/partners/viewrecord.php3frequester3dgs26collection3dtrd26recid3d0456659ci,51911,51912,103823
54578,,zxfv7iiliocj,51912,51913,103825
54579,,apf1igfm_yaj,51913,51914,103827
54580,,5abonn0c3fuj,51914,51915,103829
54581,,ylxwalk51puj,51915,51916,103831
54582,,i6ccecxwkcej,51916,51917,103833
54583,,6z5ije8om30j,51917,51918,103835
54584,,9s9gwy6sshoj,51918,51919,103837
54585,,uiroaf6fhsaj,51919,51920,103839
54586,,pu7vb1thnpgj,51920,51921,103841
54587,,otzodq2na6uj,51921,51922,103843
54588,,0-xpuaozvt8j,51922,51923,103845
54589,,b_zrluhjhqmj,51923,51924,103847
54590,,i6m08xogu6cj,51924,51925,103849
54591,,gglo5g3vjcij,51925,51926,103851
54592,,gdzxkxuwbruj,51927,51928,103855
54593,,5x3jfzqviiaj,51928,51929,103857
54594,,vnohuujgzgij,51929,51930,103859
54595,,6xly2r66faaj,51930,51931,103861
54596,,8h8tlmtqvvyj,51931,51932,103863
54597,,hsojgs2_cx4j,51932,51933,103865
54598,,kljf1vcu-owj,51933,51934,103867
54599,,ajhth4eecmkj,51934,51935,103869
54600,,spdxfjfzwmwj,51935,51936,103871
54601,,url:http://ieeexplore.ieee.org/xpl/abs_free.jsp3farnumber3d994411,51936,51937,103873
54602,,xmenc4bzn98j,51937,51938,103875
54603,,fadjc769tcoj,51938,51939,103877
54604,,0yuqldbrfa8j,51939,51940,103879
54605,,o9dlrdr269gj,51940,51941,103881
54606,,x0v_nsxytmoj,51941,51942,103883
54607,,zr6tayoyte4j,51942,51943,103885
54608,,ehq_bzrwh20j,51943,51944,103887
54609,,kkxykuugbt0j,51944,51945,103889
54610,,ilykyoqkusoj,51945,51946,103891
54611,,e2wcngjrhzqj,51946,51947,103893
54612,,dhcykncfzboj,51947,51948,103895
54613,,mqxb8iab1kuj,51948,51949,103897
54614,,x6ktjrlsiuyj,51949,51950,103899
54615,,41hovx7yoh0j,51950,51951,103901
54616,,fawl3jp6e3aj,51951,51952,103903
54617,,url:http://portal.acm.org/ft_gateway.cfm3fid3d108629126type3dpdf,51952,51953,103905
54618,,h4jqslic-tsj,51953,51954,103907
54619,,haudrhdhslwj,51954,51955,103909
54620,,pabinlcxqgsj,51955,51956,103911
54621,,ixobks9nvxwj,51956,51957,103913
54622,,obhvaxib60qj,51957,51958,103915
54623,,igd3ammrenuj,51958,51959,103917
54624,,ddrl__9ughqj,51959,51960,103919
54625,,3z56betmjvwj,51960,51961,103921
54626,,opt4pmbao2uj,51961,51962,103923
54627,,w-aax2eekquj,51962,51963,103925
54628,,qikviadlt-gj,51963,51964,103927
54629,,ft-4qcd4vtoj,51964,51965,103929
54630,,url:http://portal.acm.org/citation.cfm3fid3d168825.161155,51965,51966,103931
54631,,mj570jvcqxaj,51966,51967,103933
54632,,f5l-ayejfkqj,51967,51968,103935
54633,,whkcjopm-xaj,51968,51969,103937
54634,,pwtnmi155xsj,51969,51970,103939
54635,,mtkf7hb4g3wj,51970,51971,103941
54636,,o2fl5of_cfcj,51971,51972,103943
54637,,zypetjdqhx4j,51972,51973,103945
54638,,wd9dp08mveij,51973,51974,103947
54639,,vieggbiph4yj,51974,51975,103949
54640,,akp4vke9mcij,51975,51976,103951
54641,,aakxbbtyhu0j,51976,51977,103953
54642,,qj_6ahctrngj,51977,51978,103955
54643,,pyz9hsefni8j,51978,51979,103957
54644,,,51979,51980,103959
54645,,z0cr_fuwzsyj,51980,51981,103961
54646,,xfxt75d5jz4j,51981,51982,103963
54647,,b2cpxrjomvej,51982,51983,103965
54648,,csv0os6ibvsj,51983,51984,103967
54649,,6d4iwc73roaj,51984,51985,103969
54650,,xus0kknjvtaj,51985,51986,103971
54651,,q8dq43d6ggsj,51986,51987,103973
54652,,98k6qrbdmsyj,51987,51988,103975
54653,,6fs1hnsr_qoj,51988,51989,103977
54654,,x3klsd1fahoj,51989,51990,103979
54655,,fdedeu3csdwj,51990,51991,103981
54656,,6gaobrinv7kj,51991,51992,103983
54657,,5ywvo8envlwj,51992,51993,103985
54658,,rcxkhxb-wfkj,51993,51994,103987
54659,,5ue4vzl3amwj,51994,51995,103989
54660,,yrxltljrrzaj,51995,51996,103991
54661,,cwo0h2trxraj,51996,51997,103993
54662,,hqjgq2dapfkj,51997,51998,103995
54663,,ugiwmlvewssj,51998,51999,103997
54664,,uqueqzluivqj,51999,52000,103999
54665,,nl0f1i2duq0j,52000,52001,104001
54666,,_7xn8zjxyfuj,52001,52002,104003
54667,,ff8aahu9mpkj,52002,52003,104005
54668,,h0hrnobizmyj,52003,52004,104007
54669,,qtpki_qecpcj,52004,52005,104009
54670,,eerrqddcrz0j,52005,52006,104011
54671,,ec_lhimbpwoj,52006,52007,104013
54672,,6m0vxibga-kj,52007,52008,104015
54673,,url:http://portal.acm.org/ft_gateway.cfm3fid3d102760026type3dpdf,52008,52009,104017
54674,,lraz2lsh4c0j,52009,52010,104019
54675,,is9io1cyei0j,52010,52011,104021
54676,,7wvdxtxnrlej,52012,52013,104025
54677,,agkesiusnsaj,52013,52014,104027
54678,,onk26br5058j,52014,52015,104029
54679,,hnmhsbehr80j,52015,52016,104031
54680,,trpnirbnpxkj,52016,52017,104033
54681,,ssnlbhx9vu0j,52017,52018,104035
54682,,3gtrfoh44bqj,52018,52019,104037
54683,,,52019,52020,104039
54684,,eks4s4wlcqsj,52020,52021,104041
54685,,x49dtvboc9wj,52021,52022,104043
54686,,y5bydyzgogyj,52022,52023,104045
54687,,d3pepztrdsaj,52023,52024,104047
54688,,h_zehhiay5uj,52024,52025,104049
54689,,szkxtq8u498j,52026,52027,104053
54690,,lsyaejidxe0j,52027,52028,104055
54691,,refszhzhplsj,52028,52029,104057
54692,,e34zg3bwax8j,52029,52030,104059
54693,,v84ijwbsrpqj,52030,52031,104061
54694,,kuuijxleo9qj,52031,52032,104063
54695,,7v3f7thmyw0j,52032,52033,104065
54696,,qcq3f7tbojmj,52033,52034,104067
54697,,wcq2gm1c-nqj,52034,52035,104069
54698,,du-uysgmr24j,52035,52036,104071
54699,,ztdb5yos6jij,52036,52037,104073
54700,,ddjoezahnxej,52037,52038,104075
54701,,vq9bmyofzz0j,52038,52039,104077
54702,,y8eklvxujusj,52039,52040,104079
54703,,8t_urwaamjgj,52040,52041,104081
54704,,ujeetxpqfisj,52041,52042,104083
54705,,kdd7tdk_egsj,52042,52043,104085
54706,,q57wouljnisj,52043,52044,104087
54707,,whd36yrvbn4j,52044,52045,104089
54708,,2tc9tysgrhmj,52045,52046,104091
54709,,163kmejgvcoj,52046,52047,104093
54710,,qbcmes9iusuj,52047,52048,104095
54711,,0g2acijumg4j,52048,52049,104097
54712,,h2rn2motrpkj,52049,52050,104099
54713,,azbkl8l-up0j,52051,52052,104103
54714,,f3f4wlxhenqj,52053,52054,104107
54715,,xm9xnvi1vjuj,52054,52055,104109
54716,,frz9iq768haj,52055,52056,104111
54717,,url:http://portal.acm.org/citation.cfm3fdoid3d375663,52056,52057,104113
54718,,idswzs7gl60j,52057,52058,104115
54719,,aybb6plm2maj,52058,52059,104117
54720,,8tieutr1ngoj,52060,52061,104121
54721,,l2fskwkzexuj,52061,52062,104123
54722,,url:http://www.ingentaconnect.com/search/expand3fpub3dinfobike://els/09505849/1995/00000037/00000010/art9093126unc3d,52062,52063,104125
54723,,gs2eeczreqgj,52063,52064,104127
54724,,yftscdwofwqj,52064,52065,104129
54725,,f7613nvgekej,52065,52066,104131
54726,,i-m8x1z1lcej,52067,52068,104135
54727,,kzlwo3cdmbwj,52068,52069,104137
54728,,qw0i588nl9wj,52069,52070,104139
54729,,80smcyi0_7mj,52070,52071,104141
54730,,eokx0zh78vqj,52072,52073,104145
54731,,godxtquyygcj,52073,52074,104147
54732,,ucdvma1nf0yj,52074,52075,104149
54733,,jvpfahgkzsyj,52075,52076,104151
54734,,xwy_qwzdersj,52076,52077,104153
54735,,url:http://ieeexplore.ieee.org/iel5/35/26492/x0642548.pdf,52077,52078,104155
54736,,qbpzbhreglkj,52078,52079,104157
54737,,xdtgjdf2srkj,52079,52080,104159
54738,,_ryegvqfxswj,52080,52081,104161
54739,,3kbac5-s810j,52081,52082,104163
54740,,tnzmiksz6gkj,52082,52083,104165
54741,,a8i7ftx4qoej,52083,52084,104167
54742,,7fgjhqlqt3cj,52084,52085,104169
54743,,0ebuwdcevnoj,52085,52086,104171
54744,,b_nc-gmklxej,52086,52087,104173
54745,,1pjm2woeqzkj,52087,52088,104175
54746,,mt0i9qybtrmj,52088,52089,104177
54747,,fmfckmza6dqj,52089,52090,104179
54748,,zi3z-hgixjaj,52090,52091,104181
54749,,dd1bqyidyjej,52091,52092,104183
54750,,url:http://portal.acm.org/ft_gateway.cfm3fid3d106623526type3dpdf,52092,52093,104185
54751,,drf4aueuppkj,52093,52094,104187
54752,,rkjpnyiyffgj,52094,52095,104189
54753,,jndzzukicwkj,52095,52096,104191
54754,,jfbzdtcbyoaj,52097,52098,104195
54755,,xwwt2zxahtqj,52098,52099,104197
54756,,2mm5-9syyfej,52099,52100,104199
54757,,5d-wv5duhqmj,52100,52101,104201
54758,,h4lm2vvgtgej,52101,52102,104203
54759,,9nwll8gohy8j,52102,52103,104205
54760,,qffjepiftkoj,52103,52104,104207
54761,,8z4vj7mva8aj,52104,52105,104209
54762,,t_dqdykbvwuj,52105,52106,104211
54763,,,52106,52107,104213
54764,,decxamn_-2oj,52107,52108,104215
54765,,url:http://portal.acm.org/ft_gateway.cfm3fid3d64109326type3dpdf26dl3dguide26dl3dacm26cfid3d1111111126cftoken3d2222222,52108,52109,104217
54766,,0_bj58fb6pqj,52109,52110,104219
54767,,o8l-t5wbpxwj,52110,52111,104221
54768,,96zjtjt-kpaj,52111,52112,104223
54769,,uj3xog1lco4j,52112,52113,104225
54770,,u5pt7sfulgsj,52113,52114,104227
54771,,,52114,52115,104229
54772,,ui2el9m2v44j,52115,52116,104231
54773,,snnfv3nvbsyj,52116,52117,104233
54774,,5rpzy2wpdlaj,52117,52118,104235
54775,,icuxykdfskgj,52118,52119,104237
54776,,sqflgorogskj,52119,52120,104239
54777,,url:http://portal.acm.org/ft_gateway.cfm3fid3d24446926type3dpdf26dl3dguide26dl3dacm26cfid3d1111111126cftoken3d2222222,52120,52121,104241
54778,,viqnffpwmtaj,52121,52122,104243
54779,,hwq_x8jllogj,52122,52123,104245
54780,,1zqx-mvc1boj,52123,52124,104247
54781,,2gknc8zllrwj,52124,52125,104249
54782,,url:http://portal.acm.org/citation.cfm3fid3d881153,52125,52126,104251
54783,,vck3qh6_4akj,52126,52127,104253
54784,,heacnvs_gxqj,52127,52128,104255
54785,,8holex7vnoaj,52128,52129,104257
54786,,hbr4vdgyztyj,52129,52130,104259
54787,,,52130,52131,104261
54788,,4qaptf-w1syj,52131,52132,104263
54789,,gdqn8w4uzngj,52132,52133,104265
54790,,url:http://doi.ieeecomputersociety.org/10.1109/tkde.2004.64,52133,52134,104267
54791,,j15i81h0v9yj,52134,52135,104269
54792,,kupahup4zjcj,52135,52136,104271
54793,,ril1gpqmct0j,52136,52137,104273
54794,,zzs-zmjbndkj,52137,52138,104275
54795,,url:http://www.springerlink.com/index/g46044627134l5k5.pdf,52138,52139,104277
54796,,n66qbrorouej,52139,52140,104279
54797,,ufu6rb5zyigj,52140,52141,104281
54798,,29t4isvdrboj,52141,52142,104283
54799,,7ghevrybylej,52142,52143,104285
54800,,dxykjur4q8wj,52143,52144,104287
54801,,vi_t0ahidn4j,52144,52145,104289
54802,,hxqoc9pkfomj,52145,52146,104291
54803,,3oe0uplsjwej,52146,52147,104293
54804,,,52148,52149,104297
54805,,uaceny22_esj,52149,52150,104299
54806,,ocu8afaxupwj,52150,52151,104301
54807,,axmi0tqrxxqj,52151,52152,104303
54808,,,52152,52153,104305
54809,,mhngargwojwj,52153,52154,104307
54810,,k48y5nym3m0j,52154,52155,104309
54811,,_i8jonozukkj,52155,52156,104311
54812,,axcznbuwrqyj,52156,52157,104313
54813,,pinb6dzgi1ij,52157,52158,104315
54814,,3m_0kd8nnjgj,52158,52159,104317
54815,,slqcciw1spij,52159,52160,104319
54816,,_m7libkzezwj,52160,52161,104321
54817,,pofrlnnoe50j,52161,52162,104323
54818,,awwqqg5smikj,52162,52163,104325
54819,,h9ahvzt2ekcj,52163,52164,104327
54820,,oakfccq1vw0j,52164,52165,104329
54821,,h9melauqheej,52165,52166,104331
54822,,mrhlu2ygw8ej,52166,52167,104333
54823,,,52167,52168,104335
54824,,yf7pirzbp-ej,52168,52169,104337
54825,,tyhueqecpboj,52169,52170,104339
54826,,z7zkxk4g6ycj,52170,52171,104341
54827,,5ko7rur9rj8j,52171,52172,104343
54828,,9ycehh5t87ej,52172,52173,104345
54829,,cpi3pat4pwsj,52173,52174,104347
54830,,wxjd5yluzs8j,52174,52175,104349
54831,,bprqtnl2kpij,52175,52176,104351
54832,,mmmx28er4ioj,52176,52177,104353
54833,,7wkpovwpezuj,52177,52178,104355
54834,,9hjvcvjrm3ej,52178,52179,104357
54835,,qwklmz21cysj,52179,52180,104359
54836,,2iioim-ere0j,52180,52181,104361
54837,,u8fqjfr97hsj,52181,52182,104363
54838,,,52182,52183,104365
54839,,2gm4auh3-xoj,52183,52184,104367
54840,,nxnntb59pe0j,52184,52185,104369
54841,,t81muhzqylgj,52185,52186,104371
54842,,erfmqxp7bkaj,52186,52187,104373
54843,,fj2mc1bp7twj,52187,52188,104375
54844,,jcx4gs_a1rmj,52188,52189,104377
54845,,url:http://www.springerlink.com/index/r187542r1q703r74.pdf,52189,52190,104379
54846,,zcrdiwnkrhij,52190,52191,104381
54847,,cma57spak_4j,52191,52192,104383
54848,,uky90tokkygj,52192,52193,104385
54849,,_ky8wyq5xe8j,52193,52194,104387
54850,,hogkfbjl_oyj,52194,52195,104389
54851,,1sfnqka8gsaj,52195,52196,104391
54852,,hy90f0kw6m8j,52196,52197,104393
54853,,7yv8dr997a8j,52197,52198,104395
54854,,yu02ccbuum4j,52198,52199,104397
54855,,7vygby4sfr0j,52199,52200,104399
54856,,ytcfouogqgqj,52200,52201,104401
54857,,mzqmxlhtcxuj,52201,52202,104403
54858,,mawjiylmiswj,52202,52203,104405
54859,,q-efs9c8xtqj,52203,52204,104407
54860,,jkrooxnqshgj,52204,52205,104409
54861,,xoypg5y1sc8j,52205,52206,104411
54862,,lcbze4pw_eij,52206,52207,104413
54863,,zrn85zu1rxoj,52207,52208,104415
54864,,dfigonuw6pqj,52208,52209,104417
54865,,mw1nfgzwbbkj,52209,52210,104419
54866,,whnmywyjzjcj,52210,52211,104421
54867,,w26hezgq9umj,52211,52212,104423
54868,,url:http://www.ncbi.nlm.nih.gov/entrez/query.fcgi3fcmd3dretrieve26db3dpubmed26list_uids3d8401026dopt3dcitation,52212,52213,104425
54869,,5ngnboapm2sj,52213,52214,104427
54870,,rck0ypilef0j,52214,52215,104429
54871,,dyal7enx59wj,52215,52216,104431
54872,,01dhxrxmr_oj,52216,52217,104433
54873,,swjsrnys_ksj,52217,52218,104435
54874,,9afse7b_jiij,52218,52219,104437
54875,,t6wbrzsclnij,52219,52220,104439
54876,,,52220,52221,104441
54877,,kmixy1h12buj,52221,52222,104443
54878,,url:http://pubs.acs.org/cgi-bin/abstract.cgi/achre4/asap/abs/ar050084m.html,52222,52223,104445
54879,,cnaw9v-vejwj,52223,52224,104447
54880,,hlyrhavc0hoj,52224,52225,104449
54881,,1b8j5i_p4_ej,52225,52226,104451
54882,,o--xjlbwaq0j,52226,52227,104453
54883,,l__7arwlznkj,52227,52228,104455
54884,,uvozjxgp0roj,52228,52229,104457
54885,,txhyp-efcbgj,52229,52230,104459
54886,,url:http://portal.acm.org/ft_gateway.cfm3fid3d106521526type3dpdf,52230,52231,104461
54887,,wd6e2ztro-4j,52231,52232,104463
54888,,d9vbgr-rcm0j,52232,52233,104465
54889,,nwbwlrnc0qkj,52233,52234,104467
54890,,govmfui2noqj,52234,52235,104469
54891,,cjagtxtuzrcj,52235,52236,104471
54892,,gihhtzwyj58j,52236,52237,104473
54893,,4yfjoqqctwmj,52237,52238,104475
54894,,sj3ya55eyi0j,52238,52239,104477
54895,,jdczhi6clqkj,52239,52240,104479
54896,,url:http://www.ncbi.nlm.nih.gov/entrez/query.fcgi3fcmd3dretrieve26db3dpubmed26list_uids3d73911726dopt3dcitation,52240,52241,104481
54897,,url:http://www.csa.com/partners/viewrecord.php3frequester3dgs26collection3dtrd26recid3d0014651ci,52241,52242,104483
54898,,mvow5ddxnyqj,52242,52243,104485
54899,,h1hujkxawrmj,52243,52244,104487
54900,,thnm2feulksj,52244,52245,104489
54901,,vejln6rfdbuj,52245,52246,104491
54902,,a4trstszc5kj,52246,52247,104493
54903,,tcva-v-99rsj,52247,52248,104495
54904,,wkvvxd1fjoqj,52248,52249,104497
54905,,fmjom3xupvsj,52249,52250,104499
54906,,x5lkjrsuqguj,52250,52251,104501
54907,,dgdrtf52fbgj,52251,52252,104503
54908,,url:http://www.springerlink.com/index/v8888n398231366h.pdf,52252,52253,104505
54909,,c5xr1vtbsuqj,52253,52254,104507
54910,,srflsd3ixgmj,52254,52255,104509
54911,,wonztuovygwj,52255,52256,104511
54912,,iybwb32mmm8j,52256,52257,104513
54913,,infhymsixwqj,52257,52258,104515
54914,,p9anhitorjkj,52258,52259,104517
54915,,cifmtt3uyjqj,52260,52261,104521
54916,,gfnrsi-tskkj,52261,52262,104523
54917,,iroicdswskkj,52262,52263,104525
54918,,syyduhvozeej,52263,52264,104527
54919,,7vkvxnfsb8yj,52264,52265,104529
54920,,4din7f51n3mj,52266,52267,104533
54921,,pmwnpud-5esj,52267,52268,104535
54922,,12jxvv17ugoj,52268,52269,104537
54923,,url:http://portal.acm.org/ft_gateway.cfm3fid3d109958526type3dpdf,52269,52270,104539
54924,,sb4nakqzzp8j,52270,52271,104541
54925,,039vknghtukj,52271,52272,104543
54926,,7lpu8hbgkksj,52272,52273,104545
54927,,v9gshopvymyj,52273,52274,104547
54928,,amrqphl_onmj,52274,52275,104549
54929,,pcfviscszm8j,52275,52276,104551
54930,,tlmbnfdazdcj,52276,52277,104553
54931,,poitrzyklrgj,52277,52278,104555
54932,,eymocfbc6pcj,52278,52279,104557
54933,,wt8m_3lbausj,52279,52280,104559
54934,,frmknmtrsksj,52280,52281,104561
54935,,url:http://portal.acm.org/citation.cfm3fid3d1099554.1099727,52281,52282,104563
54936,,ae03agrdhxwj,52282,52283,104565
54937,,lbwsxlyenwij,52283,52284,104567
54938,,aozrvisc-l4j,52284,52285,104569
54939,,rkocxji8ns4j,52285,52286,104571
54940,,nvfnxdtjvtkj,52286,52287,104573
54941,,ayttmxvotimj,52287,52288,104575
54942,,mnmcavrf6pwj,52288,52289,104577
54943,,url:http://portal.acm.org/citation.cfm3fid3d264339,52289,52290,104579
54944,,h_egmyu5azgj,52290,52291,104581
54945,,uuckyqdsexoj,52291,52292,104583
54946,,url:http://portal.acm.org/citation.cfm3fid3d26397426dl3dacm26coll3dportal26cfid3d1111111126cftoken3d2222222,52292,52293,104585
54947,,izgqhg2t1smj,52293,52294,104587
54948,,zsosy07z99oj,52294,52295,104589
54949,,e6v8b3br450j,52295,52296,104591
54950,,aodhqwy_4vsj,52296,52297,104593
54951,,ulw6bb-oplaj,52297,52298,104595
54952,,url:http://www.springerlink.com/index/t611u9628153m1up.pdf,52298,52299,104597
54953,,h-dedxiifmkj,52299,52300,104599
54954,,ym4bckh_ngij,52300,52301,104601
54955,,uuisb7q5phgj,52301,52302,104603
54956,,xaksrkbpni4j,52302,52303,104605
54957,,4jygmwa5i0ej,52303,52304,104607
54958,,kzimuuvsv9yj,52304,52305,104609
54959,,zytzxxakjo0j,52305,52306,104611
54960,,_tjwhysos-uj,52306,52307,104613
54961,,eazxycxaec4j,52307,52308,104615
54962,,zqw40tjgfhmj,52308,52309,104617
54963,,ueanowxwrxqj,52309,52310,104619
54964,,czmkzep-r9gj,52310,52311,104621
54965,,xvprgggcbguj,52311,52312,104623
54966,,86-ds0u0jy0j,52312,52313,104625
54967,,e3xadr0vhisj,52313,52314,104627
54968,,wxgmn-txtcij,52314,52315,104629
54969,,u30gdgmfancj,52315,52316,104631
54970,,vv_zvs40oggj,52316,52317,104633
54971,,rxpumqpgp9wj,52317,52318,104635
54972,,zic4jluk7wsj,52318,52319,104637
54973,,fkcpp-h81x0j,52319,52320,104639
54974,,pqsau0ww1ngj,52320,52321,104641
54975,,3s5apqgkfiyj,52321,52322,104643
54976,,zmmdryiym9sj,52322,52323,104645
54977,,url:http://portal.acm.org/citation.cfm3fid3d645920,52323,52324,104647
54978,,ovodt8_hmuqj,52324,52325,104649
54979,,5esoxb3mlhcj,52325,52326,104651
54980,,so-x2gv11bkj,52326,52327,104653
54981,,1xpyjwlefomj,52327,52328,104655
54982,,hj7mtcljfwij,52328,52329,104657
54983,,lkdjd9ld8hij,52329,52330,104659
54984,,ftviff4tmlmj,52332,52333,104665
54985,,m5iz0ucsq9yj,52333,52334,104667
54986,,rkvwnzcccnuj,52334,52335,104669
54987,,52iq8up6khwj,52335,52336,104671
54988,,ryez4i4l66kj,52336,52337,104673
54989,,0vw_r9jzdwij,52337,52338,104675
54990,,lulaxkq7ucyj,52338,52339,104677
54991,,ggq-eisbrwej,52339,52340,104679
54992,,d7bjigqkqzcj,52340,52341,104681
54993,,j5t4fn3nd-qj,52341,52342,104683
54994,,n6ss2emfj1uj,52342,52343,104685
54995,,stgx-8psoooj,52343,52344,104687
54996,,8xagdhvdoaaj,52344,52345,104689
54997,,fcmfnj_-oe8j,52345,52346,104691
54998,,08-syfwphi8j,52346,52347,104693
54999,,og2wlz7kqmkj,52347,52348,104695
55000,,jsjjxmhfgxaj,52349,52350,104699
55001,,okhcmqyaoaqj,52350,52351,104701
55002,,tlqbo4lunb8j,52351,52352,104703
55003,,o84pim3imrgj,52352,52353,104705
55004,,qxkkjpngutqj,52353,52354,104707
55005,,8zavy0nqrrmj,52354,52355,104709
55006,,syeenzwltsmj,52355,52356,104711
55007,,kejxhyjevj8j,52356,52357,104713
55008,,o05yyxasf6uj,52357,52358,104715
55009,,tnm_vcawrsoj,52358,52359,104717
55010,,sy9jesiyzp8j,52359,52360,104719
55011,,5kegscoc8qkj,52360,52361,104721
55012,,s36eg_njqlmj,52361,52362,104723
55013,,url:http://portal.acm.org/citation.cfm3fid3d109080.109084,52363,52364,104727
55014,,0kqfslkdi1mj,52364,52365,104729
55015,,w-ms4ufqlv4j,52365,52366,104731
55016,,,52366,52367,104733
55017,,mjjz-spxgx8j,52367,52368,104735
55018,,219ostjehxej,52368,52369,104737
55019,,l6zmoxafamuj,52369,52370,104739
55020,,l166n4rnmvyj,52370,52371,104741
55021,,3gxax2ih3ayj,52371,52372,104743
55022,,r85yvn6u51kj,52372,52373,104745
55023,,8rbhpyfav9ej,52373,52374,104747
55024,,slu0r9ny2-sj,52374,52375,104749
55025,,0lca_i7xyksj,52375,52376,104751
55026,,o0udi5nepkcj,52376,52377,104753
55027,,url:http://portal.acm.org/citation.cfm3fid3d29682.29687,52377,52378,104755
55028,,url:http://doi.wiley.com/10.1002/he.11001,52378,52379,104757
55029,,3dkjmv0fkjcj,52379,52380,104759
55030,,8aq-uuf8344j,52380,52381,104761
55031,,xtu_f2nnfzej,52381,52382,104763
55032,,ta6-feoamasj,52382,52383,104765
55033,,fu2sir5y0nij,52383,52384,104767
55034,,nxxwxg8-gt8j,52384,52385,104769
55035,,url:http://portal.acm.org/citation.cfm3fid3d344816.34482026dl3dguide26dl3dacm26idx3dj68926part3dperiodical26wanttype3dperiodical26title3dacm2520sigmod2520record26cfid3d1111111126cftoken3d2222222,52385,52386,104771
55036,,bxq4eu-raimj,52386,52387,104773
55037,,1yks3eugx0cj,52387,52388,104775
55038,,o9bqh2rtkj8j,52388,52389,104777
55039,,dahabayvs5aj,52390,52391,104781
55040,,url:http://portal.acm.org/ft_gateway.cfm3fid3d110750626type3dpdf,52391,52392,104783
55041,,hasxhs9swbyj,52392,52393,104785
55042,,91abg-agd0qj,52393,52394,104787
55043,,zcp0smkv5zmj,52394,52395,104789
55044,,rjuzasw-jmsj,52395,52396,104791
55045,,j5bthj7upvkj,52396,52397,104793
55046,,ew4i4_5t32cj,52398,52399,104797
55047,,uoleeyagytqj,52399,52400,104799
55048,,osbvinnjsrsj,52400,52401,104801
55049,,rcm7m9ujsrqj,52401,52402,104803
55050,,wojmklt2euaj,52402,52403,104805
55051,,xmdvqbjvidyj,52403,52404,104807
55052,,fgt9qdr0jaoj,52404,52405,104809
55053,,elxozkwusasj,52405,52406,104811
55054,,bx8g6c2v6xuj,52406,52407,104813
55055,,yv8s72k-qzej,52407,52408,104815
55056,,6-5rluz4rlaj,52408,52409,104817
55057,,url:http://www.csa.com/partners/viewrecord.php3frequester3dgs26collection3dtrd26recid3d017512720214ai26recid3d017604720056ai,52409,52410,104819
55058,,e_kh3ijws-8j,52410,52411,104821
55059,,9faqjp-eb0kj,52411,52412,104823
55060,,jtd-gdufehej,52412,52413,104825
55061,,re9ytqjobwcj,52413,52414,104827
55062,,fhtziycu8rgj,52414,52415,104829
55063,,t8iqd5smq00j,52415,52416,104831
55064,,hzfnbbsxraij,52416,52417,104833
55065,,oekvodrz1dmj,52417,52418,104835
55066,,nts_9wrq0lkj,52418,52419,104837
55067,,ma4xushuj30j,52419,52420,104839
55068,,url:http://doi.wiley.com/10.1002/ace.174,52420,52421,104841
55069,,xqkqb49msfij,52421,52422,104843
55070,,2qcp18xnubsj,52422,52423,104845
55071,,ozaflqoxs4oj,52423,52424,104847
55072,,55skq1bgy48j,52424,52425,104849
55073,,2gyvwlfpyfqj,52425,52426,104851
55074,,7ovrrejv-taj,52426,52427,104853
55075,,eah1ibsj8rsj,52427,52428,104855
55076,,bbcvdb7gy00j,52428,52429,104857
55077,,2ikemlh1bgsj,52429,52430,104859
55078,,url:http://www.csa.com/partners/viewrecord.php3frequester3dgs26collection3dtrd26recid3da8622916ah,52430,52431,104861
55079,,ecmuriuo4qmj,52431,52432,104863
55080,,om_fky0rf8gj,52432,52433,104865
55081,,rpbtf7tknwej,52433,52434,104867
55082,,url:http://portal.acm.org/ft_gateway.cfm3fid3d110124926type3dpdf,52435,52436,104871
55083,,5n9a8i8-yjoj,52436,52437,104873
55084,,wobr8nub91kj,52437,52438,104875
55085,,ms7u1mtzxdqj,52438,52439,104877
55086,,n_c9llofzrwj,52439,52440,104879
55087,,kgyjgkzzna4j,52440,52441,104881
55088,,ru9a6zklm8yj,52441,52442,104883
55089,,8vz4aqqhpiaj,52442,52443,104885
55090,,xvijpwm3x68j,52443,52444,104887
55091,,h6sximhpdr8j,52444,52445,104889
55092,,yvtl64958xqj,52445,52446,104891
55093,,xsp2o8oiajmj,52446,52447,104893
55094,,plsrckyte24j,52448,52449,104897
55095,,3bb3muoopcmj,52449,52450,104899
55096,,q_q77hrcncqj,52450,52451,104901
55097,,pcaggtn55wkj,52451,52452,104903
55098,,hryfy32ygooj,52452,52453,104905
55099,,frphfeatixwj,52453,52454,104907
55100,,2dsdzy3twjej,52454,52455,104909
55101,,d8lxw2wjivgj,52455,52456,104911
55102,,viuwyqf5jhyj,52456,52457,104913
55103,,url:http://www.csa.com/partners/viewrecord.php3frequester3dgs26collection3dtrd26recid3da8622910ah,52457,52458,104915
55104,,ohteo5a7xxcj,52458,52459,104917
55105,,vukpel4oltkj,52459,52460,104919
55106,,pd6kokoujcqj,52460,52461,104921
55107,,rcryb9onqb4j,52461,52462,104923
55108,,07qgcb9_f_ij,52462,52463,104925
55109,,slf3dussw3sj,52463,52464,104927
55110,,url:http://portal.acm.org/citation.cfm3fid3d984409.98441426coll3dguide26dl3dacm26idx3dj68926part3dperiodical26wanttype3dperiodical26title3dacm2520sigmod2520record26cfid3d1111111126cftoken3d2222222,52464,52465,104929
55111,,s60xrcosuh0j,52465,52466,104931
55112,,mkfp-jnsnzoj,52466,52467,104933
55113,,ocph3bimztqj,52467,52468,104935
55114,,62ryhfe8y-cj,52468,52469,104937
55115,,k8izvwmywqwj,52469,52470,104939
55116,,h7com-onwwij,52470,52471,104941
55117,,lup3walfxcwj,52471,52472,104943
55118,,fenoicb6gwsj,52472,52473,104945
55119,,nvcynjhwddaj,52473,52474,104947
55120,,dua0m2lmu38j,52474,52475,104949
55121,,50au57yuhvaj,52475,52476,104951
55122,,ldtqlb5dk9kj,52476,52477,104953
55123,,75jkny0kgd4j,52477,52478,104955
55124,,3ly4tguu8nmj,52478,52479,104957
55125,,,52479,52480,104959
55126,,8szuszwf5syj,52480,52481,104961
55127,,kgsfamw5vdyj,52481,52482,104963
55128,,idlilhmmbtej,52482,52483,104965
55129,,ys4__xqf4csj,52483,52484,104967
55130,,s54-pu1wm4cj,52484,52485,104969
55131,,qv1yce2ioamj,52485,52486,104971
55132,,qa0ayaniwxgj,52486,52487,104973
55133,,fbdvhiz1ossj,52487,52488,104975
55134,,3wa2yk0g9kqj,52488,52489,104977
55135,,2rucn1lodi8j,52489,52490,104979
55136,,ag2yenusdcaj,52490,52491,104981
55137,,c1qhbwaho5sj,52491,52492,104983
55138,,_ldp0vevit0j,52492,52493,104985
55139,,597cex5tevuj,52493,52494,104987
55140,,xw90wvqc3eij,52494,52495,104989
55141,,_f-z-tr1rfaj,52495,52496,104991
55142,,jy1gqzkgtnkj,52496,52497,104993
55143,,hwp64rfgbeqj,52497,52498,104995
55144,,6mnnnra-bpoj,52498,52499,104997
55145,,mnkjonwks-sj,52499,52500,104999
55146,,_s0rzup2i2sj,52500,52501,105001
55147,,alk67nccbb0j,52501,52502,105003
55148,,volw9w7lxuij,52502,52503,105005
55149,,y4we4itpsfqj,52503,52504,105007
55150,,vcljuy6njsej,52504,52505,105009
55151,,fzv6m6ld5dwj,52505,52506,105011
55152,,k6lo9zfro34j,52506,52507,105013
55153,,cunaou45dokj,52507,52508,105015
55154,,qjcxegn6ar0j,52508,52509,105017
55155,,d8qwbtgr7swj,52509,52510,105019
55156,,ygrl9ygok1kj,52510,52511,105021
55157,,fay6r3plqowj,52511,52512,105023
55158,,nhxzmf2ndkyj,52512,52513,105025
55159,,h-do2f6uvfoj,52513,52514,105027
55160,,mjuzhsydy14j,52514,52515,105029
55161,,url:http://www.csa.com/partners/viewrecord.php3frequester3dgs26collection3dtrd26recid3d20021214039902mt26recid3da7423815ah,52515,52516,105031
55162,,v2hengvyzyej,52516,52517,105033
55163,,qj49didtrk8j,52517,52518,105035
55164,,bgu3dxgqt3yj,52518,52519,105037
55165,,rnft_--hj10j,52519,52520,105039
55166,,xddpfcifllqj,52520,52521,105041
55167,,7fue7yyrco4j,52521,52522,105043
55168,,xzi5g0tbkzkj,52522,52523,105045
55169,,g79wykzifp8j,52523,52524,105047
55170,,bmf7ixowvrsj,52524,52525,105049
55171,,jttj959vdakj,52525,52526,105051
55172,,url:http://portal.acm.org/ft_gateway.cfm3fid3d77700026type3dpdf26coll3dguide26dl3dacm26cfid3d1111111126cftoken3d2222222,52526,52527,105053
55173,,3l_zqojcpnyj,52527,52528,105055
55174,,4mt4gzyltk4j,52528,52529,105057
55175,,vpufbfrnxqsj,52529,52530,105059
55176,,yk8bgh1vnqgj,52530,52531,105061
55177,,vz-yeog1b2wj,52531,52532,105063
55178,,f1ota_2rd_uj,52532,52533,105065
55179,,q7jdk2p7leaj,52533,52534,105067
55180,,url:http://www.csa.com/partners/viewrecord.php3frequester3dgs26collection3dtrd26recid3d20021214040857mt26recid3da7340039ah,52534,52535,105069
55181,,zl8nh3jpw60j,52535,52536,105071
55182,,bdkztncdpx4j,52536,52537,105073
55183,,cpe35f3wrvkj,52538,52539,105077
55184,,97oq1yk7sryj,52539,52540,105079
55185,,8r9ixvj6qiyj,52540,52541,105081
55186,,rbxidn2oet8j,52541,52542,105083
55187,,216jjyx9rk4j,52542,52543,105085
55188,,i0gcz0e1cm0j,52543,52544,105087
55189,,pxp23rnl9mmj,52544,52545,105089
55190,,wa6zam0fliej,52545,52546,105091
55191,,tbcofqxsdh4j,52546,52547,105093
55192,,btjjczogo44j,52547,52548,105095
55193,,wajl5u0p9m4j,52548,52549,105097
55194,,url:http://doi.wiley.com/10.1002/anie.197809472,52549,52550,105099
55195,,eex9g9ac1gij,52550,52551,105101
55196,,hql50ja4_egj,52552,52553,105105
55197,,uwzecvzhtdsj,52553,52554,105107
55198,,riye2vpdduqj,52554,52555,105109
55199,,47kaoej6wiqj,52555,52556,105111
55200,,xr-03hdwcpgj,52556,52557,105113
55201,,url:http://portal.acm.org/citation.cfm3fid3d1107499.1107519,52557,52558,105115
55202,,zezpixdnipmj,52558,52559,105117
55203,,zqboj2r_9amj,52559,52560,105119
55204,,,52560,52561,105121
55205,,vwgmvb2g6yoj,52561,52562,105123
55206,,5x_17upjxukj,52562,52563,105125
55207,,m7pfpukqe80j,52563,52564,105127
55208,,wrjpbdw8fhkj,52564,52565,105129
55209,,gcencl5cftij,52565,52566,105131
55210,,wvyenyobbtgj,52566,52567,105133
55211,,62ev1gryowwj,52567,52568,105135
55212,,lko3snx0d2aj,52568,52569,105137
55213,,xxjiueabyvsj,52570,52571,105141
55214,,csozscyxq4ij,52571,52572,105143
55215,,o9at0c-ittij,52572,52573,105145
55216,,uyrlnymphoaj,52573,52574,105147
55217,,f0c-a-gybskj,52574,52575,105149
55218,,ph92-gs-nz4j,52575,52576,105151
55219,,url:http://portal.acm.org/citation.cfm3fid3d971699.31899126coll3dguide26dl3dacm26idx3dj68926part3dperiodical26wanttype3dperiodical26title3dacm2520sigmod2520record26cfid3d1111111126cftoken3d2222222,52576,52577,105153
55220,,ig7qmng6mqaj,52577,52578,105155
55221,,fphg04gn038j,52578,52579,105157
55222,,5yucqrqwywqj,52579,52580,105159
55223,,ywokaiyoy5aj,52580,52581,105161
55224,,eu08k_p1hamj,52581,52582,105163
55225,,-25vxxwwpuuj,52582,52583,105165
55226,,url:http://www.springerlink.com/index/p72227338m119u37.pdf,52583,52584,105167
55227,,zrmfhw3jqgwj,52584,52585,105169
55228,,wni1ihq2yd0j,52585,52586,105171
55229,,qyfekqyju7uj,52586,52587,105173
55230,,cz4flugg7l8j,52587,52588,105175
55231,,,52588,52589,105177
55232,,e7hq8hdxdsij,52589,52590,105179
55233,,1mafcdvhv3wj,52590,52591,105181
55234,,fvjfywokroej,52591,52592,105183
55235,,usvgbt02mxij,52592,52593,105185
55236,,dekr2m4m8mgj,52593,52594,105187
55237,,hf_6ftuh5aqj,52594,52595,105189
55238,,0zzscecmzucj,52595,52596,105191
55239,,vlfmpmegjuoj,52596,52597,105193
55240,,cb8a-22ieagj,52597,52598,105195
55241,,syipzgrt_u0j,52598,52599,105197
55242,,uk5ww0ccoywj,52599,52600,105199
55243,,pogotdj1t3aj,52600,52601,105201
55244,,fkggw0pu6xcj,52601,52602,105203
55245,,n0diy9dmkqej,52602,52603,105205
55246,,oyhtvbkeafej,52603,52604,105207
55247,,t5owr8cgrnmj,52604,52605,105209
55248,,,52605,52606,105211
55249,,njecpelrzvcj,52606,52607,105213
55250,,rsdge-xqyxgj,52607,52608,105215
55251,,vgwrwzbczhmj,52608,52609,105217
55252,,4s8p-kkrdt8j,52609,52610,105219
55253,,sua6ug99yisj,52610,52611,105221
55254,,oeddvnpvn1gj,52611,52612,105223
55255,,ti2cpyixynoj,52612,52613,105225
55256,,reaiq79h-y4j,52613,52614,105227
55257,,url:http://www.csa.com/partners/viewrecord.php3frequester3dgs26collection3dtrd26recid3d2271662ci,52614,52615,105229
55258,,izy_1rltub8j,52615,52616,105231
55259,,8ltuzvzboeuj,52616,52617,105233
55260,,cxbugiwz5asj,52617,52618,105235
55261,,t_makoxfrawj,52618,52619,105237
55262,,y0remwi1aaaj,52619,52620,105239
55263,,ezjrphh-fgyj,52620,52621,105241
55264,,ep6bi2m5jwcj,52621,52622,105243
55265,,cweu1otjur8j,52622,52623,105245
55266,,0tdyycejpfij,52623,52624,105247
55267,,5pisy7jvbzqj,52624,52625,105249
55268,,hhn0e5-xs7gj,52625,52626,105251
55269,,4zsfmtyn7_qj,52626,52627,105253
55270,,jrkrubnslwej,52627,52628,105255
55271,,ooydkm_xlhmj,52628,52629,105257
55272,,zkyfavjbn8wj,52629,52630,105259
55273,,g-ggezekjt8j,52630,52631,105261
55274,,hvqkekdpzqaj,52631,52632,105263
55275,,dy00wctjnl4j,52632,52633,105265
55276,,1u2g2z08tb4j,52633,52634,105267
55277,,oxxfhsmwzggj,52634,52635,105269
55278,,e1emgulnxnyj,52635,52636,105271
55279,,nwssvqwm2h8j,52636,52637,105273
55280,,aueesd6xjcqj,52637,52638,105275
55281,,kdqgl9duog8j,52638,52639,105277
55282,,60sqzfezyroj,52639,52640,105279
55283,,t2uxg8ainjoj,52640,52641,105281
55284,,r7baazjbmrsj,52641,52642,105283
55285,,jtc2ejjain0j,52642,52643,105285
55286,,jejrcl54kasj,52643,52644,105287
55287,,clkqpkkzoluj,52644,52645,105289
55288,,0kalaojkouuj,52645,52646,105291
55289,,y-nuhok2bjaj,52646,52647,105293
55290,,tqpr3n8v2hcj,52647,52648,105295
55291,,dk1ix-tec-uj,52648,52649,105297
55292,,url:http://www.csa.com/partners/viewrecord.php3frequester3dgs26collection3denv26recid3d7906913,52649,52650,105299
55293,,uywknlfjbbqj,52650,52651,105301
55294,,1reaoz9xuc4j,52651,52652,105303
55295,,9iyowcjlsc8j,52652,52653,105305
55296,,u5cpwhkvee8j,52653,52654,105307
55297,,lp1fwn61_6yj,52654,52655,105309
55298,,hq_lxmpirjuj,52655,52656,105311
55299,,dnutllubjwij,52656,52657,105313
55300,,aqy1kkcek1mj,52657,52658,105315
55301,,5zeyqz95zraj,52658,52659,105317
55302,,zjyecwk5960j,52659,52660,105319
55303,,lfzogsfdvhcj,52660,52661,105321
55304,,2ygydc1uslej,52661,52662,105323
55305,,jtos3uqpkeej,52662,52663,105325
55306,,y04ljfyni9uj,52663,52664,105327
55307,,og0_ptcqizaj,52665,52666,105331
55308,,s-bnlg-eglyj,52666,52667,105333
55309,,wm2pbjarxt0j,52667,52668,105335
55310,,m0ryzqakxpij,52668,52669,105337
55311,,87x7cvri_rmj,52669,52670,105339
55312,,sdpl8rfpd88j,52670,52671,105341
55313,,zqss2tsu9-wj,52671,52672,105343
55314,,jsh4wkcob_kj,52672,52673,105345
55315,,khdwyg7xkmcj,52674,52675,105349
55316,,23l2_cggtjkj,52675,52676,105351
55317,,uzqvcpokd6sj,52676,52677,105353
55318,,orrt25wtbjij,52677,52678,105355
55319,,url:http://www.csa.com/partners/viewrecord.php3frequester3dgs26collection3dtrd26recid3d2109007ci,52678,52679,105357
55320,,,52679,52680,105359
55321,,8bhefbvoygij,52680,52681,105361
55322,,mn-6g6re9mqj,52681,52682,105363
55323,,k53ramfehogj,52682,52683,105365
55324,,vbb3ten9p6ej,52683,52684,105367
55325,,iuukdqgdbesj,52684,52685,105369
55326,,url:http://www.csa.com/partners/viewrecord.php3frequester3dgs26collection3dtrd26recid3d8708g2p0264ep,52686,52687,105373
55327,,ugj-5y5lyuuj,52687,52688,105375
55328,,gnzpu-fqzxej,52688,52689,105377
55329,,iuh1y5tciagj,52689,52690,105379
55330,,3fr97y_3wxyj,52690,52691,105381
55331,,ulmudvlvdr4j,52691,52692,105383
55332,,nt-s70ri7yoj,52692,52693,105385
55333,,njfj4cl002oj,52693,52694,105387
55334,,6d45evzdaz4j,52694,52695,105389
55335,,url:http://portal.acm.org/ft_gateway.cfm3fid3d106624926type3dpdf,52695,52696,105391
55336,,wvzxc6suhjaj,52696,52697,105393
55337,,drwsvwckqdkj,52697,52698,105395
55338,,rrjchq2mdbgj,52699,52700,105399
55339,,0ofmgy2rdfij,52700,52701,105401
55340,,knf3jvt1sbij,52702,52703,105405
55341,,qhlqcctivlkj,52703,52704,105407
55342,,upq8d9kpeeej,52704,52705,105409
55343,,x1bdjc0twkkj,52705,52706,105411
55344,,rkgajj3mtp0j,52706,52707,105413
55345,,ps1fkornw_cj,52707,52708,105415
55346,,gcsadakhiaaj,52708,52709,105417
55347,,ezdxmefj-bkj,52709,52710,105419
55348,,a8h0hmj2k8ej,52710,52711,105421
55349,,jzw37eqnjy8j,52711,52712,105423
55350,,viz7ygqtac8j,52712,52713,105425
55351,,pcsai2xxtpoj,52713,52714,105427
55352,,xldimr2v1k4j,52714,52715,105429
55353,,ih_-vupbvyuj,52715,52716,105431
55354,,a8stezibvuej,52716,52717,105433
55355,,yctqqimyr74j,52717,52718,105435
55356,,exkcdnbnqyyj,52718,52719,105437
55357,,5g5gosh09fuj,52719,52720,105439
55358,,v-uqxhv__scj,52720,52721,105441
55359,,0fvcbcleh6mj,52721,52722,105443
55360,,cqcm1bq28lej,52722,52723,105445
55361,,yb0k0ssyb0ij,52723,52724,105447
55362,,bdu4dh_z5voj,52724,52725,105449
55363,,altqhkk-5lyj,52725,52726,105451
55364,,bwxzhnufy0cj,52726,52727,105453
55365,,_3_ey7eserij,52727,52728,105455
55366,,qbnufl5e3ggj,52728,52729,105457
55367,,w0sthf_5zs0j,52729,52730,105459
55368,,grt1ywvpwtqj,52730,52731,105461
55369,,ryz4xjbb3qmj,52731,52732,105463
55370,,1o7iwv-qy3ij,52732,52733,105465
55371,,awnznp3bbhyj,52733,52734,105467
55372,,hzlumbpnxwqj,52734,52735,105469
55373,,f3enash0ptgj,52735,52736,105471
55374,,uqfz_ftarfsj,52736,52737,105473
55375,,xomfmcdegw8j,52737,52738,105475
55376,,url:http://www.csa.com/partners/viewrecord.php3frequester3dgs26collection3denv26recid3d8913241,52738,52739,105477
55377,,5b6aovbnutmj,52739,52740,105479
55378,,ck_paaipsqgj,52740,52741,105481
55379,,tzhnidniug0j,52741,52742,105483
55380,,ctzluz5_cfkj,52742,52743,105485
55381,,jejplggv4aaj,52743,52744,105487
55382,,vjsv4-q95esj,52745,52746,105491
55383,,at-nidpodb4j,52746,52747,105493
55384,,tyrxysvqn3mj,52747,52748,105495
55385,,pweid-rasecj,52748,52749,105497
55386,,zofiaetdsdkj,52749,52750,105499
55387,,n0gea3zn-0cj,52750,52751,105501
55388,,im4yzqqbjakj,52751,52752,105503
55389,,7y50g20ltdij,52752,52753,105505
55390,,nshmlzxjs2qj,52753,52754,105507
55391,,,52754,52755,105509
55392,,uicezqcuzq8j,52755,52756,105511
55393,,8hs3gwctcdwj,52756,52757,105513
55394,,4ffxal12l18j,52757,52758,105515
55395,,weyoume8ml8j,52758,52759,105517
55396,,nhnwtke4jfej,52759,52760,105519
55397,,ohc8pwebugcj,52760,52761,105521
55398,,url:http://www.csa.com/partners/viewrecord.php3frequester3dgs26collection3dtrd26recid3dn9210409ah,52761,52762,105523
55399,,nadbcjuvgnkj,52762,52763,105525
55400,,99t9vlcwjd4j,52763,52764,105527
55401,,gzo6lrn5zewj,52764,52765,105529
55402,,wltzf1qtbtej,52765,52766,105531
55403,,lgun5gzsitij,52766,52767,105533
55404,,zpkmymsidcwj,52767,52768,105535
55405,,ojhb9cmer-qj,52768,52769,105537
55406,,s4yokynxny8j,52769,52770,105539
55407,,28pbmrr38j4j,52770,52771,105541
55408,,krtojqecptcj,52771,52772,105543
55409,,mtvoe5j-dduj,52772,52773,105545
55410,,q_57xls2dqaj,52773,52774,105547
55411,,xs0g9j8j7woj,52774,52775,105549
55412,,wexy9z3lgh0j,52775,52776,105551
55413,,6ypgazu1394j,52776,52777,105553
55414,,yrcdnrhrqrqj,52777,52778,105555
55415,,xc10c5lhslmj,52778,52779,105557
55416,,vx5opeupg7kj,52779,52780,105559
55417,,a_rpui7a_caj,52780,52781,105561
55418,,yffnprpb6xoj,52781,52782,105563
55419,,csv3nefb0baj,52782,52783,105565
55420,,gb3vzq6hlrgj,52783,52784,105567
55421,,p5eommk_itwj,52784,52785,105569
55422,,zmqrvndyblqj,52786,52787,105573
55423,,4swc9mhwn6yj,52787,52788,105575
55424,,6lg1xjt3kdcj,52788,52789,105577
55425,,swy_ijvea-gj,52789,52790,105579
55426,,phkxkubwflwj,52790,52791,105581
55427,,kulz0nwc1dcj,52792,52793,105585
55428,,pferu0azlgkj,52793,52794,105587
55429,,-6mkjuxfecmj,52794,52795,105589
55430,,ikdnup6g6uaj,52795,52796,105591
55431,,nxy4-xg0foej,52796,52797,105593
55432,,k8jdpvl-gfej,52797,52798,105595
55433,,ugmwrkan8eyj,52798,52799,105597
55434,,7zhozi4sdf8j,52799,52800,105599
55435,,lou2xazpvlaj,52800,52801,105601
55436,,g0meteppp2oj,52801,52802,105603
55437,,rjtgk9thtqaj,52802,52803,105605
55438,,tfua828cptuj,52803,52804,105607
55439,,vw9ufiz3mdyj,52804,52805,105609
55440,,vqigbw_wiqgj,52805,52806,105611
55441,,gcbm07oeuhkj,52806,52807,105613
55442,,s44yaaodifcj,52807,52808,105615
55443,,url:http://portal.acm.org/citation.cfm3fid3d155398,52808,52809,105617
55444,,ezbwibvppzcj,52809,52810,105619
55445,,1aijwq2oxiaj,52810,52811,105621
55446,,suardc274cij,52811,52812,105623
55447,,ctusm41u504j,52812,52813,105625
55448,,y-o6vy2pjsqj,52813,52814,105627
55449,,,52814,52815,105629
55450,,hqz0_ldbdfij,52815,52816,105631
55451,,hpgjb2dqteej,52816,52817,105633
55452,,skkomafsegsj,52817,52818,105635
55453,,cjiz00vb9f4j,52818,52819,105637
55454,,50eujmx17-uj,52819,52820,105639
55455,,dh-qr88pew4j,52820,52821,105641
55456,,r9izqku-br8j,52821,52822,105643
55457,,1_dga5f7zcyj,52822,52823,105645
55458,,url:http://doi.ieeecs.org/10.1109/2.48800,52823,52824,105647
55459,,7jv_on7plx8j,52824,52825,105649
55460,,epprulxijekj,52825,52826,105651
55461,,ua-gcibdyhqj,52826,52827,105653
55462,,mldeekduu_sj,52827,52828,105655
55463,,m0f7nonmygej,52828,52829,105657
55464,,fpc8rkn9obij,52829,52830,105659
55465,,m__6zfqtgk8j,52831,52832,105663
55466,,hso6wb0o1uwj,52832,52833,105665
55467,,p2tn5accqm4j,52833,52834,105667
55468,,b_wura_duiwj,52834,52835,105669
55469,,uqrax1x54foj,52835,52836,105671
55470,,x9kug78ysekj,52836,52837,105673
55471,,nfeoememsgij,52837,52838,105675
55472,,ukyvivevw7wj,52838,52839,105677
55473,,tkxnhwcn2vkj,52839,52840,105679
55474,,hnm2fi9-ogaj,52840,52841,105681
55475,,mvtj_eoinfmj,52841,52842,105683
55476,,tdgahkjyiuyj,52842,52843,105685
55477,,8sghpxc060oj,52843,52844,105687
55478,,hpvokh6bgfsj,52844,52845,105689
55479,,jgu37tkqbk8j,52845,52846,105691
55480,,wab2f5pcg1ej,52846,52847,105693
55481,,tsrseyjm8yoj,52848,52849,105697
55482,,oolhrkxtogwj,52849,52850,105699
55483,,8z40h239w9yj,52850,52851,105701
55484,,fxcbloui6emj,52852,52853,105705
55485,,url:http://doi.wiley.com/10.1002/tl.77,52853,52854,105707
55486,,my4v-vzuoqcj,52854,52855,105709
55487,,hk2lzbke6hqj,52855,52856,105711
55488,,ppwdbbohjcsj,52856,52857,105713
55489,,qimij7d3bqaj,52857,52858,105715
55490,,lh-jm7waap8j,52858,52859,105717
55491,,lwsdrcy-ek0j,52859,52860,105719
55492,,uppakh3-6ysj,52860,52861,105721
55493,,yfek1m-3ywwj,52861,52862,105723
55494,,gwfihpcktfqj,52862,52863,105725
55495,,url:http://portal.acm.org/citation.cfm3fid3d325420,52863,52864,105727
55496,,h1_dy_cl0hoj,52864,52865,105729
55497,,gmjo6gekjygj,52865,52866,105731
55498,,dtjnruc5izkj,52866,52867,105733
55499,,5gdhzhaniscj,52867,52868,105735
55500,,url:http://portal.acm.org/ft_gateway.cfm3fid3d108369726type3dpdf,52868,52869,105737
55501,,dzi1j_okgq0j,52869,52870,105739
55502,,3eeselhocxwj,52870,52871,105741
55503,,toubbmcgurmj,52871,52872,105743
55504,,6t7kym71uocj,52872,52873,105745
55505,,url:http://www.springerlink.com/index/h64267r38p0420qj.pdf,52873,52874,105747
55506,,wdtbttlzewwj,52874,52875,105749
55507,,vqwfi9de9jgj,52875,52876,105751
55508,,6uklwrtdnzgj,52876,52877,105753
55509,,url:http://portal.acm.org/ft_gateway.cfm3fid3d109971326type3dpdf,52877,52878,105755
55510,,zpzpwdzvnbcj,52878,52879,105757
55511,,1gc93dzxwk8j,52879,52880,105759
55512,,zvozkp7vdsyj,52880,52881,105761
55513,,2qzdnp5p63wj,52881,52882,105763
55514,,z0um_vmbymuj,52882,52883,105765
55515,,xxczop-apvaj,52884,52885,105769
55516,,yvby95ecjkkj,52885,52886,105771
55517,,sr42pjdvzoqj,52886,52887,105773
55518,,ikxsrw1tjvwj,52887,52888,105775
55519,,z0ckobv5znej,52888,52889,105777
55520,,kbv_nwqyuy8j,52889,52890,105779
55521,,zlzbzgaljaij,52890,52891,105781
55522,,bwuxipzzdtmj,52891,52892,105783
55523,,kfkma_z8l-4j,52892,52893,105785
55524,,ivfw7z0tec4j,52893,52894,105787
55525,,ocsopfr8mwej,52894,52895,105789
55526,,6yqi6cgi8fcj,52895,52896,105791
55527,,g9p1w4pip_yj,52896,52897,105793
55528,,v96_rvthkwoj,52897,52898,105795
55529,,yq5b_cexcyqj,52898,52899,105797
55530,,yrpxefx4sboj,52899,52900,105799
55531,,dfssbdun4gyj,52900,52901,105801
55532,,2zje5bb_pasj,52901,52902,105803
55533,,erlfq86zddej,52902,52903,105805
55534,,ycl8eazcvigj,52903,52904,105807
55535,,lc-yy1wxmvmj,52904,52905,105809
55536,,p0jobdhegyqj,52905,52906,105811
55537,,yt7arstjay0j,52906,52907,105813
55538,,cowptdqpe7mj,52907,52908,105815
55539,,bnbms_l7macj,52908,52909,105817
55540,,fbmlewe2pkmj,52909,52910,105819
55541,,_ol6vdp1noqj,52910,52911,105821
55542,,5kjyf-iro68j,52911,52912,105823
55543,,url:http://www.csa.com/partners/viewrecord.php3frequester3dgs26collection3dtrd26recid3d0122458en,52912,52913,105825
55544,,url:http://ieeexplore.ieee.org/iel3/3990/11481/00547801.pdf3farnumber3d547801,52913,52914,105827
55545,,5ogozrdqnnsj,52914,52915,105829
55546,,egvoh6shlhuj,52915,52916,105831
55547,,vzzramrsvqmj,52916,52917,105833
55548,,vwwcmu84pvsj,52917,52918,105835
55549,,m6qs1prhdwkj,52918,52919,105837
55550,,pgg9xbaszgoj,52919,52920,105839
55551,,,52920,52921,105841
55552,,ujkakpizncoj,52921,52922,105843
55553,,omezyds8kaaj,52922,52923,105845
55554,,sdnuq7g8gcej,52923,52924,105847
55555,,-3xpmt4r4g0j,52924,52925,105849
55556,,2hr8jewpqkaj,52925,52926,105851
55557,,qqf0hqiwldkj,52926,52927,105853
55558,,fpzw-vfkncyj,52927,52928,105855
55559,,2wu39nhb1wqj,52928,52929,105857
55560,,jugkoydsdccj,52929,52930,105859
55561,,qyc3pniiwgej,52930,52931,105861
55562,,url:http://www.csa.com/partners/viewrecord.php3frequester3dgs26collection3dtrd26recid3d0804930ci,52931,52932,105863
55563,,06x3z-f8jrwj,52932,52933,105865
55564,,va_ecx-qhcuj,52933,52934,105867
55565,,yey0ahiq8dkj,52934,52935,105869
55566,,0rdjk3pms9sj,52935,52936,105871
55567,,2gnip93epmwj,52936,52937,105873
55568,,url:http://portal.acm.org/citation.cfm3fdoid3d263690.264347,52937,52938,105875
55569,,cn6vd0ympjuj,52938,52939,105877
55570,,url:http://links.jstor.org/sici3fsici3d0146-4949(196124)2253a1253c54253a2522esae2522253e2.0.co253b2-s,52939,52940,105879
55571,,6iblyrosph0j,52940,52941,105881
55572,,url:http://portal.acm.org/ft_gateway.cfm3fid3d98440526type3dpdf26dl3dportal26dl3dacm26cfid3d1111111126cftoken3d2222222,52942,52943,105885
55573,,bfoxljhy1hwj,52943,52944,105887
55574,,t8kdgcsg9rij,52944,52945,105889
55575,,n1v_guwgbyij,52945,52946,105891
55576,,aiplk6bo8dij,52946,52947,105893
55577,,2sh0sp2ejk4j,52947,52948,105895
55578,,_sqjhawij3kj,52948,52949,105897
55579,,ay9h_tgpkqoj,52949,52950,105899
55580,,hemhqq9lxssj,52950,52951,105901
55581,,xk7gojjkjzgj,52951,52952,105903
55582,,ltzbck4ghhgj,52952,52953,105905
55583,,tqiyofwohkwj,52953,52954,105907
55584,,373qb6hpdbsj,52954,52955,105909
55585,,mtew6ozwpsgj,52955,52956,105911
55586,,rgk1hyjbtnej,52956,52957,105913
55587,,w5-bj8vvwlsj,52957,52958,105915
55588,,sgxbkjfla3oj,52958,52959,105917
55589,,url:http://portal.acm.org/ft_gateway.cfm3fid3d108380326type3dpdf,52959,52960,105919
55590,,url:http://doi.wiley.com/10.1002/tl.95,52960,52961,105921
55591,,9uekkgjgmggj,52961,52962,105923
55592,,nk1bfr7m9fcj,52962,52963,105925
55593,,s5zemkaipvqj,52963,52964,105927
55594,,7mulqneuph0j,52964,52965,105929
55595,,u9atcjimfjuj,52965,52966,105931
55596,,url:http://www.csa.com/partners/viewrecord.php3frequester3dgs26collection3dtrd26recid3dn9210523ah,52966,52967,105933
55597,,ixqlv8_n7fij,52967,52968,105935
55598,,y_11zv4cxasj,52968,52969,105937
55599,,xr7e71bhcioj,52969,52970,105939
55600,,8n1mkj-hvt8j,52970,52971,105941
55601,,wabggqiotmwj,52971,52972,105943
55602,,pmuqptyhlagj,52972,52973,105945
55603,,g72vrgccrjij,52973,52974,105947
55604,,w7zmokzykbuj,52974,52975,105949
55605,,nlsnmsfhixkj,52975,52976,105951
55606,,vo7zdcg5y3sj,52976,52977,105953
55607,,1idhb0mjr-ij,52977,52978,105955
55608,,390vtbxnlfyj,52978,52979,105957
55609,,tjp9f6-tcdmj,52979,52980,105959
55610,,flupvtf1gvkj,52980,52981,105961
55611,,yfkv4peg_5ej,52981,52982,105963
55612,,suxtcbtl2fkj,52982,52983,105965
55613,,yjzolbzep6wj,52984,52985,105969
55614,,jy06jewg7zqj,52985,52986,105971
55615,,z8n-ler24akj,52986,52987,105973
55616,,l2capgbqzpoj,52987,52988,105975
55617,,txtkvvdyot4j,52988,52989,105977
55618,,lfmsozycn2kj,52989,52990,105979
55619,,su8gajzec7cj,52990,52991,105981
55620,,6j5s_q9j5r0j,52991,52992,105983
55621,,clzmclddqnsj,52992,52993,105985
55622,,tkx_k3_dqt8j,52993,52994,105987
55623,,8nrpge6u3xgj,52994,52995,105989
55624,,x1mbcviuinwj,52995,52996,105991
55625,,ie7jvdhtvn0j,52996,52997,105993
55626,,tcvvagj50nuj,52997,52998,105995
55627,,,52998,52999,105997
55628,,i-cz1vzv4tqj,52999,53000,105999
55629,,v0vmh66jzmyj,53000,53001,106001
55630,,izwcgwe_wmqj,53001,53002,106003
55631,,s-gdwtdbbuij,53002,53003,106005
55632,,vbtqxu3sjacj,53003,53004,106007
55633,,8tilrozxt9sj,53004,53005,106009
55634,,ghmpur5vhj4j,53005,53006,106011
55635,,oadiqaqrn3kj,53006,53007,106013
55636,,5mrlrphf1gaj,53007,53008,106015
55637,,zgyl0ep2xsyj,53008,53009,106017
55638,,jsecrnufiz8j,53009,53010,106019
55639,,url:http://portal.acm.org/ft_gateway.cfm3fid3d101655326type3dpdf,53010,53011,106021
55640,,9zzvavyuha0j,53011,53012,106023
55641,,tdlwku1ve8oj,53012,53013,106025
55642,,zg3bor1rtdij,53013,53014,106027
55643,,ytdksya9_tgj,53014,53015,106029
55644,,hc029kxuhx8j,53015,53016,106031
55645,,lrfidfux_ugj,53016,53017,106033
55646,,url:http://www.csa.com/partners/viewrecord.php3frequester3dgs26collection3dtrd26recid3d1568251ci,53017,53018,106035
55647,,p4glatbxopej,53018,53019,106037
55648,,43uvlfx9xagj,53020,53021,106041
55649,,hdkdfhicamsj,53021,53022,106043
55650,,zt97ebvc_80j,53022,53023,106045
55651,,znxv9yg5jbij,53023,53024,106047
55652,,poizh_1ba80j,53024,53025,106049
55653,,sd_prs659ugj,53025,53026,106051
55654,,wtxp8oyjja8j,53026,53027,106053
55655,,lozkh9mhjhkj,53027,53028,106055
55656,,,53028,53029,106057
55657,,ka1uaicm4aij,53029,53030,106059
55658,,eo45uny09e4j,53030,53031,106061
55659,,bqvwrocyvdwj,53031,53032,106063
55660,,url:http://ieeexplore.ieee.org/iel1/2206/2510/00075479.pdf3farnumber3d75479,53032,53033,106065
55661,,bpnw-y0oagmj,53033,53034,106067
55662,,r4evad53rucj,53034,53035,106069
55663,,xidfmjejg9aj,53035,53036,106071
55664,,fdl8vltolj8j,53036,53037,106073
55665,,0owqkainec4j,53038,53039,106077
55666,,vvcgwc_k_44j,53039,53040,106079
55667,,hzltc4qpbggj,53040,53041,106081
55668,,fjxmfw4ovhkj,53042,53043,106085
55669,,l0coudjq4p0j,53043,53044,106087
55670,,dagci0z5hicj,53044,53045,106089
55671,,wyzwpltvtnkj,53045,53046,106091
55672,,4zhibcir4qoj,53046,53047,106093
55673,,3g3yim45yg8j,53047,53048,106095
55674,,url:http://adsabs.harvard.edu/abs/1973phdt.........1a,53048,53049,106097
55675,,4e72p3ent0ej,53049,53050,106099
55676,,pxjthpjhii4j,53051,53052,106103
55677,,kbzw5jriev0j,53052,53053,106105
55678,,6ji0itdhszqj,53053,53054,106107
55679,,0s_fuwpw0cgj,53054,53055,106109
55680,,g6tpl25miwqj,53055,53056,106111
55681,,url:http://portal.acm.org/citation.cfm3fid3d171926.171999,53056,53057,106113
55682,,url:http://doi.wiley.com/10.1002/ace.160,53057,53058,106115
55683,,,53058,53059,106117
55684,,nnndfqcozdgj,53059,53060,106119
55685,,gfonzljieisj,53060,53061,106121
55686,,u_tnkp2gpimj,53061,53062,106123
55687,,q-vnebweszoj,53062,53063,106125
55688,,hgu3ouwbyggj,53063,53064,106127
55689,,url:http://portal.acm.org/ft_gateway.cfm3fid3d108532826type3dpdf,53064,53065,106129
55690,,ka3mhv3hnnkj,53065,53066,106131
55691,,mvyrmxhijgkj,53066,53067,106133
55692,,b1lcbim6y3gj,53067,53068,106135
55693,,uxyyuvzlghij,53068,53069,106137
55694,,5urmlimjwyyj,53069,53070,106139
55695,,brdusv3tyjyj,53070,53071,106141
55696,,ckgjif-y1-yj,53071,53072,106143
55697,,url:http://portal.acm.org/citation.cfm3fid3d984488.98449226coll3dguide26dl3dacm26idx3dj68926part3dperiodical26wanttype3dperiodical26title3dacm2520sigmod2520record26cfid3d1111111126cftoken3d2222222,53072,53073,106145
55698,,79etqbjf5eqj,53073,53074,106147
55699,,yzp93loa118j,53074,53075,106149
55700,,k9sqstcs82sj,53075,53076,106151
55701,,zsn793nkqfsj,53076,53077,106153
55702,,-6etobvkctmj,53077,53078,106155
55703,,mmetfwxb-zyj,53078,53079,106157
55704,,3qgcp_pp7ksj,53079,53080,106159
55705,,s933ltzl-egj,53080,53081,106161
55706,,0gflgfwpy6cj,53081,53082,106163
55707,,hldevkd7qrgj,53082,53083,106165
55708,,yhvtmpuendmj,53083,53084,106167
55709,,rp9kxcy639oj,53084,53085,106169
55710,,gbbdu5m7b5aj,53085,53086,106171
55711,,d0l3ufxoyx4j,53086,53087,106173
55712,,3i0zaluv9soj,53087,53088,106175
55713,,6cwddkhqkhuj,53088,53089,106177
55714,,cvyihf7mxl0j,53089,53090,106179
55715,,af3784wnokuj,53090,53091,106181
55716,,url:http://www.ingentaconnect.com/search/expand3fpub3dinfobike://els/09505849/1997/00000039/00000007/art0000326unc3d,53091,53092,106183
55717,,u2n-jj3dskgj,53092,53093,106185
55718,,unibqoxqz_ej,53093,53094,106187
55719,,gaz7fydfx2qj,53094,53095,106189
55720,,bvnprcwnlm0j,53095,53096,106191
55721,,0mzphiiyp9ij,53096,53097,106193
55722,,goiwft8kgxcj,53097,53098,106195
55723,,qvxxoi7etn8j,53098,53099,106197
55724,,w-xtil-xdqyj,53099,53100,106199
55725,,ukxtosbbxm0j,53100,53101,106201
55726,,znvjxhgaqrij,53102,53103,106205
55727,,ni5jo1oqeqej,53103,53104,106207
55728,,qt9wyf1jngij,53104,53105,106209
55729,,cu6zhtownumj,53105,53106,106211
55730,,hwjihw6pcfmj,53106,53107,106213
55731,,url:http://www.csa.com/partners/viewrecord.php3frequester3dgs26collection3dtrd26recid3d0011794ci,53107,53108,106215
55732,,9tsqazkl5-cj,53108,53109,106217
55733,,url:http://www.csa.com/partners/viewrecord.php3frequester3dgs26collection3dtrd26recid3dn9210551ah,53109,53110,106219
55734,,hwgxht8bsusj,53110,53111,106221
55735,,ue7rih93rncj,53111,53112,106223
55736,,url:http://portal.acm.org/citation.cfm3fid3d375796,53112,53113,106225
55737,,ylptierg22ej,53113,53114,106227
55738,,mfbyb51nkumj,53114,53115,106229
55739,,flityix6w2sj,53115,53116,106231
55740,,-7q0rf9eokkj,53116,53117,106233
55741,,9dzlz-che7qj,53117,53118,106235
55742,,7nukcltksumj,53118,53119,106237
55743,,lf7-dxg7fssj,53120,53121,106241
55744,,pwr5agq-qaij,53121,53122,106243
55745,,7kf2ecqwfrkj,53122,53123,106245
55746,,fh_6qh5afwuj,53123,53124,106247
55747,,7wodjh17aaaj,53124,53125,106249
55748,,url:http://www.csa.com/partners/viewrecord.php3frequester3dgs26collection3dtrd26recid3d200111010671mt26recid3da0032574ah,53125,53126,106251
55749,,qvrydndrzlaj,53127,53128,106255
55750,,xcaydlfhj6gj,53128,53129,106257
55751,,8ae3zt5rfo4j,53129,53130,106259
55752,,3otzvmgwm2kj,53130,53131,106261
55753,,2vc4cesvragj,53131,53132,106263
55754,,y9vnexstrjsj,53132,53133,106265
55755,,fa4wq1q4k08j,53133,53134,106267
55756,,qagm_an5sxmj,53134,53135,106269
55757,,e7zen8dridcj,53135,53136,106271
55758,,ywwpljx0tqmj,53136,53137,106273
55759,,url:http://ieeexplore.ieee.org/iel1/2206/2685/00081888.pdf3farnumber3d81888,53137,53138,106275
55760,,55i1t72k4mij,53138,53139,106277
55761,,vir3ygllm7gj,53139,53140,106279
55762,,wtrthyai_bej,53140,53141,106281
55763,,sdaporj8trkj,53141,53142,106283
55764,,cigkfxghikcj,53142,53143,106285
55765,,lofrmteammsj,53143,53144,106287
55766,,vka-ljalr6oj,53144,53145,106289
55767,,u9en84liiroj,53145,53146,106291
55768,,foixozf8nv8j,53146,53147,106293
55769,,zsbhhy2agvej,53147,53148,106295
55770,,l-2eq2mtzasj,53148,53149,106297
55771,,,53150,53151,106301
55772,,pj3pn-8yizmj,53151,53152,106303
55773,,1s5f4qmkowyj,53152,53153,106305
55774,,btnaz-66mymj,53153,53154,106307
55775,,zb79qnwcjxaj,53154,53155,106309
55776,,970nqgyt9dqj,53155,53156,106311
55777,,tccoixof1iaj,53156,53157,106313
55778,,pybe8duxjmsj,53157,53158,106315
55779,,j5yhm7symzcj,53158,53159,106317
55780,,a-basptxh0ej,53159,53160,106319
55781,,3ppvkzbqbrwj,53160,53161,106321
55782,,_8rwxvk-ezuj,53161,53162,106323
55783,,,53162,53163,106325
55784,,ydzoel9wep4j,53163,53164,106327
55785,,u-ujiunucowj,53164,53165,106329
55786,,hqwtefu3l3aj,53165,53166,106331
55787,,b6kkhj0c-1yj,53166,53167,106333
55788,,9162louczj0j,53167,53168,106335
55789,,gshkbligvgwj,53168,53169,106337
55790,,url:http://portal.acm.org/citation.cfm3fid3d1086228.1086293,53169,53170,106339
55791,,nzwza4olli4j,53170,53171,106341
55792,,url:http://links.jstor.org/sici3fsici3d0146-4949(196423)5253a3253c222253atcotsj253e2.0.co253b2-z,53171,53172,106343
55793,,rlk2x-jumrwj,53172,53173,106345
55794,,oygsgtn-hvwj,53173,53174,106347
55795,,17flgnklk50j,53174,53175,106349
55796,,lcjlgxlov50j,53176,53177,106353
55797,,eavojcynrrwj,53177,53178,106355
55798,,cmwiiv5s6x4j,53178,53179,106357
55799,,7-y_k-eswisj,53179,53180,106359
55800,,k2hfzaczlauj,53180,53181,106361
55801,,o8jzevnxd20j,53181,53182,106363
55802,,1kl22lu8bn0j,53182,53183,106365
55803,,nqnx9ogxqgkj,53183,53184,106367
55804,,hnmqhiejulyj,53184,53185,106369
55805,,ki2rtmqxqboj,53185,53186,106371
55806,,id5uaxcul1mj,53186,53187,106373
55807,,ygnxscuww64j,53187,53188,106375
55808,,7ckn-rlwgk4j,53188,53189,106377
55809,,qigmdbhwsgkj,53190,53191,106381
55810,,9gu3guzky2kj,53191,53192,106383
55811,,ce4sl0qvsaaj,53192,53193,106385
55812,,zstdo0kxd54j,53193,53194,106387
55813,,url:http://portal.acm.org/citation.cfm3fid3d1027527.1027562,53194,53195,106389
55814,,ri79-tj5gisj,53195,53196,106391
55815,,c4sdbhpbeogj,53196,53197,106393
55816,,5r4w6ocmpncj,53197,53198,106395
55817,,gtx4dulfgoqj,53199,53200,106399
55818,,oiu85w0m7qoj,53200,53201,106401
55819,,aylm_ah5z0kj,53201,53202,106403
55820,,eeglmr7pqeqj,53202,53203,106405
55821,,,53203,53204,106407
55822,,3vvbji6xdgaj,53204,53205,106409
55823,,35yx2nw7kl4j,53205,53206,106411
55824,,bwjw_pk5ed0j,53206,53207,106413
55825,,fu0iv9rnyeaj,53207,53208,106415
55826,,cpr2v1noqfyj,53208,53209,106417
55827,,url:http://www.csa.com/partners/viewrecord.php3frequester3dgs26collection3dtrd26recid3d0610763ci,53209,53210,106419
55828,,rdytpazkpfkj,53210,53211,106421
55829,,xbnjcf0emd0j,53211,53212,106423
55830,,url:http://www.csa.com/partners/viewrecord.php3frequester3dgs26collection3dtrd26recid3dn9210418ah,53212,53213,106425
55831,,4s1hw5qdieyj,53213,53214,106427
55832,,dlgljli0c24j,53214,53215,106429
55833,,yyiynoyfj_ij,53216,53217,106433
55834,,gtqqcuuv5s0j,53217,53218,106435
55835,,0mgo_quknfoj,53218,53219,106437
55836,,kk7w1s4xdeuj,53219,53220,106439
55837,,pnfqtlkfswwj,53220,53221,106441
55838,,fwrkcundwysj,53221,53222,106443
55839,,9lkg-sthtlqj,53222,53223,106445
55840,,pzwy3m8c0c4j,53223,53224,106447
55841,,on1gwty9swsj,53224,53225,106449
55842,,bj9mizu_4fqj,53225,53226,106451
55843,,wuxn4x1mdr4j,53226,53227,106453
55844,,6h5itjgsx1yj,53227,53228,106455
55845,,waq9wkwtsr8j,53228,53229,106457
55846,,gg-sv4l4pvej,53229,53230,106459
55847,,_cctcljmjtqj,53230,53231,106461
55848,,5s6b10hik30j,53231,53232,106463
55849,,ajjxlnwzccyj,53232,53233,106465
55850,,t5dexahtqduj,53233,53234,106467
55851,,qjadyg8rxfgj,53234,53235,106469
55852,,tz0focb0xugj,53235,53236,106471
55853,,1k7au7yx7ioj,53236,53237,106473
55854,,k1pn9grezwqj,53237,53238,106475
55855,,yatn9r6lzkkj,53238,53239,106477
55856,,ydgdowfucvoj,53239,53240,106479
55857,,gwn94b9nflsj,53240,53241,106481
55858,,g8meh9nmldej,53241,53242,106483
55859,,dmljcdbxugmj,53242,53243,106485
55860,,srjydzka_haj,53243,53244,106487
55861,,9cfqegouey4j,53244,53245,106489
55862,,bqgd_dffknoj,53245,53246,106491
55863,,7yifvrlkrhmj,53246,53247,106493
55864,,qtetgfn0aokj,53247,53248,106495
55865,,vf9tlyklv-qj,53248,53249,106497
55866,,0dlickkp_cej,53249,53250,106499
55867,,lcepoh5muswj,53250,53251,106501
55868,,c6upm9cu7e4j,53251,53252,106503
55869,,lp4kmbrdqqej,53253,53254,106507
55870,,svpk9622-akj,53254,53255,106509
55871,,jmtmmx-k_tkj,53255,53256,106511
55872,,wmo7orr2_quj,53256,53257,106513
55873,,nszhdjp6oq4j,53257,53258,106515
55874,,69nflhnw_icj,53259,53260,106519
55875,,tinvjyspn2oj,53260,53261,106521
55876,,txpwwugrxicj,53261,53262,106523
55877,,mytkkvq5iemj,53262,53263,106525
55878,,lhtlv2papzyj,53263,53264,106527
55879,,url:http://adsabs.harvard.edu/abs/1976scom.nasa..213p,53264,53265,106529
55880,,s5xou_noha0j,53265,53266,106531
55881,,_6wwpjeguiaj,53266,53267,106533
55882,,vtzkaf2trgcj,53267,53268,106535
55883,,cb67eifb31gj,53268,53269,106537
55884,,ltrfcdzf1xkj,53269,53270,106539
55885,,a-okd13zh-oj,53270,53271,106541
55886,,yph7l85sreqj,53272,53273,106545
55887,,qlgohk-_hg0j,53273,53274,106547
55888,,mgp4cguiizkj,53275,53276,106551
55889,,nw7m94aw6nyj,53276,53277,106553
55890,,micz3udu0x8j,53277,53278,106555
55891,,dilhnisehx8j,53278,53279,106557
55892,,4jc1rfszq8gj,53279,53280,106559
55893,,url:http://links.jstor.org/sici3fsici3d0146-4949(196023)1253a3253c13253atedrw2522253e2.0.co253b2-y,53280,53281,106561
55894,,w-9qhxmyioij,53281,53282,106563
55895,,k6cnw9cmi-oj,53282,53283,106565
55896,,7a6-ttn8b0sj,53283,53284,106567
55897,,vfsr6gvwaq8j,53284,53285,106569
55898,,url:http://www.kluweronline.com/article.asp3fpips3d514278326pdf3d1,53285,53286,106571
55899,,fppea01kyw4j,53286,53287,106573
55900,,-1vrpdvcu2ij,53287,53288,106575
55901,,m0uirruohhoj,53288,53289,106577
55902,,lzustvdqff0j,53289,53290,106579
55903,,uu8u-gt5njoj,53290,53291,106581
55904,,rqxakvj3fs0j,53291,53292,106583
55905,,oel5qn-fyc8j,53292,53293,106585
55906,,qvqt43rvcbqj,53293,53294,106587
55907,,vysk95ptxxej,53294,53295,106589
55908,,gfwofpdqjd8j,53295,53296,106591
55909,,ubvfpd7olt0j,53296,53297,106593
55910,,url:http://www.csa.com/partners/viewrecord.php3frequester3dgs26collection3dtrd26recid3d20021212029375mt26recid3da7340043ah,53297,53298,106595
55911,,ykkv8pcox8ij,53298,53299,106597
55912,,fx2cmd-djykj,53299,53300,106599
55913,,b0jmgdlmnesj,53300,53301,106601
55914,,tjcunxoywtoj,53301,53302,106603
55915,,zwxj_1vmggcj,53302,53303,106605
55916,,6zvyqqkzcx8j,53303,53304,106607
55917,,94adtwbar7aj,53304,53305,106609
55918,,dyesoffxylkj,53305,53306,106611
55919,,rojqtmv9xkoj,53306,53307,106613
55920,,utytotf3gyaj,53307,53308,106615
55921,,9bwkzmeng10j,53308,53309,106617
55922,,psxooguk0ogj,53309,53310,106619
55923,,n_dc45k-pvaj,53311,53312,106623
55924,,wno9nuif_fuj,53312,53313,106625
55925,,jdd3hix1ntcj,53313,53314,106627
55926,,ii8y4wia8t0j,53314,53315,106629
55927,,hqitmhftgruj,53315,53316,106631
55928,,,53316,53317,106633
55929,,hvoauvspnkmj,53317,53318,106635
55930,,qkp85unl8rqj,53318,53319,106637
55931,,wnyw9pnlpwmj,53319,53320,106639
55932,,atsoa4b-0ykj,53320,53321,106641
55933,,hzbesrr-iwmj,53321,53322,106643
55934,,eja6xd6g_l4j,53322,53323,106645
55935,,ywuinbevdz4j,53323,53324,106647
55936,,tvgkq2g-_nyj,53325,53326,106651
55937,,url:http://portal.acm.org/citation.cfm3fid3d109094.109096,53326,53327,106653
55938,,om7yuinxbkyj,53327,53328,106655
55939,,4z9igatyx4mj,53328,53329,106657
55940,,1ztv3-jv8pkj,53329,53330,106659
55941,,llojl_thlgwj,53330,53331,106661
55942,,ssf_jgz-afmj,53331,53332,106663
55943,,url:http://journals.iucr.org/c/issues/1995/08/00/bk1106/bk1106.pdf,53332,53333,106665
55944,,f2ecjrr1lvkj,53333,53334,106667
55945,,hixvhfvggnqj,53334,53335,106669
55946,,uoypv6ukbd8j,53335,53336,106671
55947,,9qouh5dfz64j,53336,53337,106673
55948,,mjcf9gwqlwej,53337,53338,106675
55949,,nxmpuuzgtpij,53338,53339,106677
55950,,35ohind9mfsj,53339,53340,106679
55951,,3rpqyag2bwyj,53340,53341,106681
55952,,oxs-sdl-ct4j,53341,53342,106683
55953,,i31apqnxt7wj,53342,53343,106685
55954,,url:http://www.springerlink.com/index/p207854882335500.pdf,53343,53344,106687
55955,,j34klgd86qej,53344,53345,106689
55956,,g27mvxvquouj,53345,53346,106691
55957,,i5qlgjvboakj,53346,53347,106693
55958,,bxwx9tc0ejoj,53347,53348,106695
55959,,tmuirztuwngj,53348,53349,106697
55960,,8zr9uac-y5aj,53349,53350,106699
55961,,zquhox9lhpsj,53350,53351,106701
55962,,_ocaybp2adoj,53351,53352,106703
55963,,_8jygbdbyk8j,53352,53353,106705
55964,,url:http://ieeexplore.ieee.org/xpl/abs_free.jsp3farnumber3d718143,53353,53354,106707
55965,,qrvdoeky844j,53354,53355,106709
55966,,url:http://doi.wiley.com/10.1002/ace.22.abs,53355,53356,106711
55967,,5e8pca8tkkaj,53356,53357,106713
55968,,z_giopryrtkj,53357,53358,106715
55969,,jtzuwvq_0r0j,53358,53359,106717
55970,,qy7wdglsxp0j,53359,53360,106719
55971,,cv54vbe9kwkj,53361,53362,106723
55972,,9p-s66gxuvmj,53362,53363,106725
55973,,cuzgar8oxj8j,53363,53364,106727
55974,,jr-4rktf0-8j,53364,53365,106729
55975,,_tshsqv0eouj,53365,53366,106731
55976,,62bkedyvl3cj,53366,53367,106733
55977,,gzfcxtnltoyj,53367,53368,106735
55978,,rznuyonfffij,53368,53369,106737
55979,,427ehz_o6aaj,53369,53370,106739
55980,,cqfkcfdc380j,53370,53371,106741
55981,,4z7lrrub_1qj,53371,53372,106743
55982,,dfwdpejllcij,53372,53373,106745
55983,,08zgfxzzxxyj,53373,53374,106747
55984,,34a4h8atlxcj,53374,53375,106749
55985,,jxlh5uhyo9cj,53375,53376,106751
55986,,hmlue44lxnej,53376,53377,106753
55987,,zijy3ah13msj,53377,53378,106755
55988,,mkrc2xfvmlmj,53378,53379,106757
55989,,yuqza_fbki8j,53379,53380,106759
55990,,8ps6tiqzmocj,53380,53381,106761
55991,,cv2mw-we6zuj,53381,53382,106763
55992,,pshnp78sleqj,53382,53383,106765
55993,,bkstoxgqkeqj,53383,53384,106767
55994,,txvcfnpenkwj,53384,53385,106769
55995,,pju_bbb8kgsj,53385,53386,106771
55996,,lsfn_qj6poaj,53386,53387,106773
55997,,42vwhrod4ecj,53387,53388,106775
55998,,ycgyja8mn9kj,53388,53389,106777
55999,,url:http://www.csa.com/partners/viewrecord.php3frequester3dgs26collection3dtrd26recid3d0627067ci,53389,53390,106779
56000,,fncenjcoplqj,53390,53391,106781
56001,,lia2gsoqolkj,53392,53393,106785
56002,,t9fzsjfy2aij,53393,53394,106787
56003,,tlcygtreep0j,53394,53395,106789
56004,,wiucnmnq1gcj,53396,53397,106793
56005,,brypa1j8_zuj,53397,53398,106795
56006,,k9vsx5asq5kj,53398,53399,106797
56007,,jvt3sy9e9gwj,53399,53400,106799
56008,,mun853_xa2cj,53400,53401,106801
56009,,url:http://portal.acm.org/ft_gateway.cfm3fid3d110752126type3dpdf,53401,53402,106803
56010,,jf7hprs8htgj,53402,53403,106805
56011,,fr1dd4cxbikj,53403,53404,106807
56012,,g8syyflzldmj,53404,53405,106809
56013,,gkarzaqohm0j,53405,53406,106811
56014,,tqfkhx9swnyj,53406,53407,106813
56015,,inanws-b3xaj,53407,53408,106815
56016,,d1ve4gsw7ncj,53408,53409,106817
56017,,9sbtc1m4z24j,53409,53410,106819
56018,,fkz0oucb95qj,53410,53411,106821
56019,,y5d5jx2eamuj,53411,53412,106823
56020,,1fr3hlgmbq4j,53412,53413,106825
56021,,a0s1_7c6gloj,53413,53414,106827
56022,,iw8-n_k-mccj,53414,53415,106829
56023,,_igkapqixrmj,53416,53417,106833
56024,,llt9b_92q1cj,53417,53418,106835
56025,,pjk6ytw3laej,53418,53419,106837
56026,,gzbxokznc3kj,53419,53420,106839
56027,,bzcqi8ac2pmj,53421,53422,106843
56028,,url:http://www.springerlink.com/index/wg11p5q1v0002v18.pdf,53422,53423,106845
56029,,xatu_oxi2h0j,53423,53424,106847
56030,,a4_xkxhmrg8j,53424,53425,106849
56031,,qcldozkw4u4j,53425,53426,106851
56032,,teiiytzytssj,53426,53427,106853
56033,,qxposhtnhekj,53427,53428,106855
56034,,t6ubgojkksyj,53428,53429,106857
56035,,b_gmn8t4idqj,53429,53430,106859
56036,,cifrh1xj8fij,53430,53431,106861
56037,,auc9r9ln0ocj,53431,53432,106863
56038,,_-gpvzugduij,53432,53433,106865
56039,,3qhha4wnmmkj,53433,53434,106867
56040,,etotatwa1y4j,53434,53435,106869
56041,,gdjz_rtvjcwj,53435,53436,106871
56042,,hfbgstzoxpwj,53436,53437,106873
56043,,errtgzuxp4wj,53437,53438,106875
56044,,dxhvslqibi0j,53439,53440,106879
56045,,url:http://www.csa.com/partners/viewrecord.php3frequester3dgs26collection3dtrd26recid3d017405550037ai,53440,53441,106881
56046,,hxmvst19lqgj,53441,53442,106883
56047,,hiljiiohy5oj,53442,53443,106885
56048,,nidyihrynrij,53443,53444,106887
56049,,hsxg2luiywqj,53444,53445,106889
56050,,qzwxi1aqhiej,53445,53446,106891
56051,,url:http://portal.acm.org/ft_gateway.cfm3fid3d102763426type3dpdf,53446,53447,106893
56052,,url:http://portal.acm.org/citation.cfm3fid3d171926.171941,53447,53448,106895
56053,,isrkwsic0xkj,53448,53449,106897
56054,,abg-bvkl-wyj,53449,53450,106899
56055,,ltdxnbkslwsj,53450,53451,106901
56056,,dwtr220reqgj,53452,53453,106905
56057,,vyyj_19oztsj,53453,53454,106907
56058,,6u3g--bw01kj,53454,53455,106909
56059,,1jrli9ncy98j,53455,53456,106911
56060,,url:http://www.csa.com/partners/viewrecord.php3frequester3dgs26collection3dtrd26recid3d0332235ci,53456,53457,106913
56061,,url:http://www.ingentaconnect.com/search/expand3fpub3dinfobike://els/08830355/2001/00000035/00000004/art0003426unc3d,53457,53458,106915
56062,,7nybufit5jaj,53458,53459,106917
56063,,ecugre9p418j,53459,53460,106919
56064,,url:http://www.springerlink.com/index/g6k75167m7282085.pdf,53460,53461,106921
56065,,vhvtuqpqyq4j,53462,53463,106925
56066,,1hqkafffvi4j,53463,53464,106927
56067,,teziquyevqoj,53464,53465,106929
56068,,c5eoaxfz7bsj,53465,53466,106931
56069,,5xuhyv7upsaj,53466,53467,106933
56070,,1tz74y0dnlij,53467,53468,106935
56071,,flbrnsghmuuj,53468,53469,106937
56072,,iyvgqoqpa_ij,53469,53470,106939
56073,,lparzfmvvy0j,53470,53471,106941
56074,,xv2-mkssezkj,53471,53472,106943
56075,,4zdyfrb3bk4j,53472,53473,106945
56076,,i9kymk14atuj,53473,53474,106947
56077,,vbscqu3hsguj,53474,53475,106949
56078,,ths3ttwgdiyj,53475,53476,106951
56079,,4wkd1hlmqmyj,53477,53478,106955
56080,,opffgslw8iwj,53478,53479,106957
56081,,kowgqwi689wj,53479,53480,106959
56082,,url:http://www.csa.com/partners/viewrecord.php3frequester3dgs26collection3dtrd26recid3d1346593ci,53480,53481,106961
56083,,nndo7upoqvij,53481,53482,106963
56084,,vcvpdfwbkwkj,53482,53483,106965
56085,,cy-vmjofajaj,53483,53484,106967
56086,,u1sdob-xl6oj,53484,53485,106969
56087,,s1lm4-x5sumj,53485,53486,106971
56088,,url:http://www.csa.com/partners/viewrecord.php3frequester3dgs26collection3dtrd26recid3d0834938ci,53486,53487,106973
56089,,2wb4doaq2c8j,53487,53488,106975
56090,,8vvkjkrnorcj,53488,53489,106977
56091,,dygc4kfw5mgj,53489,53490,106979
56092,,tdysw7qkf_qj,53490,53491,106981
56093,,reuniim_z0sj,53491,53492,106983
56094,,8e1enrb4np8j,53492,53493,106985
56095,,sfpe5ejjwyij,53493,53494,106987
56096,,c78zijax6scj,53494,53495,106989
56097,,u7gsbsyd5v0j,53495,53496,106991
56098,,wb_ovign0zsj,53496,53497,106993
56099,,tjqhmhwuvymj,53497,53498,106995
56100,,qwknkmk5tk4j,53498,53499,106997
56101,,5ktvqudhurcj,53499,53500,106999
56102,,4j0crfhjoquj,53500,53501,107001
56103,,w_tukgwj3caj,53501,53502,107003
56104,,md90fw6irtij,53503,53504,107007
56105,,ninsj5snnboj,53505,53506,107011
56106,,qvnaoxfi6swj,53506,53507,107013
56107,,7jjxe7ouvloj,53507,53508,107015
56108,,aqndbwhevwcj,53508,53509,107017
56109,,9brpa_atyh4j,53509,53510,107019
56110,,hwfhbxxojfij,53510,53511,107021
56111,,n6s6_mekcoqj,53511,53512,107023
56112,,onpj3o8mjeaj,53512,53513,107025
56113,,ytegjeaot4mj,53513,53514,107027
56114,,jzfeint2ea8j,53514,53515,107029
56115,,sf0qpr3ua5qj,53515,53516,107031
56116,,aj42preplikj,53516,53517,107033
56117,,z8jytylztkej,53517,53518,107035
56118,,j8mx_omsfjcj,53518,53519,107037
56119,,qr9j7u8zupoj,53519,53520,107039
56120,,url:http://portal.acm.org/citation.cfm3fid3d984409.98441526coll3dguide26dl3dacm26idx3dj68926part3dperiodical26wanttype3dperiodical26title3dacm2520sigmod2520record26cfid3d1111111126cftoken3d2222222,53520,53521,107041
56121,,pl4vzdxksyuj,53521,53522,107043
56122,,z-ssd5ieeiwj,53522,53523,107045
56123,,url:http://portal.acm.org/citation.cfm3fid3d582192,53523,53524,107047
56124,,pszeay6_afsj,53524,53525,107049
56125,,jdcwqxfgr1wj,53525,53526,107051
56126,,3gbbuiq6mu4j,53526,53527,107053
56127,,gmexpqls2nuj,53527,53528,107055
56128,,jghg15fu-2uj,53528,53529,107057
56129,,ndstycesrroj,53529,53530,107059
56130,,uy491ghrfloj,53530,53531,107061
56131,,fgyrcqpbyfqj,53531,53532,107063
56132,,jyw3ty8hjuqj,53532,53533,107065
56133,,wgacqcklm4aj,53533,53534,107067
56134,,ryg3lwbvgqaj,53534,53535,107069
56135,,7u_dq1mdm_aj,53535,53536,107071
56136,,ixvejoydj4qj,53536,53537,107073
56137,,blet_2bokgsj,53537,53538,107075
56138,,remfczoqmlqj,53538,53539,107077
56139,,acmnnybvavqj,53540,53541,107081
56140,,aymsgrce7koj,53541,53542,107083
56141,,url:http://portal.acm.org/ft_gateway.cfm3fid3d108375526type3dpdf,53542,53543,107085
56142,,iwzftcfwbfej,53543,53544,107087
56143,,zdykxfaba3wj,53544,53545,107089
56144,,dz2ttmogqluj,53545,53546,107091
56145,,etuxy6hpenaj,53546,53547,107093
56146,,tjoj5zqkdtej,53547,53548,107095
56147,,hipphzh_dxyj,53548,53549,107097
56148,,ayebfy-0or4j,53549,53550,107099
56149,,lykimpzpbboj,53550,53551,107101
56150,,nk6vh5i9pamj,53551,53552,107103
56151,,xoz_pxozteoj,53552,53553,107105
56152,,6bhlddvubqkj,53553,53554,107107
56153,,dv5eqbqfp_0j,53554,53555,107109
56154,,r-jx4g42sfgj,53555,53556,107111
56155,,igixj1mqg90j,53556,53557,107113
56156,,1r30b6x8ihqj,53557,53558,107115
56157,,hqjifs9vfjyj,53558,53559,107117
56158,,ykg1u6sfcfej,53560,53561,107121
56159,,url:http://www.ingentaconnect.com/search/expand3fpub3dinfobike://els/09505849/2003/00000045/00000009/art0004726unc3d,53561,53562,107123
56160,,xpe5xeg24ayj,53562,53563,107125
56161,,87ymjwtn6jcj,53563,53564,107127
56162,,lc2cdd2yqgkj,53564,53565,107129
56163,,kc2bpmceqboj,53565,53566,107131
56164,,q0k1yn3kis4j,53566,53567,107133
56165,,kbl3vwdzvy4j,53567,53568,107135
56166,,6qkla7lgu_8j,53568,53569,107137
56167,,014-gc9l4_yj,53569,53570,107139
56168,,ubibcf_zygwj,53570,53571,107141
56169,,xdcrpb8fmyyj,53571,53572,107143
56170,,7gahhnmymzqj,53572,53573,107145
56171,,n63mkrrhliuj,53573,53574,107147
56172,,78xo7-t4if8j,53574,53575,107149
56173,,odftqwn5zvcj,53575,53576,107151
56174,,ta4pwo18e68j,53576,53577,107153
56175,,7nlqn9qldwgj,53577,53578,107155
56176,,url:http://www.springerlink.com/index/r32gm2911t7236t1.pdf,53578,53579,107157
56177,,s-c4iwal45oj,53579,53580,107159
56178,,ogb-wwpgewij,53580,53581,107161
56179,,jrun4z-h9iqj,53581,53582,107163
56180,,5dqu0-dz63mj,53582,53583,107165
56181,,leom8msiwc8j,53583,53584,107167
56182,,zy29byxlvs0j,53584,53585,107169
56183,,j-g7mxutbioj,53585,53586,107171
56184,,fsb1cs8_uomj,53586,53587,107173
56185,,qytswe0zjwsj,53588,53589,107177
56186,,rx8vjqtsomqj,53589,53590,107179
56187,,brn7z_ivhmoj,53590,53591,107181
56188,,xl0agzrgaxyj,53591,53592,107183
56189,,l47mh6kapyuj,53592,53593,107185
56190,,qzqt-psmhyqj,53593,53594,107187
56191,,gjuprseti-yj,53594,53595,107189
56192,,jewaqzgzkhej,53595,53596,107191
56193,,nj5p42xqr5ij,53596,53597,107193
56194,,ja20akiks0cj,53597,53598,107195
56195,,3xaf8hrqr0wj,53598,53599,107197
56196,,uvhdjwuqbjyj,53599,53600,107199
56197,,hg0gbczz_zcj,53600,53601,107201
56198,,5w_heljrmsej,53601,53602,107203
56199,,oizzuqk1szmj,53602,53603,107205
56200,,czk0pmiqw6qj,53603,53604,107207
56201,,spyggwhukjqj,53604,53605,107209
56202,,url:http://portal.acm.org/ft_gateway.cfm3fid3d106629426type3dpdf,53605,53606,107211
56203,,url:http://portal.acm.org/citation.cfm3fid3d984505.98450726dl3dacm26dl3dacm26idx3d98450526part3dperiodical26wanttype3dperiodical26title3dacm2520sigmod2520record26cfid3d1111111126cftoken3d2222222,53606,53607,107213
56204,,o3liibqm6auj,53607,53608,107215
56205,,kumbzsvuylsj,53608,53609,107217
56206,,ugk6uvojungj,53609,53610,107219
56207,,yhiysnvmeguj,53610,53611,107221
56208,,nftcxvjllpij,53611,53612,107223
56209,,bjtyl_npyjij,53612,53613,107225
56210,,,53613,53614,107227
56211,,ukig8p5ecssj,53614,53615,107229
56212,,nmi00qedntyj,53615,53616,107231
56213,,noqolyimww0j,53617,53618,107235
56214,,ni8ejmgx3fsj,53618,53619,107237
56215,,5ujeshlojikj,53619,53620,107239
56216,,url:http://www.csa.com/partners/viewrecord.php3frequester3dgs26collection3denv26recid3d3560896,53620,53621,107241
56217,,lngzschyruwj,53621,53622,107243
56218,,qhkzp4rfbvkj,53622,53623,107245
56219,,kkrgdu63uguj,53623,53624,107247
56220,,71lqyij5s_ij,53624,53625,107249
56221,,ev1qa9u5mn0j,53625,53626,107251
56222,,xkuczcmnzloj,53626,53627,107253
56223,,h_ht9k2qmwkj,53627,53628,107255
56224,,w64qj19zxloj,53628,53629,107257
56225,,m1pluxdh_m0j,53629,53630,107259
56226,,rvm2opelhmwj,53630,53631,107261
56227,,98zu99lfgzkj,53631,53632,107263
56228,,pmf7eiv5iuuj,53632,53633,107265
56229,,url:http://portal.acm.org/ft_gateway.cfm3fid3d110195926type3dpdf,53634,53635,107269
56230,,pugdpywgrecj,53635,53636,107271
56231,,f_hqjyr7j7aj,53636,53637,107273
56232,,url:http://ieeexplore.ieee.org/iel1/2206/2194/00060335.pdf3farnumber3d60335,53637,53638,107275
56233,,iiclh_wsbkcj,53638,53639,107277
56234,,esydogik5-ej,53639,53640,107279
56235,,uhcrumfvr6ij,53640,53641,107281
56236,,d_honx-mbm8j,53641,53642,107283
56237,,url:http://portal.acm.org/ft_gateway.cfm3fid3d110122426type3dpdf,53642,53643,107285
56238,,gv_yoyyxugqj,53643,53644,107287
56239,,moiucz4nytaj,53644,53645,107289
56240,,jcysfikckjqj,53645,53646,107291
56241,,0_d7qwveosij,53647,53648,107295
56242,,egn46hglw7gj,53648,53649,107297
56243,,url:http://www.springerlink.com/index/v81679u45nl060t2.pdf,53649,53650,107299
56244,,z8n1p0tsbjyj,53650,53651,107301
56245,,zuql8kzw7euj,53651,53652,107303
56246,,url:http://www.csa.com/partners/viewrecord.php3frequester3dgs26collection3dtrd26recid3d0971800ci,53652,53653,107305
56247,,kxh0wg3rm_aj,53653,53654,107307
56248,,auhrabodktcj,53654,53655,107309
56249,,watzxitnsauj,53655,53656,107311
56250,,8g0bech-o78j,53656,53657,107313
56251,,gjftiix12g0j,53657,53658,107315
56252,,q2e5pajouakj,53658,53659,107317
56253,,vskhbwm0yzmj,53659,53660,107319
56254,,o6c97lbayfcj,53660,53661,107321
56255,,pkkh-wynlvyj,53661,53662,107323
56256,,z7-3h1gv5raj,53662,53663,107325
56257,,skf2bddet0sj,53663,53664,107327
56258,,qcexttypcf8j,53664,53665,107329
56259,,vdocwjokxbyj,53666,53667,107333
56260,,nxbdumsjawsj,53667,53668,107335
56261,,3pmgpzfowwkj,53668,53669,107337
56262,,sfxviwcchcej,53669,53670,107339
56263,,l2mn4klg8woj,53670,53671,107341
56264,,_nmxmrcdkpij,53671,53672,107343
56265,,lmv8axj5ui8j,53672,53673,107345
56266,,wwsdtuzik84j,53673,53674,107347
56267,,0jzligznc4cj,53674,53675,107349
56268,,url:http://portal.acm.org/ft_gateway.cfm3fid3d108363926type3dpdf,53675,53676,107351
56269,,rr0frtzrbxmj,53676,53677,107353
56270,,my-8wswaunsj,53677,53678,107355
56271,,zgozcxqtomej,53678,53679,107357
56272,,46eikrtl3lmj,53679,53680,107359
56273,,eyk9t-mqlrwj,53680,53681,107361
56274,,muq-gwyfr2kj,53681,53682,107363
56275,,t3-lryo3cmoj,53682,53683,107365
56276,,amc9n7ys24mj,53683,53684,107367
56277,,ixbpxwykmxoj,53684,53685,107369
56278,,az8_vlr3wvej,53685,53686,107371
56279,,xi54q5go4jyj,53686,53687,107373
56280,,lt6r_hj4shcj,53688,53689,107377
56281,,bjsnashbcsqj,53689,53690,107379
56282,,0lf4qcm71jmj,53690,53691,107381
56283,,90am87wsiumj,53691,53692,107383
56284,,ja2qv4hpn_mj,53692,53693,107385
56285,,v3xgyskoe-yj,53693,53694,107387
56286,,cxeupb5wksgj,53694,53695,107389
56287,,drsvumybbomj,53695,53696,107391
56288,,n1qf7eqkgcuj,53696,53697,107393
56289,,oqjnqlgxubgj,53697,53698,107395
56290,,chrhqw4a-ycj,53698,53699,107397
56291,,ma_8ctazngyj,53699,53700,107399
56292,,sa7jykwdo1qj,53700,53701,107401
56293,,js-aorqhpesj,53701,53702,107403
56294,,hhrm5pfqecsj,53702,53703,107405
56295,,cfh1jf2yew4j,53703,53704,107407
56296,,eqhpb-opcx0j,53704,53705,107409
56297,,nej6tzhxajqj,53705,53706,107411
56298,,u_4hwnxzkl4j,53706,53707,107413
56299,,kgscrjc-or8j,53707,53708,107415
56300,,3mi8eegnx-ij,53708,53709,107417
56301,,zdyplnfwltgj,53709,53710,107419
56302,,qp07gdxlw20j,53710,53711,107421
56303,,url:http://portal.acm.org/citation.cfm3fid3d264333,53711,53712,107423
56304,,jzv1hfd-vemj,53712,53713,107425
56305,,jgqokas-hhyj,53714,53715,107429
56306,,url:http://portal.acm.org/citation.cfm3fid3d885861.885879,53715,53716,107431
56307,,llj4iqpnrawj,53716,53717,107433
56308,,xglo4i_wziyj,53717,53718,107435
56309,,url:http://www.springerlink.com/index/l5n8n69107k2842n.pdf,53718,53719,107437
56310,,bhyyikfqh5mj,53719,53720,107439
56311,,,53720,53721,107441
56312,,fkzeh6rei6yj,53721,53722,107443
56313,,ytu5ftpqhr4j,53722,53723,107445
56314,,7esidtgh2tij,53723,53724,107447
56315,,jqr-9wy_k0gj,53724,53725,107449
56316,,bhld1_tthtqj,53725,53726,107451
56317,,8acdeuc6ig4j,53726,53727,107453
56318,,ekuruxurk5uj,53727,53728,107455
56319,,vhdvria9sx0j,53728,53729,107457
56320,,_obdtsxj59ij,53729,53730,107459
56321,,lvk-7svhg2wj,53730,53731,107461
56322,,url:http://www.csa.com/partners/viewrecord.php3frequester3dgs26collection3dtrd26recid3d0804723ci,53731,53732,107463
56323,,url:http://www.springerlink.com/index/l724qx13804t84v0.pdf,53732,53733,107465
56324,,n3lwvc4ulemj,53733,53734,107467
56325,,2gagrn929u4j,53734,53735,107469
56326,,ddlnzkugk6cj,53735,53736,107471
56327,,wdam8r50doaj,53736,53737,107473
56328,,fgwsih495toj,53737,53738,107475
56329,,sofelqpbxosj,53738,53739,107477
56330,,u4obkxzrleyj,53739,53740,107479
56331,,i73pm3zjvcij,53740,53741,107481
56332,,i7tipzlixbmj,53741,53742,107483
56333,,ihkhukgvvrej,53742,53743,107485
56334,,ivxv9wl7iwij,53743,53744,107487
56335,,dyxfg0f8s20j,53744,53745,107489
56336,,6fzykoipbduj,53745,53746,107491
56337,,1tuxchslimmj,53746,53747,107493
56338,,u0nao7a_phuj,53747,53748,107495
56339,,,53748,53749,107497
56340,,4lcrl4q_o7ij,53749,53750,107499
56341,,mcbdujhns7yj,53750,53751,107501
56342,,rwnrxq7eubij,53751,53752,107503
56343,,url:http://www.csa.com/partners/viewrecord.php3frequester3dgs26collection3dtrd26recid3dn9210499ah,53752,53753,107505
56344,,0qth0ogxonuj,53753,53754,107507
56345,,url:http://www.csa.com/partners/viewrecord.php3frequester3dgs26collection3dtrd26recid3d0293444ci,53754,53755,107509
56346,,dx0-x-jxu1qj,53755,53756,107511
56347,,7b6stiu8ph8j,53756,53757,107513
56348,,9g62xdpb9pmj,53757,53758,107515
56349,,rckkgqbvmnmj,53758,53759,107517
56350,,ld79yvu8vjgj,53759,53760,107519
56351,,jteqj_zzn6oj,53760,53761,107521
56352,,2jxlgljafl8j,53761,53762,107523
56353,,url:http://taylorandfrancis.metapress.com/index/fqmgqlmjplaumaxe.pdf,53762,53763,107525
56354,,lelie2mhgtcj,53763,53764,107527
56355,,k4rzmibgf_sj,53764,53765,107529
56356,,4mrvmwl33coj,53765,53766,107531
56357,,cmnixliy9xwj,53766,53767,107533
56358,,iswybjath_ij,53767,53768,107535
56359,,dyapmxh5zosj,53768,53769,107537
56360,,k1i5jessrmoj,53769,53770,107539
56361,,1chugelyiamj,53770,53771,107541
56362,,jsapf3oowxcj,53771,53772,107543
56363,,kzmikehkag4j,53772,53773,107545
56364,,5sz3_nvv7roj,53773,53774,107547
56365,,jeatvgcprp0j,53774,53775,107549
56366,,zgo_xdfsjgij,53775,53776,107551
56367,,avfsxnsta24j,53776,53777,107553
56368,,kg_0ks9lfauj,53777,53778,107555
56369,,tzwefxezz_yj,53778,53779,107557
56370,,cs8fhfwezu0j,53779,53780,107559
56371,,url:http://portal.acm.org/ft_gateway.cfm3fid3d110197426type3dpdf,53780,53781,107561
56372,,3qkp5ouyc0kj,53781,53782,107563
56373,,url:http://doi.wiley.com/10.1002/tl.8310,53783,53784,107567
56374,,csefo55waekj,53784,53785,107569
56375,,url:http://doi.wiley.com/10.1002/tl.102,53785,53786,107571
56376,,ei6gwagz6quj,53786,53787,107573
56377,,ku3jgfwewf0j,53787,53788,107575
56378,,c968fn8df_qj,53788,53789,107577
56379,,4ofeblohoxwj,53790,53791,107581
56380,,rjux6vgkr-sj,53791,53792,107583
56381,,url:http://www.springerlink.com/index/p266272w9005nr71.pdf,53792,53793,107585
56382,,ypmyxav1o4aj,53793,53794,107587
56383,,ceecp7vtnluj,53794,53795,107589
56384,,rnxn6odcec4j,53795,53796,107591
56385,,ku7qxjpnwlmj,53796,53797,107593
56386,,2m7zmqlhwsaj,53797,53798,107595
56387,,gkgwixkluqyj,53798,53799,107597
56388,,4hwlxi0v5l0j,53799,53800,107599
56389,,bgmz3x_orw0j,53800,53801,107601
56390,,bpzjlfob1eij,53801,53802,107603
56391,,wkrherlvstmj,53802,53803,107605
56392,,mfwyd9lbf5oj,53803,53804,107607
56393,,ie-euy733hcj,53804,53805,107609
56394,,url:http://www.csa.com/partners/viewrecord.php3frequester3dgs26collection3dtrd26recid3d200111010679mt26recid3da0032583ah,53805,53806,107611
56395,,zdfrqqwka8cj,53806,53807,107613
56396,,n1_56ywhc_yj,53807,53808,107615
56397,,ddtwrf_xn8sj,53808,53809,107617
56398,,dcefssktarsj,53809,53810,107619
56399,,9csp_qaeqhij,53810,53811,107621
56400,,ylh-4hugt2gj,53811,53812,107623
56401,,zu5vkmjq_xuj,53812,53813,107625
56402,,url:http://doi.wiley.com/10.1002/ace.7509,53813,53814,107627
56403,,vvyxnkqy0ygj,53814,53815,107629
56404,,tqd6c6t91a0j,53815,53816,107631
56405,,url:http://portal.acm.org/ft_gateway.cfm3fid3d108376826type3dpdf,53816,53817,107633
56406,,cudaouoohdqj,53817,53818,107635
56407,,4gkkmz_pa2kj,53818,53819,107637
56408,,url:http://www.csa.com/partners/viewrecord.php3frequester3dgs26collection3denv26recid3d8913243,53819,53820,107639
56409,,c1q9jnza1n8j,53820,53821,107641
56410,,i51b-8bqv9aj,53821,53822,107643
56411,,5wui4sjfcaoj,53822,53823,107645
56412,,bkptodgrydaj,53823,53824,107647
56413,,oxwxhkylh3wj,53824,53825,107649
56414,,url:http://www.csa.com/partners/viewrecord.php3frequester3dgs26collection3dtrd26recid3d155957ws26recid3d199301550076md,53825,53826,107651
56415,,18wmya4is_sj,53826,53827,107653
56416,,whs6sllqs0gj,53827,53828,107655
56417,,izqzt6hbawuj,53828,53829,107657
56418,,url:http://www.csa.com/partners/viewrecord.php3frequester3dgs26collection3dtrd26recid3d0691617ci,53829,53830,107659
56419,,ywi31bvych8j,53830,53831,107661
56420,,sb6saqjf0tij,53831,53832,107663
56421,,xxwvlvtuglwj,53832,53833,107665
56422,,hvqi-xvkraij,53833,53834,107667
56423,,rejio9hc2h4j,53835,53836,107671
56424,,ua0sbrs-qboj,53836,53837,107673
56425,,i0zsxkrcxn8j,53837,53838,107675
56426,,dl4gadjf9ksj,53838,53839,107677
56427,,04lsmx9gk9cj,53839,53840,107679
56428,,csz1jl9nkrsj,53840,53841,107681
56429,,rxwjouq-dgyj,53841,53842,107683
56430,,mef-t1hzimqj,53842,53843,107685
56431,,ctdlhbz1uecj,53843,53844,107687
56432,,rldkhrbmbdqj,53844,53845,107689
56433,,8vtcklz1gxqj,53845,53846,107691
56434,,,53846,53847,107693
56435,,nfiykvhv8xsj,53847,53848,107695
56436,,asacjdavjluj,53848,53849,107697
56437,,m2zby6kpsoaj,53849,53850,107699
56438,,l6ghkikwijkj,53850,53851,107701
56439,,bmv2ipuxzemj,53851,53852,107703
56440,,wadrwpwpz_aj,53852,53853,107705
56441,,vxfk4oof4sij,53853,53854,107707
56442,,bay5_paataqj,53854,53855,107709
56443,,xewqjwdddrej,53855,53856,107711
56444,,s9d57ufpsu4j,53856,53857,107713
56445,,ngdabzlurgoj,53857,53858,107715
56446,,smtsq34vymij,53858,53859,107717
56447,,fsbv8rtxjayj,53859,53860,107719
56448,,3xrd1zli_c0j,53860,53861,107721
56449,,ey-trqts24sj,53861,53862,107723
56450,,fykncrdhptkj,53862,53863,107725
56451,,9rpltmpbkwyj,53863,53864,107727
56452,,cgbo_ztykwyj,53864,53865,107729
56453,,dwq48llanf8j,53865,53866,107731
56454,,4udoclycc9ej,53866,53867,107733
56455,,i_uphqza-nuj,53867,53868,107735
56456,,cas91wwebtwj,53868,53869,107737
56457,,d71sc-r1rkaj,53869,53870,107739
56458,,yizgoym0di8j,53870,53871,107741
56459,,jlbfsliptzgj,53871,53872,107743
56460,,k_zozh84xraj,53872,53873,107745
56461,,5ivvyjzyzq8j,53873,53874,107747
56462,,brgljsubdtcj,53874,53875,107749
56463,,g85jgj0owqmj,53875,53876,107751
56464,,sio8kr7vvlej,53876,53877,107753
56465,,laq2ywuaqacj,53877,53878,107755
56466,,kktvfd1vo2uj,53878,53879,107757
56467,,bzxhckaazl0j,53879,53880,107759
56468,,url:http://ieeexplore.ieee.org/iel5/9217/29235/01320093.pdf3farnumber3d1320093,53880,53881,107761
56469,,otmhkfqiqekj,53881,53882,107763
56470,,ote4y6s7hzqj,53882,53883,107765
56471,,aj4eqwbccmgj,53883,53884,107767
56472,,tcyosdrkarmj,53884,53885,107769
56473,,url:http://www.springerlink.com/index/m626711451048052.pdf,53885,53886,107771
56474,,xxkoon-scjsj,53886,53887,107773
56475,,iky-ssuq_0gj,53888,53889,107777
56476,,duysg2fjq2sj,53889,53890,107779
56477,,iiutlakyez8j,53890,53891,107781
56478,,sp6fdagfyiqj,53891,53892,107783
56479,,314tkh8tc1ij,53892,53893,107785
56480,,ou1xpacit6wj,53893,53894,107787
56481,,x6kimai_nscj,53894,53895,107789
56482,,url:http://ieeexplore.ieee.org/iel1/2206/1762/00046642.pdf3farnumber3d46642,53895,53896,107791
56483,,et-04zv6miaj,53896,53897,107793
56484,,v1gbio3oeqmj,53897,53898,107795
56485,,86lm0oxwbzoj,53898,53899,107797
56486,,ulnqql4m8uej,53899,53900,107799
56487,,h8tk9we6w5mj,53900,53901,107801
56488,,ebnmrqtjck0j,53901,53902,107803
56489,,vugqae0ycowj,53902,53903,107805
56490,,csz36g3kmqcj,53903,53904,107807
56491,,ekys1xfzphsj,53904,53905,107809
56492,,tne3y7ya4w8j,53906,53907,107813
56493,,45v9dlg9ic4j,53907,53908,107815
56494,,chpmofvpti8j,53908,53909,107817
56495,,ml1m1dtzyqwj,53909,53910,107819
56496,,gtkl6vyxfxkj,53910,53911,107821
56497,,c69kcefkfakj,53911,53912,107823
56498,,idjohtyxau4j,53912,53913,107825
56499,,yzmdrig4-agj,53913,53914,107827
56500,,zewl_yroacmj,53914,53915,107829
56501,,sge3ktbdqk8j,53915,53916,107831
56502,,kzc9pulkji8j,53916,53917,107833
56503,,4p1ejotehlij,53917,53918,107835
56504,,url:http://www.csa.com/partners/viewrecord.php3frequester3dgs26collection3dtrd26recid3d20021212029376mt26recid3da7340045ah,53918,53919,107837
56505,,qkuykx1nlwkj,53919,53920,107839
56506,,bcef5vzdttyj,53920,53921,107841
56507,,zqw1hrnnj9ej,53921,53922,107843
56508,,8einhbovfgmj,53922,53923,107845
56509,,l_r_cf9jdwoj,53923,53924,107847
56510,,hlrtep7x0doj,53924,53925,107849
56511,,4sercvgtccuj,53925,53926,107851
56512,,,53926,53927,107853
56513,,imlionaodfuj,53927,53928,107855
56514,,sx1_z3z000yj,53928,53929,107857
56515,,tcse4ijcjiej,53929,53930,107859
56516,,vx6_1m-l-ooj,53930,53931,107861
56517,,1frrgzyt-1wj,53931,53932,107863
56518,,_-5z43msg1aj,53932,53933,107865
56519,,uaz4qcwrddwj,53933,53934,107867
56520,,uxejyexpscyj,53934,53935,107869
56521,,edjj5fww6raj,53935,53936,107871
56522,,nbrg61mmqngj,53936,53937,107873
56523,,url:http://doi.wiley.com/10.1002/he.11007,53937,53938,107875
56524,,lm6ktv-_xiwj,53938,53939,107877
56525,,fkmbwvi0t04j,53939,53940,107879
56526,,llfbucfxejcj,53940,53941,107881
56527,,f5kldpl7_usj,53941,53942,107883
56528,,xebctbx85eej,53942,53943,107885
56529,,md0rmnju-bij,53943,53944,107887
56530,,ymavet_9tfkj,53945,53946,107891
56531,,ly5-gbp8pqgj,53946,53947,107893
56532,,xrbze-6qnacj,53947,53948,107895
56533,,0s23xp-l2eij,53948,53949,107897
56534,,bn1kqt_swbyj,53949,53950,107899
56535,,nsuontfegsej,53950,53951,107901
56536,,ybtllq6yucej,53951,53952,107903
56537,,30l6lpqp1wsj,53952,53953,107905
56538,,gqrztjaippwj,53953,53954,107907
56539,,yffvkkaeqoqj,53955,53956,107911
56540,,y-lwt1ycipij,53956,53957,107913
56541,,1t_atnqqfvyj,53957,53958,107915
56542,,nkpkzv2albcj,53958,53959,107917
56543,,qdszkw7_7jmj,53959,53960,107919
56544,,ljcja3gontwj,53960,53961,107921
56545,,ew4btcmcej0j,53961,53962,107923
56546,,w_lkuky1b6ij,53962,53963,107925
56547,,sr9h1iwpf8cj,53963,53964,107927
56548,,tj2xgfk_3dkj,53964,53965,107929
56549,,vaqlxpoe-5ej,53965,53966,107931
56550,,truj2gi7fiqj,53966,53967,107933
56551,,5u4od01stbsj,53967,53968,107935
56552,,sbidczv2vw0j,53968,53969,107937
56553,,oskbwvncgwgj,53970,53971,107941
56554,,x7ulr7a7a0oj,53971,53972,107943
56555,,o9fhivqmeokj,53972,53973,107945
56556,,kthkzwo6aioj,53973,53974,107947
56557,,ipzy_yocxbwj,53974,53975,107949
56558,,5abwot_x2juj,53975,53976,107951
56559,,v9zifz4cbdij,53976,53977,107953
56560,,qdkckb2udmoj,53977,53978,107955
56561,,zgzzl8n1kwkj,53978,53979,107957
56562,,c1wu3ovljcsj,53979,53980,107959
56563,,snx-qhxeobmj,53980,53981,107961
56564,,y-vsmtmxrmoj,53981,53982,107963
56565,,vhqhewxu2awj,53982,53983,107965
56566,,96hkixyhodmj,53983,53984,107967
56567,,anuj0eiml_gj,53984,53985,107969
56568,,x1kr0hibilaj,53985,53986,107971
56569,,xmsccns16i0j,53986,53987,107973
56570,,b1cuxu7kssuj,53987,53988,107975
56571,,1tcmzzc67rkj,53988,53989,107977
56572,,declmfmtafej,53989,53990,107979
56573,,url:http://doi.wiley.com/10.1002/tl.120,53990,53991,107981
56574,,shyhrqwxigyj,53991,53992,107983
56575,,ibdjyffrteuj,53993,53994,107987
56576,,idpmeh2ndksj,53994,53995,107989
56577,,thxahd0xpf8j,53995,53996,107991
56578,,d-o97clytoaj,53996,53997,107993
56579,,url:http://portal.acm.org/ft_gateway.cfm3fid3d34478926type3dpdf26dl3dguide26dl3dacm26cfid3d1111111126cftoken3d2222222,53997,53998,107995
56580,,ati3rg3kus4j,53998,53999,107997
56581,,hzsoprceewqj,53999,54000,107999
56582,,url:http://www.csa.com/partners/viewrecord.php3frequester3dgs26collection3dtrd26recid3dn9210448ah,54000,54001,108001
56583,,_hyfy4uujkaj,54001,54002,108003
56584,,8ovcvetunhij,54002,54003,108005
56585,,bgugdpbgdc8j,54003,54004,108007
56586,,ye5n2jf2hjmj,54004,54005,108009
56587,,er_j5bjatfcj,54005,54006,108011
56588,,vramd5t5d4ij,54007,54008,108015
56589,,o4bd92ga8mqj,54008,54009,108017
56590,,jr9dbxx1uqaj,54009,54010,108019
56591,,url:http://www.springerlink.com/index/u0175r02441p3u06.pdf,54010,54011,108021
56592,,,54011,54012,108023
56593,,ixdev4vmlqoj,54012,54013,108025
56594,,94ptcku8-ugj,54013,54014,108027
56595,,gewg_2whqiqj,54014,54015,108029
56596,,wofkrfykw1ij,54015,54016,108031
56597,,isqok6jxu2kj,54016,54017,108033
56598,,ojzhmnxmq8gj,54017,54018,108035
56599,,hk2owbfuc1qj,54018,54019,108037
56600,,kfuoeygujlej,54019,54020,108039
56601,,url:http://www.csa.com/partners/viewrecord.php3frequester3dgs26collection3dtrd26recid3d20021214039896mt26recid3da7423787ah,54020,54021,108041
56602,,url:http://portal.acm.org/citation.cfm3fid3d1053474.1053482,54021,54022,108043
56603,,rusixwbpv94j,54022,54023,108045
56604,,url:http://portal.acm.org/ft_gateway.cfm3fid3d108377426type3dpdf,54023,54024,108047
56605,,fo92aftddq8j,54025,54026,108051
56606,,url:http://portal.acm.org/ft_gateway.cfm3fid3d98441126type3dpdf26dl3dportal26dl3dacm26cfid3d1111111126cftoken3d2222222,54026,54027,108053
56607,,c9f_og9jisqj,54027,54028,108055
56608,,al5x_0unvgqj,54028,54029,108057
56609,,e8sfq7prssyj,54029,54030,108059
56610,,08b69mkekdaj,54030,54031,108061
56611,,r7dptr-r5zsj,54032,54033,108065
56612,,b67ebxlq_7mj,54033,54034,108067
56613,,ywgldxninbij,54034,54035,108069
56614,,ykks45paemyj,54035,54036,108071
56615,,,54036,54037,108073
56616,,ivcm5h8conkj,54037,54038,108075
56617,,py72y49i-psj,54038,54039,108077
56618,,rsdbt9jinoij,54039,54040,108079
56619,,8udb5voy_r0j,54040,54041,108081
56620,,n8gbmak7yxoj,54041,54042,108083
56621,,bze_idud4goj,54042,54043,108085
56622,,url:http://portal.acm.org/citation.cfm3fid3dseries9729.263949,54043,54044,108087
56623,,yxnppiphvfmj,54044,54045,108089
56624,,vwbjhtowauoj,54045,54046,108091
56625,,pnbkhhy-mcyj,54047,54048,108095
56626,,kwhkyb8e6zyj,54048,54049,108097
56627,,g7zxiblxod0j,54049,54050,108099
56628,,oza25q3qzegj,54050,54051,108101
56629,,y_amxv0jjcaj,54051,54052,108103
56630,,3vzhj-5zu6ej,54052,54053,108105
56631,,1zgqaazv3naj,54053,54054,108107
56632,,n75zpsaqymcj,54054,54055,108109
56633,,cxzhdb42r78j,54055,54056,108111
56634,,ahshhld2knyj,54056,54057,108113
56635,,ypeoq3928okj,54057,54058,108115
56636,,b7xwvrwshj8j,54058,54059,108117
56637,,uq9_jwkgwuej,54059,54060,108119
56638,,ywqm_qst4qij,54060,54061,108121
56639,,63suas1_alsj,54061,54062,108123
56640,,cpkh2fu1basj,54062,54063,108125
56641,,krxswn1z4boj,54063,54064,108127
56642,,url:http://doi.wiley.com/10.1002/anie.198010151,54064,54065,108129
56643,,f8iibnsfvboj,54065,54066,108131
56644,,dkx_l-hpdy4j,54066,54067,108133
56645,,fgtm1tdoeuij,54067,54068,108135
56646,,uhe9xt-fyymj,54068,54069,108137
56647,,czeq_mm2pmcj,54069,54070,108139
56648,,rylovp-z8z0j,54070,54071,108141
56649,,6tvkiw-y4h4j,54071,54072,108143
56650,,jbmzkvpf3g8j,54073,54074,108147
56651,,vhpuyz7vn9aj,54074,54075,108149
56652,,4mdjegtz78qj,54075,54076,108151
56653,,gygtoywpexuj,54076,54077,108153
56654,,1k_0yz8fragj,54078,54079,108157
56655,,elcpylrah7qj,54079,54080,108159
56656,,oujt5zpq-v4j,54080,54081,108161
56657,,mxlry1od_qoj,54081,54082,108163
56658,,m2yhzomq9_ij,54082,54083,108165
56659,,nlhd3tc_arkj,54083,54084,108167
56660,,xddfib2f7lej,54084,54085,108169
56661,,hqppenorthej,54085,54086,108171
56662,,98sraujvnc4j,54086,54087,108173
56663,,ug5syfno0pyj,54087,54088,108175
56664,,hrf5aj9y72mj,54088,54089,108177
56665,,mn84enp0yaij,54090,54091,108181
56666,,icazcesjwtsj,54091,54092,108183
56667,,0ih5kkgjwsej,54092,54093,108185
56668,,tcap842frk4j,54093,54094,108187
56669,,frent_i6c_gj,54094,54095,108189
56670,,7ubn45crqjmj,54095,54096,108191
56671,,j6m68ukq2rij,54096,54097,108193
56672,,6wa6opf_qxij,54097,54098,108195
56673,,rwqlyy3yroij,54098,54099,108197
56674,,bxazfdffhqoj,54099,54100,108199
56675,,lt8oy5u4e0ej,54100,54101,108201
56676,,gtmwmekckaoj,54101,54102,108203
56677,,url:http://doi.wiley.com/10.1002/ev.1028,54102,54103,108205
56678,,fhi_mhjdkvmj,54103,54104,108207
56679,,wernowgb2uwj,54104,54105,108209
56680,,qeikp6gfzpgj,54105,54106,108211
56681,,hkk2wqgbi3cj,54106,54107,108213
56682,,2irg0bbv4ngj,54107,54108,108215
56683,,kk5rb3du1zuj,54108,54109,108217
56684,,neplwqygsicj,54109,54110,108219
56685,,1xou5xzun14j,54110,54111,108221
56686,,zm9oalikwd4j,54111,54112,108223
56687,,sjewozcha8wj,54112,54113,108225
56688,,mocpiyx9cp8j,54113,54114,108227
56689,,oemu1xojsesj,54114,54115,108229
56690,,q0p7jqpytcuj,54115,54116,108231
56691,,l9icleadipaj,54116,54117,108233
56692,,h0svsslynq8j,54117,54118,108235
56693,,ujvk-v06jrgj,54118,54119,108237
56694,,shjhktlliymj,54119,54120,108239
56695,,rodm8ax5-i8j,54120,54121,108241
56696,,gs5iqtro-hcj,54121,54122,108243
56697,,oo9wlyjujp0j,54122,54123,108245
56698,,0l1okam_mooj,54123,54124,108247
56699,,rifimh3z5joj,54124,54125,108249
56700,,xw2dqp4n_ioj,54126,54127,108253
56701,,se4ifevnhwqj,54128,54129,108257
56702,,mlycbqvdcdmj,54129,54130,108259
56703,,4fgyq9vnibkj,54130,54131,108261
56704,,04r8i6cxhgwj,54131,54132,108263
56705,,8zah8fjju5yj,54132,54133,108265
56706,,bt5zeokrwz0j,54133,54134,108267
56707,,miq7k_9ujnqj,54134,54135,108269
56708,,omyaphciq80j,54135,54136,108271
56709,,,54136,54137,108273
56710,,xiuu9iwky7aj,54137,54138,108275
56711,,xzt4osl09o4j,54138,54139,108277
56712,,url:http://adsabs.harvard.edu/abs/1976infph..16..233d,54139,54140,108279
56713,,5rm0cj401eij,54140,54141,108281
56714,,url:http://portal.acm.org/ft_gateway.cfm3fid3d110192526type3dpdf,54141,54142,108283
56715,,wnfdblk-8xij,54142,54143,108285
56716,,fmuom_ogj4mj,54144,54145,108289
56717,,gmji0sdwptij,54145,54146,108291
56718,,afapej_mk3kj,54146,54147,108293
56719,,y017ahzeygqj,54147,54148,108295
56720,,y8nnkjlnlsij,54148,54149,108297
56721,,krofk_rwvucj,54149,54150,108299
56722,,slaky0negumj,54150,54151,108301
56723,,d8rbnx279lqj,54151,54152,108303
56724,,4wurtyboeryj,54153,54154,108307
56725,,y9vccmrxk9kj,54154,54155,108309
56726,,h_m5jxqqi0uj,54155,54156,108311
56727,,597vkgvm17uj,54156,54157,108313
56728,,bguasw0yvpej,54157,54158,108315
56729,,6f1otoutr0oj,54158,54159,108317
56730,,0g5u0z18esaj,54159,54160,108319
56731,,gaihanziog8j,54160,54161,108321
56732,,de9tsx4q9ssj,54161,54162,108323
56733,,wngv_bjxjjyj,54162,54163,108325
56734,,quxvhvycc2oj,54163,54164,108327
56735,,ritdfpdssjsj,54164,54165,108329
56736,,nkjekrvvo2cj,54165,54166,108331
56737,,o7a4cukjansj,54166,54167,108333
56738,,n6tlj8nptsuj,54167,54168,108335
56739,,8c9pib0vdo4j,54168,54169,108337
56740,,4qcppoqfo-qj,54169,54170,108339
56741,,bfnuzon0lhsj,54170,54171,108341
56742,,-9lmgcveri4j,54171,54172,108343
56743,,hv69zoeiokej,54172,54173,108345
56744,,imwzscczvfqj,54173,54174,108347
56745,,1hdyfa_wlwqj,54174,54175,108349
56746,,nyrqnwaekccj,54175,54176,108351
56747,,qabgclfodskj,54176,54177,108353
56748,,qklwt12evo8j,54177,54178,108355
56749,,5wzdbxaosg4j,54178,54179,108357
56750,,2rlokb-r4xkj,54179,54180,108359
56751,,lzeheqokrwaj,54180,54181,108361
56752,,bzpxgqjkmgij,54181,54182,108363
56753,,,54182,54183,108365
56754,,ywnpcnweco8j,54183,54184,108367
56755,,krjg6kmf1ugj,54184,54185,108369
56756,,tricfkiadxij,54185,54186,108371
56757,,fvrd7m-aqqij,54186,54187,108373
56758,,hk8rg5wjlssj,54187,54188,108375
56759,,nvdvhgk2pwwj,54188,54189,108377
56760,,egc4wgondjwj,54189,54190,108379
56761,,5l8by9txvhqj,54190,54191,108381
56762,,sgscklnyczsj,54191,54192,108383
56763,,8ttslym76hyj,54192,54193,108385
56764,,r_t2ewr9gpij,54193,54194,108387
56765,,si1u5o4i4hkj,54194,54195,108389
56766,,zziw1mq5s-oj,54195,54196,108391
56767,,2obljrfj7ckj,54196,54197,108393
56768,,meg5ewksg0ej,54197,54198,108395
56769,,tvwqxpvdlcwj,54198,54199,108397
56770,,64yk9uyg8ymj,54199,54200,108399
56771,,mxoju4urmeqj,54200,54201,108401
56772,,wfn2slrhdu4j,54201,54202,108403
56773,,hm9lpitiui8j,54202,54203,108405
56774,,pngytn-njwgj,54203,54204,108407
56775,,pcloxdlqgqoj,54204,54205,108409
56776,,iedwzhqnwguj,54205,54206,108411
56777,,wchvk1a5uwmj,54207,54208,108415
56778,,nhg47am5mvaj,54208,54209,108417
56779,,i34dogjzyw8j,54210,54211,108421
56780,,e7t9qldr-7kj,54211,54212,108423
56781,,1l-oom6c7zij,54212,54213,108425
56782,,rkuyc1qauycj,54213,54214,108427
56783,,sg-utdqyceoj,54215,54216,108431
56784,,83qrcoibix0j,54216,54217,108433
56785,,oglx7haa6iyj,54217,54218,108435
56786,,vdtjgsyu3vwj,54218,54219,108437
56787,,jj-yg7xym0aj,54219,54220,108439
56788,,x2yaramoan8j,54220,54221,108441
56789,,s7zchp7srzmj,54221,54222,108443
56790,,xftd-ead2ykj,54223,54224,108447
56791,,uqvb-otazi0j,54224,54225,108449
56792,,eydn-_0s97oj,54225,54226,108451
56793,,rzogcqedarcj,54226,54227,108453
56794,,kneuxv6j3nqj,54227,54228,108455
56795,,tjdcll8mdtqj,54228,54229,108457
56796,,ir3wbaumg9kj,54229,54230,108459
56797,,f_1zgfn7kzwj,54230,54231,108461
56798,,l4w8yt73oiij,54231,54232,108463
56799,,kq384uplv68j,54232,54233,108465
56800,,vbsq-lovydij,54233,54234,108467
56801,,d1qjdwawog4j,54234,54235,108469
56802,,,54235,54236,108471
56803,,url:http://portal.acm.org/citation.cfm3fid3d1101149.1101297,54236,54237,108473
56804,,fdlb2pxwqlaj,54237,54238,108475
56805,,jqlxc4sjprkj,54238,54239,108477
56806,,crvwfoz0lq0j,54239,54240,108479
56807,,c63lywsw_rgj,54240,54241,108481
56808,,d6pgzcqnewij,54241,54242,108483
56809,,fyxpggwyp2yj,54242,54243,108485
56810,,gsnppzje-oij,54243,54244,108487
56811,,nh4q_km-q50j,54244,54245,108489
56812,,_v_b724_blej,54245,54246,108491
56813,,ggnqizg508uj,54246,54247,108493
56814,,tahmdma49wwj,54247,54248,108495
56815,,url:http://www.csa.com/partners/viewrecord.php3frequester3dgs26collection3dtrd26recid3dn9210476ah,54248,54249,108497
56816,,7rnbbyph3baj,54249,54250,108499
56817,,suduid_rey0j,54250,54251,108501
56818,,lmlfez_iq2gj,54251,54252,108503
56819,,url:http://doi.wiley.com/10.1002/he.112,54252,54253,108505
56820,,djpj6sxwjcoj,54253,54254,108507
56821,,zmc454_8mfmj,54254,54255,108509
56822,,,54255,54256,108511
56823,,vtwzsba1fb0j,54256,54257,108513
56824,,wkogskwsw68j,54257,54258,108515
56825,,ncbcdzplkm0j,54258,54259,108517
56826,,vxip2muimm0j,54260,54261,108521
56827,,fimchxaygrwj,54261,54262,108523
56828,,tmdnlqqpty8j,54262,54263,108525
56829,,19hi-yuechgj,54263,54264,108527
56830,,njlhfyjgvesj,54264,54265,108529
56831,,arjzntpuy3ij,54265,54266,108531
56832,,_mbzpovevpuj,54266,54267,108533
56833,,50io0sgqciaj,54267,54268,108535
56834,,e8djqytfbi0j,54268,54269,108537
56835,,url:http://www.csa.com/partners/viewrecord.php3frequester3dgs26collection3dtrd26recid3d700410cd,54269,54270,108539
56836,,url:http://adsabs.harvard.edu/abs/1977mit..reptv....j,54270,54271,108541
56837,,w71m_mjkjrkj,54271,54272,108543
56838,,u_z0k1h4isuj,54272,54273,108545
56839,,lp_dwjaxbwij,54273,54274,108547
56840,,aoqj0lflq8gj,54274,54275,108549
56841,,qhgigjpqaqkj,54275,54276,108551
56842,,url:http://links.jstor.org/sici3fsici3d0146-4949(196722)8253a3253c459253aemf253e2.0.co253b2-3,54276,54277,108553
56843,,u_zyp8ci0o4j,54277,54278,108555
56844,,kllqervxiqqj,54278,54279,108557
56845,,44r_vyrstiqj,54279,54280,108559
56846,,i4br2_zf4jmj,54280,54281,108561
56847,,3ihemfczdbmj,54281,54282,108563
56848,,kzclwz6-kkij,54282,54283,108565
56849,,zsxyt5jm634j,54283,54284,108567
56850,,f7azeofg-q0j,54284,54285,108569
56851,,i0gc67uvbekj,54285,54286,108571
56852,,ype4cuxq0rqj,54286,54287,108573
56853,,pr_iz8yu70ej,54287,54288,108575
56854,,url:http://www.csa.com/partners/viewrecord.php3frequester3dgs26collection3dtrd26recid3d155936ws26recid3d199301550070md,54288,54289,108577
56855,,ckgqrnvwxn0j,54289,54290,108579
56856,,url:http://portal.acm.org/citation.cfm3fid3d115586.11558826coll3dguide26dl3dacm26cfid3d1111111126cftoken3d2222222,54290,54291,108581
56857,,wks6pvjkw74j,54291,54292,108583
56858,,ly_o-u-zhn0j,54292,54293,108585
56859,,2idq2kod-nyj,54293,54294,108587
56860,,gozqt0v7yrsj,54294,54295,108589
56861,,l5je5qe7x_8j,54295,54296,108591
56862,,kzm3iky_d8mj,54296,54297,108593
56863,,qvdrkpsqcugj,54297,54298,108595
56864,,rul-7ijwb2oj,54299,54300,108599
56865,,pqzg7nfdws0j,54300,54301,108601
56866,,arnwer7qheuj,54301,54302,108603
56867,,kj2hjgj6ntuj,54302,54303,108605
56868,,va_oodqq-jaj,54303,54304,108607
56869,,3lbpvcrwcfwj,54304,54305,108609
56870,,0dk5rguhf_ej,54305,54306,108611
56871,,zmuxywtysp4j,54306,54307,108613
56872,,url:http://www.geography.org.uk/journals/journals.asp3farticleid3d4,54307,54308,108615
56873,,n_rgdg3xmcoj,54308,54309,108617
56874,,7adipasapbyj,54309,54310,108619
56875,,ex1hcscnbfqj,54310,54311,108621
56876,,fmuwrcmrglyj,54311,54312,108623
56877,,url:http://www.csa.com/partners/viewrecord.php3frequester3dgs26collection3dtrd26recid3d0294187ci,54312,54313,108625
56878,,weggykgcnraj,54313,54314,108627
56879,,url:http://links.jstor.org/sici3fsici3d0146-4949(196323)4253a3253c261253atati2522253e2.0.co253b2-0,54314,54315,108629
56880,,2sqlkigvcyqj,54315,54316,108631
56881,,86hvpvmiotyj,54316,54317,108633
56882,,qo_ur11ijl8j,54317,54318,108635
56883,,tanbnlidrtwj,54318,54319,108637
56884,,rpeweibcz5ej,54319,54320,108639
56885,,z7qhls8upqcj,54320,54321,108641
56886,,aaaz2qbkcjaj,54321,54322,108643
56887,,co3rbjt8to0j,54322,54323,108645
56888,,xsmuzeihm5yj,54323,54324,108647
56889,,wvnmq9dk2gsj,54324,54325,108649
56890,,luk6stkxoywj,54325,54326,108651
56891,,url:http://adsabs.harvard.edu/abs/1983phdt........23b,54326,54327,108653
56892,,xnxnt9r9nh8j,54327,54328,108655
56893,,4v_othg0hmsj,54328,54329,108657
56894,,dm9itzhspeuj,54329,54330,108659
56895,,w_obzp_xkhgj,54330,54331,108661
56896,,tgqcpotlsoej,54331,54332,108663
56897,,6cmnzcyvpwsj,54332,54333,108665
56898,,wc1faobduksj,54333,54334,108667
56899,,kq-reqndxluj,54334,54335,108669
56900,,,54335,54336,108671
56901,,qq2ltnrntbuj,54336,54337,108673
56902,,d9_fgkve9coj,54337,54338,108675
56903,,ljswfpp8oa8j,54338,54339,108677
56904,,q8qbzjea6oaj,54339,54340,108679
56905,,tauqj8b6opyj,54340,54341,108681
56906,,3ig2rj8ngfij,54341,54342,108683
56907,,3t2antkqcouj,54342,54343,108685
56908,,jikzu3e9x40j,54343,54344,108687
56909,,itkdwkjpad4j,54344,54345,108689
56910,,psuw_8e5fe4j,54345,54346,108691
56911,,g8akxciriaij,54346,54347,108693
56912,,nolfugicqb4j,54347,54348,108695
56913,,wkwgkbyqrt0j,54348,54349,108697
56914,,j-bjobb_rhsj,54349,54350,108699
56915,,xhj6s9lelyuj,54350,54351,108701
56916,,url:http://portal.acm.org/ft_gateway.cfm3fid3d100870426type3dpdf,54351,54352,108703
56917,,ahvbxm-6maqj,54352,54353,108705
56918,,adpx-s-ygwij,54353,54354,108707
56919,,url:http://www.ingentaconnect.com/content/els/09505849/2004/00000046/00000003/art00125,54354,54355,108709
56920,,rkkwghm_vhcj,54355,54356,108711
56921,,kerk3ts_dt0j,54356,54357,108713
56922,,url:http://www.csa.com/partners/viewrecord.php3frequester3dgs26collection3dtrd26recid3d200111010683mt26recid3da0032597ah,54357,54358,108715
56923,,tm4wnhuushcj,54358,54359,108717
56924,,rdy2yret0gyj,54359,54360,108719
56925,,a3_-dzefmywj,54360,54361,108721
56926,,eyul6p0iop4j,54361,54362,108723
56927,,7k07zzwk5jmj,54362,54363,108725
56928,,qyxhn3crvq8j,54363,54364,108727
56929,,3ceyrscpr_gj,54364,54365,108729
56930,,jsnncdid0yij,54365,54366,108731
56931,,url:http://portal.acm.org/ft_gateway.cfm3fid3d95711626type3dpdf26dl3dacm26dl3dacm26cfid3d1111111126cftoken3d2222222,54366,54367,108733
56932,,mzy6f72femij,54367,54368,108735
56933,,yzosljgb3raj,54368,54369,108737
56934,,j3tzj8cday0j,54369,54370,108739
56935,,2k86ubds1k4j,54370,54371,108741
56936,,o4bjxqnhgsij,54371,54372,108743
56937,,63t-u0menw4j,54372,54373,108745
56938,,oraat7lgewoj,54373,54374,108747
56939,,56hijthi2tyj,54374,54375,108749
56940,,sieozdoabfwj,54375,54376,108751
56941,,du8zgq8hsngj,54376,54377,108753
56942,,fgnljjtwcdmj,54377,54378,108755
56943,,r5gvmgnnwbij,54378,54379,108757
56944,,b3bfq9qwfzaj,54380,54381,108761
56945,,mayq-jonbdwj,54381,54382,108763
56946,,epfmzozv1lmj,54382,54383,108765
56947,,kpfulebsioij,54383,54384,108767
56948,,bw5vxr3t7ucj,54384,54385,108769
56949,,hvrj_wzrqi4j,54385,54386,108771
56950,,ulsd8rgeozej,54386,54387,108773
56951,,hqh8z8pmgbyj,54387,54388,108775
56952,,p-viqawmmqaj,54388,54389,108777
56953,,url:http://portal.acm.org/citation.cfm3fid3d191839,54389,54390,108779
56954,,url:http://portal.acm.org/citation.cfm3fid3d1024694.1024719,54390,54391,108781
56955,,cucobfuucmkj,54391,54392,108783
56956,,o1j5cb5jd_4j,54392,54393,108785
56957,,g9yemomdjskj,54393,54394,108787
56958,,kqirkoitef8j,54394,54395,108789
56959,,8nmpxu9m2aij,54395,54396,108791
56960,,ha5_ayhwrbwj,54396,54397,108793
56961,,lmioyya79j4j,54397,54398,108795
56962,,po2wwplgtz0j,54398,54399,108797
56963,,ssxkxui6sacj,54399,54400,108799
56964,,z4fu5kcgkrij,54400,54401,108801
56965,,url:http://portal.acm.org/ft_gateway.cfm3fid3d102762626type3dpdf,54401,54402,108803
56966,,url:http://portal.acm.org/citation.cfm3fid3d89482.89504,54402,54403,108805
56967,,k7nokzrsjtcj,54403,54404,108807
56968,,o5a00lzxswkj,54404,54405,108809
56969,,p-eqrz5aavuj,54405,54406,108811
56970,,una9pwxjg1yj,54407,54408,108815
56971,,zlzymir2ar4j,54408,54409,108817
56972,,z44d2x-npvuj,54409,54410,108819
56973,,vjawcllilnoj,54410,54411,108821
56974,,,54411,54412,108823
56975,,ugooc1jhbcij,54412,54413,108825
56976,,p0qsawfn1bkj,54413,54414,108827
56977,,kgb9ynpaq1ij,54414,54415,108829
56978,,3pvfoeszuuej,54415,54416,108831
56979,,xi0k2kk_qeoj,54416,54417,108833
56980,,vfhn4smrcgej,54417,54418,108835
56981,,t268xhh1z1cj,54418,54419,108837
56982,,ko97r39oc3qj,54419,54420,108839
56983,,z0ikszfnew8j,54420,54421,108841
56984,,zghcc59vwjgj,54421,54422,108843
56985,,oav_duxpvgkj,54422,54423,108845
56986,,agpwpyofhksj,54423,54424,108847
56987,,yrgayy7ifuyj,54424,54425,108849
56988,,k7u1m1w5liwj,54425,54426,108851
56989,,7uhtt3rkjxuj,54426,54427,108853
56990,,_spymqtaoyuj,54427,54428,108855
56991,,urnpu4l7hqcj,54428,54429,108857
56992,,uqln9pgbhbwj,54429,54430,108859
56993,,ysqqhftbmvmj,54431,54432,108863
56994,,ewgyaxjhwqqj,54432,54433,108865
56995,,tkrzindk7ioj,54433,54434,108867
56996,,r9tcxpaujc8j,54434,54435,108869
56997,,uo-vs1d-c0mj,54435,54436,108871
56998,,bj3tqdt8ujej,54436,54437,108873
56999,,wluag5a3x9oj,54437,54438,108875
57000,,l3t4ozy5socj,54438,54439,108877
57001,,hjqblhfxczwj,54439,54440,108879
57002,,dzpmnkcihngj,54440,54441,108881
57003,,fspbubgspdmj,54441,54442,108883
57004,,mvust9zzsuoj,54442,54443,108885
57005,,g0cxxcluoy0j,54443,54444,108887
57006,,cnaayzmbmkej,54444,54445,108889
57007,,4ak08s31yquj,54445,54446,108891
57008,,_rq3wlaxz3aj,54446,54447,108893
57009,,ndduhwfzn4oj,54447,54448,108895
57010,,wdsbkgvegwqj,54448,54449,108897
57011,,zlzscad-vgej,54449,54450,108899
57012,,nltvsbub7hyj,54450,54451,108901
57013,,kwgqt09opocj,54451,54452,108903
57014,,bji1sp0h7tsj,54452,54453,108905
57015,,amn9rctyttej,54453,54454,108907
57016,,zxdqfrzhohqj,54454,54455,108909
57017,,ugpybzmxvtkj,54455,54456,108911
57018,,djizbrnznzgj,54456,54457,108913
57019,,i-zt2koqe1ej,54457,54458,108915
57020,,s9qej3_fjv4j,54458,54459,108917
57021,,f1wgd54uukwj,54459,54460,108919
57022,,,54460,54461,108921
57023,,htap9c7dqagj,54461,54462,108923
57024,,40-by353dfkj,54462,54463,108925
57025,,rqk9a2akvt8j,54463,54464,108927
57026,,lgers7wmzxej,54464,54465,108929
57027,,m0oqsjy8xjyj,54465,54466,108931
57028,,tiyskw7hmysj,54466,54467,108933
57029,,qhixxihgho8j,54467,54468,108935
57030,,e1yk4tuybecj,54468,54469,108937
57031,,qs11qy-zp2ej,54469,54470,108939
57032,,riowjw7s4fqj,54470,54471,108941
57033,,latjkqdqr6sj,54471,54472,108943
57034,,u2fmhe2trggj,54472,54473,108945
57035,,yk_vryne0jmj,54473,54474,108947
57036,,url:http://pubs.acs.org/cgi-bin/abstract.cgi/achre4/2005/38/i07/abs/ar040142o.html,54474,54475,108949
57037,,,54475,54476,108951
57038,,gyfflo3-bm8j,54476,54477,108953
57039,,7-vkshlsswoj,54477,54478,108955
57040,,pytk8lryjhgj,54479,54480,108959
57041,,bwoclxrnfhoj,54480,54481,108961
57042,,nlpdg2zltiaj,54481,54482,108963
57043,,url:http://www.springerlink.com/index/ur55uugk77117293.pdf,54482,54483,108965
57044,,dudezgpscmyj,54483,54484,108967
57045,,uh50ovlnf8gj,54484,54485,108969
57046,,xaw_bailproj,54485,54486,108971
57047,,bfqe0d3inhij,54486,54487,108973
57048,,h1ameam0plcj,54487,54488,108975
57049,,rnb14c5igiej,54488,54489,108977
57050,,pmd3qgyqf_aj,54489,54490,108979
57051,,om_usyitavaj,54490,54491,108981
57052,,hugmkl_c_xij,54491,54492,108983
57053,,0md0ihb9leqj,54492,54493,108985
57054,,url:http://portal.acm.org/ft_gateway.cfm3fid3d76421326type3dpdf26dl3dguide26dl3dacm26cfid3d1111111126cftoken3d2222222,54493,54494,108987
57055,,qyftwpszp34j,54494,54495,108989
57056,,sm1tz4szy6wj,54495,54496,108991
57057,,8mnoolvy8rej,54496,54497,108993
57058,,url:http://portal.acm.org/ft_gateway.cfm3fid3d109968226type3dpdf,54497,54498,108995
57059,,ndtecq0qhrcj,54498,54499,108997
57060,,55zenofzrtcj,54499,54500,108999
57061,,_ywjir9pcvqj,54500,54501,109001
57062,,mfotem2-_xsj,54501,54502,109003
57063,,qjwt-zcmjpqj,54502,54503,109005
57064,,xzoggduf9lij,54503,54504,109007
57065,,jqojn3b6r7ij,54504,54505,109009
57066,,foqeoedh-mcj,54505,54506,109011
57067,,hyffj8v4swuj,54506,54507,109013
57068,,ao9n9yyinhuj,54507,54508,109015
57069,,p0qx78hoc9mj,54508,54509,109017
57070,,,54509,54510,109019
57071,,wer8-rsnceej,54510,54511,109021
57072,,n7b9lg4tpzgj,54511,54512,109023
57073,,qf4-lrcl-vaj,54512,54513,109025
57074,,syvrk9kj_8kj,54513,54514,109027
57075,,auwfhmtkhqqj,54514,54515,109029
57076,,1sjxt9dnvscj,54515,54516,109031
57077,,trnntplgaqgj,54516,54517,109033
57078,,8ysow2acnzcj,54517,54518,109035
57079,,o6cckkrxabwj,54518,54519,109037
57080,,nhhnjfcjf_kj,54519,54520,109039
57081,,wmvvgcertt4j,54520,54521,109041
57082,,ba1wiqmsmbuj,54521,54522,109043
57083,,xqs4xe6xdqij,54522,54523,109045
57084,,8lxfbfjov24j,54523,54524,109047
57085,,fbxrvgaf7l0j,54524,54525,109049
57086,,cuooi5jjxxqj,54525,54526,109051
57087,,wmpzlrc5sx8j,54526,54527,109053
57088,,,54527,54528,109055
57089,,embadf3koimj,54528,54529,109057
57090,,yzvpzmpmgcej,54529,54530,109059
57091,,sxt807rr-nsj,54530,54531,109061
57092,,cwhqzosb8q4j,54531,54532,109063
57093,,ngfkrg6e4fqj,54532,54533,109065
57094,,ludsnprrlqsj,54533,54534,109067
57095,,url:http://portal.acm.org/ft_gateway.cfm3fid3d22385926type3dpdf26coll3dguide26dl3dacm26cfid3d1111111126cftoken3d2222222,54534,54535,109069
57096,,1he3ewrzosej,54535,54536,109071
57097,,9puwosii0mqj,54536,54537,109073
57098,,1l_tms_jttgj,54537,54538,109075
57099,,i3fs2xz9qiej,54538,54539,109077
57100,,0mc-jwpquy0j,54539,54540,109079
57101,,x9z5cvgad7yj,54540,54541,109081
57102,,jklizzstxjqj,54541,54542,109083
57103,,fut7x82plsgj,54542,54543,109085
57104,,,54543,54544,109087
57105,,url:http://adsabs.harvard.edu/abs/1980umas.reptq....s,54544,54545,109089
57106,,jmgdmwsjuk0j,54545,54546,109091
57107,,lwlq9rwui8cj,54546,54547,109093
57108,,vtfqnhhixwcj,54547,54548,109095
57109,,eph0j4uodiwj,54548,54549,109097
57110,,url:http://portal.acm.org/ft_gateway.cfm3fid3d12890426type3dpdf26dl3dguide26dl3dacm26cfid3d1111111126cftoken3d2222222,54549,54550,109099
57111,,bia-9dtfcqij,54550,54551,109101
57112,,jevjfsxktjqj,54551,54552,109103
57113,,tnlmh37tfgcj,54552,54553,109105
57114,,zb7hbm6ifeoj,54553,54554,109107
57115,,ydzcbvi5poej,54554,54555,109109
57116,,j6t9c0nlx3oj,54555,54556,109111
57117,,fsfwufii_nkj,54556,54557,109113
57118,,wzh7ycyizvkj,54557,54558,109115
57119,,f3nmcxooht0j,54559,54560,109119
57120,,bmb9nuotngmj,54560,54561,109121
57121,,5h91tiun7csj,54561,54562,109123
57122,,ffzgbfs54dsj,54562,54563,109125
57123,,gxumxlb6vf0j,54563,54564,109127
57124,,rtcgz7pmohij,54564,54565,109129
57125,,gfrmtb2qhgyj,54565,54566,109131
57126,,oxc-6rqkst0j,54566,54567,109133
57127,,61k8klmj0s4j,54567,54568,109135
57128,,6p8wubq3w-uj,54569,54570,109139
57129,,idpit_bsv48j,54570,54571,109141
57130,,crwwvegaci4j,54571,54572,109143
57131,,ldzpnugzlvuj,54572,54573,109145
57132,,j3nim0w0xa8j,54573,54574,109147
57133,,ulocrm8qraij,54574,54575,109149
57134,,f1eqlwymvekj,54575,54576,109151
57135,,x2aoxve31rgj,54576,54577,109153
57136,,ctvc34ghatkj,54577,54578,109155
57137,,ybp3xj4qvtoj,54578,54579,109157
57138,,vnek-2iimssj,54579,54580,109159
57139,,bdtdknb6eaej,54580,54581,109161
57140,,mxergfoujnsj,54581,54582,109163
57141,,url:http://doi.wiley.com/10.1002/jnr.490140214,54582,54583,109165
57142,,b-jvlqbgjzyj,54583,54584,109167
57143,,c9geknv3xgyj,54584,54585,109169
57144,,1zqi3buoefyj,54585,54586,109171
57145,,b8nfo5hl5muj,54586,54587,109173
57146,,cuztznxpqxuj,54587,54588,109175
57147,,_m2lek5zsjuj,54588,54589,109177
57148,,avzgsdskuvaj,54589,54590,109179
57149,,9zkooybask0j,54590,54591,109181
57150,,_w1eawqtpbwj,54591,54592,109183
57151,,p9lc3i5ngvej,54592,54593,109185
57152,,url:http://portal.acm.org/citation.cfm3fid3d601858.60187926dl3dguide26dl3dacm26idx3dj68926part3dperiodical26wanttype3dperiodical26title3dacm2520sigmod2520record26cfid3d1111111126cftoken3d2222222,54593,54594,109187
57153,,nbhhnjkyseoj,54594,54595,109189
57154,,zgnofy7sigkj,54595,54596,109191
57155,,fn4o_opxlawj,54596,54597,109193
57156,,5se3cckngvkj,54597,54598,109195
57157,,xgsvca5kfraj,54598,54599,109197
57158,,qahspx__mk8j,54599,54600,109199
57159,,ix0-qlkpbwqj,54600,54601,109201
57160,,t93rx4dacpkj,54601,54602,109203
57161,,hdvcgz_5qj0j,54602,54603,109205
57162,,url:http://doi.wiley.com/10.1002/ace.128,54603,54604,109207
57163,,jq1s1lbugegj,54604,54605,109209
57164,,datrwpyyg7uj,54605,54606,109211
57165,,t0fhbzw78zkj,54606,54607,109213
57166,,eag1lb90xw0j,54607,54608,109215
57167,,0j9hku6q20cj,54608,54609,109217
57168,,296uruyb5xcj,54609,54610,109219
57169,,url:http://doi.wiley.com/10.1002/he.157,54610,54611,109221
57170,,56fenbhiekaj,54611,54612,109223
57171,,bqxfgeh-u4kj,54612,54613,109225
57172,,bculij--mxwj,54613,54614,109227
57173,,8tx0gsi2ax4j,54614,54615,109229
57174,,bvye0luu-zkj,54615,54616,109231
57175,,kp3srf6yyrkj,54616,54617,109233
57176,,y0nrcwxfyrij,54617,54618,109235
57177,,detsgqeo6emj,54618,54619,109237
57178,,38uaww1dqbmj,54619,54620,109239
57179,,lnkclnstxrej,54620,54621,109241
57180,,pqu_yiu_fbuj,54621,54622,109243
57181,,tyr6ejnckmij,54622,54623,109245
57182,,p4ixf74uw6oj,54623,54624,109247
57183,,url:http://www.ingentaconnect.com/content/els/09505849/2003/00000045/00000009/art00212,54624,54625,109249
57184,,exhhbmfmy1uj,54625,54626,109251
57185,,1apxsofvq30j,54626,54627,109253
57186,,q9rwlm_fkqkj,54627,54628,109255
57187,,gigof4dlg7yj,54628,54629,109257
57188,,x4si9whnr0mj,54629,54630,109259
57189,,9akz1s_ufgmj,54630,54631,109261
57190,,_ojagig_yrej,54631,54632,109263
57191,,q4ywn3tbofaj,54633,54634,109267
57192,,i8uvzec9c0aj,54634,54635,109269
57193,,hb8o9nfe2omj,54635,54636,109271
57194,,yxnk2wpwlzkj,54636,54637,109273
57195,,qqagegpn7rqj,54637,54638,109275
57196,,qiqyb9zjfcuj,54638,54639,109277
57197,,url:http://portal.acm.org/ft_gateway.cfm3fid3d108359426type3dpdf,54639,54640,109279
57198,,url:http://portal.acm.org/citation.cfm3fid3d192593.19743626dl3dguide26dl3dacm26type3dseries26idx3d19259326part3dproceedings26wanttype3dproceedings26title3dinternational2520multimedia2520conference26cfid3d1111111126cftoken3d2222222,54640,54641,109281
57199,,on4advgbfxmj,54641,54642,109283
57200,,4symmeziywcj,54642,54643,109285
57201,,cgbuc-7u2tgj,54643,54644,109287
57202,,xahmsmrbinoj,54644,54645,109289
57203,,yabfhxehsfwj,54645,54646,109291
57204,,vikbfy4thiyj,54646,54647,109293
57205,,url:http://portal.acm.org/ft_gateway.cfm3fid3d106521126type3dpdf,54647,54648,109295
57206,,whkjvn3j8dwj,54648,54649,109297
57207,,2ya3pvgeytqj,54649,54650,109299
57208,,tlx3ql5p6nej,54650,54651,109301
57209,,92di1hoxmb4j,54651,54652,109303
57210,,_gcfocfeqioj,54652,54653,109305
57211,,bx5hzkq8vg8j,54653,54654,109307
57212,,url:http://adsabs.harvard.edu/abs/1983mit..reptr....i,54654,54655,109309
57213,,_antdl_0yayj,54655,54656,109311
57214,,z12o6tmy_qcj,54656,54657,109313
57215,,bold13t1czwj,54657,54658,109315
57216,,fqncz7x-hlaj,54658,54659,109317
57217,,eu-qm9xuvwsj,54659,54660,109319
57218,,jq0wor55vj4j,54660,54661,109321
57219,,ayhoppxkdeij,54661,54662,109323
57220,,typ5ilkk7kij,54662,54663,109325
57221,,url:http://adsabs.harvard.edu/abs/1984phdt........36s,54663,54664,109327
57222,,url:http://portal.acm.org/citation.cfm3fid3d234286.1057809,54664,54665,109329
57223,,wqj5eia0lggj,54665,54666,109331
57224,,lir9paiia0oj,54666,54667,109333
57225,,edi-6xrl66oj,54667,54668,109335
57226,,wtaw-htmgmmj,54668,54669,109337
57227,,xnslff8nekyj,54669,54670,109339
57228,,u3cwgexqwnej,54671,54672,109343
57229,,ehf37se_0mqj,54672,54673,109345
57230,,y93liga1orij,54673,54674,109347
57231,,pkkwt3mmizgj,54674,54675,109349
57232,,3uiztctau1ij,54675,54676,109351
57233,,url:http://www.csa.com/partners/viewrecord.php3frequester3dgs26collection3dtrd26recid3dn9210463ah,54676,54677,109353
57234,,zmurtvbdkx4j,54677,54678,109355
57235,,vwkijbb9xmgj,54678,54679,109357
57236,,sp5lcmjnjo4j,54679,54680,109359
57237,,uia57rfdba8j,54680,54681,109361
57238,,b8gr_atufzaj,54681,54682,109363
57239,,exvud6e5bamj,54682,54683,109365
57240,,v1w8mu2dl90j,54683,54684,109367
57241,,uwha-lp5h5ij,54684,54685,109369
57242,,mddrlt2fvwwj,54686,54687,109373
57243,,30zlmqylbucj,54687,54688,109375
57244,,zf4ngsdtghkj,54688,54689,109377
57245,,pjsnj7fi9lij,54689,54690,109379
57246,,na-s2ikwgvcj,54690,54691,109381
57247,,i_icno0kwn4j,54691,54692,109383
57248,,gfohaha0clsj,54692,54693,109385
57249,,r2j6jxw9wg0j,54693,54694,109387
57250,,t9dspywymzij,54694,54695,109389
57251,,jrxue0v0cywj,54695,54696,109391
57252,,khuddbhbzzkj,54696,54697,109393
57253,,d9lttlyrh_aj,54697,54698,109395
57254,,iry7wp0mbyaj,54698,54699,109397
57255,,fcj4umecgmsj,54699,54700,109399
57256,,ru7ozmcpg8kj,54700,54701,109401
57257,,wbvb47b9mxsj,54701,54702,109403
57258,,1fl5hay2408j,54702,54703,109405
57259,,4detmsorkz4j,54703,54704,109407
57260,,7ridfnb4niij,54704,54705,109409
57261,,iq0nrloe6fkj,54705,54706,109411
57262,,37yvrfspm6mj,54706,54707,109413
57263,,iz-n4kpqkj8j,54707,54708,109415
57264,,bx3vpzovovsj,54708,54709,109417
57265,,hz7qkd1mlnej,54709,54710,109419
57266,,6zvlvqwbkd0j,54710,54711,109421
57267,,04ej2knmpe4j,54711,54712,109423
57268,,7ibojqszszmj,54712,54713,109425
57269,,kb5jjje42zyj,54713,54714,109427
57270,,zeqn88cizfsj,54714,54715,109429
57271,,fmhev7gbfsuj,54715,54716,109431
57272,,rsz--eb28j8j,54716,54717,109433
57273,,h4hm5wix8umj,54717,54718,109435
57274,,bocbvsiachij,54718,54719,109437
57275,,url:http://portal.acm.org/citation.cfm3fid3d1083592.1083656,54719,54720,109439
57276,,j8owltgypxuj,54720,54721,109441
57277,,sfgbciyugvmj,54721,54722,109443
57278,,rw5ii5upiquj,54722,54723,109445
57279,,scjbc3jpjsej,54723,54724,109447
57280,,url:http://doi.wiley.com/10.1002/ace.91,54724,54725,109449
57281,,bazki1yij0oj,54725,54726,109451
57282,,xzhtbsklkwej,54726,54727,109453
57283,,kcrjk3fb4kmj,54727,54728,109455
57284,,fwdfjlw_4cqj,54728,54729,109457
57285,,b62eueii29uj,54729,54730,109459
57286,,o4-lks9xmlgj,54730,54731,109461
57287,,urjb0kxmkvmj,54731,54732,109463
57288,,dxxxiz4aaigj,54732,54733,109465
57289,,dwkbx0pemwuj,54733,54734,109467
57290,,zwunqbahc80j,54734,54735,109469
57291,,gka2_vbdji4j,54735,54736,109471
57292,,7bxddhbtehej,54736,54737,109473
57293,,1oqu1pfj-ugj,54737,54738,109475
57294,,br6jogwqyjej,54738,54739,109477
57295,,vl9z524bzvsj,54739,54740,109479
57296,,pkmwbyk8i4qj,54740,54741,109481
57297,,ejrgbszwms8j,54741,54742,109483
57298,,rqufazpdnuej,54742,54743,109485
57299,,tofnpppc6tsj,54743,54744,109487
57300,,url:http://doi.wiley.com/10.1002/ev.1515,54744,54745,109489
57301,,iuz4idi0slsj,54745,54746,109491
57302,,zayw5-a8iemj,54746,54747,109493
57303,,url:http://www.csa.com/partners/viewrecord.php3frequester3dgs26collection3dtrd26recid3d0153797ci,54747,54748,109495
57304,,zlcyuq5jdbmj,54748,54749,109497
57305,,kmsfo2ripjej,54749,54750,109499
57306,,2r4g0gbd2haj,54750,54751,109501
57307,,m7wuxwhqvg8j,54751,54752,109503
57308,,j2m83ovnemwj,54752,54753,109505
57309,,url:http://doi.wiley.com/10.1002/he.54,54753,54754,109507
57310,,tlmh5ycnwbkj,54754,54755,109509
57311,,wucchbarfvwj,54756,54757,109513
57312,,7fptkjhorzsj,54757,54758,109515
57313,,xf12uhb0wz0j,54758,54759,109517
57314,,cpu5banpk0uj,54759,54760,109519
57315,,rflgjxoglcuj,54760,54761,109521
57316,,url:http://portal.acm.org/ft_gateway.cfm3fid3d109958126type3dpdf,54761,54762,109523
57317,,fwyafqormpwj,54762,54763,109525
57318,,ghsx7gkujtsj,54763,54764,109527
57319,,url:http://portal.acm.org/citation.cfm3fid3d80838326coll3dportal26dl3dacm,54764,54765,109529
57320,,6awglf2gtboj,54765,54766,109531
57321,,sbsd7gextk0j,54767,54768,109535
57322,,k4tyxnz-__8j,54768,54769,109537
57323,,bjho2ftv4fsj,54769,54770,109539
57324,,so5bthtfvxsj,54770,54771,109541
57325,,ckmpcin7tryj,54771,54772,109543
57326,,bzegotmofjuj,54772,54773,109545
57327,,8f0yprw1eowj,54773,54774,109547
57328,,nb-e5ixv5hcj,54774,54775,109549
57329,,f76f0p4pdq8j,54775,54776,109551
57330,,qlimtgjq9z8j,54776,54777,109553
57331,,d4eiiouc1uuj,54777,54778,109555
57332,,ymc0vao7nbkj,54778,54779,109557
57333,,jr393cokpcmj,54779,54780,109559
57334,,1rzq4y8syn4j,54780,54781,109561
57335,,giktb2ghnjoj,54782,54783,109565
57336,,zmgeohumgo0j,54783,54784,109567
57337,,hpcwqq2nesij,54784,54785,109569
57338,,ed9onzutonaj,54785,54786,109571
57339,,dtyf6vmwessj,54786,54787,109573
57340,,bcvdemnrefmj,54787,54788,109575
57341,,stqpxyiprosj,54788,54789,109577
57342,,vtftmxful9yj,54789,54790,109579
57343,,rjg51smoacwj,54790,54791,109581
57344,,cxnahjcphrmj,54792,54793,109585
57345,,0kfnhhwhlp0j,54793,54794,109587
57346,,uo4iu4ofzmmj,54794,54795,109589
57347,,ryxdu-gwwdgj,54795,54796,109591
57348,,zl9ib7_c4bwj,54796,54797,109593
57349,,w1fgi2c8kkuj,54797,54798,109595
57350,,yiwh22hbtacj,54798,54799,109597
57351,,e4doqfl7-dqj,54799,54800,109599
57352,,bmy8xxjnq3ej,54800,54801,109601
57353,,6t75ly6wroyj,54801,54802,109603
57354,,cbspxvsgnbaj,54802,54803,109605
57355,,xsn5quclulyj,54803,54804,109607
57356,,,54804,54805,109609
57357,,esgodyxewnij,54805,54806,109611
57358,,or63ctwfutgj,54806,54807,109613
57359,,5f-sio4suwsj,54807,54808,109615
57360,,yd2vxdduitij,54808,54809,109617
57361,,,54809,54810,109619
57362,,qgipyvc-qe8j,54810,54811,109621
57363,,_xynh3ulbl0j,54811,54812,109623
57364,,iybbqezqpscj,54812,54813,109625
57365,,8pii62vmsjsj,54813,54814,109627
57366,,yzhfliwzawqj,54814,54815,109629
57367,,zzlrkvf8gacj,54815,54816,109631
57368,,url:http://www.emeraldinsight.com/insight/viewcontentservlet3ffilename3d/published/emeraldfulltextarticle/pdf/0010431010.pdf,54816,54817,109633
57369,,o_vue4t_1xej,54817,54818,109635
57370,,qwse3ybriioj,54818,54819,109637
57371,,dclqoqamayqj,54819,54820,109639
57372,,tl3eepxln0sj,54820,54821,109641
57373,,alundjtt1oaj,54821,54822,109643
57374,,rs_21nm2vdij,54822,54823,109645
57375,,cj0ylfhie7mj,54823,54824,109647
57376,,_mg9pl8mqk8j,54824,54825,109649
57377,,tuf_ugojy0gj,54825,54826,109651
57378,,u9okc_mtxmqj,54826,54827,109653
57379,,4pvlmhlu8zij,54827,54828,109655
57380,,w-wpeh4lfusj,54828,54829,109657
57381,,nx5yo3ndifej,54829,54830,109659
57382,,3shkghsl2jgj,54830,54831,109661
57383,,url:http://www.csa.com/partners/viewrecord.php3frequester3dgs26collection3dtrd26recid3d0834395ci,54831,54832,109663
57384,,cev7seu0p9sj,54832,54833,109665
57385,,6hdibsl7tqkj,54833,54834,109667
57386,,xssjyzz9okmj,54834,54835,109669
57387,,2l79kz4ndmkj,54835,54836,109671
57388,,zveky4nd8psj,54836,54837,109673
57389,,okmbb9yf0yaj,54837,54838,109675
57390,,muxtimdjljgj,54838,54839,109677
57391,,-7qdnmftkv4j,54839,54840,109679
57392,,ygrtv1czzg8j,54840,54841,109681
57393,,v4j2mho7l3uj,54841,54842,109683
57394,,pm_-oyvk56kj,54842,54843,109685
57395,,vl4btfn3xagj,54843,54844,109687
57396,,,54844,54845,109689
57397,,tabm9xzpj4sj,54845,54846,109691
57398,,azzl5ksjsmcj,54846,54847,109693
57399,,gfbvmhlza1mj,54847,54848,109695
57400,,da45onlusoqj,54848,54849,109697
57401,,s_mcilwpnugj,54849,54850,109699
57402,,ttpnyg2wemoj,54850,54851,109701
57403,,yvte9o2vqfaj,54851,54852,109703
57404,,1idt_afx5i4j,54852,54853,109705
57405,,iyezmyqsfx8j,54853,54854,109707
57406,,0s7hzpntsu0j,54854,54855,109709
57407,,w6eo3owl-1ej,54855,54856,109711
57408,,dg4an9hxq2wj,54856,54857,109713
57409,,uefbwqtttluj,54857,54858,109715
57410,,8_jfodvuv0mj,54858,54859,109717
57411,,2g1gw3t-fvqj,54859,54860,109719
57412,,uef1ezlf2qoj,54860,54861,109721
57413,,yvptkdquwomj,54861,54862,109723
57414,,c55ymk-185yj,54862,54863,109725
57415,,cpyn9vr63yyj,54863,54864,109727
57416,,h83nyat5caej,54864,54865,109729
57417,,gb4xuc47ircj,54865,54866,109731
57418,,url:http://portal.acm.org/ft_gateway.cfm3fid3d106618826type3dpdf,54866,54867,109733
57419,,lqx9_af2r60j,54867,54868,109735
57420,,1p41ctg8iwwj,54868,54869,109737
57421,,iw7jq3rqbcwj,54869,54870,109739
57422,,url:http://doi.wiley.com/10.1002/ev.1511,54870,54871,109741
57423,,c8tslazzzdoj,54871,54872,109743
57424,,w2_skvo3nrgj,54872,54873,109745
57425,,ehywek-pc8uj,54873,54874,109747
57426,,dbug3qfsbcuj,54874,54875,109749
57427,,fqlrvol6fkcj,54875,54876,109751
57428,,fowy7jo85fqj,54876,54877,109753
57429,,5sb4hr4ton0j,54877,54878,109755
57430,,gclonixyekej,54878,54879,109757
57431,,gaphi80bboij,54879,54880,109759
57432,,,54880,54881,109761
57433,,agwryz9u9v0j,54881,54882,109763
57434,,km2h7xtd4_qj,54882,54883,109765
57435,,v8mj4ee03cuj,54883,54884,109767
57436,,ljx37mgc1qqj,54884,54885,109769
57437,,rs0_-jsrzykj,54885,54886,109771
57438,,xr4hbug230qj,54886,54887,109773
57439,,mufyqxgdgkqj,54887,54888,109775
57440,,uxvccg_p3quj,54888,54889,109777
57441,,ugaparfsnnqj,54889,54890,109779
57442,,90qkfhs_tgej,54890,54891,109781
57443,,laeqpnd791mj,54891,54892,109783
57444,,56y4jxs7qt4j,54892,54893,109785
57445,,gpu7hrnjd2aj,54893,54894,109787
57446,,ispcdzkntu4j,54894,54895,109789
57447,,5r7u5j-u8_ij,54895,54896,109791
57448,,cdgbcqb7zswj,54896,54897,109793
57449,,rahknmdqya8j,54897,54898,109795
57450,,2b1nw5j0jdmj,54898,54899,109797
57451,,r3gdjpsjsmsj,54899,54900,109799
57452,,qshwgxkk50gj,54900,54901,109801
57453,,9i_oxfgsbtej,54901,54902,109803
57454,,fmrgogzzfkgj,54902,54903,109805
57455,,url:http://www.springerlink.com/index/u2744505v0718117.pdf,54903,54904,109807
57456,,djtfld1m7vej,54904,54905,109809
57457,,rs8sczmhswmj,54905,54906,109811
57458,,4tbl4r9pp7yj,54906,54907,109813
57459,,honxvrukilsj,54907,54908,109815
57460,,2uz0zliqhugj,54908,54909,109817
57461,,v7lrs03mf1sj,54909,54910,109819
57462,,qltwh0-m8muj,54910,54911,109821
57463,,ipzwwrzwqqmj,54911,54912,109823
57464,,dqqmfcewsisj,54912,54913,109825
57465,,6zalsigkleyj,54913,54914,109827
57466,,ir8mgz5jlk0j,54914,54915,109829
57467,,w-nmgsvv6t0j,54915,54916,109831
57468,,pgtk69tlxmaj,54916,54917,109833
57469,,ccwfrs4g81ej,54917,54918,109835
57470,,xxw3vg2i5n4j,54918,54919,109837
57471,,xvakkwimwuqj,54919,54920,109839
57472,,9w5itybrubkj,54920,54921,109841
57473,,7jihy9xptgaj,54921,54922,109843
57474,,hjfm2ubm9tkj,54922,54923,109845
57475,,im6vrwljkpaj,54923,54924,109847
57476,,f8mdcql_o2kj,54924,54925,109849
57477,,erfcetqymdqj,54925,54926,109851
57478,,auje6z7dz_yj,54926,54927,109853
57479,,c-maizfjuauj,54927,54928,109855
57480,,yypd6x9ifd8j,54928,54929,109857
57481,,qxlp279411ej,54929,54930,109859
57482,,cw1e2ounrquj,54930,54931,109861
57483,,tjmdbeds67mj,54931,54932,109863
57484,,url:http://portal.acm.org/citation.cfm3fid3d984488.98448926coll3dguide26dl3dacm26idx3dj68926part3dperiodical26wanttype3dperiodical26title3dacm2520sigmod2520record26cfid3d1111111126cftoken3d2222222,54932,54933,109865
57485,,hujeg2axmx4j,54933,54934,109867
57486,,6n42dpyt0mkj,54934,54935,109869
57487,,3lamk47y1vij,54936,54937,109873
57488,,url:http://ieeexplore.ieee.org/iel6/22/24998/01128129.pdf3farnumber3d1128129,54937,54938,109875
57489,,m6naki_aubaj,54938,54939,109877
57490,,j0lz_sgwk9mj,54939,54940,109879
57491,,g7yeempn4aqj,54940,54941,109881
57492,,n-ew6yyosfuj,54941,54942,109883
57493,,url:http://www.csa.com/partners/viewrecord.php3frequester3dgs26collection3dtrd26recid3d100221ws26recid3d8201310167md26recid3d018112610634xai,54942,54943,109885
57494,,hqgkgdf-v_sj,54943,54944,109887
57495,,45sqd6n6dncj,54944,54945,109889
57496,,fhrz39bkwn4j,54945,54946,109891
57497,,vaea4fvpokoj,54947,54948,109895
57498,,ylkinp-xgbkj,54948,54949,109897
57499,,d8qrqdkx-u4j,54949,54950,109899
57500,,ropfvk-4jckj,54950,54951,109901
57501,,pqeo-vbx-wqj,54951,54952,109903
57502,,xr2odzoefbgj,54952,54953,109905
57503,,hi4mh9czi6uj,54953,54954,109907
57504,,cmtgwrunphej,54954,54955,109909
57505,,url:http://portal.acm.org/citation.cfm3fid3d592193.592263,54955,54956,109911
57506,,bkj3wtghalaj,54956,54957,109913
57507,,3w7a5qgmb60j,54957,54958,109915
57508,,mds2z-omtagj,54958,54959,109917
57509,,qwp7w2u4czej,54959,54960,109919
57510,,fiscmqsx6okj,54960,54961,109921
57511,,axzstzaipjwj,54961,54962,109923
57512,,jbagr7ftxykj,54962,54963,109925
57513,,jlols0logtwj,54963,54964,109927
57514,,xtsd7zisw9yj,54964,54965,109929
57515,,ojsrmdpdrxcj,54965,54966,109931
57516,,o9yyp7pa7j4j,54966,54967,109933
57517,,m0zkh0aacx8j,54967,54968,109935
57518,,84ftuzyk7doj,54969,54970,109939
57519,,b8mipcdg1xej,54970,54971,109941
57520,,qw_of_qwmvqj,54971,54972,109943
57521,,7xoa7oizlxmj,54973,54974,109947
57522,,85skejei3ycj,54974,54975,109949
57523,,url:http://portal.acm.org/citation.cfm3fid3d276305,54975,54976,109951
57524,,gqygqz1iheyj,54976,54977,109953
57525,,ptuywpj6tf4j,54977,54978,109955
57526,,oy9eejkpmlwj,54978,54979,109957
57527,,dwswjo_ezp8j,54979,54980,109959
57528,,bal7_fz3gkij,54980,54981,109961
57529,,kp4dptl-thoj,54981,54982,109963
57530,,qzcp3igk6o0j,54982,54983,109965
57531,,989hzrulkk0j,54983,54984,109967
57532,,wymaoccsbkmj,54984,54985,109969
57533,,zlyoykhk1tkj,54985,54986,109971
57534,,q0fqu39yd8uj,54986,54987,109973
57535,,y1fo0fzqkowj,54987,54988,109975
57536,,9j2hlsu8zgkj,54988,54989,109977
57537,,9m36aow_8ogj,54989,54990,109979
57538,,v77df11t62aj,54990,54991,109981
57539,,os-zsy84fdqj,54991,54992,109983
57540,,od-pztw4itwj,54992,54993,109985
57541,,m9nsexf-lpaj,54993,54994,109987
57542,,keifgddu2mqj,54994,54995,109989
57543,,url:http://doi.wiley.com/10.1002/he.16,54995,54996,109991
57544,,altymzwccdgj,54996,54997,109993
57545,,nrhgu8chnnyj,54997,54998,109995
57546,,fg7ii4tslsej,54998,54999,109997
57547,,dnew6_ibn_aj,54999,55000,109999
57548,,kf1tx2mqnuej,55000,55001,110001
57549,,vjlfk_aczmsj,55001,55002,110003
57550,,sz9esx0d0icj,55002,55003,110005
57551,,vytu2szu8l4j,55003,55004,110007
57552,,1sboz3q3imuj,55004,55005,110009
57553,,j-u8insn1yqj,55005,55006,110011
57554,,jeveex9x7twj,55006,55007,110013
57555,,ouarkfkdprkj,55007,55008,110015
57556,,qkghvmez-hej,55008,55009,110017
57557,,zmef9epzxpyj,55009,55010,110019
57558,,hvvf0afgoesj,55010,55011,110021
57559,,pxg3jpjfkz4j,55011,55012,110023
57560,,tbyd5efezpyj,55012,55013,110025
57561,,bgmkbd8ktjaj,55013,55014,110027
57562,,i9u9daqwm3sj,55014,55015,110029
57563,,dahew3icbngj,55015,55016,110031
57564,,eu0gx8-dqqqj,55016,55017,110033
57565,,tuu6-eu8eyij,55017,55018,110035
57566,,p-ulm324qbcj,55018,55019,110037
57567,,wylwm2tiarij,55019,55020,110039
57568,,zioi5if8dfuj,55020,55021,110041
57569,,zl_ag5gfuoaj,55021,55022,110043
57570,,1mewzo5obruj,55022,55023,110045
57571,,9jute4_44ygj,55023,55024,110047
57572,,smobkiw3-mkj,55024,55025,110049
57573,,bgdx-1zu4icj,55025,55026,110051
57574,,uly6u9qtjy0j,55026,55027,110053
57575,,nrc80mcbg80j,55027,55028,110055
57576,,ipgzf9nkp7gj,55028,55029,110057
57577,,nskhj6haxp8j,55029,55030,110059
57578,,62oekz5_-uwj,55030,55031,110061
57579,,xgpkyps_s18j,55031,55032,110063
57580,,1ymxfho3j6yj,55032,55033,110065
57581,,hjf1l1_uld0j,55033,55034,110067
57582,,url:http://portal.acm.org/citation.cfm3fid3d288549,55034,55035,110069
57583,,e3m8ky_5n3aj,55035,55036,110071
57584,,fqwsestxzsaj,55036,55037,110073
57585,,1ac3rq4fwuij,55037,55038,110075
57586,,6r1vezqofjqj,55038,55039,110077
57587,,i7h87lgxt20j,55039,55040,110079
57588,,3vhoqv3stbej,55040,55041,110081
57589,,30eqof6xqoej,55041,55042,110083
57590,,_psba9jxupyj,55042,55043,110085
57591,,buygivazkfkj,55043,55044,110087
57592,,wznt-lsp1lcj,55044,55045,110089
57593,,5x5mpgcsyv4j,55045,55046,110091
57594,,tnbetepoghkj,55046,55047,110093
57595,,w1onmvjq6-uj,55047,55048,110095
57596,,y1hmjodjq7uj,55049,55050,110099
57597,,skpkbakrotaj,55050,55051,110101
57598,,bugomp17baoj,55051,55052,110103
57599,,3safcvqh3qwj,55052,55053,110105
57600,,url:http://www.csa.com/partners/viewrecord.php3frequester3dgs26collection3dtrd26recid3d2005102518078ci,55053,55054,110107
57601,,y5rqjnmxx9gj,55054,55055,110109
57602,,93rswpotc9wj,55055,55056,110111
57603,,pcly9ibupvuj,55056,55057,110113
57604,,hr_rg-zo1nwj,55057,55058,110115
57605,,var06vb9qgwj,55058,55059,110117
57606,,87kheb4qiisj,55059,55060,110119
57607,,afbotlogc_0j,55060,55061,110121
57608,,iziuacaisg4j,55061,55062,110123
57609,,ex7d9wmq40cj,55062,55063,110125
57610,,ljj1bn1s15sj,55063,55064,110127
57611,,i7b34uemgtsj,55064,55065,110129
57612,,knfgmo2gtlij,55065,55066,110131
57613,,0brpir5yd80j,55066,55067,110133
57614,,1u2scmjfbjuj,55067,55068,110135
57615,,1hvfatp1pd8j,55068,55069,110137
57616,,xw2rmilejsyj,55069,55070,110139
57617,,twav0f00dpsj,55070,55071,110141
57618,,oczifkmr-jgj,55071,55072,110143
57619,,633jyv2xqi4j,55072,55073,110145
57620,,r2dmcbkxxhoj,55073,55074,110147
57621,,xp9dzxtpar8j,55074,55075,110149
57622,,3slsyj1hl8cj,55075,55076,110151
57623,,tv3wv8ift28j,55076,55077,110153
57624,,nkf6vahzqukj,55077,55078,110155
57625,,_kilboqnypgj,55078,55079,110157
57626,,pe8_vllzewwj,55079,55080,110159
57627,,1zm7xilg3zqj,55080,55081,110161
57628,,pxuschoj8a8j,55082,55083,110165
57629,,shzwb-lw1muj,55083,55084,110167
57630,,4mgnbz7tofsj,55084,55085,110169
57631,,fm_kus9bgt8j,55085,55086,110171
57632,,0yqane7pftqj,55086,55087,110173
57633,,s75cfrmt0hij,55087,55088,110175
57634,,1eog0xiub-sj,55088,55089,110177
57635,,h4pfhm0jytoj,55089,55090,110179
57636,,3tw45xa3kwyj,55090,55091,110181
57637,,nbb3jcgho5aj,55091,55092,110183
57638,,swas0jhwtxoj,55093,55094,110187
57639,,jw-wtqeq_tej,55094,55095,110189
57640,,ltgyb11rdsgj,55095,55096,110191
57641,,qrfeeem1pcqj,55096,55097,110193
57642,,q4wtjrnxpm4j,55097,55098,110195
57643,,rhdppd-zxaoj,55098,55099,110197
57644,,tt29bvgnb9mj,55099,55100,110199
57645,,lp11xhgf_0wj,55100,55101,110201
57646,,cgv-h4tno5uj,55101,55102,110203
57647,,amxpjn__3xyj,55102,55103,110205
57648,,kehvapwrtewj,55103,55104,110207
57649,,url:http://portal.acm.org/ft_gateway.cfm3fid3d108626326type3dpdf,55104,55105,110209
57650,,p6ucpohyl1mj,55105,55106,110211
57651,,ilrrb-vywl0j,55106,55107,110213
57652,,mfpufu8hr2aj,55108,55109,110217
57653,,wi4potnho8mj,55109,55110,110219
57654,,abi___3eszuj,55110,55111,110221
57655,,xy2oenvfa6uj,55111,55112,110223
57656,,hh95b5uzyxoj,55112,55113,110225
57657,,-1pem3a1pcej,55114,55115,110229
57658,,2oz5-3gayt8j,55115,55116,110231
57659,,kf0v214jf1qj,55116,55117,110233
57660,,15rubshqepuj,55117,55118,110235
57661,,r6mo1pazfaqj,55118,55119,110237
57662,,jqteabwzwy0j,55119,55120,110239
57663,,tin5xiu8si0j,55120,55121,110241
57664,,s5acwquv95kj,55121,55122,110243
57665,,x7glq3vgm54j,55122,55123,110245
57666,,s-egxxtetdmj,55123,55124,110247
57667,,b6bxejoykq0j,55124,55125,110249
57668,,ohykemqkbmgj,55125,55126,110251
57669,,5xlyftzzflmj,55126,55127,110253
57670,,53ugdxgegq0j,55127,55128,110255
57671,,e6d-uhwtp_ej,55128,55129,110257
57672,,wy3kwecbah0j,55129,55130,110259
57673,,litnepng-ckj,55130,55131,110261
57674,,uj22uuudqwkj,55131,55132,110263
57675,,s6_kylkge1yj,55132,55133,110265
57676,,uwcgbpazzfwj,55133,55134,110267
57677,,rajcg7fo1jmj,55135,55136,110271
57678,,mu3c7h8a_7gj,55136,55137,110273
57679,,bh4b-t8hsjsj,55137,55138,110275
57680,,bpgoovg4l34j,55138,55139,110277
57681,,u1drdyw2z_yj,55139,55140,110279
57682,,kqqiq5cqnl8j,55140,55141,110281
57683,,3gohrnpjbrcj,55141,55142,110283
57684,,x319clqvt1cj,55142,55143,110285
57685,,19vihsimaxcj,55143,55144,110287
57686,,dzthjub2250j,55144,55145,110289
57687,,uaidru_qi-kj,55145,55146,110291
57688,,re_n6-fmvqcj,55146,55147,110293
57689,,url:http://portal.acm.org/citation.cfm3fid3d130311,55147,55148,110295
57690,,cjoi33yy5kij,55148,55149,110297
57691,,egqg_hnu9ogj,55149,55150,110299
57692,,jhuq9lqxlb0j,55150,55151,110301
57693,,yztpztyqn6sj,55151,55152,110303
57694,,3tmbcz98eygj,55152,55153,110305
57695,,_k8j8teiszqj,55153,55154,110307
57696,,jekres1zx1wj,55154,55155,110309
57697,,mag5n4urxhaj,55155,55156,110311
57698,,d0qof1wxc_uj,55156,55157,110313
57699,,cp82jd8yzamj,55157,55158,110315
57700,,scplazn7gpsj,55158,55159,110317
57701,,myafixdsgwaj,55159,55160,110319
57702,,ouhzffrtxsij,55160,55161,110321
57703,,u3zj2jfdz-ej,55161,55162,110323
57704,,url:http://portal.acm.org/citation.cfm3fid3d1101149.1101354,55162,55163,110325
57705,,oyvtxqt9ybgj,55163,55164,110327
57706,,url:http://www.csa.com/partners/viewrecord.php3frequester3dgs26collection3dtrd26recid3dn9210393ah,55164,55165,110329
57707,,tmaj4dxfkosj,55165,55166,110331
57708,,lt4ubtx12zij,55166,55167,110333
57709,,9r8vs6hypsuj,55168,55169,110337
57710,,wkt8-jp-fpaj,55169,55170,110339
57711,,i2rbviv_9vgj,55170,55171,110341
57712,,bujezncrjqaj,55171,55172,110343
57713,,gihrk9htvquj,55172,55173,110345
57714,,fkz00jqnglsj,55173,55174,110347
57715,,l_obc6kpz94j,55174,55175,110349
57716,,hwg_l1jr1ogj,55175,55176,110351
57717,,cntgirrsl3ej,55176,55177,110353
57718,,niygvhgzxxaj,55177,55178,110355
57719,,gqmghicrxy0j,55178,55179,110357
57720,,hiwobb2phamj,55179,55180,110359
57721,,2bjskbubtnej,55180,55181,110361
57722,,pqncnwfvs_mj,55181,55182,110363
57723,,swwovilkxoqj,55182,55183,110365
57724,,url:http://portal.acm.org/ft_gateway.cfm3fid3d106616726type3dpdf,55183,55184,110367
57725,,url:http://doi.wiley.com/10.1002/he.10102,55184,55185,110369
57726,,o9f5ov8adxaj,55185,55186,110371
57727,,url:http://doi.wiley.com/10.1002/he.131,55186,55187,110373
57728,,vjptkvqpf9uj,55187,55188,110375
57729,,gxmbodtgyksj,55188,55189,110377
57730,,6u7dsdx--n0j,55189,55190,110379
57731,,h-rxa8nzt3yj,55190,55191,110381
57732,,z9vhfocchlwj,55191,55192,110383
57733,,url:http://portal.acm.org/citation.cfm3fid3d192717,55192,55193,110385
57734,,url:http://www.csa.com/partners/viewrecord.php3frequester3dgs26collection3dtrd26recid3dn9210384ah,55193,55194,110387
57735,,tk9mwpvwb7ij,55194,55195,110389
57736,,cezlhgsvpi4j,55195,55196,110391
57737,,_e_sn1tpzawj,55196,55197,110393
57738,,gd7dcp0ad8mj,55197,55198,110395
57739,,duh4hvvhffwj,55198,55199,110397
57740,,ti3lbjjzfiuj,55199,55200,110399
57741,,_g-w2phdou8j,55200,55201,110401
57742,,yiijjq-n6luj,55201,55202,110403
57743,,q7bvceln63mj,55202,55203,110405
57744,,cnf2eczj7q0j,55203,55204,110407
57745,,url:http://www.csa.com/partners/viewrecord.php3frequester3dgs26collection3dtrd26recid3dn9210497ah,55204,55205,110409
57746,,e9jngd0_h5wj,55205,55206,110411
57747,,pzjvmittmcwj,55206,55207,110413
57748,,ie1mabstjmej,55207,55208,110415
57749,,gy_7sywlqtmj,55208,55209,110417
57750,,29sakqargyij,55210,55211,110421
57751,,4gcmdmrcxwyj,55211,55212,110423
57752,,u8l4mjmytj8j,55212,55213,110425
57753,,1xsg0k7zilsj,55213,55214,110427
57754,,yzh2w16gmzsj,55214,55215,110429
57755,,gep9ctcojl8j,55215,55216,110431
57756,,n2myan_qbnuj,55216,55217,110433
57757,,krflbnmktoej,55217,55218,110435
57758,,mjzt-4tvwbuj,55218,55219,110437
57759,,1dbuaqy8eegj,55219,55220,110439
57760,,igmjhelwjkgj,55220,55221,110441
57761,,url:http://portal.acm.org/citation.cfm3fid3d1101149.1101341,55221,55222,110443
57762,,zoxzkj0_2buj,55222,55223,110445
57763,,rb0cfzgqcz8j,55223,55224,110447
57764,,dlw7fos6ljij,55224,55225,110449
57765,,59b9fovvhwej,55225,55226,110451
57766,,l0-cnlwsz0ej,55226,55227,110453
57767,,zdmn1xpu3ruj,55227,55228,110455
57768,,ajepgjkkdukj,55228,55229,110457
57769,,bn4cvfgo9ewj,55229,55230,110459
57770,,d1wah-m-qxij,55230,55231,110461
57771,,vh9k03qdcg4j,55231,55232,110463
57772,,wrpdvlumzl4j,55233,55234,110467
57773,,url:http://www.geography.org.uk/journals/journals.asp3farticleid3d75,55234,55235,110469
57774,,wnsqg528gluj,55235,55236,110471
57775,,8c8_uwculxqj,55236,55237,110473
57776,,fnypyuw9pwej,55237,55238,110475
57777,,9dx3j4svvawj,55238,55239,110477
57778,,pihzew48lwej,55239,55240,110479
57779,,p_noal7410ij,55240,55241,110481
57780,,cqti6-oftd0j,55241,55242,110483
57781,,o0b3qfkcuzwj,55242,55243,110485
57782,,8yktbfeoizkj,55243,55244,110487
57783,,url:http://portal.acm.org/citation.cfm3fid3d592093.592137,55244,55245,110489
57784,,h1eu8rxcp90j,55245,55246,110491
57785,,lwmzzgqnlsej,55246,55247,110493
57786,,om41h5_bc5oj,55247,55248,110495
57787,,omojqd6nl5yj,55248,55249,110497
57788,,kglvdnx4f1wj,55249,55250,110499
57789,,url:http://www.springerlink.com/index/qv0873315368x5g5.pdf,55250,55251,110501
57790,,ouuvfmc3xakj,55251,55252,110503
57791,,rp1mjqzfrtgj,55252,55253,110505
57792,,lpnjwcmf_m4j,55254,55255,110509
57793,,jmte2jwkfvyj,55255,55256,110511
57794,,9k6ezydvewsj,55256,55257,110513
57795,,vxp8gxrgv2sj,55257,55258,110515
57796,,ifvthfeve2oj,55258,55259,110517
57797,,ftw8nyg0apsj,55259,55260,110519
57798,,zby3xbfvljij,55260,55261,110521
57799,,vakyejznpm0j,55261,55262,110523
57800,,ehbfbc1r9oij,55262,55263,110525
57801,,tknudtjzmisj,55263,55264,110527
57802,,nwktyxg7wlij,55264,55265,110529
57803,,a9bwchkajwgj,55265,55266,110531
57804,,qiftuabmqdgj,55266,55267,110533
57805,,tccar9z0zn0j,55267,55268,110535
57806,,goxogg9mqfej,55268,55269,110537
57807,,url:http://adsabs.harvard.edu/abs/1977phdt........30o,55269,55270,110539
57808,,4l5xlnu9mxaj,55270,55271,110541
57809,,cdzjl3y51eyj,55271,55272,110543
57810,,url:http://www.ingentaconnect.com/search/expand3fpub3dinfobike://els/09505849/1998/00000040/00000002/art0003226unc3d,55272,55273,110545
57811,,eeou3snj6tcj,55273,55274,110547
57812,,url:http://www.csa.com/partners/viewrecord.php3frequester3dgs26collection3dtrd26recid3d560244ci,55274,55275,110549
57813,,xjjsl30ss3aj,55275,55276,110551
57814,,0nmembr5bf4j,55276,55277,110553
57815,,dvxolinw4ykj,55277,55278,110555
57816,,onlvhuau6eyj,55278,55279,110557
57817,,iyyzimgjmt4j,55279,55280,110559
57818,,q5qiiwj1elij,55280,55281,110561
57819,,snxjfvkollej,55281,55282,110563
57820,,e9fremm6j10j,55282,55283,110565
57821,,7vhydqzmpusj,55283,55284,110567
57822,,dcxpbhq_a-yj,55284,55285,110569
57823,,fb2yspabqxyj,55285,55286,110571
57824,,8fwcnac9jtsj,55286,55287,110573
57825,,alxsgfogoccj,55287,55288,110575
57826,,tspap7hgr2wj,55288,55289,110577
57827,,url:http://portal.acm.org/ft_gateway.cfm3fid3d109973126type3dpdf,55289,55290,110579
57828,,jj-o3pcxwiwj,55290,55291,110581
57829,,ineh7qzewbwj,55291,55292,110583
57830,,_6buefgc4wgj,55292,55293,110585
57831,,yenqldkdhtkj,55293,55294,110587
57832,,cllpyzjkdl4j,55294,55295,110589
57833,,zh7_yb30ed8j,55295,55296,110591
57834,,jmbtxzemh0oj,55296,55297,110593
57835,,eq5_sh8s4x8j,55297,55298,110595
57836,,r_t2e8bbakgj,55298,55299,110597
57837,,6ganzz2pbncj,55299,55300,110599
57838,,r-3jlyolkmqj,55300,55301,110601
57839,,c7nupw_zg64j,55301,55302,110603
57840,,6hzipol9abwj,55302,55303,110605
57841,,p8fidzgy8tgj,55303,55304,110607
57842,,udaqflic2hkj,55304,55305,110609
57843,,e8q95mdke04j,55305,55306,110611
57844,,_fkzb0nkqjoj,55307,55308,110615
57845,,gilwz-rlvfkj,55308,55309,110617
57846,,rxunn_5y8kgj,55309,55310,110619
57847,,wjrxfsiws4aj,55310,55311,110621
57848,,fxdzp7a7by0j,55311,55312,110623
57849,,zanzvrgrcx0j,55312,55313,110625
57850,,j84ue-nl5fqj,55314,55315,110629
57851,,wsmxac0umnij,55315,55316,110631
57852,,4yihjauy6uaj,55316,55317,110633
57853,,fsv9vnnei4aj,55317,55318,110635
57854,,yfox2ug0x6gj,55318,55319,110637
57855,,5gnid1aqnkoj,55319,55320,110639
57856,,mgxoeythe80j,55320,55321,110641
57857,,rkyvux3prm8j,55321,55322,110643
57858,,ywvvrzfxmoqj,55322,55323,110645
57859,,vc8g4d5tclsj,55323,55324,110647
57860,,url:http://www.csa.com/partners/viewrecord.php3frequester3dgs26collection3dtrd26recid3d0835496ci,55324,55325,110649
57861,,iw7ivbyh50oj,55325,55326,110651
57862,,syvitpive8uj,55326,55327,110653
57863,,o7po9x_y-hkj,55327,55328,110655
57864,,nlhgmrartggj,55328,55329,110657
57865,,e9wrkn_ygwyj,55329,55330,110659
57866,,url:http://doi.wiley.com/10.1002/he.10702,55330,55331,110661
57867,,wpji3garnigj,55331,55332,110663
57868,,ps2unae-n_gj,55332,55333,110665
57869,,7rquicxmjkyj,55333,55334,110667
57870,,xsgfho-c-l8j,55334,55335,110669
57871,,legoypwqy0gj,55335,55336,110671
57872,,3dqojjurai0j,55336,55337,110673
57873,,tdb0nytfojkj,55337,55338,110675
57874,,zdflndghysej,55338,55339,110677
57875,,_5iejdvam6cj,55339,55340,110679
57876,,au2o0wovy5sj,55340,55341,110681
57877,,url:http://www.springerlink.com/index/x10jq5521256h588.pdf,55341,55342,110683
57878,,7aj8wgtjv1gj,55342,55343,110685
57879,,c5e7af9gxuwj,55343,55344,110687
57880,,ejmoue3pcewj,55344,55345,110689
57881,,ehyh-uhkkh4j,55345,55346,110691
57882,,gsywmgpfprsj,55347,55348,110695
57883,,yovfoq472ggj,55348,55349,110697
57884,,skpd8-8_xquj,55349,55350,110699
57885,,url:http://doi.wiley.com/10.1002/tl.86,55350,55351,110701
57886,,l72mp68vvqsj,55351,55352,110703
57887,,og7todprjukj,55352,55353,110705
57888,,ukgazb6f4a4j,55353,55354,110707
57889,,uyr_oafbd-mj,55354,55355,110709
57890,,u_hgady99b4j,55355,55356,110711
57891,,h21mq9rg-g0j,55356,55357,110713
57892,,kptumcvetgoj,55357,55358,110715
57893,,ik9b-w-utn0j,55359,55360,110719
57894,,u0v428tzwh8j,55360,55361,110721
57895,,bpvczeh_vtwj,55361,55362,110723
57896,,mwxawihijyej,55362,55363,110725
57897,,url:http://portal.acm.org/citation.cfm3fid3d319908,55363,55364,110727
57898,,_6yhumsnwxsj,55364,55365,110729
57899,,hcrrdqsm1yyj,55365,55366,110731
57900,,rzqag9ptdqsj,55367,55368,110735
57901,,pzpiaeeq1huj,55368,55369,110737
57902,,uumdjj13klcj,55369,55370,110739
57903,,5ifo6isju0aj,55370,55371,110741
57904,,guyadqq1cpwj,55371,55372,110743
57905,,ipgjsd9isggj,55372,55373,110745
57906,,xgwcsslbvsmj,55373,55374,110747
57907,,url:http://portal.acm.org/ft_gateway.cfm3fid3d110195626type3dpdf,55374,55375,110749
57908,,url:http://www.ingentaconnect.com/search/expand3fpub3dinfobike://els/09505849/1997/00000039/00000008/art0001326unc3d,55375,55376,110751
57909,,26vrfcd9qccj,55376,55377,110753
57910,,9wtqynfv7v0j,55377,55378,110755
57911,,gcsnbeazcuej,55378,55379,110757
57912,,vq5qme3ngzej,55379,55380,110759
57913,,ke1buejonuij,55380,55381,110761
57914,,ywddinf5flqj,55381,55382,110763
57915,,qrm-uvbibogj,55383,55384,110767
57916,,eztkkaf7e4kj,55384,55385,110769
57917,,vqpqxpttooej,55385,55386,110771
57918,,zwpjz2ta2bsj,55386,55387,110773
57919,,jn8nr8rx7imj,55387,55388,110775
57920,,b806cjr51fij,55388,55389,110777
57921,,rh5vor1x-a8j,55389,55390,110779
57922,,vsvj2xhgfs4j,55390,55391,110781
57923,,y3e6fq-jrn4j,55391,55392,110783
57924,,hdvwcpwzb4yj,55393,55394,110787
57925,,oewmdk_7ayqj,55394,55395,110789
57926,,df4fnttlayoj,55395,55396,110791
57927,,wm8tbbsv1fkj,55397,55398,110795
57928,,gcjilu0umdoj,55398,55399,110797
57929,,qpep5gti3tkj,55399,55400,110799
57930,,qw6wplahxq8j,55400,55401,110801
57931,,kmoz6v2juu4j,55401,55402,110803
57932,,4ma-p43on8sj,55402,55403,110805
57933,,j2gyy75jswsj,55403,55404,110807
57934,,tn_8sj5xq48j,55404,55405,110809
57935,,5ol13e_n_hej,55405,55406,110811
57936,,x5kgdxhs-waj,55406,55407,110813
57937,,1hlzl_tjav4j,55407,55408,110815
57938,,lsdoeqirfj4j,55408,55409,110817
57939,,smlnr_pwq9sj,55409,55410,110819
57940,,2hddoejhjgqj,55410,55411,110821
57941,,xvtefcz6cg8j,55411,55412,110823
57942,,jxsoirey21ej,55412,55413,110825
57943,,lyvxy_nxi38j,55413,55414,110827
57944,,xud-kge4stej,55414,55415,110829
57945,,dpsn29w7g44j,55416,55417,110833
57946,,ufk9iw24bgoj,55417,55418,110835
57947,,lh1-gmwbd8kj,55419,55420,110839
57948,,vbcpjhuucm4j,55420,55421,110841
57949,,,55421,55422,110843
57950,,url:http://portal.acm.org/ft_gateway.cfm3fid3d110199226type3dpdf,55422,55423,110845
57951,,30_7_pvxy84j,55423,55424,110847
57952,,11ghwlrsxpmj,55424,55425,110849
57953,,7mcitagv5_yj,55425,55426,110851
57954,,frbdtjok4roj,55426,55427,110853
57955,,92rma4arjmoj,55427,55428,110855
57956,,q2djmkxr1t4j,55428,55429,110857
57957,,w2sfnemykpej,55429,55430,110859
57958,,oikkyuxtkiuj,55430,55431,110861
57959,,86zqmnbnpdmj,55431,55432,110863
57960,,tbprqwvxvgsj,55432,55433,110865
57961,,z1w9idad5faj,55433,55434,110867
57962,,5sxgehcv77mj,55434,55435,110869
57963,,gsgrykihl2gj,55435,55436,110871
57964,,rrtlhfngkvsj,55436,55437,110873
57965,,8rkvn3j27eej,55437,55438,110875
57966,,zb9yrdn2b54j,55438,55439,110877
57967,,pnqqyq127ycj,55439,55440,110879
57968,,rzhjaqk7xtsj,55440,55441,110881
57969,,heywfgl9ca4j,55441,55442,110883
57970,,oc7urvscv5qj,55442,55443,110885
57971,,yd_7w5rcznoj,55443,55444,110887
57972,,gwpow8nyp2cj,55444,55445,110889
57973,,iijydun8vc4j,55445,55446,110891
57974,,pglcj2qbbuqj,55446,55447,110893
57975,,jbsyjucuikyj,55447,55448,110895
57976,,1tstsmosg4yj,55448,55449,110897
57977,,xidbpf2joswj,55449,55450,110899
57978,,k_v7eobudy8j,55450,55451,110901
57979,,121t4z49gbej,55452,55453,110905
57980,,url:http://www.springerlink.com/index/nx8215748824640k.pdf,55453,55454,110907
57981,,url:http://pubs.acs.org/cgi-bin/abstract.cgi/achre4/2005/38/i10/abs/ar040270c.html,55454,55455,110909
57982,,fqxbajqmigij,55455,55456,110911
57983,,0d7g3rpop9sj,55456,55457,110913
57984,,xjlz3ny-ezsj,55457,55458,110915
57985,,xwf4kotaojkj,55458,55459,110917
57986,,lm0teyretloj,55459,55460,110919
57987,,wsx63x87c0ej,55460,55461,110921
57988,,uv9qivxscacj,55461,55462,110923
57989,,1nvwsxab5skj,55462,55463,110925
57990,,v1pbbkifwpqj,55463,55464,110927
57991,,wtvawyjdu8ej,55464,55465,110929
57992,,jex2qbw-oeuj,55465,55466,110931
57993,,b4llk2kpqwqj,55466,55467,110933
57994,,8xfukuvwjhaj,55467,55468,110935
57995,,k6kgpxzzmygj,55468,55469,110937
57996,,v3kbyjcodcaj,55469,55470,110939
57997,,g9tb3j46moej,55470,55471,110941
57998,,arfsu1zwge8j,55471,55472,110943
57999,,c-t3aqyqxf4j,55472,55473,110945
58000,,mtojydos2xij,55473,55474,110947
58001,,gw060ixf8vqj,55474,55475,110949
58002,,l2y2u5f48wcj,55475,55476,110951
58003,,aur-p53csk8j,55476,55477,110953
58004,,hqitklvgzjij,55477,55478,110955
58005,,19rida84q4gj,55478,55479,110957
58006,,url:http://doi.wiley.com/10.1002/he.11205,55479,55480,110959
58007,,url:http://www.csa.com/partners/viewrecord.php3frequester3dgs26collection3denv26recid3d8913242,55480,55481,110961
58008,,sk0ay7dbctgj,55481,55482,110963
58009,,xu5vza_exlkj,55482,55483,110965
58010,,5scrvs3ko7qj,55483,55484,110967
58011,,awtf-kw1qbuj,55484,55485,110969
58012,,4fcxhyzo_b8j,55485,55486,110971
58013,,awm-7zzao7wj,55486,55487,110973
58014,,4jzomcsrpqsj,55487,55488,110975
58015,,h2vvhtcja7ij,55488,55489,110977
58016,,6s31iq0mhhuj,55489,55490,110979
58017,,l3unxzprajaj,55490,55491,110981
58018,,hi1jlg6kxeaj,55491,55492,110983
58019,,mmtlybxwos4j,55492,55493,110985
58020,,vqwca0lq2j0j,55493,55494,110987
58021,,cwzvt5zveluj,55494,55495,110989
58022,,vee1lxymfnyj,55495,55496,110991
58023,,1tdaj3rhauwj,55496,55497,110993
58024,,3exf2kwcrcij,55497,55498,110995
58025,,ysvazqbg9sej,55498,55499,110997
58026,,url:http://pubs.acs.org/cgi-bin/abstract.cgi/achre4/2005/38/i02/abs/ar020247w.html,55499,55500,110999
58027,,spdjncjyftwj,55500,55501,111001
58028,,url:http://www.csa.com/partners/viewrecord.php3frequester3dgs26collection3denv26recid3d8913238,55501,55502,111003
58029,,1hf65at1efoj,55502,55503,111005
58030,,aanmzvjc0ruj,55503,55504,111007
58031,,clrrgsc2kgsj,55504,55505,111009
58032,,url:http://portal.acm.org/ft_gateway.cfm3fid3d109967426type3dpdf,55505,55506,111011
58033,,up5cyzm3zscj,55506,55507,111013
58034,,i_jrpp9rl3sj,55507,55508,111015
58035,,i09qvdyxxpej,55508,55509,111017
58036,,hdnmxwgo48ej,55509,55510,111019
58037,,o5v_jbeve_ij,55510,55511,111021
58038,,_qpkctws1zwj,55511,55512,111023
58039,,vqs_i1ig8dsj,55512,55513,111025
58040,,akvb7pazx8wj,55513,55514,111027
58041,,2jqrka8ejusj,55514,55515,111029
58042,,ylva4u9imp8j,55515,55516,111031
58043,,zj54yxl78fej,55516,55517,111033
58044,,x5qneq0-icwj,55517,55518,111035
58045,,ohsqfjhds-8j,55518,55519,111037
58046,,wmuwmav1jkwj,55519,55520,111039
58047,,4vgmhqxcj_4j,55520,55521,111041
58048,,l9rzyv5owpgj,55521,55522,111043
58049,,f4dkgyat1icj,55522,55523,111045
58050,,ltyid0eynzej,55524,55525,111049
58051,,yk_um5e6ny8j,55525,55526,111051
58052,,os5qy8ry5mij,55526,55527,111053
58053,,6yzniq7kckoj,55527,55528,111055
58054,,fiaedgxavf0j,55528,55529,111057
58055,,xi8xrpai8hmj,55529,55530,111059
58056,,ouph0alprcqj,55530,55531,111061
58057,,jjmmf9m6z4aj,55531,55532,111063
58058,,url:http://portal.acm.org/citation.cfm3fid3d234286.1057815,55532,55533,111065
58059,,lhep-antkfgj,55533,55534,111067
58060,,v5xsrbzb4zgj,55534,55535,111069
58061,,av8krghj_taj,55535,55536,111071
58062,,kkwdsls8pkej,55536,55537,111073
58063,,c6wnxttdkpkj,55537,55538,111075
58064,,m2eoulbokc8j,55538,55539,111077
58065,,kkq_2bg6wxaj,55539,55540,111079
58066,,url:http://links.jstor.org/sici3fsici3d0146-4949(196321252f22)4253a2253c172253atsoeh253e2.0.co253b2-i,55540,55541,111081
58067,,url:http://portal.acm.org/ft_gateway.cfm3fid3d108626726type3dpdf,55541,55542,111083
58068,,mjda4chq9jsj,55542,55543,111085
58069,,1xd73nf7pgej,55543,55544,111087
58070,,kugbdaoi1ukj,55544,55545,111089
58071,,5nxn5l4dxtij,55545,55546,111091
58072,,zg6alpbzvdoj,55548,55549,111097
58073,,url:http://links.jstor.org/sici3fsici3d0146-4949(196723)8253a4253c473253aial253e2.0.co253b2-w,55549,55550,111099
58074,,tkn_mf3etkyj,55550,55551,111101
58075,,ytagbz4gkpwj,55551,55552,111103
58076,,hlc8gnhireaj,55552,55553,111105
58077,,o-khdj8gheqj,55553,55554,111107
58078,,bhcsajfc-z0j,55554,55555,111109
58079,,jn3tqfeiqgwj,55555,55556,111111
58080,,3-glcoxa5xgj,55557,55558,111115
58081,,pbqoyaumhi4j,55558,55559,111117
58082,,rpgtj5ljwkcj,55559,55560,111119
58083,,zjkue9c9wpoj,55560,55561,111121
58084,,c0aqpkq73oaj,55561,55562,111123
58085,,id9vqmdozhuj,55562,55563,111125
58086,,pwtzui_t3m0j,55564,55565,111129
58087,,ggmyagzsyr4j,55565,55566,111131
58088,,fkivlvare7sj,55566,55567,111133
58089,,fopctn-mv10j,55567,55568,111135
58090,,ndomi5uxihwj,55568,55569,111137
58091,,zrrqrcf2pwqj,55569,55570,111139
58092,,bc5dhmase5sj,55570,55571,111141
58093,,zzdou9j10s0j,55571,55572,111143
58094,,xnefos45vuqj,55572,55573,111145
58095,,yumyswrhicsj,55573,55574,111147
58096,,sjunf0_ribqj,55574,55575,111149
58097,,2xq04znkc0gj,55575,55576,111151
58098,,uvgob46ce5aj,55576,55577,111153
58099,,v4yhpwkobsij,55577,55578,111155
58100,,z9dfg107wcij,55578,55579,111157
58101,,qgu1yoeizwqj,55579,55580,111159
58102,,rwkkfvhuraoj,55580,55581,111161
58103,,aashf3fkbgmj,55581,55582,111163
58104,,url:http://www.springerlink.com/index/j11r173r410gk7m7.pdf,55582,55583,111165
58105,,brhksjypisqj,55584,55585,111169
58106,,com959cgleuj,55585,55586,111171
58107,,url:http://ieeexplore.ieee.org/iel5/9217/29235/01320073.pdf3farnumber3d1320073,55586,55587,111173
58108,,ue0rcrrdxt4j,55587,55588,111175
58109,,6gelqjq1nfgj,55588,55589,111177
58110,,urcoex0x3e4j,55589,55590,111179
58111,,mvf6o9rduk4j,55590,55591,111181
58112,,y3gsk8953-uj,55591,55592,111183
58113,,mvhf7fcojmaj,55592,55593,111185
58114,,qlfxy5h4couj,55593,55594,111187
58115,,yiaxpniraecj,55594,55595,111189
58116,,ezmsdumwujej,55595,55596,111191
58117,,g0qyoqoyvsgj,55596,55597,111193
58118,,,55597,55598,111195
58119,,jzvm0tubvq0j,55598,55599,111197
58120,,url:http://doi.wiley.com/10.1002/ev.1506,55599,55600,111199
58121,,c_pa_gm9onaj,55600,55601,111201
58122,,eg2gpm7shaaj,55601,55602,111203
58123,,b34-yj6rhlmj,55602,55603,111205
58124,,bld0moxtsegj,55603,55604,111207
58125,,8ksvucux9guj,55604,55605,111209
58126,,f7krntclgusj,55605,55606,111211
58127,,nhvvkgtvhocj,55606,55607,111213
58128,,0v4l1d6sygoj,55607,55608,111215
58129,,y6fkb2qyprej,55608,55609,111217
58130,,hk2vbfzb1qaj,55609,55610,111219
58131,,clf04mgcpsuj,55610,55611,111221
58132,,1eyw4mcgf5mj,55611,55612,111223
58133,,yhaksowsilkj,55613,55614,111227
58134,,eifxk-kwhpoj,55614,55615,111229
58135,,qzgri7_ec18j,55615,55616,111231
58136,,qpvc6b5ftwuj,55616,55617,111233
58137,,85dkcqjrypuj,55617,55618,111235
58138,,tht9tvnknq4j,55618,55619,111237
58139,,mjprykvd4rgj,55619,55620,111239
58140,,f8u4ql1ohyaj,55620,55621,111241
58141,,f56uxwue9cqj,55621,55622,111243
58142,,oea6tlyqfyej,55622,55623,111245
58143,,aqebdrznhfaj,55623,55624,111247
58144,,url:http://links.jstor.org/sici3fsici3d0146-4949(196522)6253a2253c190253amsato253e2.0.co253b2-8,55624,55625,111249
58145,,url:http://adsabs.harvard.edu/abs/1976scom.nasa..609d,55625,55626,111251
58146,,rwdkrlnz4hoj,55626,55627,111253
58147,,7suz_npy9dkj,55627,55628,111255
58148,,bijjefphxaaj,55628,55629,111257
58149,,jrg7yq318_8j,55629,55630,111259
58150,,,55630,55631,111261
58151,,azzffoprcdmj,55631,55632,111263
58152,,vujntheijawj,55632,55633,111265
58153,,zv00bwjnisoj,55633,55634,111267
58154,,7rho602laokj,55634,55635,111269
58155,,pu1fqmb2s9yj,55635,55636,111271
58156,,lpxkgyq1fqmj,55636,55637,111273
58157,,5bw37ymdq0uj,55637,55638,111275
58158,,7e7yglcgn9aj,55638,55639,111277
58159,,up5fphyrkg0j,55639,55640,111279
58160,,qjbmv0witbuj,55640,55641,111281
58161,,2kimo8jkkswj,55641,55642,111283
58162,,vql9yvbysmej,55642,55643,111285
58163,,itb4igpzaycj,55643,55644,111287
58164,,zlanus1s02kj,55644,55645,111289
58165,,f3qzhwodlgaj,55645,55646,111291
58166,,3dbudljecaqj,55646,55647,111293
58167,,bjp3iwuejyej,55647,55648,111295
58168,,pm7yms9dph8j,55648,55649,111297
58169,,lnnr-pbvjlyj,55649,55650,111299
58170,,qwkeyjj6vx8j,55650,55651,111301
58171,,url:http://portal.acm.org/citation.cfm3fid3dseries9729.128807,55651,55652,111303
58172,,f3haw7u74qqj,55652,55653,111305
58173,,sbaxqshxqnaj,55653,55654,111307
58174,,lngtveq_wssj,55654,55655,111309
58175,,in3vj5krwkkj,55655,55656,111311
58176,,sfyezjecccij,55656,55657,111313
58177,,k6ti5l-1grmj,55657,55658,111315
58178,,zy88brjeorcj,55658,55659,111317
58179,,vnuxiuyrsusj,55659,55660,111319
58180,,o1pw9ntdmcmj,55660,55661,111321
58181,,,55661,55662,111323
58182,,5fsiim54nhmj,55662,55663,111325
58183,,jwoddu0ekauj,55663,55664,111327
58184,,8kqcminfjisj,55664,55665,111329
58185,,uryv-xbhmu8j,55665,55666,111331
58186,,zd5bke02ymwj,55666,55667,111333
58187,,y043n_q9xmqj,55667,55668,111335
58188,,wwbqferglguj,55668,55669,111337
58189,,yzxbpcrvsq4j,55669,55670,111339
58190,,gfcmpcj4lcqj,55671,55672,111343
58191,,cdeuegiwrskj,55672,55673,111345
58192,,gekf46wqtckj,55673,55674,111347
58193,,68uokfeyawkj,55674,55675,111349
58194,,n9wcwausttsj,55675,55676,111351
58195,,vgqnh8dcrrij,55676,55677,111353
58196,,wbnsyesbn8qj,55678,55679,111357
58197,,5dr4kwvqproj,55679,55680,111359
58198,,c9j5tbouhokj,55680,55681,111361
58199,,9whup_62lh0j,55681,55682,111363
58200,,0j0xgmb-acsj,55682,55683,111365
58201,,bgkoki1hytkj,55683,55684,111367
58202,,hvjqtd6nfxgj,55684,55685,111369
58203,,tyxkh_esfcij,55685,55686,111371
58204,,,55686,55687,111373
58205,,3mgk6qnkt9qj,55687,55688,111375
58206,,klxpr0yoe_sj,55688,55689,111377
58207,,mjcsxhyixbaj,55689,55690,111379
58208,,w9vfokcyvqoj,55690,55691,111381
58209,,mzgnzzm0alqj,55691,55692,111383
58210,,qw9ovmjv7vkj,55692,55693,111385
58211,,z1oqqfwui38j,55694,55695,111389
58212,,,55695,55696,111391
58213,,url:http://portal.acm.org/ft_gateway.cfm3fid3d109961026type3dpdf,55696,55697,111393
58214,,oqp4tjv4p-4j,55697,55698,111395
58215,,kkp1q5mkotsj,55698,55699,111397
58216,,a_85ebhfluij,55699,55700,111399
58217,,udbeqeq6eiaj,55700,55701,111401
58218,,pstiwkwxtj0j,55701,55702,111403
58219,,_4arkdprarqj,55702,55703,111405
58220,,tvcdos_e7bqj,55703,55704,111407
58221,,,55704,55705,111409
58222,,5ku4shzxrycj,55705,55706,111411
58223,,url:http://portal.acm.org/citation.cfm3fid3d48351.48354,55706,55707,111413
58224,,uvqcgea6y3wj,55707,55708,111415
58225,,onw9rfkjhdkj,55708,55709,111417
58226,,lzauul9kmtwj,55709,55710,111419
58227,,nbq1wmyg7k0j,55710,55711,111421
58228,,rdr5fto4dywj,55711,55712,111423
58229,,gzmgha2hqzgj,55712,55713,111425
58230,,lkjmlo-bycmj,55713,55714,111427
58231,,ylyrvzhxfrij,55714,55715,111429
58232,,ombgmcr8b6wj,55715,55716,111431
58233,,96jea2z2knuj,55717,55718,111435
58234,,nexgzv1bqwcj,55718,55719,111437
58235,,cmaqdiarcj0j,55719,55720,111439
58236,,e34bzue4eakj,55720,55721,111441
58237,,kbs5fkq7lewj,55721,55722,111443
58238,,_6jbypcpdqgj,55722,55723,111445
58239,,z1fvjp3lawaj,55723,55724,111447
58240,,ydjt0iwibiqj,55724,55725,111449
58241,,nutwevc1isuj,55725,55726,111451
58242,,n0dzvi5-jkqj,55726,55727,111453
58243,,z7j4u1sj52cj,55727,55728,111455
58244,,60vx2ycmoduj,55728,55729,111457
58245,,gmxlgexied0j,55729,55730,111459
58246,,d3j6dxtxakwj,55730,55731,111461
58247,,8zk4xr3s_wwj,55731,55732,111463
58248,,haxjnrutwuoj,55732,55733,111465
58249,,1rc8rd7ves0j,55733,55734,111467
58250,,4oqkamp3puyj,55734,55735,111469
58251,,url:http://links.jstor.org/sici3fsici3d0146-4949(196622)7253a2253c142253areba2522m253e2.0.co253b2-3,55735,55736,111471
58252,,in1enoldz8cj,55736,55737,111473
58253,,ftkcl8muxuaj,55738,55739,111477
58254,,dnkgrxyji9qj,55739,55740,111479
58255,,frjwuhotxfqj,55740,55741,111481
58256,,jnxuelyh9gcj,55741,55742,111483
58257,,,55742,55743,111485
58258,,vutivhqd3j0j,55743,55744,111487
58259,,tbzewnb2feaj,55744,55745,111489
58260,,mvgncmlo-byj,55745,55746,111491
58261,,cb-fcplehqaj,55746,55747,111493
58262,,cdb_ztijcq8j,55747,55748,111495
58263,,vy4jvmucsvcj,55749,55750,111499
58264,,ouqvgpnwveyj,55750,55751,111501
58265,,okaulw_-74qj,55751,55752,111503
58266,,hv3dch3hpxqj,55752,55753,111505
58267,,kcnvsgbnzs0j,55753,55754,111507
58268,,m_rq87hvxhuj,55754,55755,111509
58269,,pnk-9uprqqyj,55755,55756,111511
58270,,e02uros6ntqj,55756,55757,111513
58271,,z887r_2w4xmj,55757,55758,111515
58272,,perbs-am1nqj,55758,55759,111517
58273,,3pux08m9c-sj,55759,55760,111519
58274,,n8aqettpargj,55760,55761,111521
58275,,inm0hiq8ypij,55761,55762,111523
58276,,ejzm4elo8fwj,55762,55763,111525
58277,,qosqkmsnawyj,55763,55764,111527
58278,,fu-suak0riwj,55764,55765,111529
58279,,vmqcgybrn9yj,55765,55766,111531
58280,,p7vzf4mkro4j,55766,55767,111533
58281,,r3dg-tn-e8wj,55767,55768,111535
58282,,5bxpinsd2uoj,55768,55769,111537
58283,,i_xs6vbd-oej,55769,55770,111539
58284,,vy7qzp2gaksj,55770,55771,111541
58285,,wbblj0iq7bmj,55771,55772,111543
58286,,r1xdnddihjwj,55772,55773,111545
58287,,6qaztvcjdxmj,55773,55774,111547
58288,,4pr6rpifmw0j,55774,55775,111549
58289,,bsc0mzndgxwj,55775,55776,111551
58290,,uuoj1ozjgk0j,55776,55777,111553
58291,,hty6luihv7kj,55777,55778,111555
58292,,rwuw1mv4wlwj,55778,55779,111557
58293,,mnpfwpaajluj,55779,55780,111559
58294,,iqigbyyznxqj,55780,55781,111561
58295,,8zbmiybcjyej,55781,55782,111563
58296,,ldctorgwzhaj,55782,55783,111565
58297,,k4s0agock10j,55783,55784,111567
58298,,bffgigughcij,55784,55785,111569
58299,,uviq0iymsisj,55785,55786,111571
58300,,hmwyrjkphaej,55786,55787,111573
58301,,t18an4domgej,55787,55788,111575
58302,,ogfvz26-elaj,55788,55789,111577
58303,,akkyvpkktwwj,55789,55790,111579
58304,,prowdi5ntaij,55790,55791,111581
58305,,v6e-2ismvtoj,55792,55793,111585
58306,,a8h9zvwl7bwj,55793,55794,111587
58307,,url:http://portal.acm.org/ft_gateway.cfm3fid3d106626026type3dpdf,55794,55795,111589
58308,,jmjyina5bpkj,55795,55796,111591
58309,,url:http://www.csa.com/partners/viewrecord.php3frequester3dgs26collection3dtrd26recid3d8204540540md,55796,55797,111593
58310,,iclunvoinhkj,55797,55798,111595
58311,,i0drb9dxlysj,55798,55799,111597
58312,,iknouwxfoaaj,55799,55800,111599
58313,,mv7fqxrtae4j,55800,55801,111601
58314,,30i2w66kfhqj,55801,55802,111603
58315,,gbkwjrwolskj,55802,55803,111605
58316,,1ziwj_ts01qj,55803,55804,111607
58317,,of3yw4lplkqj,55804,55805,111609
58318,,3tmrtz4086sj,55805,55806,111611
58319,,ayqilkcg_o8j,55806,55807,111613
58320,,bjufo-y5kl8j,55807,55808,111615
58321,,0qmm7muekc8j,55808,55809,111617
58322,,3e4yjsl1htsj,55809,55810,111619
58323,,bsrijq_ofvcj,55810,55811,111621
58324,,byqpeijh-hoj,55811,55812,111623
58325,,pbszlfr5vcoj,55812,55813,111625
58326,,ztyuj9aatcgj,55813,55814,111627
58327,,url:http://www.springerlink.com/index/hk6nl71588065447.pdf,55814,55815,111629
58328,,jrkybvfpojcj,55815,55816,111631
58329,,pepryzcfn_qj,55816,55817,111633
58330,,vu23dmxtefmj,55817,55818,111635
58331,,wm0ftnu5w9kj,55818,55819,111637
58332,,lgqwkewmmiqj,55819,55820,111639
58333,,7ktcsik-8yej,55820,55821,111641
58334,,ymqanndibssj,55821,55822,111643
58335,,m1euheaky0mj,55822,55823,111645
58336,,aidnm024xlij,55823,55824,111647
58337,,jfazoisvd8wj,55824,55825,111649
58338,,vzxq30gz9r0j,55825,55826,111651
58339,,9apjt2af1kqj,55826,55827,111653
58340,,9ooetixrcfuj,55827,55828,111655
58341,,6rm1xl9901wj,55828,55829,111657
58342,,gu-esksstyij,55829,55830,111659
58343,,yanyx_jr1ysj,55830,55831,111661
58344,,xas7--rqcf0j,55831,55832,111663
58345,,3ilf1lunvfyj,55832,55833,111665
58346,,14syvm01ghoj,55833,55834,111667
58347,,mlbuolqelecj,55834,55835,111669
58348,,9y1fk9icow4j,55835,55836,111671
58349,,dc9c-eac2ruj,55836,55837,111673
58350,,kuzm9ofgc1uj,55837,55838,111675
58351,,xwpqxrogz18j,55838,55839,111677
58352,,axbmtlahq_oj,55839,55840,111679
58353,,citxukjjamoj,55840,55841,111681
58354,,2vu05fovxyyj,55841,55842,111683
58355,,g78nxo0jsr4j,55843,55844,111687
58356,,asdbkdqscsyj,55844,55845,111689
58357,,wp_gyyvwxaqj,55845,55846,111691
58358,,2vfsmrtrgqoj,55846,55847,111693
58359,,mgmdnhax41cj,55847,55848,111695
58360,,sgssprqwpvgj,55848,55849,111697
58361,,n4nyj3c99imj,55849,55850,111699
58362,,pe-uyjjo-vsj,55850,55851,111701
58363,,dwkwzizinxaj,55851,55852,111703
58364,,w2t2k98mvxkj,55852,55853,111705
58365,,gdnae4joen0j,55853,55854,111707
58366,,qbisq-7q62mj,55854,55855,111709
58367,,j22nkgoelh4j,55855,55856,111711
58368,,av7rqulsqiaj,55856,55857,111713
58369,,itnwvngcxvyj,55857,55858,111715
58370,,url:http://www.ingentaconnect.com/search/expand3fpub3dinfobike://els/08830355/2001/00000035/00000002/art0001326unc3d,55858,55859,111717
58371,,eohzfls25asj,55859,55860,111719
58372,,shzsgoqpubqj,55860,55861,111721
58373,,thtqpjsixq8j,55861,55862,111723
58374,,e9wyk5aznyqj,55862,55863,111725
58375,,ic3aw93ntz0j,55863,55864,111727
58376,,hld7exz0qagj,55864,55865,111729
58377,,g_7hs0zbzewj,55865,55866,111731
58378,,td06fasd55aj,55866,55867,111733
58379,,,55867,55868,111735
58380,,i-v43qz4ynsj,55868,55869,111737
58381,,egk_vjfkvy8j,55869,55870,111739
58382,,lbccsotp89aj,55870,55871,111741
58383,,ntshltiggwqj,55871,55872,111743
58384,,yqgekx3o_uuj,55872,55873,111745
58385,,3ouisd9xks4j,55873,55874,111747
58386,,ic9dj0u3rxyj,55874,55875,111749
58387,,bontwclui3oj,55875,55876,111751
58388,,95ls1rshpqqj,55876,55877,111753
58389,,zarj8rzves4j,55877,55878,111755
58390,,4xgwbehvcbqj,55878,55879,111757
58391,,jypjlo8wnzgj,55879,55880,111759
58392,,em4dhrqxtaaj,55880,55881,111761
58393,,url:http://doi.wiley.com/10.1002/anie.198702661,55881,55882,111763
58394,,4wgrejohxx8j,55882,55883,111765
58395,,iinrwk8hovkj,55883,55884,111767
58396,,ml9o9hl__pej,55884,55885,111769
58397,,bwvggmro89aj,55885,55886,111771
58398,,k-jlycxjnryj,55886,55887,111773
58399,,dcpjzuzszccj,55887,55888,111775
58400,,b8etfvs3ocgj,55888,55889,111777
58401,,estarmhc4ngj,55889,55890,111779
58402,,bexz_dtaio8j,55890,55891,111781
58403,,5x_nf5gmploj,55891,55892,111783
58404,,aihmdorp7bsj,55892,55893,111785
58405,,yqsf8r-vo4aj,55893,55894,111787
58406,,s6kindi4fe8j,55894,55895,111789
58407,,url:http://adsabs.harvard.edu/abs/1980phdt........62d,55895,55896,111791
58408,,7kuzocl0m44j,55896,55897,111793
58409,,pbf0evv-pgcj,55897,55898,111795
58410,,yus0xw-v41sj,55898,55899,111797
58411,,go0jkw34xo0j,55899,55900,111799
58412,,vzy-kp-xbyuj,55900,55901,111801
58413,,eskeonw4eoij,55901,55902,111803
58414,,wozkeqcozvwj,55902,55903,111805
58415,,nfnlh7yhyjyj,55903,55904,111807
58416,,xukwqrog2jgj,55904,55905,111809
58417,,cor5jnyfkskj,55905,55906,111811
58418,,uhyu5e5ibfej,55906,55907,111813
58419,,f-tttffr5twj,55907,55908,111815
58420,,gert4nrgf7oj,55908,55909,111817
58421,,foy9ur1vvpyj,55909,55910,111819
58422,,qghuvg1e-rcj,55910,55911,111821
58423,,zob31whajh8j,55911,55912,111823
58424,,url:http://www.springerlink.com/index/r77538rn564872m6.pdf,55912,55913,111825
58425,,crjpc3agvvwj,55913,55914,111827
58426,,llvld2lfw9aj,55914,55915,111829
58427,,r8dopts4orgj,55915,55916,111831
58428,,dnfx6tbtdzaj,55916,55917,111833
58429,,y-cqbzv70swj,55917,55918,111835
58430,,5zoxnfbljwkj,55918,55919,111837
58431,,vmrorcj4s_qj,55919,55920,111839
58432,,estfwl693ouj,55920,55921,111841
58433,,xv5gqzmhofoj,55922,55923,111845
58434,,_ztkme5sjhoj,55923,55924,111847
58435,,6-acaadom0sj,55924,55925,111849
58436,,wjlry4d5lauj,55925,55926,111851
58437,,o3xigsicqq4j,55926,55927,111853
58438,,plimuiddd3ej,55927,55928,111855
58439,,m56huw18jkaj,55928,55929,111857
58440,,3q5rhhc8pqej,55929,55930,111859
58441,,ozksdxrze1ej,55930,55931,111861
58442,,gkdsq0t28ssj,55931,55932,111863
58443,,pdtjuykmjggj,55932,55933,111865
58444,,vusnzwa6sq8j,55933,55934,111867
58445,,syfzooqp6c4j,55934,55935,111869
58446,,hpb4twalscyj,55935,55936,111871
58447,,jwvbm7wh4qsj,55936,55937,111873
58448,,rcapoo_sv18j,55937,55938,111875
58449,,vobvfwi43mmj,55938,55939,111877
58450,,of9duiv6jmoj,55939,55940,111879
58451,,url:http://doi.wiley.com/10.1002/ace.8105,55940,55941,111881
58452,,sbpl-16tqkgj,55941,55942,111883
58453,,vinyflvq0uij,55942,55943,111885
58454,,ruediwlsbduj,55943,55944,111887
58455,,dppcmdk8ezoj,55944,55945,111889
58456,,url:http://www.csa.com/partners/viewrecord.php3frequester3dgs26collection3dtrd26recid3dn9210477ah,55945,55946,111891
58457,,k44p0ggihhoj,55946,55947,111893
58458,,fnkaofozyqgj,55947,55948,111895
58459,,7in6hhumutij,55948,55949,111897
58460,,hl_8ihbi6dmj,55949,55950,111899
58461,,gn2ow_n2obgj,55950,55951,111901
58462,,rbbfkitp9kcj,55951,55952,111903
58463,,t4jorwvunzoj,55952,55953,111905
58464,,jap2fvdu6u8j,55953,55954,111907
58465,,x6xdmlro_d0j,55954,55955,111909
58466,,avs9oey-d_aj,55955,55956,111911
58467,,vqvvcqemjbkj,55956,55957,111913
58468,,ydvlendlbayj,55957,55958,111915
58469,,mwwthfy_8xij,55958,55959,111917
58470,,jl0enlbog9ij,55959,55960,111919
58471,,or9yfrl_5h8j,55960,55961,111921
58472,,sesiuded8uij,55962,55963,111925
58473,,7sbkcdlpzq4j,55963,55964,111927
58474,,url:http://www.csa.com/partners/viewrecord.php3frequester3dgs26collection3dtrd26recid3d0835768ci,55964,55965,111929
58475,,fwjifv-stmmj,55965,55966,111931
58476,,gnl4uc5wbrkj,55966,55967,111933
58477,,f6rxidedlfgj,55967,55968,111935
58478,,xwjba67rxr4j,55968,55969,111937
58479,,zthjft2quayj,55969,55970,111939
58480,,eejrk_bpoigj,55970,55971,111941
58481,,r5g1eakd4tsj,55971,55972,111943
58482,,amg-6ujagiuj,55972,55973,111945
58483,,bf1avafdqjaj,55973,55974,111947
58484,,uuu2fuvm1joj,55974,55975,111949
58485,,n5saolhgkh0j,55975,55976,111951
58486,,3joz3gjmplij,55976,55977,111953
58487,,xqnoip0orpsj,55977,55978,111955
58488,,gjtuaimljruj,55978,55979,111957
58489,,q3vm8iaxecyj,55979,55980,111959
58490,,u-mfvjh8v3cj,55980,55981,111961
58491,,niix5xfa2mgj,55981,55982,111963
58492,,aacgqwidghej,55982,55983,111965
58493,,2oeznd-f8huj,55983,55984,111967
58494,,hxmini8rfqgj,55984,55985,111969
58495,,zxra-xv3a2ej,55985,55986,111971
58496,,c1nswf7gcgej,55986,55987,111973
58497,,asvzdvmvub0j,55987,55988,111975
58498,,url:http://www.csa.com/partners/viewrecord.php3frequester3dgs26collection3dtrd26recid3d200111010707mt26recid3da0032641ah,55988,55989,111977
58499,,jx9zefrmi1sj,55989,55990,111979
58500,,url:http://portal.acm.org/citation.cfm3fid3d18265526dl3dacm26coll3dguide26cfid3d1111111126cftoken3d2222222,55990,55991,111981
58501,,whkbazux-_sj,55991,55992,111983
58502,,odtqt8e-9mij,55992,55993,111985
58503,,bmtl6mirbmgj,55993,55994,111987
58504,,alaeu9pg5lej,55994,55995,111989
58505,,cy7ccujot8wj,55995,55996,111991
58506,,mgj4hsut_3ej,55996,55997,111993
58507,,99znqzw2pcij,55997,55998,111995
58508,,uja7nl1l240j,55998,55999,111997
58509,,x2osht_3mzgj,55999,56000,111999
58510,,kep-xo_8kfoj,56000,56001,112001
58511,,pm_6uzotnkkj,56001,56002,112003
58512,,b60m91mxbccj,56002,56003,112005
58513,,f7rrgwoqipgj,56003,56004,112007
58514,,_dtj6cjqfaqj,56004,56005,112009
58515,,2qyl4s6sdxqj,56005,56006,112011
58516,,riwjxf_tjxuj,56006,56007,112013
58517,,3rr-unqajiyj,56007,56008,112015
58518,,wlhpb4mxs4kj,56008,56009,112017
58519,,url:http://portal.acm.org/citation.cfm3fid3d1084805.1084823,56009,56010,112019
58520,,url:http://adsabs.harvard.edu/abs/1989mit..repts....h,56010,56011,112021
58521,,snwdpn8axeej,56011,56012,112023
58522,,d6uobzu9iugj,56012,56013,112025
58523,,y0bfvrml0z0j,56013,56014,112027
58524,,t2agd2p2im4j,56014,56015,112029
58525,,ogedbo2c_igj,56015,56016,112031
58526,,-7tm_rtxh9cj,56016,56017,112033
58527,,usyqylwh04wj,56017,56018,112035
58528,,_-gi61hx_hwj,56018,56019,112037
58529,,ekf-ndrsodqj,56019,56020,112039
58530,,f-u1s3gbi2uj,56020,56021,112041
58531,,url:http://portal.acm.org/ft_gateway.cfm3fid3d106630526type3dpdf,56021,56022,112043
58532,,ivmbi-v8rz0j,56023,56024,112047
58533,,_e2eq4zpko4j,56024,56025,112049
58534,,kuyfjk7kxgej,56025,56026,112051
58535,,ltvmdemjgvaj,56026,56027,112053
58536,,5kh98tjat5oj,56027,56028,112055
58537,,mext0rndnf4j,56028,56029,112057
58538,,fr0bpqbo42ij,56030,56031,112061
58539,,hmit7hfwszkj,56031,56032,112063
58540,,kkshujjgsfuj,56032,56033,112065
58541,,1yd2eom3ydqj,56033,56034,112067
58542,,u9xefu-jgm0j,56034,56035,112069
58543,,0ofvccnij-0j,56035,56036,112071
58544,,urtmvemapa8j,56036,56037,112073
58545,,oqx98om7y7mj,56037,56038,112075
58546,,pa3kszkicj4j,56038,56039,112077
58547,,e0gykasxky8j,56039,56040,112079
58548,,wewn45o9bykj,56040,56041,112081
58549,,ihm0jir7srwj,56041,56042,112083
58550,,ns0p_gd6c_mj,56042,56043,112085
58551,,m1zguu2ih30j,56043,56044,112087
58552,,x55l7ovc3aij,56044,56045,112089
58553,,url:http://portal.acm.org/ft_gateway.cfm3fid3d95712526type3dpdf26dl3dguide26dl3dacm26cfid3d1111111126cftoken3d2222222,56045,56046,112091
58554,,zhh0gcewbywj,56046,56047,112093
58555,,czpxz8kd2zwj,56047,56048,112095
58556,,r7kinicp8mcj,56048,56049,112097
58557,,ohh3kfryffmj,56049,56050,112099
58558,,onwe2gl8zm8j,56050,56051,112101
58559,,ewucutufghyj,56051,56052,112103
58560,,_jkcq80n8uij,56052,56053,112105
58561,,s_lcr_bbc_ej,56053,56054,112107
58562,,znar8ssj-joj,56054,56055,112109
58563,,rqpejxacx-ij,56055,56056,112111
58564,,wuqq0btqbgaj,56056,56057,112113
58565,,n49kspoadvkj,56057,56058,112115
58566,,att2km98wuij,56058,56059,112117
58567,,fm-m8md_fjkj,56059,56060,112119
58568,,qol5lyth-rgj,56060,56061,112121
58569,,vhuudfmyiayj,56061,56062,112123
58570,,shc9kyeepwej,56062,56063,112125
58571,,detgabokakqj,56063,56064,112127
58572,,yg7dsv_vpnij,56064,56065,112129
58573,,kl7upwmite4j,56065,56066,112131
58574,,ad33wumi58mj,56066,56067,112133
58575,,av3zxsc6wzej,56067,56068,112135
58576,,k8cjssy-jiqj,56068,56069,112137
58577,,9_ofzvbz-ayj,56069,56070,112139
58578,,c7errphlhqoj,56070,56071,112141
58579,,yn9fuwvoklaj,56071,56072,112143
58580,,31prqloufnqj,56072,56073,112145
58581,,xn9d6emgwn0j,56073,56074,112147
58582,,xwytk03c7w4j,56074,56075,112149
58583,,url:http://links.jstor.org/sici3fsici3d0146-4949(196722)8253a3253c407253amarira253e2.0.co253b2-q,56075,56076,112151
58584,,wf7ba_txcdij,56076,56077,112153
58585,,,56077,56078,112155
58586,,6mx4gah65hoj,56078,56079,112157
58587,,ifiv0xejvikj,56079,56080,112159
58588,,29nd28r0ndwj,56080,56081,112161
58589,,0dkwze9l_mij,56081,56082,112163
58590,,kcubc3htfroj,56082,56083,112165
58591,,1ntgmsqf2q0j,56083,56084,112167
58592,,uz70byznqhgj,56084,56085,112169
58593,,5dccbuxadtsj,56085,56086,112171
58594,,9rhyahemvagj,56086,56087,112173
58595,,aafv9gtoue0j,56087,56088,112175
58596,,emhhlamhy-aj,56088,56089,112177
58597,,nbxgk0inlfgj,56089,56090,112179
58598,,dav9lb0quqej,56090,56091,112181
58599,,fjuq0wqsdksj,56091,56092,112183
58600,,url:http://portal.acm.org/ft_gateway.cfm3fid3d109958426type3dpdf,56092,56093,112185
58601,,n8vsqfg-qdsj,56094,56095,112189
58602,,hxbunbckgwqj,56095,56096,112191
58603,,y1cdo2klcssj,56096,56097,112193
58604,,url:http://adsabs.harvard.edu/abs/1978phdt........76s,56097,56098,112195
58605,,hn84x1kafdoj,56098,56099,112197
58606,,lzrymv1pt68j,56099,56100,112199
58607,,5e6fejcxfyej,56100,56101,112201
58608,,jb3-myxrtvij,56102,56103,112205
58609,,42ywu89mkiij,56103,56104,112207
58610,,m46oatmwlfkj,56104,56105,112209
58611,,drtfwdvqalmj,56105,56106,112211
58612,,qq9njxe-i78j,56106,56107,112213
58613,,irpj6_g90w4j,56107,56108,112215
58614,,g2wcr9yvrt4j,56108,56109,112217
58615,,zl2xqmmu4qsj,56109,56110,112219
58616,,gop4v7voonqj,56110,56111,112221
58617,,dv_liiwxt-0j,56111,56112,112223
58618,,fk-vyc8qnakj,56112,56113,112225
58619,,t8bporxb1vsj,56113,56114,112227
58620,,d4i1twf-ci8j,56114,56115,112229
58621,,jusff9sx1uyj,56115,56116,112231
58622,,awpisxuxda0j,56116,56117,112233
58623,,039czqa-e_kj,56117,56118,112235
58624,,cg8cvynv-lqj,56118,56119,112237
58625,,,56119,56120,112239
58626,,-0gdo01dgcgj,56120,56121,112241
58627,,,56121,56122,112243
58628,,a5xdi-557qqj,56123,56124,112247
58629,,uljff0kx18cj,56124,56125,112249
58630,,qzvrskgbsnmj,56125,56126,112251
58631,,ur0zsyvetesj,56126,56127,112253
58632,,ezkgnl_bv7qj,56127,56128,112255
58633,,ytxn3s1xidaj,56128,56129,112257
58634,,zulwri0jqb0j,56129,56130,112259
58635,,bqxuatvxipej,56130,56131,112261
58636,,ivhul6erw94j,56131,56132,112263
58637,,lixaglyrxzwj,56132,56133,112265
58638,,q-hvfjgwx6mj,56133,56134,112267
58639,,odoq9cjzfogj,56134,56135,112269
58640,,yimalvfefnoj,56135,56136,112271
58641,,ycrjhb1zvxuj,56136,56137,112273
58642,,ysq7aymyiacj,56137,56138,112275
58643,,jj64xkk75zij,56138,56139,112277
58644,,8btwydaeuamj,56139,56140,112279
58645,,y7e1gezhg4kj,56140,56141,112281
58646,,i8bnekifihyj,56142,56143,112285
58647,,yxlkawsle6sj,56143,56144,112287
58648,,pukaounkkewj,56144,56145,112289
58649,,k2dbqhgh3pyj,56145,56146,112291
58650,,9fwlesjcocqj,56146,56147,112293
58651,,yzgty1dek8uj,56147,56148,112295
58652,,shfgk7iev-qj,56148,56149,112297
58653,,hrydm6f31goj,56149,56150,112299
58654,,dvhojjixwa4j,56150,56151,112301
58655,,z8rtgmgf7a8j,56151,56152,112303
58656,,mwud7fn7be0j,56152,56153,112305
58657,,qv86rrmor-uj,56153,56154,112307
58658,,7lih8wufl_0j,56154,56155,112309
58659,,d3gdce0j_rgj,56155,56156,112311
58660,,k2kpskzphyqj,56156,56157,112313
58661,,dn3i0qo0neuj,56157,56158,112315
58662,,fa7t1ekrknwj,56158,56159,112317
58663,,ochcoxevhqkj,56159,56160,112319
58664,,gvipzf3sulyj,56160,56161,112321
58665,,9e1gxd5mvhuj,56161,56162,112323
58666,,auq-zzcz1ecj,56162,56163,112325
58667,,wtbdmonmuxaj,56163,56164,112327
58668,,btf0yxso4loj,56164,56165,112329
58669,,k3dcmzbgunqj,56165,56166,112331
58670,,bv3rm2hew1ej,56166,56167,112333
58671,,yfegc5k39r8j,56168,56169,112337
58672,,ocamq9ibz-sj,56170,56171,112341
58673,,lgrsld4k-nuj,56171,56172,112343
58674,,nfyjixxwb3oj,56172,56173,112345
58675,,w4imswhrvi8j,56174,56175,112349
58676,,m4xrhcsw4baj,56175,56176,112351
58677,,vm0j_is5mn8j,56176,56177,112353
58678,,jebehxtatqwj,56177,56178,112355
58679,,qum_yuy_a7uj,56178,56179,112357
58680,,l4vtj31ixc8j,56179,56180,112359
58681,,oc5hpdyjdokj,56180,56181,112361
58682,,jzt0efwsjp8j,56182,56183,112365
58683,,5h6jx1j7us4j,56183,56184,112367
58684,,qbzqtl3s5aij,56184,56185,112369
58685,,uddnm7dpzswj,56185,56186,112371
58686,,rs3jig5uk9uj,56186,56187,112373
58687,,ghcglisfdvcj,56187,56188,112375
58688,,dxnidx9bfxkj,56188,56189,112377
58689,,53wemldliysj,56189,56190,112379
58690,,kc-iarrsvr0j,56190,56191,112381
58691,,js8v5nlmlcuj,56191,56192,112383
58692,,liwpobnd_34j,56192,56193,112385
58693,,qz9da7vdywyj,56193,56194,112387
58694,,7-dbfcdtzxkj,56194,56195,112389
58695,,l2s_f92wvvgj,56195,56196,112391
58696,,sje7q-yew9yj,56196,56197,112393
58697,,,56197,56198,112395
58698,,5obmwchcfqsj,56198,56199,112397
58699,,r0pzkyvelgsj,56199,56200,112399
58700,,dosaxifzjsqj,56200,56201,112401
58701,,tb8sxexqhrqj,56201,56202,112403
58702,,sa9nekfzs0ej,56202,56203,112405
58703,,2lqfsnip3vej,56203,56204,112407
58704,,flxzycvem5kj,56204,56205,112409
58705,,yahacbugb6ej,56205,56206,112411
58706,,45flftitrqqj,56206,56207,112413
58707,,klklgdq7tkoj,56207,56208,112415
58708,,loxsg9vxnf0j,56208,56209,112417
58709,,7ihofhryplaj,56209,56210,112419
58710,,o06soruwpb4j,56210,56211,112421
58711,,xxkaw7m8wloj,56211,56212,112423
58712,,57vl5w2vgz4j,56212,56213,112425
58713,,yysppwid4xuj,56213,56214,112427
58714,,9bpxrvoejtcj,56214,56215,112429
58715,,efgowivr71ij,56215,56216,112431
58716,,2bt7dvqa1lkj,56216,56217,112433
58717,,gb12owxggxsj,56217,56218,112435
58718,,yvvhksy84eyj,56218,56219,112437
58719,,8idvdyorxv0j,56219,56220,112439
58720,,h3-3_pjrfnsj,56220,56221,112441
58721,,8mhjc-sorf8j,56221,56222,112443
58722,,pkmn5cdy7kcj,56222,56223,112445
58723,,qzvvbwh30j4j,56223,56224,112447
58724,,ijdzbdotc6mj,56224,56225,112449
58725,,vkzvvvbsikoj,56225,56226,112451
58726,,pnb4l-t-4gej,56226,56227,112453
58727,,i8sy9aadwbqj,56227,56228,112455
58728,,4kuqugg0mywj,56228,56229,112457
58729,,mhzo8vzjuv4j,56229,56230,112459
58730,,xtdalczia7ij,56230,56231,112461
58731,,7j9koierlkyj,56231,56232,112463
58732,,enzvnheum44j,56232,56233,112465
58733,,goupoosp8sej,56233,56234,112467
58734,,tttkvegk2yij,56234,56235,112469
58735,,qcnelfk4eoej,56235,56236,112471
58736,,q3k0jtdzq-ij,56236,56237,112473
58737,,url:http://portal.acm.org/ft_gateway.cfm3fid3d108623826type3dpdf,56237,56238,112475
58738,,nmzse-scw4mj,56238,56239,112477
58739,,mhbu3r47ouuj,56239,56240,112479
58740,,a74b_9mlgkmj,56240,56241,112481
58741,,bhau6axaleoj,56241,56242,112483
58742,,xtvqtb271lej,56242,56243,112485
58743,,zhublb_nx38j,56243,56244,112487
58744,,rehm8uyk1k8j,56244,56245,112489
58745,,mocvzpzvuhaj,56245,56246,112491
58746,,f7mi_nlmdtyj,56247,56248,112495
58747,,xoiksa7fal0j,56248,56249,112497
58748,,sddlrgayfz0j,56249,56250,112499
58749,,ajkthjaq0xqj,56250,56251,112501
58750,,isye3cewtjej,56251,56252,112503
58751,,nf1uoxi5r3mj,56252,56253,112505
58752,,xp95-nffu8aj,56253,56254,112507
58753,,ujpbvfvnrw8j,56254,56255,112509
58754,,1avul1p8z7kj,56255,56256,112511
58755,,7ukotkjkww8j,56256,56257,112513
58756,,ffimhkjmwogj,56257,56258,112515
58757,,ozg5zlhfasmj,56258,56259,112517
58758,,vsjphys4ooaj,56259,56260,112519
58759,,idm_u8osqwoj,56260,56261,112521
58760,,dpqrwnvo7rej,56261,56262,112523
58761,,cv6eraw6hzwj,56262,56263,112525
58762,,7jch7nfi6tgj,56263,56264,112527
58763,,0elpkyqqv88j,56264,56265,112529
58764,,yhaglm9qcgaj,56265,56266,112531
58765,,eovodppwoa4j,56266,56267,112533
58766,,lagt72hkf3gj,56267,56268,112535
58767,,oikyjgqmlwkj,56268,56269,112537
58768,,xdwfekptz0uj,56269,56270,112539
58769,,jg0d9bkjrkij,56270,56271,112541
58770,,wozwtgrjab8j,56271,56272,112543
58771,,qncmkvcbsagj,56272,56273,112545
58772,,2qd96m1aa0wj,56273,56274,112547
58773,,xm3jwnk3_v8j,56274,56275,112549
58774,,ecoqoqq1eswj,56275,56276,112551
58775,,qaxraexpnu8j,56276,56277,112553
58776,,09ukrguasugj,56277,56278,112555
58777,,url:http://portal.acm.org/citation.cfm3fid3d776985.77699526coll3dguide26dl3dacm26idx3dj68926part3dperiodical26wanttype3dperiodical26title3dacm2520sigmod2520record26cfid3d1111111126cftoken3d2222222,56278,56279,112557
58778,,ze4im0h4w2sj,56279,56280,112559
58779,,gi9esh0kqr8j,56280,56281,112561
58780,,owgp7etjfvsj,56281,56282,112563
58781,,pmosobcfcpuj,56283,56284,112567
58782,,v48jfdesyxyj,56284,56285,112569
58783,,url:http://www.springerlink.com/index/x15p702771q66148.pdf,56285,56286,112571
58784,,url:http://www.springerlink.com/index/n10w80q30j12w6m3.pdf,56286,56287,112573
58785,,aqexgwgmvhgj,56287,56288,112575
58786,,nxkx0v8rhqqj,56288,56289,112577
58787,,gfkyzs9b1zmj,56289,56290,112579
58788,,fcn_y3omcaaj,56290,56291,112581
58789,,k2g2biqhcg8j,56291,56292,112583
58790,,s8apguo-rzoj,56292,56293,112585
58791,,de1bl3lcauqj,56293,56294,112587
58792,,rv8y5ijm7gmj,56294,56295,112589
58793,,aibgwdm9y1ej,56295,56296,112591
58794,,ckjgbc5dhhcj,56296,56297,112593
58795,,kaf15fikhruj,56297,56298,112595
58796,,url:http://www.springerlink.com/index/w14n79x43372p151.pdf,56298,56299,112597
58797,,,56299,56300,112599
58798,,roo9oix_qo0j,56300,56301,112601
58799,,egg01t4dj_wj,56301,56302,112603
58800,,_qztj1ccvmij,56302,56303,112605
58801,,jgj0twnejtcj,56304,56305,112609
58802,,5rrs2rkhtc4j,56305,56306,112611
58803,,geqikhtlqh4j,56306,56307,112613
58804,,osluajji_b4j,56307,56308,112615
58805,,jlyna-tldrmj,56308,56309,112617
58806,,mqp1vw53fpqj,56309,56310,112619
58807,,gpxyxghbwkwj,56310,56311,112621
58808,,mehiksqb4m8j,56311,56312,112623
58809,,id6pgky1d_qj,56312,56313,112625
58810,,gu-zb6umkzij,56313,56314,112627
58811,,wn4-closstmj,56314,56315,112629
58812,,q3cuvkaxuaaj,56315,56316,112631
58813,,ibbmclhzwh8j,56316,56317,112633
58814,,qmidby8ongej,56317,56318,112635
58815,,drkuju7uunqj,56318,56319,112637
58816,,url:http://doi.wiley.com/10.1002/ev.1061,56319,56320,112639
58817,,2xyvqc4u7wkj,56320,56321,112641
58818,,jae5cxufsi8j,56321,56322,112643
58819,,aoi0t3v9zgaj,56322,56323,112645
58820,,wkcqqdraulcj,56323,56324,112647
58821,,7k3kilbq7soj,56324,56325,112649
58822,,url:http://portal.acm.org/citation.cfm3fid3d71384.71389,56325,56326,112651
58823,,s8ddybfo0b8j,56326,56327,112653
58824,,tpn9aroew28j,56327,56328,112655
58825,,avzup6ktsbqj,56328,56329,112657
58826,,m3_ged5vaugj,56329,56330,112659
58827,,nsn_2bnt_mmj,56330,56331,112661
58828,,hwrekgn-unyj,56331,56332,112663
58829,,2jwony0vh3ij,56332,56333,112665
58830,,ilnmzjj3-sij,56333,56334,112667
58831,,hklh6y-y8qyj,56334,56335,112669
58832,,p1u7yusovjej,56335,56336,112671
58833,,oh8o4cmecp0j,56336,56337,112673
58834,,hbmggvjiqlgj,56337,56338,112675
58835,,url:http://doi.wiley.com/10.1002/tl.2,56338,56339,112677
58836,,fgulwljswoej,56339,56340,112679
58837,,quryt_alngcj,56340,56341,112681
58838,,r3faia-_cfaj,56341,56342,112683
58839,,_faf3hr_sm4j,56342,56343,112685
58840,,7q4ca5asu18j,56343,56344,112687
58841,,4qwoajn5izuj,56346,56347,112693
58842,,url:http://www.springerlink.com/index/j233321203428341.pdf,56347,56348,112695
58843,,odfzskrtpawj,56348,56349,112697
58844,,h47o1ori250j,56349,56350,112699
58845,,snlii6g10ikj,56350,56351,112701
58846,,mgrukm0tn1wj,56351,56352,112703
58847,,hs446yz0nlgj,56352,56353,112705
58848,,xddbtfhy-fmj,56353,56354,112707
58849,,ujcubbqi2fcj,56354,56355,112709
58850,,8nt7g7owjdyj,56355,56356,112711
58851,,vnjlb8agh6wj,56356,56357,112713
58852,,c7cjk5twvauj,56357,56358,112715
58853,,xclyttnf5ncj,56358,56359,112717
58854,,9op0hsam5dwj,56359,56360,112719
58855,,tmmen78voxcj,56360,56361,112721
58856,,enm8v4uy3ooj,56361,56362,112723
58857,,,56362,56363,112725
58858,,5qvprbtmixsj,56363,56364,112727
58859,,umktzckdipqj,56364,56365,112729
58860,,xzmgmpejbvkj,56365,56366,112731
58861,,fkr54bs26cij,56366,56367,112733
58862,,4iicmt0tzfyj,56367,56368,112735
58863,,sildqxjotj8j,56368,56369,112737
58864,,4dxhgcusdw8j,56369,56370,112739
58865,,nobv7pggljij,56370,56371,112741
58866,,b5lgccy8bbyj,56371,56372,112743
58867,,e3qa-xrdbloj,56372,56373,112745
58868,,,56373,56374,112747
58869,,_0pv0si09-0j,56374,56375,112749
58870,,nwikwdvtrzaj,56375,56376,112751
58871,,44v72rntkyij,56376,56377,112753
58872,,gif5edrlr3sj,56377,56378,112755
58873,,pniap8ps4qgj,56378,56379,112757
58874,,v05yopnpax8j,56379,56380,112759
58875,,kkznx3aijsoj,56380,56381,112761
58876,,url:http://portal.acm.org/citation.cfm3fdoid3d217279.215295,56381,56382,112763
58877,,wkvlrc2nndcj,56382,56383,112765
58878,,fdk0wwladv8j,56383,56384,112767
58879,,eeny9_p9wdgj,56384,56385,112769
58880,,wg7yr--ujlmj,56385,56386,112771
58881,,s3-tn7tgfqaj,56386,56387,112773
58882,,wqy65q46h_yj,56387,56388,112775
58883,,lcuqoipzde4j,56388,56389,112777
58884,,a9h8y_fuoncj,56389,56390,112779
58885,,rk12xypoor4j,56390,56391,112781
58886,,uau4yl53_58j,56391,56392,112783
58887,,kw3puelwmuqj,56392,56393,112785
58888,,estabv2itiij,56393,56394,112787
58889,,aoujxvtxvqij,56394,56395,112789
58890,,url:http://www.csa.com/partners/viewrecord.php3frequester3dgs26collection3dtrd26recid3d20021263001654mt26recid3da7212144ah,56395,56396,112791
58891,,klawd-bnjxcj,56396,56397,112793
58892,,cjhwru64vswj,56397,56398,112795
58893,,mriofe851bij,56398,56399,112797
58894,,iu93mvqfiq0j,56399,56400,112799
58895,,yueniqqzfs4j,56400,56401,112801
58896,,u3-ti-vu7i8j,56401,56402,112803
58897,,rxstsd1wrmgj,56402,56403,112805
58898,,qq7karxk3_qj,56403,56404,112807
58899,,hy7ynduvu_wj,56404,56405,112809
58900,,gv7cpephhbsj,56405,56406,112811
58901,,f2focdziftcj,56406,56407,112813
58902,,ecqqmhdyu5ej,56407,56408,112815
58903,,2qt0jwckrfcj,56408,56409,112817
58904,,url:http://adsabs.harvard.edu/abs/1984rame.conf..238l,56409,56410,112819
58905,,url:http://portal.acm.org/ft_gateway.cfm3fid3d108374826type3dpdf,56410,56411,112821
58906,,vkbsdrryid4j,56411,56412,112823
58907,,a5i2nk7u0jmj,56412,56413,112825
58908,,fjefiib5fpuj,56413,56414,112827
58909,,ltgmtr1awccj,56414,56415,112829
58910,,ulbaxmzmkouj,56416,56417,112833
58911,,p83c5gkke3mj,56417,56418,112835
58912,,pi4dpkvuuukj,56418,56419,112837
58913,,wwg2iaq2ttgj,56419,56420,112839
58914,,letc4dd7_gcj,56420,56421,112841
58915,,n851vqzcajgj,56421,56422,112843
58916,,ou4jt6ddtmcj,56422,56423,112845
58917,,,56423,56424,112847
58918,,0hhyo7tqjugj,56424,56425,112849
58919,,alvondqou2qj,56425,56426,112851
58920,,c5d5rvv9oeaj,56426,56427,112853
58921,,oic-iw3k4naj,56427,56428,112855
58922,,nyafhpetymuj,56428,56429,112857
58923,,gd7fwtej35ej,56429,56430,112859
58924,,nzy8jowxq6yj,56430,56431,112861
58925,,cm_brvxj8zej,56431,56432,112863
58926,,cszqqqpmxjij,56432,56433,112865
58927,,gb1n0yopzkaj,56433,56434,112867
58928,,9stn0up3otij,56434,56435,112869
58929,,bpikae0unvsj,56435,56436,112871
58930,,ikkcmjz2oe4j,56437,56438,112875
58931,,uocopushonej,56438,56439,112877
58932,,a7cspegmii8j,56439,56440,112879
58933,,aumbbk7eubuj,56440,56441,112881
58934,,r3uccvie63ej,56441,56442,112883
58935,,c5nfi9sih_qj,56442,56443,112885
58936,,81jqbf3xmy0j,56443,56444,112887
58937,,86kiq3v_nkij,56444,56445,112889
58938,,tqndosezxbaj,56445,56446,112891
58939,,21ac9jmdmjaj,56446,56447,112893
58940,,wvzo2rkkkzuj,56447,56448,112895
58941,,2-wbh36amt4j,56448,56449,112897
58942,,rbg47x2egbgj,56449,56450,112899
58943,,_es1twalijyj,56450,56451,112901
58944,,iqqexal0mzij,56451,56452,112903
58945,,a9hrekmzqm4j,56452,56453,112905
58946,,malhlqreeowj,56453,56454,112907
58947,,9dc0m0001n0j,56454,56455,112909
58948,,obdl7axdwg4j,56455,56456,112911
58949,,tjqf7tg14t4j,56456,56457,112913
58950,,ljatzlnq29gj,56457,56458,112915
58951,,gzpgpeditfsj,56458,56459,112917
58952,,agxot36i5soj,56459,56460,112919
58953,,url:http://portal.acm.org/citation.cfm3fid3d565117.56513026dl3dguide26dl3dacm26idx3dj68926part3dperiodical26wanttype3dperiodical26title3dacm2520sigmod2520record26cfid3d1111111126cftoken3d2222222,56460,56461,112921
58954,,3qzthqnytf8j,56461,56462,112923
58955,,ixwhvabkpwgj,56462,56463,112925
58956,,migoix43emmj,56463,56464,112927
58957,,g3jrbpstxsqj,56464,56465,112929
58958,,illb5sysgt8j,56465,56466,112931
58959,,46psbfuq8_8j,56466,56467,112933
58960,,rzf_ozzs2hmj,56467,56468,112935
58961,,url:http://www.csa.com/partners/viewrecord.php3frequester3dgs26collection3dtrd26recid3d0014652ci,56468,56469,112937
58962,,qzxjyiask98j,56469,56470,112939
58963,,6up76u_9zwcj,56470,56471,112941
58964,,n3lzvh7ukwej,56471,56472,112943
58965,,url:http://portal.acm.org/citation.cfm3fid3d582095.582111,56472,56473,112945
58966,,,56473,56474,112947
58967,,87sgp4myiooj,56474,56475,112949
58968,,url:http://www.csa.com/partners/viewrecord.php3frequester3dgs26collection3dtrd26recid3d0080889ci,56475,56476,112951
58969,,2wvovzsq0ksj,56476,56477,112953
58970,,_7nbw7rlts4j,56477,56478,112955
58971,,s_1fmnzra9sj,56478,56479,112957
58972,,6apsevjb-wej,56479,56480,112959
58973,,gutnv0vhoiyj,56480,56481,112961
58974,,z2xnx7ctk4cj,56481,56482,112963
58975,,03jbm5joo1ej,56482,56483,112965
58976,,rpb2nyjigfqj,56483,56484,112967
58977,,vkli9rtmsnwj,56484,56485,112969
58978,,scghzhtbbloj,56485,56486,112971
58979,,mnh34wptaqij,56486,56487,112973
58980,,zlqs6w05lhuj,56487,56488,112975
58981,,getccr-na7sj,56488,56489,112977
58982,,my3eov4budij,56489,56490,112979
58983,,wba-chz2fdej,56490,56491,112981
58984,,rhbybrihns0j,56491,56492,112983
58985,,l9majrfggxgj,56492,56493,112985
58986,,nadaojjsrfqj,56494,56495,112989
58987,,pylw8hx5_hcj,56495,56496,112991
58988,,6-cbnv7pcmyj,56496,56497,112993
58989,,bpjp_2y3aq0j,56497,56498,112995
58990,,krllu13thpij,56498,56499,112997
58991,,2ehwxw0ij4aj,56499,56500,112999
58992,,27cb4mksdduj,56500,56501,113001
58993,,qxu-bp6ucwmj,56501,56502,113003
58994,,e9xfdnh670yj,56502,56503,113005
58995,,tp1vibhoraij,56503,56504,113007
58996,,qzwj4ccqbjqj,56504,56505,113009
58997,,rblpqhodpwqj,56505,56506,113011
58998,,lnswslqilosj,56506,56507,113013
58999,,rxls-qa8p3aj,56507,56508,113015
59000,,cztsjonnfgij,56508,56509,113017
59001,,imm-ho95algj,56509,56510,113019
59002,,wo8ieju_k-ej,56510,56511,113021
59003,,ujo0oglbvz0j,56511,56512,113023
59004,,_hv8j-ks6qgj,56512,56513,113025
59005,,2xbh895fzzkj,56513,56514,113027
59006,,1mv5ycz8-b8j,56514,56515,113029
59007,,,56515,56516,113031
59008,,zdn3zbueidsj,56516,56517,113033
59009,,btb4r5y4kjej,56517,56518,113035
59010,,64ehbigc8caj,56518,56519,113037
59011,,ci__jziscegj,56520,56521,113041
59012,,l4ftwihhl2aj,56521,56522,113043
59013,,m-1xzswrmomj,56522,56523,113045
59014,,av2r7d_byccj,56523,56524,113047
59015,,rrhy2sixhd4j,56525,56526,113051
59016,,3cyad-mlnnyj,56526,56527,113053
59017,,,56527,56528,113055
59018,,eeg_r7wxte8j,56528,56529,113057
59019,,url:http://doi.wiley.com/10.1002/he.11107,56529,56530,113059
59020,,7dftbjtrhwaj,56530,56531,113061
59021,,xbv2zde8dl4j,56531,56532,113063
59022,,23rgaepmihyj,56532,56533,113065
59023,,_ufnfnjkrd0j,56533,56534,113067
59024,,icoe8glpwmij,56534,56535,113069
59025,,s1rx-mfa6e8j,56535,56536,113071
59026,,iuui_qru_i8j,56536,56537,113073
59027,,3eptayfj9dmj,56537,56538,113075
59028,,2mpi5tanwbkj,56538,56539,113077
59029,,enjnfjejkbuj,56540,56541,113081
59030,,epuwvr4kd18j,56541,56542,113083
59031,,f2x6im46xpqj,56542,56543,113085
59032,,eqphel7r_gkj,56543,56544,113087
59033,,gpjsja30jqwj,56544,56545,113089
59034,,xwjzmws0ocuj,56545,56546,113091
59035,,x8howlv0yb4j,56546,56547,113093
59036,,gi8in5_q-woj,56547,56548,113095
59037,,ywgpdmp8qxej,56548,56549,113097
59038,,url:http://www.springerlink.com/index/w52u41m0514161k2.pdf,56549,56550,113099
59039,,2pwepijiqgij,56550,56551,113101
59040,,qcpfeb_ta3sj,56551,56552,113103
59041,,tvizs1t-948j,56552,56553,113105
59042,,l68uvhnjvcyj,56553,56554,113107
59043,,ynpfyfuka64j,56554,56555,113109
59044,,xkziiiup1t8j,56555,56556,113111
59045,,zzyrp5pgatij,56556,56557,113113
59046,,wdfyibyp_kqj,56557,56558,113115
59047,,c71qv3mqcryj,56558,56559,113117
59048,,4ga0ts2_rp0j,56559,56560,113119
59049,,2upmqqu6rkgj,56560,56561,113121
59050,,pnszkeetei8j,56561,56562,113123
59051,,4dubzt7gomwj,56562,56563,113125
59052,,lw2xnxrgsdqj,56563,56564,113127
59053,,ewlcjd4bg_ij,56564,56565,113129
59054,,qhca0miwmr8j,56565,56566,113131
59055,,gzevuvgqmsuj,56566,56567,113133
59056,,djl3orblztyj,56567,56568,113135
59057,,yzachbgknjij,56568,56569,113137
59058,,8ztb-wakhusj,56569,56570,113139
59059,,ouom2offr7qj,56570,56571,113141
59060,,t7etzwlo9guj,56571,56572,113143
59061,,s0v81rlsedgj,56572,56573,113145
59062,,yteqqzubxyoj,56573,56574,113147
59063,,,56574,56575,113149
59064,,woy-goyqsnuj,56575,56576,113151
59065,,9inffo1mf_mj,56576,56577,113153
59066,,agvfgwmcjkoj,56577,56578,113155
59067,,bo1rny4bu4kj,56579,56580,113159
59068,,ngf-hqwz9d4j,56580,56581,113161
59069,,suknm3a1l8oj,56581,56582,113163
59070,,rezyrbouxfaj,56582,56583,113165
59071,,1b8c0lfneq8j,56583,56584,113167
59072,,nnorksunghkj,56584,56585,113169
59073,,url:http://portal.acm.org/ft_gateway.cfm3fid3d109955626type3dpdf,56585,56586,113171
59074,,e4yea3iwjgyj,56586,56587,113173
59075,,jlzim-ahdw8j,56587,56588,113175
59076,,rjemzo8gmoij,56588,56589,113177
59077,,rmipfd2h6dyj,56589,56590,113179
59078,,8gupnsktq04j,56590,56591,113181
59079,,c8lobhpjb40j,56591,56592,113183
59080,,m8ihndv09lwj,56592,56593,113185
59081,,tesxg6ts4bgj,56593,56594,113187
59082,,w9zmesxc55uj,56594,56595,113189
59083,,uevw-fswasuj,56595,56596,113191
59084,,iykg07gxdsoj,56596,56597,113193
59085,,px-0r0xqxpkj,56597,56598,113195
59086,,qcifspxitvqj,56598,56599,113197
59087,,albw49vjioyj,56599,56600,113199
59088,,bccwunvt_cmj,56600,56601,113201
59089,,s2iv2a_0mb8j,56601,56602,113203
59090,,5ooqggg2ojcj,56602,56603,113205
59091,,nawnphqe4fej,56603,56604,113207
59092,,xso2mpefq6oj,56604,56605,113209
59093,,cbbmrjmyg_ij,56605,56606,113211
59094,,cp-nkkky8l0j,56606,56607,113213
59095,,njozem8mf2wj,56607,56608,113215
59096,,mb7vgw7edwcj,56608,56609,113217
59097,,bga5byopqwsj,56609,56610,113219
59098,,qnvaydurlc8j,56610,56611,113221
59099,,jearajd2q88j,56611,56612,113223
59100,,at_ai3kn3dej,56612,56613,113225
59101,,gq8o6ajsxruj,56613,56614,113227
59102,,0euwm3xqfsuj,56614,56615,113229
59103,,vee6-p20k8uj,56615,56616,113231
59104,,7monij572qyj,56616,56617,113233
59105,,7b_7eu56cfaj,56617,56618,113235
59106,,url:http://www.csa.com/partners/viewrecord.php3frequester3dgs26collection3dtrd26recid3d155941ws26recid3d199301530039md26recid3d199302p60018ai,56618,56619,113237
59107,,1bfr_zcofymj,56619,56620,113239
59108,,0rrllfmppl0j,56620,56621,113241
59109,,19zohtgeugoj,56621,56622,113243
59110,,w-lvctmuyyqj,56622,56623,113245
59111,,_0scdv2hrckj,56623,56624,113247
59112,,9f565nkmbouj,56624,56625,113249
59113,,t5wcmnkbsiuj,56625,56626,113251
59114,,5drfxrkwe2gj,56626,56627,113253
59115,,k7obf5y4ih8j,56627,56628,113255
59116,,x7w4rqxqf70j,56628,56629,113257
59117,,zofbcnw_vgwj,56629,56630,113259
59118,,g52mhz_2siuj,56630,56631,113261
59119,,az84jb1clo0j,56631,56632,113263
59120,,5tnj_7h6j5ej,56632,56633,113265
59121,,r2l4fg736suj,56633,56634,113267
59122,,9xmpgzma7swj,56634,56635,113269
59123,,mdgeygfyd54j,56635,56636,113271
59124,,tldmvxrtsrwj,56636,56637,113273
59125,,byan0lxlklgj,56637,56638,113275
59126,,xr50nxmrvfcj,56638,56639,113277
59127,,wlicqnlg39ej,56639,56640,113279
59128,,dxptsa4pkrij,56640,56641,113281
59129,,xcf3wrv7uaij,56641,56642,113283
59130,,hczpmlsh0dej,56642,56643,113285
59131,,zatwrc5xblqj,56643,56644,113287
59132,,g_fnkktfydkj,56644,56645,113289
59133,,kpqkrfydx9kj,56645,56646,113291
59134,,szcvumclszoj,56646,56647,113293
59135,,sky6hbuvpqgj,56647,56648,113295
59136,,75fspzw5fwyj,56648,56649,113297
59137,,sd8povgcv90j,56649,56650,113299
59138,,oeqqit6f2ocj,56651,56652,113303
59139,,wru1zwdmcuuj,56652,56653,113305
59140,,2l_7pbmmopuj,56653,56654,113307
59141,,oxptf7z00qgj,56654,56655,113309
59142,,zoj_3dtueoej,56655,56656,113311
59143,,_7gyrw1hjlyj,56656,56657,113313
59144,,jebd88u5xjqj,56657,56658,113315
59145,,ayvmqczjd4wj,56658,56659,113317
59146,,_6kagku-zxwj,56659,56660,113319
59147,,nxj_8y7lmhsj,56660,56661,113321
59148,,2czld-ig5xcj,56661,56662,113323
59149,,iylfcgficbgj,56662,56663,113325
59150,,pw17wgvkyggj,56663,56664,113327
59151,,fce0pzohaakj,56664,56665,113329
59152,,uwhhcjc_05cj,56665,56666,113331
59153,,qgcli1z_ywkj,56666,56667,113333
59154,,aiwdgaol_goj,56667,56668,113335
59155,,goyhhuj7musj,56668,56669,113337
59156,,cloep6da4scj,56669,56670,113339
59157,,cq72dmboqosj,56670,56671,113341
59158,,fa13kg2kaayj,56671,56672,113343
59159,,6oztsy0ce1ij,56672,56673,113345
59160,,cfujbhjoppaj,56673,56674,113347
59161,,s2ejbyqdlraj,56674,56675,113349
59162,,tmtjvb2zamej,56675,56676,113351
59163,,szdil6dttmgj,56676,56677,113353
59164,,2bbdv6hv8gsj,56677,56678,113355
59165,,url:http://adsabs.harvard.edu/abs/1976scom.nasa..843m,56678,56679,113357
59166,,,56679,56680,113359
59167,,llwcsdzckcqj,56680,56681,113361
59168,,1na_y_0hop8j,56681,56682,113363
59169,,ekolu9kqeecj,56682,56683,113365
59170,,url:http://portal.acm.org/citation.cfm3fid3d957013.957121,56683,56684,113367
59171,,byuwqw3-sgaj,56684,56685,113369
59172,,pzpzuuowej8j,56685,56686,113371
59173,,qdmqklrl8tcj,56686,56687,113373
59174,,k-iidwojtrwj,56687,56688,113375
59175,,nxgjusglqvcj,56688,56689,113377
59176,,,56689,56690,113379
59177,,fidrlbocfzwj,56690,56691,113381
59178,,lofibaxacg0j,56692,56693,113385
59179,,ufqm6gaam3sj,56693,56694,113387
59180,,-7ymrgwev6uj,56694,56695,113389
59181,,wqyfetaxmfkj,56695,56696,113391
59182,,tjxgo-yh5rcj,56696,56697,113393
59183,,08jltsm508gj,56697,56698,113395
59184,,gr3-l-wyiocj,56698,56699,113397
59185,,hlikv7lldwqj,56699,56700,113399
59186,,elfwgilf4j8j,56700,56701,113401
59187,,tff94ziv1tij,56701,56702,113403
59188,,ixgrlaafezwj,56702,56703,113405
59189,,vbisgaecsoyj,56704,56705,113409
59190,,ssf6wtbpndkj,56705,56706,113411
59191,,nxl6rktyesyj,56706,56707,113413
59192,,uvs5vawo31oj,56708,56709,113417
59193,,l5nuro6urf4j,56709,56710,113419
59194,,iwmsbvxsca0j,56710,56711,113421
59195,,zttlinhkvhej,56711,56712,113423
59196,,rwxzofmcmj4j,56712,56713,113425
59197,,lsqmmgau0paj,56713,56714,113427
59198,,em9ibtr_scsj,56714,56715,113429
59199,,mgzlcn1pposj,56715,56716,113431
59200,,0mukhgc3mguj,56716,56717,113433
59201,,ki53nvhof1ej,56717,56718,113435
59202,,c2qec5r4ni4j,56718,56719,113437
59203,,ffbo2hlgqxqj,56719,56720,113439
59204,,8y2y4eenklmj,56720,56721,113441
59205,,axhjqklpc8sj,56721,56722,113443
59206,,5_rsr3gdjbyj,56722,56723,113445
59207,,falh_uh2fqaj,56723,56724,113447
59208,,mixfm7sbch0j,56724,56725,113449
59209,,yrrbpwkvuhoj,56725,56726,113451
59210,,lkv3z6olgq8j,56726,56727,113453
59211,,vt2aoibs-xaj,56727,56728,113455
59212,,cvtks2wqyr8j,56728,56729,113457
59213,,vrbdi_bzq7gj,56729,56730,113459
59214,,p2uthquhoaij,56730,56731,113461
59215,,ljc7xs3hxxaj,56731,56732,113463
59216,,tgfxe-jvep0j,56732,56733,113465
59217,,glmjmsfdgxwj,56733,56734,113467
59218,,7x9f_hj_eugj,56734,56735,113469
59219,,i_ywe2vglvgj,56735,56736,113471
59220,,accxjnp5ytsj,56736,56737,113473
59221,,ipvndagydoij,56738,56739,113477
59222,,9w4flfczm_0j,56739,56740,113479
59223,,_l-pxdocfrsj,56740,56741,113481
59224,,,56741,56742,113483
59225,,xjfep9cbjeoj,56742,56743,113485
59226,,fh9z7-mwxh4j,56743,56744,113487
59227,,,56744,56745,113489
59228,,ew8pn6lisdij,56745,56746,113491
59229,,1w0rmel-znuj,56746,56747,113493
59230,,tk1jmpzzkbgj,56747,56748,113495
59231,,n63is4q7kmqj,56748,56749,113497
59232,,kvcxubyvnd0j,56749,56750,113499
59233,,dohrbhmx8eoj,56750,56751,113501
59234,,njd89gy0uv0j,56751,56752,113503
59235,,ewmnsz0dnjuj,56752,56753,113505
59236,,5jbsnrau1raj,56753,56754,113507
59237,,eotv5omflsgj,56754,56755,113509
59238,,cow6j112t3wj,56755,56756,113511
59239,,gq9oyh7q5esj,56756,56757,113513
59240,,lb8fd9npro4j,56757,56758,113515
59241,,kvxxp3vlkvqj,56758,56759,113517
59242,,jh3kekrodfqj,56759,56760,113519
59243,,aa42qg6f7rqj,56760,56761,113521
59244,,zy3uium5gccj,56761,56762,113523
59245,,plhye0gr-y8j,56762,56763,113525
59246,,wbefzqzqy1sj,56763,56764,113527
59247,,j2jpczxjsecj,56764,56765,113529
59248,,fumohzpjdhkj,56765,56766,113531
59249,,d_jpk4d9p_wj,56766,56767,113533
59250,,tqtgxgdyg0cj,56767,56768,113535
59251,,atno_t9jmbmj,56768,56769,113537
59252,,pvh4vhsxhaij,56769,56770,113539
59253,,dtkcxq2jbzij,56770,56771,113541
59254,,wfnwnnnp5tcj,56771,56772,113543
59255,,idyso7b2fbaj,56772,56773,113545
59256,,pfqde-x65c0j,56773,56774,113547
59257,,75rqlcpcbduj,56774,56775,113549
59258,,waprd8gfqvej,56775,56776,113551
59259,,shdietq-bfwj,56776,56777,113553
59260,,q6qela_hsqij,56777,56778,113555
59261,,5-ulwsysvpaj,56778,56779,113557
59262,,qyacixtdqe8j,56779,56780,113559
59263,,z2e20ddhn9gj,56780,56781,113561
59264,,do88wov_lzsj,56781,56782,113563
59265,,f9upje0yl10j,56782,56783,113565
59266,,uyofjaj5csej,56783,56784,113567
59267,,vdnun3d1bxsj,56784,56785,113569
59268,,gdc5gkhglokj,56785,56786,113571
59269,,371ictmcr-uj,56786,56787,113573
59270,,8y7audoi5cij,56787,56788,113575
59271,,1zzlqulbta4j,56789,56790,113579
59272,,kazafbum52ej,56790,56791,113581
59273,,2rrljpzx9doj,56791,56792,113583
59274,,tmnojaeirgsj,56792,56793,113585
59275,,xxf-rufhupaj,56793,56794,113587
59276,,b6dexsksvjmj,56794,56795,113589
59277,,epdrehytgxoj,56795,56796,113591
59278,,htkgrs3wrwyj,56796,56797,113593
59279,,9rjvgh00megj,56797,56798,113595
59280,,biu20hwlzygj,56798,56799,113597
59281,,7oeexznb2jsj,56799,56800,113599
59282,,,56800,56801,113601
59283,,az4kmenjt60j,56801,56802,113603
59284,,shzf3gqkkomj,56802,56803,113605
59285,,dxgmvco6xb0j,56803,56804,113607
59286,,t9v6n-cqevmj,56804,56805,113609
59287,,aowgojzxa28j,56805,56806,113611
59288,,8bujyrcglz8j,56807,56808,113615
59289,,cy6k0esasqqj,56808,56809,113617
59290,,ol3lxb8sg7cj,56809,56810,113619
59291,,url:http://adsabs.harvard.edu/abs/1976scom.nasa..121k,56810,56811,113621
59292,,kdwgwva8dykj,56811,56812,113623
59293,,g8pzgdvh83qj,56812,56813,113625
59294,,uuemt7zo9dwj,56813,56814,113627
59295,,ygaixm0d6wgj,56814,56815,113629
59296,,kyl147pbruej,56815,56816,113631
59297,,xqj7jk8iuj8j,56816,56817,113633
59298,,zbrhzqc4gkqj,56817,56818,113635
59299,,w9qkrzrrlsmj,56818,56819,113637
59300,,j4ew4i_ajgij,56819,56820,113639
59301,,qdeoczssiimj,56820,56821,113641
59302,,n0kd412uxlij,56821,56822,113643
59303,,f4vf6phf0jqj,56822,56823,113645
59304,,url:http://www.csa.com/partners/viewrecord.php3frequester3dgs26collection3dtrd26recid3d017405530113ai,56823,56824,113647
59305,,cvtvxmmgd4aj,56824,56825,113649
59306,,epp6i4h7xxej,56825,56826,113651
59307,,imfrmh__bfij,56826,56827,113653
59308,,uegsugmqrq0j,56827,56828,113655
59309,,gwanlo7bbqyj,56828,56829,113657
59310,,_pvsfc9zjymj,56829,56830,113659
59311,,odoqj40rxqsj,56830,56831,113661
59312,,tbuhdqgyueqj,56831,56832,113663
59313,,ybbntsmehm4j,56832,56833,113665
59314,,68o2bcxvl1oj,56834,56835,113669
59315,,hrx56k1wh7ej,56835,56836,113671
59316,,njcmmrsntuqj,56836,56837,113673
59317,,dqlw3j9lce0j,56837,56838,113675
59318,,tcfo65yrd9uj,56838,56839,113677
59319,,ouxbrmvqv6sj,56839,56840,113679
59320,,2os3ao6zh8oj,56840,56841,113681
59321,,url:http://www.csa.com/partners/viewrecord.php3frequester3dgs26collection3dtrd26recid3d2470457ci,56841,56842,113683
59322,,3zgzan9eo9sj,56842,56843,113685
59323,,odnmpm5xaocj,56843,56844,113687
59324,,r5wowvaakwij,56844,56845,113689
59325,,hsjdkjq4yhsj,56845,56846,113691
59326,,z9gvku_5ybqj,56846,56847,113693
59327,,vp1ipm2b9pyj,56847,56848,113695
59328,,csruity1itgj,56848,56849,113697
59329,,xcp94opt5omj,56849,56850,113699
59330,,e4ylmuhlb6aj,56850,56851,113701
59331,,u8hq5ks1a0aj,56851,56852,113703
59332,,hvp76jfwnkyj,56852,56853,113705
59333,,w3h7tg7s37kj,56853,56854,113707
59334,,jeipcd9qqp4j,56854,56855,113709
59335,,btzqid3fgtij,56855,56856,113711
59336,,dq123st4vmsj,56856,56857,113713
59337,,s9tijnkq6hyj,56858,56859,113717
59338,,nezrjcqjzyuj,56859,56860,113719
59339,,4ertabmpzckj,56860,56861,113721
59340,,vsqljem1kq4j,56861,56862,113723
59341,,rryjmfdgraej,56862,56863,113725
59342,,bq7obgf_cbaj,56863,56864,113727
59343,,dmfdqexjjskj,56864,56865,113729
59344,,xblmcy8erwoj,56865,56866,113731
59345,,sphacvrxv-wj,56866,56867,113733
59346,,us-v_n8yu7mj,56867,56868,113735
59347,,xxwacnrtbtgj,56868,56869,113737
59348,,w5cmxwsjraqj,56869,56870,113739
59349,,gaukqjhbqqsj,56870,56871,113741
59350,,url:http://www.csa.com/partners/viewrecord.php3frequester3dgs26collection3denv26recid3d8603847,56871,56872,113743
59351,,hvi_joppseqj,56872,56873,113745
59352,,zdx2tgtgrvij,56874,56875,113749
59353,,aq1djseyx8uj,56875,56876,113751
59354,,spbop5wxlk0j,56876,56877,113753
59355,,bru9ujhn4z4j,56877,56878,113755
59356,,bttp4ryw9raj,56878,56879,113757
59357,,3_dqsk3r0foj,56879,56880,113759
59358,,-15jpxlqpm0j,56880,56881,113761
59359,,ho8ojgp-4oqj,56881,56882,113763
59360,,0-jsw5bb83kj,56882,56883,113765
59361,,pi5jswhyoycj,56883,56884,113767
59362,,ka8zyrj4_ggj,56884,56885,113769
59363,,bfq2rgx3jhoj,56885,56886,113771
59364,,3kkdaxmc5lwj,56886,56887,113773
59365,,qx3qkevnr0oj,56887,56888,113775
59366,,nfv8uq1g7vij,56888,56889,113777
59367,,b8prh9zqe7gj,56890,56891,113781
59368,,_a4z048cxkgj,56891,56892,113783
59369,,zt3ziftchdij,56892,56893,113785
59370,,rxbsnz-aw20j,56893,56894,113787
59371,,rjzylivn5f0j,56894,56895,113789
59372,,83kjvw0qg_uj,56895,56896,113791
59373,,th4ah4pqv6mj,56896,56897,113793
59374,,b6sa0rioowmj,56897,56898,113795
59375,,ivrb6cqwdqsj,56898,56899,113797
59376,,1orthf9mg2cj,56899,56900,113799
59377,,iwedhkpqjowj,56900,56901,113801
59378,,l3-o1mqiaw0j,56901,56902,113803
59379,,pacpnuzsprkj,56902,56903,113805
59380,,im6pncxchscj,56903,56904,113807
59381,,ccbj_cre4i8j,56904,56905,113809
59382,,_rywkb28b6oj,56905,56906,113811
59383,,xpyvudm1rjej,56906,56907,113813
59384,,bwgwh0ymkhgj,56907,56908,113815
59385,,mzf07ix2vwkj,56908,56909,113817
59386,,rxyiki2-w1wj,56909,56910,113819
59387,,caclh4tmgfgj,56910,56911,113821
59388,,kj8ihw_bkigj,56911,56912,113823
59389,,mfyzxuyv_bwj,56912,56913,113825
59390,,ap3xqbq4vjwj,56913,56914,113827
59391,,xf5g6jxc9dwj,56914,56915,113829
59392,,q60wl6mlhxkj,56915,56916,113831
59393,,qudlpibhtbaj,56916,56917,113833
59394,,cixz2jzco_yj,56917,56918,113835
59395,,iirkthjylcsj,56918,56919,113837
59396,,uxos8tgbdhej,56919,56920,113839
59397,,nmt5jg_iuvaj,56920,56921,113841
59398,,ovsyr37zzxkj,56921,56922,113843
59399,,nddhv4m2lb8j,56922,56923,113845
59400,,q79rdmicitij,56923,56924,113847
59401,,q72t2lrakw4j,56924,56925,113849
59402,,gbfjcncgaxmj,56925,56926,113851
59403,,githlwfrwnqj,56926,56927,113853
59404,,url:http://www.csa.com/partners/viewrecord.php3frequester3dgs26collection3dtrd26recid3d8204540535md,56927,56928,113855
59405,,nmnwkefxgkwj,56928,56929,113857
59406,,jhro0y4h-zij,56929,56930,113859
59407,,_mtlpuhh2wsj,56930,56931,113861
59408,,m2ar2zckhcsj,56931,56932,113863
59409,,0a2exdiny0qj,56932,56933,113865
59410,,uckrbjjilfij,56933,56934,113867
59411,,qaxozngmbcgj,56934,56935,113869
59412,,szlbqkriysqj,56935,56936,113871
59413,,rddupzx9frwj,56936,56937,113873
59414,,vqzppsblvicj,56937,56938,113875
59415,,,56939,56940,113879
59416,,iuggx1ka2moj,56940,56941,113881
59417,,zxbyqffq_6wj,56941,56942,113883
59418,,url:http://portal.acm.org/ft_gateway.cfm3fid3d98306826type3dpdf26dl3dportal26dl3dacm26cfid3d1111111126cftoken3d2222222,56942,56943,113885
59419,,ceklbti9zhgj,56943,56944,113887
59420,,vwk0ebbgjm8j,56944,56945,113889
59421,,ox-3ial8olej,56945,56946,113891
59422,,fvuxgqztob8j,56946,56947,113893
59423,,s05pveo2qwuj,56947,56948,113895
59424,,yj5mkcyclpkj,56948,56949,113897
59425,,qxffamsklhmj,56949,56950,113899
59426,,7ncz0ne_ussj,56950,56951,113901
59427,,vtu-jtjbn70j,56951,56952,113903
59428,,e-qcwifmknkj,56952,56953,113905
59429,,2okiz_x8o_ej,56953,56954,113907
59430,,2bao_dzfcuqj,56954,56955,113909
59431,,a-uoxe6bobcj,56955,56956,113911
59432,,jijdom-zmmcj,56956,56957,113913
59433,,w9izqrzaa74j,56957,56958,113915
59434,,_a7qxm7xz28j,56958,56959,113917
59435,,matuyhwqiyaj,56959,56960,113919
59436,,hbedqbpnjlej,56960,56961,113921
59437,,uhyfpgi8cp4j,56961,56962,113923
59438,,sm0dunanztmj,56962,56963,113925
59439,,rtnqqki6_vaj,56963,56964,113927
59440,,wtjx5zluxc8j,56964,56965,113929
59441,,eynvf0fspjkj,56965,56966,113931
59442,,asi4h7ciyeyj,56966,56967,113933
59443,,yuhm__xgenqj,56967,56968,113935
59444,,uveckymn5bkj,56968,56969,113937
59445,,cb8b1orbze0j,56969,56970,113939
59446,,tka-bfkuhx4j,56970,56971,113941
59447,,t7s8ax3-9f0j,56971,56972,113943
59448,,,56972,56973,113945
59449,,qfxkb5elv0gj,56973,56974,113947
59450,,_wdzgpdohwoj,56974,56975,113949
59451,,0mvtswtcjr0j,56975,56976,113951
59452,,ymub0ainrmwj,56976,56977,113953
59453,,94typ9psptaj,56977,56978,113955
59454,,nbwqoe3mlb4j,56978,56979,113957
59455,,wpzo5jjmeacj,56979,56980,113959
59456,,5cqmbtrtyduj,56980,56981,113961
59457,,bjr7fi6mv9wj,56982,56983,113965
59458,,xyghvga3ciaj,56983,56984,113967
59459,,fxk0nh50rwij,56984,56985,113969
59460,,url:http://portal.acm.org/ft_gateway.cfm3fid3d110131526type3dpdf,56985,56986,113971
59461,,cmobpt8avayj,56986,56987,113973
59462,,knzowibgpqij,56987,56988,113975
59463,,xgykx_cvdjwj,56988,56989,113977
59464,,bdryjmyz4b4j,56989,56990,113979
59465,,wdubykoj-emj,56990,56991,113981
59466,,pncbmycrzyuj,56991,56992,113983
59467,,novedbndwc0j,56992,56993,113985
59468,,wrvo_uy4kvwj,56993,56994,113987
59469,,s0v_n9_44awj,56994,56995,113989
59470,,ky9pftlkgtej,56995,56996,113991
59471,,28jpfc5tacaj,56996,56997,113993
59472,,bibmn8zfnksj,56997,56998,113995
59473,,url:http://www.csa.com/partners/viewrecord.php3frequester3dgs26collection3dtrd26recid3dn9210387ah,56998,56999,113997
59474,,rahw2orbeuij,56999,57000,113999
59475,,td9wa7rkbnsj,57000,57001,114001
59476,,0lm5yfrujqej,57001,57002,114003
59477,,yblybgcbdcmj,57002,57003,114005
59478,,vwyqywunxdaj,57003,57004,114007
59479,,zcbctj5p-zsj,57004,57005,114009
59480,,orvdcotjhsej,57005,57006,114011
59481,,url:http://adsabs.harvard.edu/abs/1976infph..16..253m,57006,57007,114013
59482,,url:http://portal.acm.org/citation.cfm3fid3d215292,57007,57008,114015
59483,,zc8kqtt0jtoj,57008,57009,114017
59484,,v9znsd8_pioj,57009,57010,114019
59485,,jp1khvyt7r0j,57010,57011,114021
59486,,bev8v7z5ry8j,57011,57012,114023
59487,,usvx7x-hvgij,57012,57013,114025
59488,,wg8o4cj8cq4j,57013,57014,114027
59489,,owforkdvxtej,57014,57015,114029
59490,,0q28tmoal-ij,57015,57016,114031
59491,,0n_gmx_chwyj,57016,57017,114033
59492,,w-dy1py85g0j,57017,57018,114035
59493,,rg1d_8nultaj,57018,57019,114037
59494,,vdp9h-x1kzaj,57019,57020,114039
59495,,_issxf_apwuj,57020,57021,114041
59496,,url:http://portal.acm.org/citation.cfm3fid3d983028.98303626coll3dguide26dl3dacm26idx3dj68926part3dperiodical26wanttype3dperiodical26title3dacm2520sigmod2520record26cfid3d1111111126cftoken3d2222222,57021,57022,114043
59497,,bd2gxevvwxgj,57022,57023,114045
59498,,psnrgfhv3msj,57023,57024,114047
59499,,vznwmyg2zh8j,57024,57025,114049
59500,,al91zuxdmluj,57025,57026,114051
59501,,wef3q_u7brsj,57026,57027,114053
59502,,u172f-oayhqj,57027,57028,114055
59503,,dgn2p00zs4wj,57028,57029,114057
59504,,url:http://pubs.acs.org/cgi-bin/abstract.cgi/achre4/2005/38/i12/abs/ar040242u.html,57029,57030,114059
59505,,6gxrrexyuxej,57030,57031,114061
59506,,1mpsn1mk7zqj,57031,57032,114063
59507,,iohxyectf-ej,57032,57033,114065
59508,,pawu8z5nybkj,57033,57034,114067
59509,,fkx65xbyzegj,57034,57035,114069
59510,,2i0ed-wx8c8j,57035,57036,114071
59511,,enikps3o3iqj,57036,57037,114073
59512,,kpe11txvmfij,57037,57038,114075
59513,,_vfyzouurmij,57038,57039,114077
59514,,cc_arh5yr0kj,57039,57040,114079
59515,,hbf-by_do9wj,57040,57041,114081
59516,,abluuo9ikauj,57041,57042,114083
59517,,url:http://portal.acm.org/ft_gateway.cfm3fid3d108364226type3dpdf,57042,57043,114085
59518,,aqu5n6do4kcj,57043,57044,114087
59519,,btx3htuorr0j,57044,57045,114089
59520,,url:http://portal.acm.org/citation.cfm3fid3d95813.95821,57045,57046,114091
59521,,04lwckatvmcj,57046,57047,114093
59522,,ekmjugy6j10j,57047,57048,114095
59523,,pgqfk4dlxgsj,57048,57049,114097
59524,,rtnp2gc9zsgj,57049,57050,114099
59525,,gb1fkkqcmrij,57050,57051,114101
59526,,wlkxiwtlv-wj,57051,57052,114103
59527,,phbviehmhqej,57052,57053,114105
59528,,h787vpn0gl0j,57053,57054,114107
59529,,yyz5aiujg_ej,57054,57055,114109
59530,,6vzggvahbayj,57055,57056,114111
59531,,gbpha2ulqz0j,57056,57057,114113
59532,,pmhb3zuv9iwj,57057,57058,114115
59533,,7excacf56cij,57058,57059,114117
59534,,ixyjdgiae48j,57059,57060,114119
59535,,cqaugylfbpoj,57060,57061,114121
59536,,qk6h-h8opfqj,57061,57062,114123
59537,,cfmujyunukcj,57062,57063,114125
59538,,wl01w-v-jzij,57063,57064,114127
59539,,ggaoksqgpzqj,57064,57065,114129
59540,,hq2irlftfguj,57065,57066,114131
59541,,iqsoa75yypkj,57066,57067,114133
59542,,j5nx2rp2yhmj,57067,57068,114135
59543,,twofse9ds60j,57068,57069,114137
59544,,r381dsjpl20j,57069,57070,114139
59545,,zvnljbbb1g4j,57070,57071,114141
59546,,url:http://portal.acm.org/ft_gateway.cfm3fid3d110191826type3dpdf,57072,57073,114145
59547,,qbdluhdgv1qj,57073,57074,114147
59548,,qmouhtkf5ykj,57074,57075,114149
59549,,yyo8k-dsyfqj,57075,57076,114151
59550,,url:http://www.csa.com/partners/viewrecord.php3frequester3dgs26collection3dtrd26recid3dn9210378ah,57076,57077,114153
59551,,tagqk4x7je0j,57077,57078,114155
59552,,ldvd5avoihqj,57078,57079,114157
59553,,yzeh6v4ssbgj,57079,57080,114159
59554,,wtxszbjftxoj,57080,57081,114161
59555,,mk5fv99rdbkj,57081,57082,114163
59556,,url:http://portal.acm.org/ft_gateway.cfm3fid3d95705426type3dpdf26dl3dguide26dl3dacm26cfid3d1111111126cftoken3d2222222,57082,57083,114165
59557,,_d9mm3ft9wwj,57083,57084,114167
59558,,md1nw-ia3myj,57084,57085,114169
59559,,ij0gqqvxlvqj,57085,57086,114171
59560,,iey-fprfej8j,57086,57087,114173
59561,,cpodcxpjl1wj,57087,57088,114175
59562,,0o4pen2kqncj,57088,57089,114177
59563,,ybgxhucas_8j,57089,57090,114179
59564,,zm1srf2wygmj,57090,57091,114181
59565,,o3zb-nvdp-4j,57091,57092,114183
59566,,bixddgc3i5qj,57092,57093,114185
59567,,wvqrgallw24j,57093,57094,114187
59568,,nkgpwpk9nzgj,57094,57095,114189
59569,,fqbxmi2lgnoj,57095,57096,114191
59570,,1_yrnxy2-y8j,57096,57097,114193
59571,,qjhcme9r9yej,57097,57098,114195
59572,,eh2fzl_1nsyj,57098,57099,114197
59573,,ccqewe-buqwj,57099,57100,114199
59574,,29zjgqsazcaj,57100,57101,114201
59575,,faxbn3fsldwj,57101,57102,114203
59576,,d6ritxshvkqj,57102,57103,114205
59577,,rv_oj_smf50j,57103,57104,114207
59578,,efgq6q_idi0j,57104,57105,114209
59579,,nx7mbbemhjgj,57105,57106,114211
59580,,,57106,57107,114213
59581,,zehuqirbdusj,57107,57108,114215
59582,,bul7td3xnbej,57108,57109,114217
59583,,ry3ivqsh0ouj,57109,57110,114219
59584,,fx6kdlba8q8j,57110,57111,114221
59585,,372xslecrumj,57111,57112,114223
59586,,ah8wqfysbhuj,57112,57113,114225
59587,,uc-bruy2p6yj,57113,57114,114227
59588,,w-ckstcpgfwj,57114,57115,114229
59589,,g9i7k0vguy4j,57115,57116,114231
59590,,x3gpk-e8om4j,57116,57117,114233
59591,,lfg4mzr-q80j,57117,57118,114235
59592,,,57118,57119,114237
59593,,dfqzd36vhhgj,57119,57120,114239
59594,,url:http://www.educause.edu/ir/library/pdf/ers0302/rs/ers030212.pdf,57120,57121,114241
59595,,0xod2oqpzqqj,57121,57122,114243
59596,,_j2galc3m4aj,57122,57123,114245
59597,,a8bvytve8gmj,57124,57125,114249
59598,,url:http://www.springerlink.com/index/w1u93k1472p7r382.pdf,57125,57126,114251
59599,,o0vtbljqshmj,57126,57127,114253
59600,,0tu-trzknvyj,57127,57128,114255
59601,,ofqsrdo-qg0j,57128,57129,114257
59602,,,57129,57130,114259
59603,,y8udbaphypuj,57130,57131,114261
59604,,scivyeb6xauj,57131,57132,114263
59605,,lypqudaezrij,57132,57133,114265
59606,,ttihwo6-g0mj,57133,57134,114267
59607,,io7zis2bkqoj,57134,57135,114269
59608,,ov-sjueact4j,57135,57136,114271
59609,,avfpbee84psj,57136,57137,114273
59610,,eoqmn52z00mj,57137,57138,114275
59611,,4ru5k1bnovmj,57138,57139,114277
59612,,lm25su-wny0j,57139,57140,114279
59613,,x6mjpfaez2gj,57140,57141,114281
59614,,url:http://portal.acm.org/citation.cfm3fid3dseries9729.265703,57142,57143,114285
59615,,elw4hkx4hk0j,57143,57144,114287
59616,,edbapidffsuj,57144,57145,114289
59617,,zukzfmgooe0j,57145,57146,114291
59618,,t2sdd9ipwnmj,57146,57147,114293
59619,,9_nlrn5vdygj,57147,57148,114295
59620,,qyx_wr5l4wwj,57148,57149,114297
59621,,tcoostrkqjqj,57149,57150,114299
59622,,riebmzvobucj,57150,57151,114301
59623,,g4h0wlusxaij,57151,57152,114303
59624,,cia-q5vwcf8j,57152,57153,114305
59625,,j32m-j_yyumj,57153,57154,114307
59626,,9vikpd7thiij,57154,57155,114309
59627,,d0evu0ezm-uj,57155,57156,114311
59628,,4j5ryw5xa7yj,57156,57157,114313
59629,,pgz0p5m7_uoj,57157,57158,114315
59630,,ykbwx7cemmmj,57158,57159,114317
59631,,muesgn_tim0j,57159,57160,114319
59632,,url:http://www.ingentaconnect.com/content/els/09505849/2001/00000043/00000004/art00171,57160,57161,114321
59633,,hfbui3nhl7uj,57161,57162,114323
59634,,z3qiqb4n_a4j,57162,57163,114325
59635,,ihuxh52-zjej,57163,57164,114327
59636,,url:http://portal.acm.org/citation.cfm3fid3d192593.197419,57164,57165,114329
59637,,nclvthrffiyj,57165,57166,114331
59638,,yegt779m_j8j,57166,57167,114333
59639,,zdkdqxkak30j,57168,57169,114337
59640,,wxn_s_ytveqj,57169,57170,114339
59641,,fbqz7ox27ekj,57170,57171,114341
59642,,l81ehgbwheej,57171,57172,114343
59643,,fnfg8xszwjsj,57172,57173,114345
59644,,4dfpz6bhet0j,57173,57174,114347
59645,,ucp82hdyni8j,57174,57175,114349
59646,,xaauwtoxpaqj,57175,57176,114351
59647,,8a0oboo0u4kj,57176,57177,114353
59648,,8uiyqd9qysuj,57177,57178,114355
59649,,kdefxv7xzkgj,57178,57179,114357
59650,,brmuonybovmj,57179,57180,114359
59651,,0prxie-fqhqj,57180,57181,114361
59652,,zwxlxkox-yej,57181,57182,114363
59653,,url:http://portal.acm.org/citation.cfm3fid3d1031570.1031590,57182,57183,114365
59654,,bx2ozark7pij,57183,57184,114367
59655,,b-ah5i7zszoj,57184,57185,114369
59656,,hcm3_wlk-68j,57185,57186,114371
59657,,0ykvgaln_98j,57186,57187,114373
59658,,27e0sldz4hij,57187,57188,114375
59659,,pxsmzgffvogj,57188,57189,114377
59660,,0ciqhlfp1imj,57189,57190,114379
59661,,3fmrztgamcoj,57190,57191,114381
59662,,pbjdn_r6aa4j,57191,57192,114383
59663,,_yatyvae7l0j,57192,57193,114385
59664,,pobdeq9zvcwj,57193,57194,114387
59665,,76asf6yptr8j,57194,57195,114389
59666,,qhv2enshaz8j,57195,57196,114391
59667,,cwzb_pqe8x0j,57196,57197,114393
59668,,td63xjmtur8j,57197,57198,114395
59669,,at6a8lbmfjgj,57198,57199,114397
59670,,traz_sfh9f4j,57199,57200,114399
59671,,dybadgdd2fej,57200,57201,114401
59672,,neheeg4r-ycj,57201,57202,114403
59673,,brybwzfys7oj,57202,57203,114405
59674,,x87w9rjybwoj,57203,57204,114407
59675,,url:http://www.csa.com/partners/viewrecord.php3frequester3dgs26collection3dtrd26recid3d443609ci,57204,57205,114409
59676,,h24espfv8moj,57205,57206,114411
59677,,zaqt2mr3opij,57206,57207,114413
59678,,wmwvfe45a9aj,57207,57208,114415
59679,,x09sfxr5xu8j,57208,57209,114417
59680,,_ozpdvpauo4j,57210,57211,114421
59681,,1lfevsxn4vsj,57211,57212,114423
59682,,o2uoayvvva8j,57213,57214,114427
59683,,dapf3jrfaykj,57214,57215,114429
59684,,pyspyu4uasgj,57215,57216,114431
59685,,uaxquot8jbgj,57216,57217,114433
59686,,smq1qyc7viuj,57217,57218,114435
59687,,url:http://portal.acm.org/ft_gateway.cfm3fid3d109958926type3dpdf,57218,57219,114437
59688,,6vqwguzheckj,57219,57220,114439
59689,,fbuetcjkpbgj,57220,57221,114441
59690,,mbnbou25lq0j,57221,57222,114443
59691,,zxa-vpm-pwaj,57222,57223,114445
59692,,a3gm0trgbwij,57223,57224,114447
59693,,rhz6y7q62-oj,57224,57225,114449
59694,,vax1f7qpnfsj,57225,57226,114451
59695,,yurahucucwmj,57226,57227,114453
59696,,5lkvsiw8ummj,57227,57228,114455
59697,,url:http://www.springerlink.com/index/w070u4vg8m618770.pdf,57228,57229,114457
59698,,url:http://doi.wiley.com/10.1002/anie.198005531,57229,57230,114459
59699,,vz3hhqz9hhoj,57230,57231,114461
59700,,zgtkptluiuaj,57231,57232,114463
59701,,yzzu__-5w3cj,57232,57233,114465
59702,,phiujzhpno0j,57233,57234,114467
59703,,vubqb5-mhzkj,57234,57235,114469
59704,,eu7yjq6s36kj,57235,57236,114471
59705,,bzm03w4fb_qj,57236,57237,114473
59706,,,57237,57238,114475
59707,,8m_6omuvyjwj,57238,57239,114477
59708,,tm22zy9kr8cj,57239,57240,114479
59709,,wggz49n3pfwj,57240,57241,114481
59710,,sasficipx2yj,57241,57242,114483
59711,,p22kqv7u_ayj,57242,57243,114485
59712,,ujd39pot2cwj,57243,57244,114487
59713,,y9slrocw3dsj,57244,57245,114489
59714,,enb3jcrhoi8j,57246,57247,114493
59715,,g5byy_lnbkyj,57247,57248,114495
59716,,dg0-a2fsyvyj,57248,57249,114497
59717,,tiodpyl-txkj,57249,57250,114499
59718,,_flm5avylxgj,57250,57251,114501
59719,,p9ikjum8kf8j,57251,57252,114503
59720,,ejq9kbpymboj,57252,57253,114505
59721,,gcpgq6cbwp0j,57253,57254,114507
59722,,hpxcybziz9mj,57254,57255,114509
59723,,x0z6x0tarn0j,57255,57256,114511
59724,,fol7ba4x6oij,57256,57257,114513
59725,,zonw-w8gj3oj,57257,57258,114515
59726,,q5iyvzk8ce0j,57258,57259,114517
59727,,s9xkkk8rnewj,57259,57260,114519
59728,,url:http://www.springerlink.com/index/r2r68v28h8605842.pdf,57260,57261,114521
59729,,ddlyivs_8kgj,57261,57262,114523
59730,,iovanzn2on8j,57262,57263,114525
59731,,,57263,57264,114527
59732,,mfkavhris0oj,57264,57265,114529
59733,,fx7i0f39jjgj,57265,57266,114531
59734,,5ne7g6xtyvkj,57266,57267,114533
59735,,smz73dtz7iqj,57267,57268,114535
59736,,url:http://doi.ieeecomputersociety.org/10.1109/tkde.2004.62,57268,57269,114537
59737,,appznj0qu2mj,57269,57270,114539
59738,,ecxegytd3q4j,57270,57271,114541
59739,,e6pxwewjxc4j,57271,57272,114543
59740,,z8btx8nxsz8j,57272,57273,114545
59741,,qaghyj8xyx4j,57273,57274,114547
59742,,2lypqegzfb8j,57274,57275,114549
59743,,lo9th1ozjxgj,57275,57276,114551
59744,,ha28uxi1mgoj,57276,57277,114553
59745,,c9ih3lrrlgyj,57277,57278,114555
59746,,gvekgc3yzoaj,57278,57279,114557
59747,,hlqmreti7sqj,57279,57280,114559
59748,,ecv6e2ajlp4j,57280,57281,114561
59749,,k6752bgag2qj,57281,57282,114563
59750,,url:http://portal.acm.org/citation.cfm3fid3d1099554.1099700,57282,57283,114565
59751,,700z2gzux30j,57283,57284,114567
59752,,xrexarbvoj0j,57284,57285,114569
59753,,g6andukkljij,57285,57286,114571
59754,,sqtf36jz64mj,57286,57287,114573
59755,,ckw2ucbcwxej,57287,57288,114575
59756,,url:http://portal.acm.org/citation.cfm3fid3d234286.1057837,57288,57289,114577
59757,,url:http://portal.acm.org/citation.cfm3fid3d171926,57289,57290,114579
59758,,pvn7remy0j8j,57290,57291,114581
59759,,tolahotgkamj,57291,57292,114583
59760,,bu7icehbxtwj,57292,57293,114585
59761,,blcxuxncfhkj,57293,57294,114587
59762,,1equnad8h4kj,57294,57295,114589
59763,,r9x6tuqzi7aj,57295,57296,114591
59764,,qmizzsxk7agj,57296,57297,114593
59765,,url:http://portal.acm.org/ft_gateway.cfm3fid3d106519626type3dpdf,57297,57298,114595
59766,,rjqicyuri7uj,57298,57299,114597
59767,,v8ngnueo45qj,57299,57300,114599
59768,,l7v3pn1xtykj,57300,57301,114601
59769,,url:http://www.springerlink.com/index/k40u436312636521.pdf,57301,57302,114603
59770,,4lpv1ixejxej,57302,57303,114605
59771,,ojf1k5ngbeqj,57303,57304,114607
59772,,6iddn8gga38j,57304,57305,114609
59773,,uqduvxojjcuj,57305,57306,114611
59774,,y6-wxu69nkwj,57306,57307,114613
59775,,ep8u32kwme4j,57307,57308,114615
59776,,ifll_yfvcqsj,57308,57309,114617
59777,,99nkpf7a4uij,57309,57310,114619
59778,,oofkkpxt_fcj,57310,57311,114621
59779,,jvk7cqjmjwuj,57311,57312,114623
59780,,4lplbflniqgj,57312,57313,114625
59781,,evihz8cqx30j,57313,57314,114627
59782,,k0ax6fxcmnmj,57314,57315,114629
59783,,b0t1syrlr1oj,57315,57316,114631
59784,,piivlmz1rj4j,57316,57317,114633
59785,,gbj8yaxgjvqj,57317,57318,114635
59786,,6f2uhbg25sqj,57318,57319,114637
59787,,yvlwrvqq3owj,57319,57320,114639
59788,,u6vxnmifndoj,57320,57321,114641
59789,,ule9idz5u4cj,57321,57322,114643
59790,,url:http://portal.acm.org/citation.cfm3fid3d21971326dl3dguide26dl3dacm26type3dissue26idx3dj68926part3dperiodical26wanttype3dperiodical26title3dacm2520sigmod2520record26cfid3d1111111126cftoken3d2222222,57322,57323,114645
59791,,i3hsexvjxiuj,57323,57324,114647
59792,,7eu0izf_opwj,57324,57325,114649
59793,,plgjze8w9naj,57325,57326,114651
59794,,x8c-mtys0uwj,57326,57327,114653
59795,,_csil_4gqiqj,57327,57328,114655
59796,,ftagbc8xojkj,57328,57329,114657
59797,,qmyd-bssjeej,57329,57330,114659
59798,,s43ekfqp0eej,57330,57331,114661
59799,,wnmgtsi0tdyj,57331,57332,114663
59800,,lgcjrwebpdkj,57332,57333,114665
59801,,k_nxosz6a1yj,57333,57334,114667
59802,,o5ywkbhyeegj,57334,57335,114669
59803,,2pzj2jnrzhkj,57335,57336,114671
59804,,v69uqed8qiij,57336,57337,114673
59805,,yjeuk3qvvd0j,57338,57339,114677
59806,,2c4wknq6veaj,57339,57340,114679
59807,,giki8sgtvukj,57340,57341,114681
59808,,de7l7ktgjqwj,57341,57342,114683
59809,,21delkyqjrcj,57342,57343,114685
59810,,mj49elewaeij,57343,57344,114687
59811,,0mctzujcobwj,57345,57346,114691
59812,,url:http://www.emeraldinsight.com/insight/html/output/published/emeraldfulltextarticle/pdf/0010420908.pdf,57346,57347,114693
59813,,n7pgfej7az4j,57347,57348,114695
59814,,5a1y-kcyp6wj,57348,57349,114697
59815,,zzxeheukbcqj,57349,57350,114699
59816,,fciqfsfkdw0j,57350,57351,114701
59817,,du7h5psijqej,57351,57352,114703
59818,,ocgjvmffr9kj,57352,57353,114705
59819,,qrdmnxpjvcij,57353,57354,114707
59820,,,57354,57355,114709
59821,,wtibomrhsrkj,57355,57356,114711
59822,,inrtkhamzomj,57356,57357,114713
59823,,onf19huhjmmj,57357,57358,114715
59824,,z8wodibqml4j,57358,57359,114717
59825,,v4c6wp0-d00j,57359,57360,114719
59826,,bgi4uxc41pcj,57360,57361,114721
59827,,23cnr1ehpgwj,57361,57362,114723
59828,,url:http://adsabs.harvard.edu/abs/1976infph..16...51d,57362,57363,114725
59829,,22v3hif95ewj,57363,57364,114727
59830,,jp1div1w0emj,57364,57365,114729
59831,,,57365,57366,114731
59832,,tceq4babyp4j,57366,57367,114733
59833,,el4r0de6sokj,57367,57368,114735
59834,,7ugpaehos0yj,57368,57369,114737
59835,,url:http://www.csa.com/partners/viewrecord.php3frequester3dgs26collection3dtrd26recid3d0879379ci,57369,57370,114739
59836,,tbsrofrwz70j,57370,57371,114741
59837,,amjhvphaodij,57371,57372,114743
59838,,kdjhaevhj-yj,57372,57373,114745
59839,,zap3ip1xfsmj,57373,57374,114747
59840,,rn4rd7qwyk4j,57374,57375,114749
59841,,2znatgvou4yj,57375,57376,114751
59842,,9oauy9d6gtij,57376,57377,114753
59843,,ns2i1qzuik0j,57377,57378,114755
59844,,ti73ro1kmhoj,57379,57380,114759
59845,,pwg8sc123naj,57380,57381,114761
59846,,mebdfc6o5xqj,57381,57382,114763
59847,,4qupwyuxhi8j,57382,57383,114765
59848,,3onbmdm-yioj,57383,57384,114767
59849,,noxsxzem5zkj,57384,57385,114769
59850,,aoop5p4spbij,57385,57386,114771
59851,,1i4jshecam8j,57386,57387,114773
59852,,yrv4diq3yakj,57387,57388,114775
59853,,shulbmqp8vcj,57388,57389,114777
59854,,lifyxaqtr2kj,57389,57390,114779
59855,,ielmozyahdaj,57390,57391,114781
59856,,nhnlm68nbpwj,57391,57392,114783
59857,,wxq-ykwyuyej,57392,57393,114785
59858,,nhkz52royksj,57393,57394,114787
59859,,wfpq_vao0hcj,57395,57396,114791
59860,,zdhomrdugyoj,57396,57397,114793
59861,,rhiln6vllfaj,57397,57398,114795
59862,,j8kdwctjn7aj,57398,57399,114797
59863,,,57399,57400,114799
59864,,oe0g2-ssmbij,57400,57401,114801
59865,,7b0hheiut3ej,57401,57402,114803
59866,,hnfmrsgqjgej,57402,57403,114805
59867,,czoan2mjkfej,57403,57404,114807
59868,,lnac05x2ah4j,57405,57406,114811
59869,,lzimw6okq64j,57406,57407,114813
59870,,3zc1dl44vegj,57407,57408,114815
59871,,url:http://ieeexplore.ieee.org/iel1/2206/3160/00101352.pdf3farnumber3d101352,57408,57409,114817
59872,,bsnxyxojyogj,57409,57410,114819
59873,,dtpvmuhw7iaj,57410,57411,114821
59874,,zunuey3a6f0j,57411,57412,114823
59875,,l7x0xlikudsj,57412,57413,114825
59876,,_wmschgougaj,57413,57414,114827
59877,,jmx4cjnv3bsj,57414,57415,114829
59878,,kmzmhub0fxkj,57415,57416,114831
59879,,b7hwzjauwrgj,57416,57417,114833
59880,,jchw88xct6cj,57417,57418,114835
59881,,t7o-wspntpaj,57418,57419,114837
59882,,nztol55pzjcj,57419,57420,114839
59883,,p3jmpupy0duj,57420,57421,114841
59884,,ub4fs3onxxkj,57421,57422,114843
59885,,3305qgqnxkij,57422,57423,114845
59886,,glmufgfvljcj,57423,57424,114847
59887,,gfgq9dmqxruj,57424,57425,114849
59888,,7ipppi4rze4j,57425,57426,114851
59889,,j9xnt_wa_xgj,57426,57427,114853
59890,,1p0c_2eb4uuj,57427,57428,114855
59891,,yyodwjrvaucj,57428,57429,114857
59892,,vs2emspi2ooj,57429,57430,114859
59893,,jtrmgbkwalgj,57430,57431,114861
59894,,rxm86en_j38j,57431,57432,114863
59895,,hrlggaac4zwj,57432,57433,114865
59896,,ogwkiu5yqjgj,57433,57434,114867
59897,,p2r6kiiodfmj,57434,57435,114869
59898,,bzfdrojhbhwj,57435,57436,114871
59899,,u34mhzh17xqj,57436,57437,114873
59900,,ipbd7vphzgyj,57438,57439,114877
59901,,nsmc9rk4-mqj,57439,57440,114879
59902,,_kycgskik0mj,57440,57441,114881
59903,,xux-kcoqi5yj,57441,57442,114883
59904,,w3nucqtmzesj,57442,57443,114885
59905,,fwjvavcytzmj,57443,57444,114887
59906,,llzws4urrtkj,57444,57445,114889
59907,,l7cdzhet5fcj,57445,57446,114891
59908,,1vmu3w75xyoj,57446,57447,114893
59909,,merx9irytv8j,57447,57448,114895
59910,,t4hf2qlgktkj,57448,57449,114897
59911,,99gloxe8uzkj,57449,57450,114899
59912,,eqwq9nxo5vyj,57450,57451,114901
59913,,u9x0fiypxeuj,57451,57452,114903
59914,,bdinqadf8nej,57452,57453,114905
59915,,fpi2ez86iikj,57453,57454,114907
59916,,qdkmilfhfiyj,57454,57455,114909
59917,,y88lie5sgrwj,57455,57456,114911
59918,,t8jgrpbtdfkj,57456,57457,114913
59919,,lcaumhe57esj,57457,57458,114915
59920,,oxkevhbzu-ij,57458,57459,114917
59921,,8o0d8xluwguj,57459,57460,114919
59922,,wjx8l7umfdqj,57460,57461,114921
59923,,9ervorac4xgj,57461,57462,114923
59924,,url:http://portal.acm.org/ft_gateway.cfm3fid3d108363526type3dpdf,57462,57463,114925
59925,,ab09edfzcvij,57463,57464,114927
59926,,gbsomfxzf14j,57464,57465,114929
59927,,ljgxl8u26juj,57465,57466,114931
59928,,url:http://doi.wiley.com/10.1002/ev.1502,57466,57467,114933
59929,,mj40dahwpauj,57467,57468,114935
59930,,vljwn5sb-ogj,57468,57469,114937
59931,,c99ffm1eiyej,57469,57470,114939
59932,,4wh6h53f2byj,57470,57471,114941
59933,,whgm-bd3y8cj,57471,57472,114943
59934,,xpp-pl5darqj,57472,57473,114945
59935,,beuvc0kbwuej,57473,57474,114947
59936,,y4_vkqwhk88j,57474,57475,114949
59937,,5shcciaabfqj,57475,57476,114951
59938,,yr3ohun1q2aj,57476,57477,114953
59939,,yp0gysy1vpuj,57477,57478,114955
59940,,muh2arcj6o8j,57478,57479,114957
59941,,g1mpr4xmrooj,57479,57480,114959
59942,,34l2p0vtjvkj,57480,57481,114961
59943,,woidxlksioaj,57481,57482,114963
59944,,7j-gi_inwy0j,57482,57483,114965
59945,,ei7seckqkoqj,57483,57484,114967
59946,,obrtfnkvbnej,57485,57486,114971
59947,,bizdmjv6xhgj,57486,57487,114973
59948,,d8cr99ehmwaj,57487,57488,114975
59949,,ekaulkvly_yj,57488,57489,114977
59950,,ggskm5zzgqej,57489,57490,114979
59951,,qqwlpnfe2aij,57490,57491,114981
59952,,7-wswj4ftq4j,57491,57492,114983
59953,,,57492,57493,114985
59954,,7zezkzygwyyj,57493,57494,114987
59955,,taf83viydjej,57494,57495,114989
59956,,kvrdg1sybt0j,57495,57496,114991
59957,,zr968mueji4j,57496,57497,114993
59958,,qlex82l7h6wj,57498,57499,114997
59959,,xjkort14ks8j,57499,57500,114999
59960,,jkmooxkxjeij,57500,57501,115001
59961,,tvhg7merbugj,57501,57502,115003
59962,,blueqs02rjwj,57502,57503,115005
59963,,i4cvqjr4yumj,57503,57504,115007
59964,,qvrf0iqgrjcj,57504,57505,115009
59965,,yrgvbcasvh0j,57505,57506,115011
59966,,lcgdieya6dsj,57506,57507,115013
59967,,juvrsklojzsj,57507,57508,115015
59968,,ns4erggg06gj,57508,57509,115017
59969,,abiqhxgxojej,57509,57510,115019
59970,,bqe1mqw2nhcj,57510,57511,115021
59971,,n9igaj-xtw4j,57511,57512,115023
59972,,6zp_nxwl1ewj,57512,57513,115025
59973,,-8wupnnctwej,57513,57514,115027
59974,,g1h8xtegg-kj,57514,57515,115029
59975,,w8bp1ekghm8j,57515,57516,115031
59976,,c4m40zywvwsj,57516,57517,115033
59977,,yevwizoxb9ij,57517,57518,115035
59978,,iffxkilqddaj,57518,57519,115037
59979,,dum9ek_7owcj,57519,57520,115039
59980,,3e2gsmgcvusj,57520,57521,115041
59981,,3f-hkbt7k8mj,57521,57522,115043
59982,,gtj2-ljhmy4j,57522,57523,115045
59983,,hoogpgxau8ij,57523,57524,115047
59984,,n4suclqz4rcj,57524,57525,115049
59985,,mpqcvbs1i_uj,57526,57527,115053
59986,,ldvsthw7skuj,57527,57528,115055
59987,,xjcy8kou0pkj,57528,57529,115057
59988,,url:http://portal.acm.org/ft_gateway.cfm3fid3d27795326type3dpdf26dl3dguide26dl3dacm26cfid3d1111111126cftoken3d2222222,57529,57530,115059
59989,,svrzyx3nsgaj,57530,57531,115061
59990,,jrjqtwnkdlyj,57531,57532,115063
59991,,,57532,57533,115065
59992,,hoysrciad9oj,57533,57534,115067
59993,,r2xodo0mvxcj,57534,57535,115069
59994,,x87f5fsdtvwj,57536,57537,115073
59995,,eg_zchper8mj,57537,57538,115075
59996,,gyisqitzlagj,57538,57539,115077
59997,,1rwcmosugruj,57539,57540,115079
59998,,fwwlod4uo8qj,57540,57541,115081
59999,,b4eso5ueh0yj,57541,57542,115083
60000,,09gzg5bavdij,57542,57543,115085
60001,,dczxdbpknngj,57543,57544,115087
60002,,4likslkwn5yj,57544,57545,115089
60003,,hi6oxxerrr0j,57545,57546,115091
60004,,_9_lfq6tpb8j,57546,57547,115093
60005,,1ae1bmqd8cgj,57547,57548,115095
60006,,gqhxd-efg9aj,57548,57549,115097
60007,,o-ebjd_pe7ij,57549,57550,115099
60008,,nrv43rwzumsj,57550,57551,115101
60009,,yb_biqzfcgej,57551,57552,115103
60010,,ro2mx4crurcj,57552,57553,115105
60011,,tkqmjaj40_cj,57553,57554,115107
60012,,hq7uox0f1pcj,57554,57555,115109
60013,,0rhm2gaylmqj,57555,57556,115111
60014,,0l04fhv0-5oj,57557,57558,115115
60015,,nvpdx1llkxkj,57558,57559,115117
60016,,u39xodv4a8aj,57559,57560,115119
60017,,17xax6gtflsj,57560,57561,115121
60018,,url:http://doi.wiley.com/10.1002/he.10605,57561,57562,115123
60019,,6ljfgfxpivkj,57562,57563,115125
60020,,7cgoubvskdwj,57563,57564,115127
60021,,2wvawvxocnsj,57564,57565,115129
60022,,matwbavy-n0j,57565,57566,115131
60023,,k23hypa3y-aj,57566,57567,115133
60024,,1zaaltpdixyj,57567,57568,115135
60025,,ct7cmh-awosj,57568,57569,115137
60026,,4-igdwzdi-qj,57569,57570,115139
60027,,hlgmkfse_90j,57570,57571,115141
60028,,sln0_jyke6ej,57571,57572,115143
60029,,ls_7wr3wsyyj,57572,57573,115145
60030,,ifxhgqokdhuj,57573,57574,115147
60031,,fsyfg9vx7twj,57574,57575,115149
60032,,1nu9p9aafkej,57575,57576,115151
60033,,kwiemcvhl0ej,57577,57578,115155
60034,,bk7c2yvt-mwj,57578,57579,115157
60035,,zy9snzgd8skj,57579,57580,115159
60036,,7aexbzzfnocj,57580,57581,115161
60037,,url:http://doi.wiley.com/10.1002/tl.150,57581,57582,115163
60038,,zatyfiywic8j,57583,57584,115167
60039,,cal9nmdz5smj,57584,57585,115169
60040,,ygchvfk3opaj,57586,57587,115173
60041,,qsybbieiptsj,57587,57588,115175
60042,,zp6_7sfujwmj,57588,57589,115177
60043,,2muevvug-s8j,57589,57590,115179
60044,,yeenqefqhjyj,57590,57591,115181
60045,,5fmbn9i1qeej,57591,57592,115183
60046,,n7uwje8j66ej,57592,57593,115185
60047,,yuh1uy4limsj,57593,57594,115187
60048,,8zfp60tsnl4j,57594,57595,115189
60049,,1r74qgvkleaj,57595,57596,115191
60050,,xscjk1zoyy4j,57596,57597,115193
60051,,o_1mkspglhij,57597,57598,115195
60052,,a78lxr80kjuj,57598,57599,115197
60053,,b99bvulfwacj,57599,57600,115199
60054,,tkyysuinrgqj,57600,57601,115201
60055,,frtkjaaqnyuj,57601,57602,115203
60056,,fqljjqefd08j,57602,57603,115205
60057,,cyb0mzu0swuj,57603,57604,115207
60058,,fb3vrmidlmuj,57604,57605,115209
60059,,gahogvdmqoyj,57605,57606,115211
60060,,3n8xqr4o5auj,57606,57607,115213
60061,,url:http://portal.acm.org/citation.cfm3fid3d592205.592524,57607,57608,115215
60062,,rj3hypox9saj,57608,57609,115217
60063,,pmqgaz_kzpgj,57609,57610,115219
60064,,zgzt3htgfrgj,57610,57611,115221
60065,,riovjzg_mjwj,57611,57612,115223
60066,,b8fgpiofk6mj,57612,57613,115225
60067,,3peeufzx1hmj,57613,57614,115227
60068,,i9ljvmz9dusj,57614,57615,115229
60069,,ftwrysx7xwaj,57615,57616,115231
60070,,glygkserersj,57616,57617,115233
60071,,yzpwhuov4rqj,57617,57618,115235
60072,,uqvpouvz5cuj,57618,57619,115237
60073,,mh8-_med4byj,57619,57620,115239
60074,,url:http://www.csa.com/partners/viewrecord.php3frequester3dgs26collection3dtrd26recid3dn9210557ah,57620,57621,115241
60075,,yaymc8edz_oj,57622,57623,115245
60076,,icnj2dyzawej,57623,57624,115247
60077,,sd3nscyzjcuj,57624,57625,115249
60078,,lpwmryov7mgj,57626,57627,115253
60079,,tpylj2gcubqj,57628,57629,115257
60080,,dip57u4oxtyj,57629,57630,115259
60081,,url:http://portal.acm.org/citation.cfm3fid3d876899.881180,57630,57631,115261
60082,,ugbytien59kj,57631,57632,115263
60083,,9kh3cpataiaj,57632,57633,115265
60084,,_fn0s_pgaauj,57633,57634,115267
60085,,orkm5x462gaj,57634,57635,115269
60086,,qefqqwuf98yj,57635,57636,115271
60087,,sacst0cjbwkj,57636,57637,115273
60088,,lveqheknkucj,57637,57638,115275
60089,,7oh57qyjw2ij,57638,57639,115277
60090,,lul4rduyy74j,57639,57640,115279
60091,,whm5saed3t4j,57640,57641,115281
60092,,8dkmyma0uvqj,57641,57642,115283
60093,,g2zxg2aybz8j,57642,57643,115285
60094,,url:http://portal.acm.org/ft_gateway.cfm3fid3d35312026type3dpdf26dl3dportal26dl3dacm26cfid3d1111111126cftoken3d2222222,57643,57644,115287
60095,,os0gfixp0waj,57644,57645,115289
60096,,yis--p1ejh4j,57645,57646,115291
60097,,pxkc13m39scj,57646,57647,115293
60098,,zf5ei7as5kaj,57647,57648,115295
60099,,tgqlwol37nyj,57648,57649,115297
60100,,wnqc_di8cfkj,57649,57650,115299
60101,,tumjuvnpdxaj,57650,57651,115301
60102,,j_u_kpxqhswj,57651,57652,115303
60103,,oqsbjo-tdqej,57652,57653,115305
60104,,fiiuymvj6sqj,57653,57654,115307
60105,,87volv7-5h0j,57654,57655,115309
60106,,6q39phu2vfyj,57655,57656,115311
60107,,swp40pz0o54j,57656,57657,115313
60108,,url:http://portal.acm.org/ft_gateway.cfm3fid3d110130726type3dpdf,57657,57658,115315
60109,,lmtodoxt45mj,57658,57659,115317
60110,,vjuphzkbeggj,57659,57660,115319
60111,,x6phxaugqoaj,57660,57661,115321
60112,,m1mgdozqngaj,57661,57662,115323
60113,,3alyn2sxrmej,57662,57663,115325
60114,,eckkv_ewukwj,57663,57664,115327
60115,,url:http://portal.acm.org/ft_gateway.cfm3fid3d14182726type3dpdf26coll3dguide26dl3dacm26cfid3d1111111126cftoken3d2222222,57664,57665,115329
60116,,xbsqdocdeagj,57665,57666,115331
60117,,tgdkz_6hrw4j,57666,57667,115333
60118,,m8zmx1eqvkmj,57667,57668,115335
60119,,vqtnhgiskbij,57668,57669,115337
60120,,qt2w9-kqid8j,57669,57670,115339
60121,,dn5qcvwf78uj,57670,57671,115341
60122,,60pmwvzautsj,57671,57672,115343
60123,,zjrd8fvy6tgj,57672,57673,115345
60124,,fu5mza4beq8j,57673,57674,115347
60125,,lgczbzwqvvsj,57674,57675,115349
60126,,bmmzkxstdywj,57675,57676,115351
60127,,url:http://ieeexplore.ieee.org/iel1/2206/2510/00075480.pdf3farnumber3d75480,57676,57677,115353
60128,,glgk9jj-ddkj,57677,57678,115355
60129,,tlv-a9lx8owj,57678,57679,115357
60130,,akmd94ujfkmj,57679,57680,115359
60131,,rx4ug0m_-9uj,57680,57681,115361
60132,,p6wbel9dsrej,57681,57682,115363
60133,,aip3phwpproj,57682,57683,115365
60134,,3objjvj2nocj,57683,57684,115367
60135,,jkkrbu6k50ij,57684,57685,115369
60136,,uhcmyiqrgcyj,57685,57686,115371
60137,,frjcw_a1shmj,57686,57687,115373
60138,,m77rjkiifwyj,57687,57688,115375
60139,,xdpoq-dy8taj,57688,57689,115377
60140,,ormtygbvjr8j,57689,57690,115379
60141,,,57690,57691,115381
60142,,u9rtugr0yw0j,57691,57692,115383
60143,,hg48gdo2opyj,57692,57693,115385
60144,,y-gnuba0keqj,57693,57694,115387
60145,,ujsmbxpc5byj,57694,57695,115389
60146,,e-tajv86jvsj,57695,57696,115391
60147,,_rbw4upl8ayj,57696,57697,115393
60148,,x_5dkhi36tsj,57697,57698,115395
60149,,wkgvb_dx0w0j,57699,57700,115399
60150,,7vwrke6webkj,57700,57701,115401
60151,,bxnojqaopiuj,57701,57702,115403
60152,,rs5hxgq0qwmj,57702,57703,115405
60153,,f66vnsiyn6yj,57703,57704,115407
60154,,ra8l8mm3xh0j,57704,57705,115409
60155,,rqtbbuybqjkj,57705,57706,115411
60156,,dpvkyxyqfmij,57706,57707,115413
60157,,c1q4qmgcqi4j,57707,57708,115415
60158,,vh8blkx9j0uj,57708,57709,115417
60159,,_q4-p39ygigj,57709,57710,115419
60160,,au9btm72bgaj,57710,57711,115421
60161,,url:http://www.csa.com/partners/viewrecord.php3frequester3dgs26collection3dtrd26recid3dn9210370ah,57711,57712,115423
60162,,n5atrczyeraj,57712,57713,115425
60163,,ecqgdvi4glwj,57713,57714,115427
60164,,url:http://doi.wiley.com/10.1002/tl.143,57714,57715,115429
60165,,5lyfbfkn63qj,57715,57716,115431
60166,,gvvsb4hkggqj,57716,57717,115433
60167,,tsvdas3b6mkj,57718,57719,115437
60168,,,57719,57720,115439
60169,,ejddywpysmij,57720,57721,115441
60170,,xnnirajbihoj,57721,57722,115443
60171,,tsfvox40q9qj,57722,57723,115445
60172,,bwdewlwzcusj,57723,57724,115447
60173,,wc6ywezs0qmj,57724,57725,115449
60174,,htrezevhjsej,57725,57726,115451
60175,,onel5fzgedyj,57726,57727,115453
60176,,rwsnx7sghwwj,57727,57728,115455
60177,,xcaatdkhgcgj,57728,57729,115457
60178,,iyzdgbvskqyj,57729,57730,115459
60179,,u5iqisyfncwj,57730,57731,115461
60180,,pvsnachoh4yj,57731,57732,115463
60181,,1kw1dzywickj,57732,57733,115465
60182,,j55etjfmwdaj,57733,57734,115467
60183,,ywlv4d7gshgj,57734,57735,115469
60184,,url:http://www.springerlink.com/index/cfm1025xf89jlnh8.pdf,57735,57736,115471
60185,,oe1krub5bwaj,57736,57737,115473
60186,,vn131lm8rbgj,57737,57738,115475
60187,,w3r6hgrwrlyj,57738,57739,115477
60188,,bttho_r8vwwj,57739,57740,115479
60189,,sz-zijfs8yaj,57740,57741,115481
60190,,9cjq61gnhguj,57741,57742,115483
60191,,eghbsq8lwx4j,57742,57743,115485
60192,,-2gwa2djkguj,57743,57744,115487
60193,,9m6wowopsykj,57744,57745,115489
60194,,qgfd34gbvo0j,57745,57746,115491
60195,,n-kedx56ek0j,57746,57747,115493
60196,,1-plhqlt5gsj,57747,57748,115495
60197,,url:http://doi.wiley.com/10.1002/he.148,57748,57749,115497
60198,,gueqjiei17oj,57749,57750,115499
60199,,ezsx1mi5rwij,57750,57751,115501
60200,,ddsknxbll3uj,57751,57752,115503
60201,,,57752,57753,115505
60202,,mvll2wfdixqj,57753,57754,115507
60203,,a8nukk9mpxgj,57754,57755,115509
60204,,o9gfh020z2uj,57755,57756,115511
60205,,13lry_cgkb0j,57756,57757,115513
60206,,64hy_aniavsj,57757,57758,115515
60207,,hy65f7mkwuyj,57758,57759,115517
60208,,vwlscy-muakj,57759,57760,115519
60209,,kzc3ru2y2lmj,57760,57761,115521
60210,,anrtnujp9pej,57761,57762,115523
60211,,wwmotph_abwj,57762,57763,115525
60212,,09fxgekxvlsj,57763,57764,115527
60213,,ykbu1ayo6q0j,57764,57765,115529
60214,,7mw-zq2-on4j,57765,57766,115531
60215,,qrfmeoa5osqj,57766,57767,115533
60216,,gqubjsmobsgj,57767,57768,115535
60217,,gh2densd85oj,57768,57769,115537
60218,,4bpkehas0lcj,57770,57771,115541
60219,,qugus7ucshwj,57771,57772,115543
60220,,oceehjkzk-oj,57772,57773,115545
60221,,3bnvpkz5m5sj,57773,57774,115547
60222,,z9wrxlyfvl0j,57774,57775,115549
60223,,dzdc3_knbdmj,57775,57776,115551
60224,,pditjxjok1yj,57776,57777,115553
60225,,fp9zy6vpj-ij,57777,57778,115555
60226,,_bj_dkq0xfcj,57778,57779,115557
60227,,l6jrtvtyy5qj,57779,57780,115559
60228,,_hgnibui1vqj,57780,57781,115561
60229,,dri7vld2w3uj,57781,57782,115563
60230,,msrerft292wj,57782,57783,115565
60231,,61p17thyd8cj,57783,57784,115567
60232,,url:http://portal.acm.org/citation.cfm3fid3d144111.144149,57784,57785,115569
60233,,0ubkshekpzqj,57785,57786,115571
60234,,7gn25vfqq0ej,57786,57787,115573
60235,,1pmkvdhrjdcj,57787,57788,115575
60236,,7zcbgkpqercj,57788,57789,115577
60237,,vzeojkiwqm8j,57789,57790,115579
60238,,s_zbkg2d6voj,57790,57791,115581
60239,,2caphzlbu8oj,57791,57792,115583
60240,,cay1b3-hk0ij,57792,57793,115585
60241,,gw_enwfygjqj,57793,57794,115587
60242,,t4vytr7ism4j,57794,57795,115589
60243,,lyt9q2uq9zwj,57795,57796,115591
60244,,rfvraj2w8hmj,57796,57797,115593
60245,,x3u6bkaot0yj,57797,57798,115595
60246,,2mty1_cf4kcj,57798,57799,115597
60247,,nykmtufc1ygj,57799,57800,115599
60248,,ejlnkfy3y8ej,57800,57801,115601
60249,,wp63eywvk4yj,57801,57802,115603
60250,,er6bubynioyj,57802,57803,115605
60251,,zud3nvyecqij,57803,57804,115607
60252,,ezv_dy8bv20j,57804,57805,115609
60253,,z4t72kuhclij,57805,57806,115611
60254,,,57806,57807,115613
60255,,mtpcoywfacoj,57807,57808,115615
60256,,cim4e8xbz5wj,57808,57809,115617
60257,,5v7nohit6e0j,57809,57810,115619
60258,,43l18ytpfbuj,57810,57811,115621
60259,,gpap0mj1zusj,57811,57812,115623
60260,,_yzxfcqj2bmj,57812,57813,115625
60261,,yyzlitpedoij,57813,57814,115627
60262,,w00kenzkpr0j,57814,57815,115629
60263,,wtzsd23xss0j,57815,57816,115631
60264,,rntxvpjjfkcj,57816,57817,115633
60265,,aulp3kexgvgj,57817,57818,115635
60266,,8safqvxkjeej,57818,57819,115637
60267,,ywtsdardstcj,57819,57820,115639
60268,,rvxchd6e1oyj,57820,57821,115641
60269,,jf31w9e2n1uj,57821,57822,115643
60270,,iml9awmj0tuj,57822,57823,115645
60271,,pdkfhelxntcj,57823,57824,115647
60272,,apwdiz_ccqej,57824,57825,115649
60273,,foxmpw4kwtkj,57825,57826,115651
60274,,wjmc1rjf6wgj,57826,57827,115653
60275,,qul-7tbt_q8j,57828,57829,115657
60276,,elgcmnjmsaej,57829,57830,115659
60277,,aqqdjgipqooj,57830,57831,115661
60278,,cghg009jfnaj,57831,57832,115663
60279,,xgtq7ehdehmj,57832,57833,115665
60280,,ifejq1lz_5sj,57833,57834,115667
60281,,eptp8x_xmxej,57834,57835,115669
60282,,mwzbh4pmxasj,57835,57836,115671
60283,,ung98k4mkc0j,57836,57837,115673
60284,,ykt9etfidb0j,57837,57838,115675
60285,,elpbl8vygyoj,57838,57839,115677
60286,,c9gtqq5ccecj,57839,57840,115679
60287,,jymnj0fjicqj,57840,57841,115681
60288,,pdvurr3eriqj,57841,57842,115683
60289,,bcnozmrsrimj,57842,57843,115685
60290,,raxyaqem4xsj,57843,57844,115687
60291,,e7o2icofdsej,57844,57845,115689
60292,,ezmbo7umecuj,57845,57846,115691
60293,,xm6_uolylbwj,57846,57847,115693
60294,,r8bjuls022ej,57847,57848,115695
60295,,rpf1xv1khgwj,57848,57849,115697
60296,,ru9pihjobxoj,57849,57850,115699
60297,,saupms1ncn4j,57850,57851,115701
60298,,osqh1_saorcj,57851,57852,115703
60299,,p_k0_rpheocj,57852,57853,115705
60300,,l0rf8_ktmvaj,57854,57855,115709
60301,,124ohyupptej,57855,57856,115711
60302,,xnihk2y8adkj,57856,57857,115713
60303,,wod1zcv-1xyj,57857,57858,115715
60304,,oyuz_3vgthqj,57858,57859,115717
60305,,myq5cyzuk8aj,57859,57860,115719
60306,,q9yrmegjloaj,57860,57861,115721
60307,,5jkmsn-7q9uj,57861,57862,115723
60308,,sb-nvl5829ej,57862,57863,115725
60309,,a20lp3w9vjoj,57863,57864,115727
60310,,7eunkltnzsqj,57864,57865,115729
60311,,boyrmdfcotqj,57865,57866,115731
60312,,79cvvwsqylcj,57867,57868,115735
60313,,fwafj_2l9guj,57868,57869,115737
60314,,znzhrqcdftwj,57869,57870,115739
60315,,fhmm_2gia4aj,57870,57871,115741
60316,,fj-pxopeiugj,57871,57872,115743
60317,,rybszl0uxqoj,57872,57873,115745
60318,,ot-h4yvpg70j,57874,57875,115749
60319,,yrqk67qvqlkj,57875,57876,115751
60320,,a8uiwgsdxu4j,57876,57877,115753
60321,,xdujyjlx6g4j,57877,57878,115755
60322,,url:http://ieeexplore.ieee.org/xpl/abs_free.jsp3farnumber3d1316841,57878,57879,115757
60323,,uatfkgqdy4oj,57879,57880,115759
60324,,i1e45m0aa8ej,57880,57881,115761
60325,,cezrqajnewuj,57881,57882,115763
60326,,gzerj8bziwwj,57882,57883,115765
60327,,xppoz49t5nuj,57883,57884,115767
60328,,6pfpun7ukraj,57884,57885,115769
60329,,ok9iuodo6xoj,57885,57886,115771
60330,,a1ngqoxs1v0j,57886,57887,115773
60331,,c8lf7grrfcmj,57887,57888,115775
60332,,wzxbuxg1hawj,57888,57889,115777
60333,,e4gxprins0wj,57889,57890,115779
60334,,6kegoshc6rqj,57890,57891,115781
60335,,url:http://www.csa.com/partners/viewrecord.php3frequester3dgs26collection3dtrd26recid3dn9210435ah,57891,57892,115783
60336,,bpenypp9bewj,57892,57893,115785
60337,,aalaorxsoqwj,57893,57894,115787
60338,,kw-jxykuxdkj,57894,57895,115789
60339,,s8nejewyvlyj,57895,57896,115791
60340,,url:http://www.ncbi.nlm.nih.gov/entrez/query.fcgi3fcmd3dretrieve26db3dpubmed26list_uids3d1024594526dopt3dcitation,57896,57897,115793
60341,,b0fa3twq6duj,57897,57898,115795
60342,,2ivha-6exlwj,57898,57899,115797
60343,,soejoqqzhg0j,57899,57900,115799
60344,,4sjtsjtrja8j,57900,57901,115801
60345,,w8v6wdctu7yj,57901,57902,115803
60346,,rvksxpm6p04j,57902,57903,115805
60347,,39puhpqxwv4j,57903,57904,115807
60348,,zifc0glw9xmj,57904,57905,115809
60349,,dnypoqri9mqj,57905,57906,115811
60350,,xhvktaigy6gj,57906,57907,115813
60351,,0juu3eeiramj,57907,57908,115815
60352,,hhzf0ib9pnij,57908,57909,115817
60353,,mithiebaahwj,57909,57910,115819
60354,,c0fehbp-beaj,57910,57911,115821
60355,,33mk47cuti0j,57911,57912,115823
60356,,egenb3t_r8yj,57912,57913,115825
60357,,e2wpbtc2r5wj,57913,57914,115827
60358,,5dlwzxouygqj,57914,57915,115829
60359,,jh5ghdzgmvkj,57915,57916,115831
60360,,hgcmx5mwgq8j,57916,57917,115833
60361,,url:http://doi.wiley.com/10.1002/ace.8709,57917,57918,115835
60362,,cy5uh-izsrej,57918,57919,115837
60363,,hxk1szep5boj,57919,57920,115839
60364,,qa77se6iaiuj,57920,57921,115841
60365,,v9thtb0sin0j,57921,57922,115843
60366,,r2feidkrfxqj,57922,57923,115845
60367,,yjblojuaznmj,57923,57924,115847
60368,,j93i0qpt_2wj,57924,57925,115849
60369,,nneqe0-xlkkj,57925,57926,115851
60370,,0gil2kwjngcj,57926,57927,115853
60371,,kmmgm1msclaj,57927,57928,115855
60372,,egaqsjfsam0j,57928,57929,115857
60373,,url:http://www.csa.com/partners/viewrecord.php3frequester3dgs26collection3dtrd26recid3dn9210438ah,57929,57930,115859
60374,,fylfdzto26uj,57930,57931,115861
60375,,kn-cw3ifzdqj,57931,57932,115863
60376,,gj8b3eralbsj,57932,57933,115865
60377,,b3rme6lxmgkj,57933,57934,115867
60378,,pv6up1ybinoj,57934,57935,115869
60379,,o2roiyhhkwqj,57935,57936,115871
60380,,r85wgzlhb1cj,57936,57937,115873
60381,,wlxvb56u4ukj,57937,57938,115875
60382,,6i1j1xompomj,57938,57939,115877
60383,,z6dk4vfdpn8j,57939,57940,115879
60384,,mj2qojqfwycj,57940,57941,115881
60385,,28dzank_9a0j,57941,57942,115883
60386,,ob2vqltw1byj,57942,57943,115885
60387,,pca9bjxyrmsj,57943,57944,115887
60388,,eigxyq5jgq4j,57944,57945,115889
60389,,p7wbtcwkd38j,57945,57946,115891
60390,,yulgbnxmffyj,57946,57947,115893
60391,,,57947,57948,115895
60392,,txsrbrjedfej,57948,57949,115897
60393,,um1mjnwfbq8j,57949,57950,115899
60394,,5kynvi5hjnoj,57950,57951,115901
60395,,eymsgzlsusej,57953,57954,115907
60396,,_hz0wldkeeyj,57954,57955,115909
60397,,f9onz_t_sa0j,57955,57956,115911
60398,,lgqbucptnf8j,57956,57957,115913
60399,,s2lwr0lurjuj,57957,57958,115915
60400,,okb1s_t18n0j,57958,57959,115917
60401,,edrz-ihtieuj,57959,57960,115919
60402,,-0jdi-1iotyj,57960,57961,115921
60403,,m6okjmxhfnkj,57961,57962,115923
60404,,fjms8ziiogcj,57962,57963,115925
60405,,slyxv1rp3-sj,57963,57964,115927
60406,,lzevmtjkeroj,57964,57965,115929
60407,,4eltupqmexij,57965,57966,115931
60408,,gfg4d5xfmwgj,57966,57967,115933
60409,,qw5g2ibupeij,57967,57968,115935
60410,,lxicr1m1lr4j,57968,57969,115937
60411,,xnkwtyhv37sj,57969,57970,115939
60412,,nhlyjueq-oaj,57970,57971,115941
60413,,-7ue_nz4stuj,57971,57972,115943
60414,,url:http://www.csa.com/partners/viewrecord.php3frequester3dgs26collection3denv26recid3d761541,57972,57973,115945
60415,,0bumffgpcuqj,57973,57974,115947
60416,,eehuvsqfpwcj,57974,57975,115949
60417,,tm3nnp6be1gj,57975,57976,115951
60418,,gdyhi3mlsxmj,57976,57977,115953
60419,,gpeevzzqffmj,57977,57978,115955
60420,,afkeagtbun8j,57978,57979,115957
60421,,2jtkhiaqj-4j,57979,57980,115959
60422,,hq-wysin108j,57980,57981,115961
60423,,aidj8xlrct8j,57981,57982,115963
60424,,1nx7tngeqrqj,57982,57983,115965
60425,,s7ao9hlp694j,57983,57984,115967
60426,,c0mcipjogxoj,57984,57985,115969
60427,,url:http://portal.acm.org/ft_gateway.cfm3fid3d110125426type3dpdf,57985,57986,115971
60428,,cdnq737aejqj,57986,57987,115973
60429,,xfclj4dlt1mj,57988,57989,115977
60430,,ip9s_nlgg9oj,57989,57990,115979
60431,,sehcx_zaydij,57990,57991,115981
60432,,3tmuxih-izej,57991,57992,115983
60433,,ql-n1zna-bij,57992,57993,115985
60434,,otwd0bn7xwoj,57993,57994,115987
60435,,gy652xxjhb8j,57994,57995,115989
60436,,dlxiinrfoesj,57995,57996,115991
60437,,zmvltfmsigij,57996,57997,115993
60438,,url:http://doi.wiley.com/10.1002/tl.172,57997,57998,115995
60439,,92lumjoinc4j,57998,57999,115997
60440,,wbgdc_rsi14j,57999,58000,115999
60441,,ff7stivmfyyj,58000,58001,116001
60442,,hzwyxtrodbij,58001,58002,116003
60443,,hipgqhq-a9mj,58002,58003,116005
60444,,cac09pk1j2oj,58003,58004,116007
60445,,xbmmxga3pl0j,58004,58005,116009
60446,,7mwxqo6cq1ij,58005,58006,116011
60447,,bolsmj88blsj,58006,58007,116013
60448,,dlymxxpy2qyj,58007,58008,116015
60449,,cnsenety9csj,58008,58009,116017
60450,,4kikhlx8r2mj,58009,58010,116019
60451,,azaoqcwyaqwj,58010,58011,116021
60452,,grcy7zdrfxsj,58011,58012,116023
60453,,bxszvghiqjkj,58012,58013,116025
60454,,url:http://portal.acm.org/ft_gateway.cfm3fid3d108379326type3dpdf,58013,58014,116027
60455,,axu6ulx-ppyj,58014,58015,116029
60456,,url:http://portal.acm.org/ft_gateway.cfm3fid3d109338426type3dpdf,58015,58016,116031
60457,,url:http://doi.wiley.com/10.1002/ace.164,58016,58017,116033
60458,,,58017,58018,116035
60459,,hutsppakazmj,58018,58019,116037
60460,,url:http://portal.acm.org/ft_gateway.cfm3fid3d109338626type3dpdf,58019,58020,116039
60461,,upb5kano-faj,58020,58021,116041
60462,,szwhpif7vzkj,58021,58022,116043
60463,,eqa3crafwocj,58022,58023,116045
60464,,mnxixoe-vbgj,58023,58024,116047
60465,,3kipzqonljyj,58024,58025,116049
60466,,wmyjf5xw6kgj,58025,58026,116051
60467,,d1tfrffp-p4j,58026,58027,116053
60468,,e7mp24pejakj,58027,58028,116055
60469,,ilrdnhlfkxkj,58028,58029,116057
60470,,dyx-rllbdngj,58029,58030,116059
60471,,yvojojonfiij,58030,58031,116061
60472,,bpceoq6vksoj,58032,58033,116065
60473,,o10esaxyckgj,58033,58034,116067
60474,,rb2vkrwnxywj,58034,58035,116069
60475,,kehakj_hyqcj,58035,58036,116071
60476,,yu8tidxkxxuj,58036,58037,116073
60477,,uqc9iaqrxs0j,58037,58038,116075
60478,,zvaj8us6e0kj,58038,58039,116077
60479,,zgaxnuuz5bkj,58039,58040,116079
60480,,_1n4nkd4amij,58040,58041,116081
60481,,f__anighr70j,58041,58042,116083
60482,,3bcza8q-2b8j,58042,58043,116085
60483,,oibi1bptohgj,58043,58044,116087
60484,,0wxg_f591xij,58044,58045,116089
60485,,7vdanu34rhwj,58045,58046,116091
60486,,aorp263r-amj,58046,58047,116093
60487,,069oynrbtagj,58047,58048,116095
60488,,rnnafccslrsj,58048,58049,116097
60489,,ao37kqmvgt8j,58049,58050,116099
60490,,oouazajklw8j,58050,58051,116101
60491,,f5pomjqmm3gj,58051,58052,116103
60492,,ufhy2rq90n4j,58052,58053,116105
60493,,gljn4f4f63wj,58053,58054,116107
60494,,cxlat9hrutmj,58054,58055,116109
60495,,_1elealbbr4j,58055,58056,116111
60496,,y8jg6nztxc4j,58056,58057,116113
60497,,nz1mvmkfwmej,58057,58058,116115
60498,,dper1stwtysj,58058,58059,116117
60499,,url:http://www.springerlink.com/index/ju61446782xkj266.pdf,58059,58060,116119
60500,,9alijlkf3dgj,58060,58061,116121
60501,,qbaeqcbfituj,58061,58062,116123
60502,,wlnpzk2hyjgj,58062,58063,116125
60503,,tkni7tcjceej,58063,58064,116127
60504,,l4nphlzaq8ij,58064,58065,116129
60505,,22yrw1obqvoj,58066,58067,116133
60506,,jm8cxpvucbmj,58067,58068,116135
60507,,nrz5j_wlfckj,58068,58069,116137
60508,,ueidi44g0zyj,58069,58070,116139
60509,,ocm2pngzbnwj,58070,58071,116141
60510,,pxxsdwq6s98j,58071,58072,116143
60511,,mt6vtv0uhrcj,58072,58073,116145
60512,,hr5oecsj9u8j,58073,58074,116147
60513,,ascoujkddi0j,58074,58075,116149
60514,,tis6j9mg9xoj,58075,58076,116151
60515,,sy3o3vmynzmj,58076,58077,116153
60516,,hriymqz7vjij,58077,58078,116155
60517,,uobiotlmncsj,58078,58079,116157
60518,,kja5nluhc-mj,58079,58080,116159
60519,,oqrwishrbh8j,58080,58081,116161
60520,,3woqzktzl3ej,58081,58082,116163
60521,,dvnni-aaxzsj,58082,58083,116165
60522,,0fzc_jwqq6ij,58083,58084,116167
60523,,lnonjcnrkdcj,58084,58085,116169
60524,,rlvmlnk2uz4j,58085,58086,116171
60525,,lglmunhynskj,58086,58087,116173
60526,,gkrf_tw-az0j,58087,58088,116175
60527,,w2h98wuoz8ej,58088,58089,116177
60528,,hgkw3nnchl4j,58089,58090,116179
60529,,pn3mktvf34qj,58090,58091,116181
60530,,1tm-s5uyr80j,58091,58092,116183
60531,,nqhuj6chvgyj,58092,58093,116185
60532,,jr9hxr82hykj,58093,58094,116187
60533,,yluyoc6-vlij,58094,58095,116189
60534,,kofz1tlo28aj,58095,58096,116191
60535,,lsx1kctq840j,58096,58097,116193
60536,,hbrgosydi3oj,58097,58098,116195
60537,,b0fdj2ja9rsj,58098,58099,116197
60538,,xn6xaxslg9ej,58099,58100,116199
60539,,ptidyqyslukj,58100,58101,116201
60540,,,58101,58102,116203
60541,,zxyjdtusutoj,58102,58103,116205
60542,,m9ckim3ibfsj,58103,58104,116207
60543,,x0wl5sqpyikj,58104,58105,116209
60544,,url:http://www.ingentaconnect.com/content/els/08830355/2001/00000035/00000003/art00029,58105,58106,116211
60545,,4kggf3ujxvyj,58106,58107,116213
60546,,zesi86cfhkcj,58107,58108,116215
60547,,ervvpt7me7ej,58108,58109,116217
60548,,xkq2xuzkqooj,58109,58110,116219
60549,,uzzyos0imi8j,58110,58111,116221
60550,,fay0okhhat4j,58111,58112,116223
60551,,7ljh1lepcjuj,58112,58113,116225
60552,,ehqdt03ejigj,58113,58114,116227
60553,,sd1vkphguxwj,58114,58115,116229
60554,,fzsrce60aucj,58115,58116,116231
60555,,ysqbmphnheoj,58116,58117,116233
60556,,m4fxqu6n0_ej,58117,58118,116235
60557,,nqiu9nqq3vij,58118,58119,116237
60558,,jmbhk1yaujij,58119,58120,116239
60559,,yarlruz1mtsj,58120,58121,116241
60560,,rvtgcn3zje8j,58121,58122,116243
60561,,zipkjobv5zoj,58122,58123,116245
60562,,url:http://adsabs.harvard.edu/abs/1978phdt.......119c,58123,58124,116247
60563,,a5f98rgy2zuj,58124,58125,116249
60564,,uajkeeopf2wj,58125,58126,116251
60565,,cpzmw7o4pa8j,58126,58127,116253
60566,,h42ygkypsj8j,58127,58128,116255
60567,,idlbmlawbdsj,58128,58129,116257
60568,,4ivhntbie24j,58130,58131,116261
60569,,bxnif2rxvqgj,58131,58132,116263
60570,,ljqpj04-zhcj,58132,58133,116265
60571,,aw2ohlronpyj,58134,58135,116269
60572,,jzr0dxrlghqj,58135,58136,116271
60573,,rsbqx_mjhauj,58136,58137,116273
60574,,supkbjrdai4j,58137,58138,116275
60575,,6etdwmetf0oj,58138,58139,116277
60576,,eirwjgvldq0j,58139,58140,116279
60577,,nrgiborlxqcj,58140,58141,116281
60578,,rgdzlefqrvgj,58141,58142,116283
60579,,8qcrepzgh-yj,58142,58143,116285
60580,,cbdo5gtn3e8j,58143,58144,116287
60581,,axxvd6s-s9ej,58144,58145,116289
60582,,1j2ps4gsaa0j,58145,58146,116291
60583,,jqqgs11omksj,58146,58147,116293
60584,,url:http://links.jstor.org/sici3fsici3d0146-4949(196224)3253a1253c49253ap1asom253e2.0.co253b2-t,58148,58149,116297
60585,,daqybbcbxwej,58149,58150,116299
60586,,url:http://doi.wiley.com/10.1002/ace.32,58151,58152,116303
60587,,jm0bgu-x1hmj,58153,58154,116307
60588,,3lrgujns5gej,58155,58156,116311
60589,,y0jps7f9y_0j,58156,58157,116313
60590,,hci0pd8ebjoj,58157,58158,116315
60591,,szwecq6zummj,58158,58159,116317
60592,,f3hy2oybb5cj,58159,58160,116319
60593,,qozqhi9tck4j,58160,58161,116321
60594,,1udnligiq4kj,58162,58163,116325
60595,,y5wxbi18vruj,58163,58164,116327
60596,,kq9h1gstls4j,58164,58165,116329
60597,,yzvwmr42mckj,58165,58166,116331
60598,,rc6nsby5whqj,58166,58167,116333
60599,,m5vx6gem6yaj,58167,58168,116335
60600,,0myzesx920wj,58168,58169,116337
60601,,md5lpy_weboj,58169,58170,116339
60602,,x1kbiffhkxmj,58170,58171,116341
60603,,l_osqgyiqtqj,58171,58172,116343
60604,,jsxq8jeyp2aj,58173,58174,116347
60605,,yau5z7ui8mej,58174,58175,116349
60606,,78ebgloygsmj,58175,58176,116351
60607,,yj15ihf65xgj,58176,58177,116353
60608,,url:http://www.csa.com/partners/viewrecord.php3frequester3dgs26collection3dtrd26recid3d0956285ci26recid3d0956285ea,58177,58178,116355
60609,,y3tblhkqm2sj,58178,58179,116357
60610,,f9fmtzcvwegj,58179,58180,116359
60611,,o7c0qiqvhawj,58180,58181,116361
60612,,za-on5bxq-uj,58181,58182,116363
60613,,vcnxv8l-8vkj,58182,58183,116365
60614,,tsahfukddg8j,58183,58184,116367
60615,,url:http://links.jstor.org/sici3fsici3d0146-4949(196721)8253a2253c268253airapin253e2.0.co253b2-4,58184,58185,116369
60616,,kpvpdkgxalij,58185,58186,116371
60617,,iwtce_r0d5ij,58186,58187,116373
60618,,qdv9wfhkjlsj,58187,58188,116375
60619,,fhzlshix-cqj,58188,58189,116377
60620,,hhp_wjrecaij,58189,58190,116379
60621,,eyh40uq9yc8j,58190,58191,116381
60622,,nbdeolcljukj,58191,58192,116383
60623,,bccrqm_0c_qj,58192,58193,116385
60624,,quqxk8yias4j,58193,58194,116387
60625,,ur5whepp29aj,58194,58195,116389
60626,,rk-bsrnej90j,58195,58196,116391
60627,,4rmgqnohl1sj,58196,58197,116393
60628,,fty-y4zgticj,58197,58198,116395
60629,,9mlvp9dp0emj,58198,58199,116397
60630,,pw3waa8kwswj,58199,58200,116399
60631,,-6k6y6zqs2aj,58200,58201,116401
60632,,3at27uiiyiaj,58201,58202,116403
60633,,xlhdsoe09icj,58202,58203,116405
60634,,url:http://adsabs.harvard.edu/abs/1983tpdn.nasa.....b,58203,58204,116407
60635,,_xnmzmhsrvqj,58204,58205,116409
60636,,hgda5kqjbq8j,58205,58206,116411
60637,,gqcrqumgp9sj,58206,58207,116413
60638,,litgve0v9v8j,58207,58208,116415
60639,,url:http://www.springerlink.com/index/q1j7u54458570510.pdf,58208,58209,116417
60640,,mnbloiclwpaj,58209,58210,116419
60641,,l5xhnmj6fhkj,58210,58211,116421
60642,,8ryohq2nb14j,58211,58212,116423
60643,,ksd7sk769esj,58212,58213,116425
60644,,toydjeczvmkj,58213,58214,116427
60645,,zujl3xv_pyej,58214,58215,116429
60646,,y8hsabtcgxkj,58215,58216,116431
60647,,ehlr80jwt-gj,58216,58217,116433
60648,,url:http://www.blackwell-synergy.com/links/doi/10.1111/j.0033-0124.1993.00446.x/abs/,58217,58218,116435
60649,,qpph0a6rkkyj,58218,58219,116437
60650,,kvjbwe6u3iyj,58219,58220,116439
60651,,x6kcva730lcj,58220,58221,116441
60652,,gz6aj1cq0oej,58221,58222,116443
60653,,mq7p6mng9zaj,58222,58223,116445
60654,,dkdyz41-jesj,58223,58224,116447
60655,,vmqeukfzhaej,58224,58225,116449
60656,,5jnwzr2cnnyj,58225,58226,116451
60657,,bs_kxp0hegwj,58226,58227,116453
60658,,wusjxgy2ebsj,58227,58228,116455
60659,,ybyg-e6rxumj,58228,58229,116457
60660,,jsmfzo-qx98j,58229,58230,116459
60661,,isv0gw0vl8oj,58230,58231,116461
60662,,we9rzb_esjuj,58231,58232,116463
60663,,osgndsxvrlcj,58232,58233,116465
60664,,senwg7hn6r4j,58233,58234,116467
60665,,zc-wsatiaokj,58234,58235,116469
60666,,y2uzppbjpjqj,58235,58236,116471
60667,,2t7awiijd5qj,58236,58237,116473
60668,,qowtgp5uhqcj,58238,58239,116477
60669,,ye9iuyg5ml0j,58239,58240,116479
60670,,sytegep-zqwj,58240,58241,116481
60671,,glmo_uurncmj,58241,58242,116483
60672,,pi2wfuovrogj,58242,58243,116485
60673,,iagphssw140j,58243,58244,116487
60674,,aszimejorpaj,58244,58245,116489
60675,,kxy0vgt3xvqj,58245,58246,116491
60676,,zk6qq-iodwkj,58246,58247,116493
60677,,m0w5x_ja5kcj,58247,58248,116495
60678,,4vbapd5pm9aj,58248,58249,116497
60679,,url:http://links.jstor.org/sici3fsici3d0146-4949(196223)3253a3253c67253atanacs253e2.0.co253b2-q,58249,58250,116499
60680,,i0dpbivirx8j,58250,58251,116501
60681,,d2xkifs0yk4j,58251,58252,116503
60682,,lvidcb__h1oj,58252,58253,116505
60683,,url:http://doi.wiley.com/10.1002/he.17.abs,58253,58254,116507
60684,,xtia4vl9shwj,58255,58256,116511
60685,,niveutafchaj,58256,58257,116513
60686,,j7_usdvt2iij,58257,58258,116515
60687,,vxjyy0oim-4j,58258,58259,116517
60688,,zgunku2zly0j,58259,58260,116519
60689,,08il8pvc8wwj,58260,58261,116521
60690,,uyb7tjbw-6wj,58261,58262,116523
60691,,rxbw34axn9mj,58263,58264,116527
60692,,oqil2m-bndij,58264,58265,116529
60693,,otnd1zcyr0sj,58265,58266,116531
60694,,viybk6ynhf0j,58266,58267,116533
60695,,pzz56ggodeqj,58267,58268,116535
60696,,b0ydxjdpot8j,58268,58269,116537
60697,,,58269,58270,116539
60698,,rxqqqqtaeioj,58270,58271,116541
60699,,spkymyhjhfaj,58271,58272,116543
60700,,si4xuxqicrqj,58272,58273,116545
60701,,ndwcxtikuf4j,58273,58274,116547
60702,,irr8c0edflkj,58274,58275,116549
60703,,t2ev3jad54cj,58275,58276,116551
60704,,_bkvqurjjecj,58276,58277,116553
60705,,g2gnhyx6znsj,58277,58278,116555
60706,,pj5ixjpktskj,58278,58279,116557
60707,,oj_ar7rvq9qj,58279,58280,116559
60708,,exyqaja_6naj,58280,58281,116561
60709,,dohrgqistwgj,58281,58282,116563
60710,,lng6ipvv_iaj,58282,58283,116565
60711,,stx30tccbo8j,58283,58284,116567
60712,,q1rkm5gmek4j,58284,58285,116569
60713,,gloqi8ytlmwj,58285,58286,116571
60714,,voqwybopxpaj,58286,58287,116573
60715,,url:http://portal.acm.org/ft_gateway.cfm3fid3d98453426type3dpdf26dl3dguide26dl3dacm26cfid3d1111111126cftoken3d2222222,58287,58288,116575
60716,,qtajiozk-ngj,58288,58289,116577
60717,,jya6cs3f43ej,58290,58291,116581
60718,,6xqkn0apkpmj,58291,58292,116583
60719,,elucfesg5xaj,58292,58293,116585
60720,,_7jgop03kvgj,58293,58294,116587
60721,,xonhceakhbgj,58294,58295,116589
60722,,hz78svq8p2wj,58295,58296,116591
60723,,rqoyljn3ndcj,58296,58297,116593
60724,,jxa8nvye6ayj,58297,58298,116595
60725,,,58298,58299,116597
60726,,qcshj7wmp9qj,58299,58300,116599
60727,,3ggk0hmkotqj,58300,58301,116601
60728,,h_bdylpd79oj,58301,58302,116603
60729,,rcmgrb81x-4j,58302,58303,116605
60730,,ppntp8bk3_0j,58304,58305,116609
60731,,lfs9vr-fszej,58305,58306,116611
60732,,bg3qlty0_bej,58306,58307,116613
60733,,uqogairlqbmj,58307,58308,116615
60734,,uigjetxcvpmj,58308,58309,116617
60735,,yknqmczsrb8j,58309,58310,116619
60736,,ffcxsyy1nx0j,58310,58311,116621
60737,,52l9su9ssq0j,58311,58312,116623
60738,,lclz2ol6thaj,58312,58313,116625
60739,,uji1lukdaqoj,58313,58314,116627
60740,,xf1uivna2jkj,58314,58315,116629
60741,,f-2htl7cwc4j,58316,58317,116633
60742,,jrkcujwcdogj,58317,58318,116635
60743,,6puxcjyyeooj,58318,58319,116637
60744,,xgsc5vo_kjej,58319,58320,116639
60745,,yjbkqsygn0gj,58320,58321,116641
60746,,w7zfy1egyaej,58321,58322,116643
60747,,fzl4ixvpc6ij,58322,58323,116645
60748,,vs-brehza_ej,58323,58324,116647
60749,,neoilwrdhhgj,58324,58325,116649
60750,,hahacmi6z2wj,58325,58326,116651
60751,,javvhq27cnmj,58326,58327,116653
60752,,vykl9jbr-2gj,58327,58328,116655
60753,,kig4filv7a8j,58328,58329,116657
60754,,bpsbjmwddq0j,58329,58330,116659
60755,,u74kqc_5lggj,58330,58331,116661
60756,,bxfgyprn9uyj,58331,58332,116663
60757,,cctvdxxnwtoj,58332,58333,116665
60758,,3bod10th5hgj,58333,58334,116667
60759,,xyi_-dftmwgj,58334,58335,116669
60760,,moqmz-zjhn0j,58335,58336,116671
60761,,hsitibvn2lgj,58336,58337,116673
60762,,tngpsyzrqwmj,58337,58338,116675
60763,,ud9memdkszaj,58338,58339,116677
60764,,mgkx7asfi5uj,58339,58340,116679
60765,,rmfxiybrt7aj,58340,58341,116681
60766,,jqntxlrbvmsj,58341,58342,116683
60767,,bnanfwx-ubcj,58342,58343,116685
60768,,url:http://portal.acm.org/ft_gateway.cfm3fid3d108377126type3dpdf,58343,58344,116687
60769,,egr7azzr6f4j,58344,58345,116689
60770,,dvr5yrm74woj,58345,58346,116691
60771,,imppcqc5vrsj,58347,58348,116695
60772,,wzayhs6qpdkj,58348,58349,116697
60773,,ybjdxjkdhkyj,58349,58350,116699
60774,,_pptzwsaszgj,58350,58351,116701
60775,,9wpe1owrm1ij,58351,58352,116703
60776,,ct5pfujud8kj,58352,58353,116705
60777,,qgyeewxnngoj,58353,58354,116707
60778,,bejjogfzi0sj,58354,58355,116709
60779,,dw_t6rbmalqj,58355,58356,116711
60780,,tm8zjkz3hq8j,58357,58358,116715
60781,,dfk3q-sktc4j,58358,58359,116717
60782,,zms-bfuisnuj,58359,58360,116719
60783,,888w59-tqzyj,58360,58361,116721
60784,,3t6_wa6ifrgj,58361,58362,116723
60785,,,58362,58363,116725
60786,,url:http://doi.wiley.com/10.1002/ace.140,58363,58364,116727
60787,,qhrmzfzllbaj,58364,58365,116729
60788,,4lhjywz6rj4j,58365,58366,116731
60789,,ctrrblzvlmij,58366,58367,116733
60790,,zsphpzkizewj,58367,58368,116735
60791,,cymezbp9hbsj,58368,58369,116737
60792,,a1ue0hwn9-sj,58369,58370,116739
60793,,vphpx4gkv8qj,58370,58371,116741
60794,,s5itlvnigdcj,58371,58372,116743
60795,,paxlo-chtcqj,58372,58373,116745
60796,,url:http://www.csa.com/partners/viewrecord.php3frequester3dgs26collection3dtrd26recid3d200111010702mt26recid3da0032632ah,58373,58374,116747
60797,,ioy7jozt3aej,58374,58375,116749
60798,,pvv5m63tgaoj,58375,58376,116751
60799,,u6bhhgcbekoj,58376,58377,116753
60800,,y-xizfh0ts0j,58377,58378,116755
60801,,url:http://www.csa.com/partners/viewrecord.php3frequester3dgs26collection3dtrd26recid3d8204540530md,58378,58379,116757
60802,,qh8j9yr7ngwj,58379,58380,116759
60803,,jqvkmfwen9cj,58381,58382,116763
60804,,ks_li8nmypwj,58382,58383,116765
60805,,url:http://doi.wiley.com/10.1002/ace.20.abs,58383,58384,116767
60806,,9ievrylbbtqj,58384,58385,116769
60807,,pftbkqlwnb4j,58385,58386,116771
60808,,url:http://ieeexplore.ieee.org/iel5/9217/29235/01320095.pdf3farnumber3d1320095,58386,58387,116773
60809,,36y_7fnjddqj,58387,58388,116775
60810,,q9wsk12y_nyj,58388,58389,116777
60811,,ukm5zvzkgimj,58389,58390,116779
60812,,acxcz9vzeroj,58390,58391,116781
60813,,jtvvzo4o0fgj,58391,58392,116783
60814,,jr97vh_tllcj,58392,58393,116785
60815,,aroypqm2zbyj,58393,58394,116787
60816,,2yfpf6ng2bsj,58394,58395,116789
60817,,1nu8pteifq8j,58395,58396,116791
60818,,r9u7b_axhcij,58396,58397,116793
60819,,5h26za2086wj,58397,58398,116795
60820,,url:http://doi.wiley.com/10.1002/he.125,58398,58399,116797
60821,,rlxqp8l6p_gj,58399,58400,116799
60822,,7gjucdswliuj,58400,58401,116801
60823,,gpnlwxl7m4qj,58401,58402,116803
60824,,jf3ys4jimvqj,58402,58403,116805
60825,,uqzw-htqzduj,58403,58404,116807
60826,,_qtu56kalfuj,58404,58405,116809
60827,,uslmcdq5gusj,58405,58406,116811
60828,,url:http://www.csa.com/partners/viewrecord.php3frequester3dgs26collection3dtrd26recid3d0989162ci,58406,58407,116813
60829,,htb6eeqkbz4j,58407,58408,116815
60830,,s6ecxvcx5jej,58408,58409,116817
60831,,ay3hpani4quj,58409,58410,116819
60832,,wjtbdcnur74j,58410,58411,116821
60833,,9b2omkskammj,58411,58412,116823
60834,,tyvqhq6tqxsj,58413,58414,116827
60835,,rhn9vtmrxmij,58414,58415,116829
60836,,dktma5evq34j,58415,58416,116831
60837,,b0n1ks0wpgmj,58416,58417,116833
60838,,o1je4nnszaaj,58417,58418,116835
60839,,ux4xscrvnlsj,58418,58419,116837
60840,,ytpaktbfhv8j,58420,58421,116841
60841,,v2_pxxg3ybkj,58421,58422,116843
60842,,akvuamfzcdyj,58422,58423,116845
60843,,fwvwekb3xz4j,58423,58424,116847
60844,,_02c0jhfvpmj,58424,58425,116849
60845,,url:http://www.springerlink.com/index/n452275219754mp0.pdf,58425,58426,116851
60846,,h7s_bocrxmoj,58426,58427,116853
60847,,url:http://portal.acm.org/citation.cfm3fid3d202672,58427,58428,116855
60848,,g1mpwmacegsj,58428,58429,116857
60849,,myemdmuhyzaj,58429,58430,116859
60850,,g2m7obr_8zkj,58430,58431,116861
60851,,681_yzus-toj,58431,58432,116863
60852,,xsf_znbnltoj,58432,58433,116865
60853,,otpwbqpvoikj,58433,58434,116867
60854,,ddfll4_lio4j,58434,58435,116869
60855,,6ob_7_luwygj,58435,58436,116871
60856,,kifqlhmvrsgj,58436,58437,116873
60857,,bdoz9gctp6sj,58437,58438,116875
60858,,vlvks_1uktuj,58438,58439,116877
60859,,url:http://portal.acm.org/citation.cfm3fid3d182591.18265426dl3dacm26dl3dacm26type3dseries26idx3d18259126part3dproceedings26wanttype3dproceedings26title3dsymposium2520on2520principles2520of2520database2520systems26cfid3d1111111126cftoken3d2222222,58439,58440,116879
60860,,udm1fxuvbh0j,58440,58441,116881
60861,,url:http://portal.acm.org/citation.cfm3fid3d237661.23767226dl3dacm26dl3dacm26type3dseries26idx3d23766126part3dproceedings26wanttype3dproceedings26title3dsymposium2520on2520principles2520of2520database2520systems26cfid3d1111111126cftoken3d2222222,58441,58442,116883
60862,,jvjpmr-7hakj,58442,58443,116885
60863,,url:http://portal.acm.org/citation.cfm3fid3d182591.18260326dl3dguide26dl3dacm26type3dseries26idx3d18259126part3dproceedings26wanttype3dproceedings26title3dsymposium2520on2520principles2520of2520database2520systems26cfid3d1111111126cftoken3d2222222,58443,58444,116887
60864,,ctohzl-xbsmj,58444,58445,116889
60865,,url:http://portal.acm.org/citation.cfm3fid3d800297.81153326dl3dguide26dl3dacm26type3dseries26idx3dseries47326part3dproceedings26wanttype3dproceedings26title3dinternational2520conference2520on2520management2520of2520data2520and2520symposium2520on2520principles2520of2520database2520systems26cfid3d1111111126cftoken3d2222222,58445,58446,116891
60866,,d9rk3ze4hxkj,58446,58447,116893
60867,,9hlhoj6bnmwj,58447,58448,116895
60868,,tncpefgmbtoj,58448,58449,116897
60869,,glor9jsjmv4j,58449,58450,116899
60870,,url:http://portal.acm.org/citation.cfm3fid3d237661.23770726dl3dacm26dl3dacm26type3dseries26idx3d23766126part3dproceedings26wanttype3dproceedings26title3dsymposium2520on2520principles2520of2520database2520systems26cfid3d1111111126cftoken3d2222222,58450,58451,116901
60871,,yv4lnkefdjqj,58451,58452,116903
60872,,ul50mcnyqsej,58452,58453,116905
60873,,361wcsby5vmj,58453,58454,116907
60874,,zllvv5pwsoaj,58454,58455,116909
60875,,wbsq46ve6fyj,58455,58456,116911
60876,,url:http://portal.acm.org/citation.cfm3fid3d6012.1542226dl3dacm26dl3dacm26type3dseries26idx3d601226part3dproceedings26wanttype3dproceedings26title3dsymposium2520on2520principles2520of2520database2520systems26cfid3d1111111126cftoken3d2222222,58456,58457,116913
60877,,ahlofoxubw0j,58457,58458,116915
60878,,url:http://portal.acm.org/citation.cfm3fid3d113413.11343226dl3dacm26dl3dacm26type3dseries26idx3d11341326part3dproceedings26wanttype3dproceedings26title3dsymposium2520on2520principles2520of2520database2520systems26cfid3d1111111126cftoken3d2222222,58458,58459,116917
60879,,url:http://portal.acm.org/citation.cfm3fid3d73721.7374326dl3dportal26dl3dacm26type3dseries26idx3dseries47326part3dproceedings26wanttype3dproceedings26title3dinternational2520conference2520on2520management2520of2520data2520and2520symposium2520on2520principles2520of2520database2520systems26cfid3d1111111126cftoken3d2222222,58460,58461,116921
60880,,ydnum3twwlaj,58461,58462,116923
60881,,url:http://portal.acm.org/citation.cfm3fid3d237661.23768926dl3dacm26dl3dacm26type3dseries26idx3d23766126part3dproceedings26wanttype3dproceedings26title3dsymposium2520on2520principles2520of2520database2520systems26cfid3d1111111126cftoken3d2222222,58462,58463,116925
60882,,8lh_ksrbuyij,58463,58464,116927
60883,,dwdchqdl-mej,58464,58465,116929
60884,,mdhepx-94uuj,58465,58466,116931
60885,,d-muqcrwrxkj,58466,58467,116933
60886,,cvjlz70c0hyj,58467,58468,116935
60887,,mxef2e0949aj,58468,58469,116937
60888,,x4svlefc8c4j,58469,58470,116939
60889,,apjqdi4g3rcj,58470,58471,116941
60890,,syzdbplspwaj,58471,58472,116943
60891,,url:http://ieeexplore.ieee.org/iel5/9217/29235/01320062.pdf3farnumber3d1320062,58472,58473,116945
60892,,sid6kfl9m7oj,58473,58474,116947
60893,,jba8wa_p8mgj,58474,58475,116949
60894,,ks8amusq_5sj,58475,58476,116951
60895,,jtfwtimkt8ij,58476,58477,116953
60896,,tfb9gjlg4_uj,58478,58479,116957
60897,,o4bica_rel0j,58479,58480,116959
60898,,dzi4gwpybocj,58481,58482,116963
60899,,xzdethckmq4j,58482,58483,116965
60900,,lswniorceegj,58483,58484,116967
60901,,t5fn25gbywij,58484,58485,116969
60902,,yj8hw0t8xb4j,58485,58486,116971
60903,,bwjteg-g4agj,58486,58487,116973
60904,,vmdnfxw9w5sj,58487,58488,116975
60905,,xaionmf39pwj,58488,58489,116977
60906,,hgrh-jvfmb4j,58489,58490,116979
60907,,,58490,58491,116981
60908,,yz4bwssh0hwj,58491,58492,116983
60909,,q5gwedmqxgij,58492,58493,116985
60910,,okvhigw3uvsj,58493,58494,116987
60911,,lwrmzsuhny0j,58495,58496,116991
60912,,n1rthprezvkj,58496,58497,116993
60913,,ib3ryfegna8j,58497,58498,116995
60914,,url:http://www.csa.com/partners/viewrecord.php3frequester3dgs26collection3dtrd26recid3dn9210455ah,58498,58499,116997
60915,,fw4kojlmdzoj,58499,58500,116999
60916,,r0c4pvi_-ncj,58501,58502,117003
60917,,yprvyvisg6yj,58502,58503,117005
60918,,j3igp-dywkgj,58503,58504,117007
60919,,c0t5hgncmo0j,58504,58505,117009
60920,,vjhbtnkjdruj,58505,58506,117011
60921,,vrloqd6a2l8j,58506,58507,117013
60922,,ljlb1n3rdaqj,58507,58508,117015
60923,,cxlp1nqpuzcj,58508,58509,117017
60924,,rxrfnxl0dfsj,58509,58510,117019
60925,,xbgk4bdbtucj,58510,58511,117021
60926,,p1keyfmmxp8j,58511,58512,117023
60927,,url:http://www.springerlink.com/index/j805k662617n0160.pdf,58512,58513,117025
60928,,nhg0s1rsbqaj,58513,58514,117027
60929,,ks2-y0dxpn4j,58514,58515,117029
60930,,dakuxchqnzej,58515,58516,117031
60931,,syt_niovnq8j,58516,58517,117033
60932,,qm3a6zlzxwaj,58517,58518,117035
60933,,diumiom-3zmj,58518,58519,117037
60934,,gcq9uwkeutgj,58519,58520,117039
60935,,s9ckzzqqyuaj,58521,58522,117043
60936,,se9flagdqwoj,58523,58524,117047
60937,,ywdvujqsipqj,58524,58525,117049
60938,,gqwasz_7pgmj,58525,58526,117051
60939,,cuxfrtuioecj,58526,58527,117053
60940,,i0l0-vflhyij,58527,58528,117055
60941,,lttsc53hie0j,58528,58529,117057
60942,,0ecglprvrh8j,58529,58530,117059
60943,,dpowv8o9kpuj,58530,58531,117061
60944,,yekldiemapgj,58531,58532,117063
60945,,jlmkf93-pqyj,58533,58534,117067
60946,,wytxctlrmesj,58534,58535,117069
60947,,n4egxug9z5yj,58535,58536,117071
60948,,bnizdeaiilij,58536,58537,117073
60949,,tuyppuxqhwyj,58537,58538,117075
60950,,9koex4aefqwj,58538,58539,117077
60951,,wtl6ztfcevuj,58539,58540,117079
60952,,0vnfz6g0gcwj,58540,58541,117081
60953,,ksizqzxt4tmj,58541,58542,117083
60954,,tsxyoh7f5ocj,58542,58543,117085
60955,,vo2gz9m3bj4j,58543,58544,117087
60956,,4y6z02im5fmj,58544,58545,117089
60957,,wtvbqtbwmpqj,58545,58546,117091
60958,,pvxcbz5bzwkj,58546,58547,117093
60959,,url:http://pubs.acs.org/cgi-bin/abstract.cgi/achre4/2005/38/i08/abs/ar040224c.html,58547,58548,117095
60960,,vurxwzvai44j,58548,58549,117097
60961,,txox_l9dxiij,58549,58550,117099
60962,,bn9dj2jeiv8j,58550,58551,117101
60963,,mg9m3espexej,58551,58552,117103
60964,,w3o6icnkcjoj,58552,58553,117105
60965,,3uzyeffi9r0j,58553,58554,117107
60966,,uwatuj9rnkkj,58554,58555,117109
60967,,mepticlxuscj,58555,58556,117111
60968,,tn5dpbaxvqqj,58556,58557,117113
60969,,ojcqq9yegauj,58557,58558,117115
60970,,dsawzzeanvsj,58558,58559,117117
60971,,vzrmrx-xspoj,58559,58560,117119
60972,,l72glxjjh1yj,58560,58561,117121
60973,,xqnn8k_s29uj,58561,58562,117123
60974,,v8wopxxyqnaj,58562,58563,117125
60975,,405eqlcmbugj,58563,58564,117127
60976,,lhlbudvfkboj,58564,58565,117129
60977,,3gy5tow6vagj,58565,58566,117131
60978,,mzgqenfgmqqj,58566,58567,117133
60979,,il_e8w2nqdwj,58567,58568,117135
60980,,kl3gijly93sj,58568,58569,117137
60981,,url:http://portal.acm.org/citation.cfm3fid3d983048.98304926dl3dguide26dl3dguide26idx3d98304826part3dperiodical26wanttype3dperiodical26title3dacm2520sigmod2520record26cfid3d1111111126cftoken3d2222222,58569,58570,117139
60982,,dsijgnp7fegj,58570,58571,117141
60983,,kcktpkxg8acj,58571,58572,117143
60984,,00yxymkdoygj,58572,58573,117145
60985,,2c7hvg6qu9sj,58573,58574,117147
60986,,mbbfcsxne2sj,58574,58575,117149
60987,,_wvc3q9caysj,58575,58576,117151
60988,,goxkhu_nxnij,58576,58577,117153
60989,,g5inomlmuocj,58577,58578,117155
60990,,9z6eyrecprwj,58578,58579,117157
60991,,gkdss6jjdk4j,58579,58580,117159
60992,,tdcbvwzmjkgj,58580,58581,117161
60993,,egdxhz3lcbij,58581,58582,117163
60994,,vt_gvzhzdf8j,58582,58583,117165
60995,,d7op5ahvcmej,58583,58584,117167
60996,,cvrcyf-vejmj,58584,58585,117169
60997,,tkpv6ol2qqmj,58585,58586,117171
60998,,xvsizuiwrrcj,58586,58587,117173
60999,,juslg_zhjrmj,58587,58588,117175
61000,,url:http://www.csa.com/partners/viewrecord.php3frequester3dgs26collection3dtrd26recid3dn9210502ah,58588,58589,117177
61001,,tkkh9pksgxcj,58589,58590,117179
61002,,qibrxctdrumj,58590,58591,117181
61003,,lyb3zlwgzwaj,58591,58592,117183
61004,,huvqvxy9oyij,58592,58593,117185
61005,,fdyithjwkygj,58593,58594,117187
61006,,cj_wgtthkpyj,58594,58595,117189
61007,,pmjcomp4aakj,58595,58596,117191
61008,,grkzb_ustsij,58596,58597,117193
61009,,ecbt7uathe8j,58597,58598,117195
61010,,gmh5p7fd9bcj,58598,58599,117197
61011,,u7_2j5tckvyj,58599,58600,117199
61012,,hp-wy-m-edsj,58600,58601,117201
61013,,m8xgtqz5jc4j,58601,58602,117203
61014,,_mm9ozyyblaj,58602,58603,117205
61015,,xd-dpskts1oj,58603,58604,117207
61016,,qjkftb5syywj,58604,58605,117209
61017,,ns7vivffuisj,58605,58606,117211
61018,,vwcuqdto5nyj,58606,58607,117213
61019,,blvqav4o2kgj,58607,58608,117215
61020,,o18yvey1rnwj,58608,58609,117217
61021,,ukcvwrnnobqj,58609,58610,117219
61022,,vuidyydpbouj,58610,58611,117221
61023,,uwzocwnzn44j,58611,58612,117223
61024,,tehez_yceaej,58612,58613,117225
61025,,5r3rerxfyz8j,58613,58614,117227
61026,,ryd3ahaburmj,58614,58615,117229
61027,,6juantuacl0j,58615,58616,117231
61028,,c9aeobfjmhyj,58616,58617,117233
61029,,jmjp5pi0wcwj,58617,58618,117235
61030,,aeh2dwbwybuj,58618,58619,117237
61031,,kflpr1xb5hqj,58619,58620,117239
61032,,ldzfpaigmgyj,58620,58621,117241
61033,,url:http://adsabs.harvard.edu/abs/1976scom.nasa..124h,58621,58622,117243
61034,,pq4mzqv84gaj,58622,58623,117245
61035,,sq1wqiyxnxsj,58623,58624,117247
61036,,rtgy8fvxxbkj,58624,58625,117249
61037,,ri8q4cbdooij,58625,58626,117251
61038,,upvhf4zhf00j,58626,58627,117253
61039,,url:http://portal.acm.org/ft_gateway.cfm3fid3d108628626type3dpdf,58627,58628,117255
61040,,ecibbcpbziwj,58628,58629,117257
61041,,0n3zpxtk5tej,58629,58630,117259
61042,,qnbgg2ruu_wj,58630,58631,117261
61043,,r5vnftc-tikj,58631,58632,117263
61044,,9f094dmnreuj,58632,58633,117265
61045,,ss7smp0nwowj,58633,58634,117267
61046,,joxack9vcdoj,58634,58635,117269
61047,,y9mr9qidaeuj,58635,58636,117271
61048,,svl_du_r8msj,58636,58637,117273
61049,,arpsmwoohiaj,58637,58638,117275
61050,,b9bbbxuhm0ej,58638,58639,117277
61051,,ft8sy-kq_v8j,58639,58640,117279
61052,,nsmimbwycyij,58640,58641,117281
61053,,d7o1pmpt7toj,58641,58642,117283
61054,,d9ma_mdl7cej,58642,58643,117285
61055,,l3zzfisu10mj,58643,58644,117287
61056,,eqho4neyxacj,58644,58645,117289
61057,,2lf-iqi0-umj,58645,58646,117291
61058,,7pytswdwu4kj,58646,58647,117293
61059,,jwvzgnhk2bij,58647,58648,117295
61060,,v9az_wug_9uj,58648,58649,117297
61061,,30kvapcloxej,58649,58650,117299
61062,,juarkbw9b1yj,58650,58651,117301
61063,,5566vjewfscj,58651,58652,117303
61064,,mlkvvcjsziyj,58652,58653,117305
61065,,85lkqnnhhssj,58653,58654,117307
61066,,spwlstp02tgj,58654,58655,117309
61067,,a7dmcwm2mpmj,58655,58656,117311
61068,,tx3nkp0b710j,58656,58657,117313
61069,,url:http://doi.wiley.com/10.1002/tl.146,58657,58658,117315
61070,,rxufxprlqmgj,58658,58659,117317
61071,,yoyz0cce3mgj,58659,58660,117319
61072,,blo23jjovzaj,58660,58661,117321
61073,,t7kydxkruxqj,58661,58662,117323
61074,,x5ym2i3h3_wj,58662,58663,117325
61075,,o-tic1xp-igj,58663,58664,117327
61076,,2z7kl5yrqpej,58664,58665,117329
61077,,76d26j-w4qmj,58665,58666,117331
61078,,hnlyi7fpsy4j,58666,58667,117333
61079,,6s9kxnleod8j,58667,58668,117335
61080,,vvk3mtlyxy8j,58668,58669,117337
61081,,2s_mxf8tbfij,58669,58670,117339
61082,,26ijvfwfyvgj,58670,58671,117341
61083,,d9pogwq3beqj,58671,58672,117343
61084,,wjsdbel2n3ej,58672,58673,117345
61085,,gxa9_kj7oc4j,58673,58674,117347
61086,,iz_fhq9fnmcj,58674,58675,117349
61087,,mwqepscm5oqj,58675,58676,117351
61088,,zp5lenu_hxej,58676,58677,117353
61089,,gr7rwnh1g6gj,58677,58678,117355
61090,,0b-kenffqugj,58678,58679,117357
61091,,qzcn26jp988j,58679,58680,117359
61092,,sf2mfmyq2jaj,58680,58681,117361
61093,,tvgonjwkajwj,58681,58682,117363
61094,,eapfugtxwe4j,58682,58683,117365
61095,,,58683,58684,117367
61096,,vmowqbhimtej,58684,58685,117369
61097,,i4k6lnymoikj,58686,58687,117373
61098,,jldvydho8zyj,58687,58688,117375
61099,,_4dgadkm2uwj,58688,58689,117377
61100,,c-mkyjcgqpwj,58689,58690,117379
61101,,hytqhqf6mgcj,58690,58691,117381
61102,,uwef9rvohwkj,58691,58692,117383
61103,,_17zpke47mcj,58692,58693,117385
61104,,h3dmphgbnhkj,58693,58694,117387
61105,,k_krakcozwkj,58694,58695,117389
61106,,l5y7wqzn4bgj,58695,58696,117391
61107,,sd_jr-o0lwej,58696,58697,117393
61108,,ty_xu54dgiej,58697,58698,117395
61109,,9uekf5wskbej,58698,58699,117397
61110,,x3wm5ty4qtuj,58699,58700,117399
61111,,ja2tfktshuwj,58700,58701,117401
61112,,rzvlxrdfygkj,58701,58702,117403
61113,,blxqcz0xprmj,58702,58703,117405
61114,,0uzbq5pil1kj,58703,58704,117407
61115,,a6axoihgxiaj,58704,58705,117409
61116,,c-jxwfdvj0wj,58705,58706,117411
61117,,54xlsjydnvgj,58706,58707,117413
61118,,wpcfn_hmmdaj,58707,58708,117415
61119,,tq6yceiqitij,58708,58709,117417
61120,,eecwhqnzitmj,58709,58710,117419
61121,,ligd_a94qwwj,58710,58711,117421
61122,,w1di9s0fusej,58711,58712,117423
61123,,w7pbinogqaqj,58712,58713,117425
61124,,cunvk6ep1oej,58713,58714,117427
61125,,xdilc9tmzqij,58714,58715,117429
61126,,lgqo_6fwyycj,58715,58716,117431
61127,,lbmct3ewuoej,58716,58717,117433
61128,,itnbsawnncyj,58717,58718,117435
61129,,hoxnesmm36ij,58718,58719,117437
61130,,-9l5fooe6awj,58719,58720,117439
61131,,tat5nz4mk9kj,58720,58721,117441
61132,,udsis2xxlhij,58721,58722,117443
61133,,5kfoaqtt7bmj,58722,58723,117445
61134,,dwwsuaisx5qj,58723,58724,117447
61135,,url:http://pubs.acs.org/cgi-bin/abstract.cgi/achre4/2005/38/i02/abs/ar0401892b.html,58724,58725,117449
61136,,nox2hj9_6esj,58725,58726,117451
61137,,tkez6mtaxvgj,58726,58727,117453
61138,,ifkphrqsupyj,58727,58728,117455
61139,,wuli6oiudyuj,58728,58729,117457
61140,,edcf5nk-krkj,58729,58730,117459
61141,,url:http://www.csa.com/partners/viewrecord.php3frequester3dgs26collection3denv26recid3d8913263,58730,58731,117461
61142,,yfvriavu_qyj,58731,58732,117463
61143,,lfv9a7crdvkj,58732,58733,117465
61144,,b-hpvd6xzsoj,58733,58734,117467
61145,,krlex4lgxkij,58734,58735,117469
61146,,gbudrp9yyosj,58735,58736,117471
61147,,i92663vxnnsj,58736,58737,117473
61148,,hexca0adyucj,58737,58738,117475
61149,,b3vlinkdnoaj,58738,58739,117477
61150,,gcev-683i3wj,58739,58740,117479
61151,,g_ewc1lmzjij,58740,58741,117481
61152,,6wkpocnn61aj,58741,58742,117483
61153,,fnpyotg-sokj,58742,58743,117485
61154,,y69e-v1vbn4j,58743,58744,117487
61155,,jpoigw6pqz8j,58744,58745,117489
61156,,fpubq8-buiwj,58745,58746,117491
61157,,ilrnnr9f6rwj,58746,58747,117493
61158,,mr6xyli9xi0j,58747,58748,117495
61159,,sourslybhqij,58748,58749,117497
61160,,0xgc_qehgxuj,58749,58750,117499
61161,,zi9airg5voyj,58750,58751,117501
61162,,uqhnbpw0zx8j,58751,58752,117503
61163,,an47mph1k4gj,58752,58753,117505
61164,,url:http://www.springerlink.com/index/p65454p71076g451.pdf,58753,58754,117507
61165,,9p1zl71ese8j,58754,58755,117509
61166,,f1itzwg9jy4j,58755,58756,117511
61167,,dx7v7wg77tqj,58756,58757,117513
61168,,zwhe1jv6f84j,58758,58759,117517
61169,,ibgoz5cvdquj,58759,58760,117519
61170,,mhshirx07zmj,58760,58761,117521
61171,,n7tur9zgauij,58761,58762,117523
61172,,nhpfmzgpmiqj,58762,58763,117525
61173,,url:http://links.jstor.org/sici3fsici3d0146-4949(196221252f22)3253a2253c50253aeprgar253e2.0.co253b2-m,58763,58764,117527
61174,,isueayy3pm4j,58764,58765,117529
61175,,kvkmj5tfdcgj,58765,58766,117531
61176,,3xz8ybgqiz4j,58766,58767,117533
61177,,henloq6efpuj,58767,58768,117535
61178,,cioomrnxxqcj,58768,58769,117537
61179,,6x9jsa5yuncj,58769,58770,117539
61180,,cza2ywulwi0j,58771,58772,117543
61181,,5lmegio8s1sj,58772,58773,117545
61182,,6ffqh-kdcbmj,58773,58774,117547
61183,,bkamrydbo3qj,58774,58775,117549
61184,,2oc5vhbeil0j,58775,58776,117551
61185,,,58776,58777,117553
61186,,ockugeackpyj,58777,58778,117555
61187,,hkxr2bh07ioj,58778,58779,117557
61188,,z8nuo6ncrx8j,58779,58780,117559
61189,,hpsx3cgupkij,58780,58781,117561
61190,,mkllofm2oqej,58781,58782,117563
61191,,nblcys05v_ej,58782,58783,117565
61192,,url:http://portal.acm.org/citation.cfm3fid3d647678.732008,58783,58784,117567
61193,,ipmay65xkmej,58784,58785,117569
61194,,axyhjf86q20j,58785,58786,117571
61195,,kgl4tagt2mij,58786,58787,117573
61196,,g8n9qyesafej,58787,58788,117575
61197,,meujhxovhvuj,58788,58789,117577
61198,,fulibwezsaej,58789,58790,117579
61199,,ctjzeqh3azmj,58790,58791,117581
61200,,ksp6b0pgpb4j,58791,58792,117583
61201,,b2iob6wdrjqj,58792,58793,117585
61202,,dgtewxsnij0j,58793,58794,117587
61203,,vpucnrdfyymj,58794,58795,117589
61204,,7226rvgbo04j,58795,58796,117591
61205,,url:http://portal.acm.org/ft_gateway.cfm3fid3d15689526type3dpdf26coll3dguide26dl3dacm26cfid3d1111111126cftoken3d2222222,58796,58797,117593
61206,,bf9f-werwhmj,58797,58798,117595
61207,,rze5fsphawej,58798,58799,117597
61208,,igsgvlezldqj,58799,58800,117599
61209,,bjlqgujkbnej,58800,58801,117601
61210,,g6yw0nmbaycj,58801,58802,117603
61211,,s3bkpvucbxyj,58802,58803,117605
61212,,fcrnjlb06ecj,58803,58804,117607
61213,,hec_ldqzapgj,58804,58805,117609
61214,,yjapepxblvcj,58805,58806,117611
61215,,z-xae0ovppoj,58806,58807,117613
61216,,ydthuoexaygj,58807,58808,117615
61217,,fggmegqbq1ij,58808,58809,117617
61218,,u-ygwwnhfcqj,58809,58810,117619
61219,,wup5qcxfr2ej,58810,58811,117621
61220,,lctpzqva_qsj,58811,58812,117623
61221,,xnz-wz6uhacj,58812,58813,117625
61222,,adrn3tkzyrij,58813,58814,117627
61223,,_pvf5q7edrkj,58814,58815,117629
61224,,url:http://portal.acm.org/ft_gateway.cfm3fid3d108373326type3dpdf,58815,58816,117631
61225,,yobl0vbcqvwj,58816,58817,117633
61226,,mhyyhn__fyuj,58817,58818,117635
61227,,url:http://www.csa.com/partners/viewrecord.php3frequester3dgs26collection3dtrd26recid3dn9210568ah,58818,58819,117637
61228,,d_rvghnbhlej,58819,58820,117639
61229,,g91zh1jd3ecj,58820,58821,117641
61230,,otiirqass4mj,58821,58822,117643
61231,,rdcwpkdwjmqj,58822,58823,117645
61232,,6sqcfwz4cbkj,58823,58824,117647
61233,,url:http://www.csa.com/partners/viewrecord.php3frequester3dgs26collection3dtrd26recid3d20021211018629mt26recid3da8012640ah,58824,58825,117649
61234,,13vuf9ntwduj,58825,58826,117651
61235,,28mtfsc-kcij,58826,58827,117653
61236,,ukrgrvxmnkkj,58828,58829,117657
61237,,nyg2uo_1krcj,58829,58830,117659
61238,,o_trkjdfb5mj,58830,58831,117661
61239,,ygnunfcktpmj,58831,58832,117663
61240,,pwg9kngegn0j,58832,58833,117665
61241,,0o32qoiufboj,58833,58834,117667
61242,,aivqiwbbngij,58834,58835,117669
61243,,e_symzxingwj,58835,58836,117671
61244,,hxdfalzp8iyj,58836,58837,117673
61245,,jjdrwhmd3tkj,58837,58838,117675
61246,,6qjy2i9nfloj,58838,58839,117677
61247,,,58839,58840,117679
61248,,a5epb4_afhsj,58840,58841,117681
61249,,2tzcuym7pfsj,58841,58842,117683
61250,,qne3kxnhrlkj,58842,58843,117685
61251,,0va_bsrr_d4j,58843,58844,117687
61252,,bcyu4bhaskuj,58844,58845,117689
61253,,bpllldpti74j,58845,58846,117691
61254,,tocuqxgfkoaj,58846,58847,117693
61255,,xvpqkb-s_iij,58847,58848,117695
61256,,ngoxabsnxumj,58848,58849,117697
61257,,pailefsqdnoj,58849,58850,117699
61258,,afwrtvcl13cj,58850,58851,117701
61259,,z6q3tajs7uyj,58851,58852,117703
61260,,3sovb8uegj0j,58852,58853,117705
61261,,4jjz7k80proj,58853,58854,117707
61262,,o3-zppqke80j,58854,58855,117709
61263,,o-1xenwqcgoj,58855,58856,117711
61264,,6jmdgknnxjgj,58856,58857,117713
61265,,gbkoobkytgyj,58857,58858,117715
61266,,elfiygde_voj,58858,58859,117717
61267,,se9zwsjlm_sj,58860,58861,117721
61268,,6v71nklbyi4j,58861,58862,117723
61269,,u2b_voyjov4j,58862,58863,117725
61270,,ii2aonilfecj,58863,58864,117727
61271,,m2lpfhkog5kj,58864,58865,117729
61272,,5cwufy7zraoj,58865,58866,117731
61273,,dginkdamkj8j,58866,58867,117733
61274,,agidczofn2mj,58868,58869,117737
61275,,esosnaviqi4j,58869,58870,117739
61276,,d1hdhoonvl4j,58870,58871,117741
61277,,xtl7wklyb64j,58871,58872,117743
61278,,bqsvyugwls8j,58872,58873,117745
61279,,hfwxgb0erdqj,58873,58874,117747
61280,,byxvupr9bjqj,58874,58875,117749
61281,,v_fnuwkirh8j,58875,58876,117751
61282,,9gn1y43tmxej,58876,58877,117753
61283,,8fa_hyd-wumj,58877,58878,117755
61284,,lwfat23a-uij,58878,58879,117757
61285,,oallzl4dqxsj,58879,58880,117759
61286,,2s3xtoiju7wj,58880,58881,117761
61287,,ntsn5_uvd3gj,58881,58882,117763
61288,,j7e6vgg4kouj,58882,58883,117765
61289,,fy3kkkzblw8j,58883,58884,117767
61290,,t2zm9dcwiomj,58884,58885,117769
61291,,s1d8rlvge3qj,58885,58886,117771
61292,,9zxl0uykucwj,58886,58887,117773
61293,,s-bt0x6h2quj,58887,58888,117775
61294,,k1gqz6exa-gj,58888,58889,117777
61295,,mhskh8h0x2oj,58889,58890,117779
61296,,zwrxlfeupqkj,58890,58891,117781
61297,,vbi6xdjg0x8j,58891,58892,117783
61298,,_onl2pr9a6kj,58892,58893,117785
61299,,cnftpz71xmyj,58893,58894,117787
61300,,yn4hiicioiej,58894,58895,117789
61301,,auoy7ikv8_4j,58895,58896,117791
61302,,xgj-tahyo7yj,58896,58897,117793
61303,,f1bohdxuij4j,58897,58898,117795
61304,,fsck4pvptg4j,58898,58899,117797
61305,,xlo5exd1nckj,58899,58900,117799
61306,,vn1g9mglh4mj,58901,58902,117803
61307,,h4b5wanpcywj,58902,58903,117805
61308,,q07zlifj2i4j,58903,58904,117807
61309,,_--0upmswpsj,58904,58905,117809
61310,,url:http://portal.acm.org/ft_gateway.cfm3fid3d34481926type3dpdf26dl3dguide26dl3dacm26cfid3d1111111126cftoken3d2222222,58905,58906,117811
61311,,pnqsrkhlbvaj,58906,58907,117813
61312,,_o6nksjhqxmj,58907,58908,117815
61313,,jwat--yzopaj,58908,58909,117817
61314,,gys_ss2rpuqj,58909,58910,117819
61315,,nswwuxvxckgj,58910,58911,117821
61316,,ixrttbgsagij,58911,58912,117823
61317,,98jat0cxmguj,58912,58913,117825
61318,,fhtbsphq5qsj,58913,58914,117827
61319,,sqndboib3haj,58914,58915,117829
61320,,v7acdop85w4j,58915,58916,117831
61321,,dks-x323egmj,58916,58917,117833
61322,,c53ls4elbhcj,58917,58918,117835
61323,,fjl_5gxydqyj,58918,58919,117837
61324,,jiv9bk2-myqj,58919,58920,117839
61325,,igvswuz_lwcj,58920,58921,117841
61326,,ircpx0pnfnsj,58921,58922,117843
61327,,ter2z1k6ph0j,58922,58923,117845
61328,,xrhytwegzomj,58923,58924,117847
61329,,qwiebe_d-tsj,58924,58925,117849
61330,,vxhd6w85_auj,58925,58926,117851
61331,,hk54xbubysoj,58926,58927,117853
61332,,fh_t3ddwhlaj,58927,58928,117855
61333,,l4t-upndalkj,58928,58929,117857
61334,,ursne38mm1ej,58929,58930,117859
61335,,yxiru4xzibaj,58930,58931,117861
61336,,wxcjwg20dxij,58931,58932,117863
61337,,fyjviqb-0b4j,58932,58933,117865
61338,,2kbdpbznpcwj,58933,58934,117867
61339,,jx1un8yvd1ij,58934,58935,117869
61340,,nkqjapmxkaaj,58936,58937,117873
61341,,gsp43tr3ktgj,58937,58938,117875
61342,,ebwj4pbitzij,58938,58939,117877
61343,,bklxx5lergqj,58939,58940,117879
61344,,gkx8uyweengj,58940,58941,117881
61345,,vpacbnhrz3wj,58941,58942,117883
61346,,uvzhbhr0qscj,58942,58943,117885
61347,,d4yn9irtpdcj,58943,58944,117887
61348,,hajug-2gqdkj,58944,58945,117889
61349,,bd-lu1jeg-aj,58945,58946,117891
61350,,spy0ewsyokyj,58946,58947,117893
61351,,yzfbjd6ggduj,58947,58948,117895
61352,,url:http://links.jstor.org/sici3fsici3d0146-4949(196723)8253a4253c548253aasrote253e2.0.co253b2-a,58948,58949,117897
61353,,fv4rjgmrgbkj,58949,58950,117899
61354,,sdp7pnlzuv4j,58950,58951,117901
61355,,zeotceypyh0j,58951,58952,117903
61356,,nmirl_rhpvyj,58952,58953,117905
61357,,tr0xq6ivypwj,58953,58954,117907
61358,,05enf0fxewaj,58954,58955,117909
61359,,pa_obvyi9tcj,58955,58956,117911
61360,,yky8tz43mzmj,58956,58957,117913
61361,,yolbqqsdtzaj,58957,58958,117915
61362,,kxdsfrngowij,58958,58959,117917
61363,,t4h_5q-uc6kj,58959,58960,117919
61364,,dr5nb6ey72cj,58960,58961,117921
61365,,dpq1efxdtt4j,58961,58962,117923
61366,,yhwxd8vfvyuj,58962,58963,117925
61367,,url:http://ieeexplore.ieee.org/xpl/abs_free.jsp3farnumber3d1316835,58963,58964,117927
61368,,uwwdv6ztbh4j,58964,58965,117929
61369,,shsg3d9amzoj,58965,58966,117931
61370,,q13gzkio8v4j,58966,58967,117933
61371,,g0lobdtyfhmj,58967,58968,117935
61372,,py1uoctqcruj,58968,58969,117937
61373,,,58969,58970,117939
61374,,da1huuu5hgej,58970,58971,117941
61375,,crv1svgclouj,58971,58972,117943
61376,,lxppoh_t9taj,58972,58973,117945
61377,,y-legunlwpej,58973,58974,117947
61378,,dwaagapho1ej,58974,58975,117949
61379,,vognhybffikj,58975,58976,117951
61380,,pvumggjga7gj,58976,58977,117953
61381,,rxwhkfjt95wj,58977,58978,117955
61382,,ifx4cyl1xmqj,58978,58979,117957
61383,,rgjdfx5ascaj,58979,58980,117959
61384,,url:http://www.ingentaconnect.com/content/els/13891286/1999/00000031/00000009/art00013,58980,58981,117961
61385,,yptwjwu-nkmj,58981,58982,117963
61386,,qp9jtkepf_8j,58982,58983,117965
61387,,-0o9sjtcbkaj,58983,58984,117967
61388,,0mywkwkwviuj,58984,58985,117969
61389,,v9mlnue_nxgj,58985,58986,117971
61390,,oihdoudfceqj,58986,58987,117973
61391,,n6gwz81vta8j,58988,58989,117977
61392,,3nfgpvhaqokj,58989,58990,117979
61393,,zf8g79-uynqj,58990,58991,117981
61394,,j-rvyrj1r50j,58991,58992,117983
61395,,wjkeimbfypqj,58992,58993,117985
61396,,rgg1jbrkcg8j,58993,58994,117987
61397,,aijykaarhq8j,58994,58995,117989
61398,,url:http://portal.acm.org/ft_gateway.cfm3fid3d110196326type3dpdf,58995,58996,117991
61399,,1hsskuhxrvaj,58996,58997,117993
61400,,url:http://doi.wiley.com/10.1002/ev.1477,58997,58998,117995
61401,,xddljyyazyij,58998,58999,117997
61402,,odnmcijo6xmj,58999,59000,117999
61403,,y1qs0j9--wmj,59000,59001,118001
61404,,rlyqhsix57aj,59001,59002,118003
61405,,mi5pq7g9kmwj,59002,59003,118005
61406,,9-uzlkjstwyj,59003,59004,118007
61407,,xa4--a6oevqj,59004,59005,118009
61408,,lvaelcgxdz0j,59006,59007,118013
61409,,fwurg_kgtsyj,59007,59008,118015
61410,,bohvmrfy5cwj,59008,59009,118017
61411,,3gbnk1g8ek4j,59009,59010,118019
61412,,yuzcropw2lqj,59010,59011,118021
61413,,hyranl42nnsj,59011,59012,118023
61414,,vs5dp34ase0j,59012,59013,118025
61415,,rizkrozwuxij,59013,59014,118027
61416,,1ui4onebxe4j,59014,59015,118029
61417,,zl3sfug2uqsj,59015,59016,118031
61418,,s34vco8rlfkj,59016,59017,118033
61419,,n2q6tnvletij,59017,59018,118035
61420,,tlpu0xbrufcj,59018,59019,118037
61421,,2uuf8hwd0iej,59019,59020,118039
61422,,gerfgtb8oc0j,59020,59021,118041
61423,,gmlvkbtgaqij,59021,59022,118043
61424,,a9ud39rws5aj,59022,59023,118045
61425,,ofxlw3vrjb8j,59023,59024,118047
61426,,xzcjbhh3gwaj,59024,59025,118049
61427,,j-xjlx0nuxsj,59025,59026,118051
61428,,rcsfdxbif40j,59026,59027,118053
61429,,nyfp9ckzj4sj,59027,59028,118055
61430,,cjlpcpdaywuj,59028,59029,118057
61431,,qn6r3ec61b4j,59029,59030,118059
61432,,ojkdnggrzbkj,59030,59031,118061
61433,,rq9fppas2h8j,59031,59032,118063
61434,,fnjzqvzc81ej,59032,59033,118065
61435,,48uwe13ssxqj,59033,59034,118067
61436,,url:http://portal.acm.org/ft_gateway.cfm3fid3d37575526type3dpdf26dl3dguide26dl3dguide26cfid3d1111111126cftoken3d2222222,59034,59035,118069
61437,,exizizrhhnoj,59035,59036,118071
61438,,g_2nwkv90lsj,59036,59037,118073
61439,,rljsegt6ubmj,59037,59038,118075
61440,,x4fawdtxdwmj,59038,59039,118077
61441,,fqged2cd7-kj,59039,59040,118079
61442,,ovkezcfd8c4j,59040,59041,118081
61443,,xcsktbjhht4j,59041,59042,118083
61444,,v9mt_gxj0nkj,59042,59043,118085
61445,,a-awipkinnij,59043,59044,118087
61446,,x-nt0euzwguj,59044,59045,118089
61447,,mxb3c8stlmkj,59045,59046,118091
61448,,url:http://www.csa.com/partners/viewrecord.php3frequester3dgs26collection3dtrd26recid3da8622985ah,59046,59047,118093
61449,,cqlnlmump1aj,59047,59048,118095
61450,,we9hgnwq8yaj,59048,59049,118097
61451,,ezttborgnocj,59049,59050,118099
61452,,ssfct5wh8gsj,59050,59051,118101
61453,,zdvag5mpsk8j,59051,59052,118103
61454,,hptbysmponqj,59052,59053,118105
61455,,v5h6nvwa-ckj,59053,59054,118107
61456,,sn_twi_w0e4j,59054,59055,118109
61457,,whfepjegjvwj,59055,59056,118111
61458,,hddfzds10usj,59056,59057,118113
61459,,yqj3tinkti8j,59057,59058,118115
61460,,ehxswsqe8aqj,59058,59059,118117
61461,,xlpwp0xh9fkj,59059,59060,118119
61462,,pf2wwyy8zw8j,59060,59061,118121
61463,,5q16mr6ji-uj,59061,59062,118123
61464,,ypcmyrt5apsj,59062,59063,118125
61465,,lnxzwujvgiij,59063,59064,118127
61466,,1-6mdejtalcj,59064,59065,118129
61467,,aavc-qwpickj,59065,59066,118131
61468,,2k9bgrjc-hyj,59066,59067,118133
61469,,dffmx-ubxwwj,59067,59068,118135
61470,,nnxjknvk9r8j,59068,59069,118137
61471,,eh-up_ms7lwj,59069,59070,118139
61472,,zspks_n08soj,59070,59071,118141
61473,,k5qknddp-a8j,59071,59072,118143
61474,,i4yvkvig740j,59072,59073,118145
61475,,zhwndtchkcyj,59073,59074,118147
61476,,nahlp4ht2q0j,59074,59075,118149
61477,,5izkao0gid0j,59075,59076,118151
61478,,oagky4jg9smj,59076,59077,118153
61479,,kddxbll1b9oj,59077,59078,118155
61480,,feoi0ph0kraj,59078,59079,118157
61481,,f-bmhdw_e6uj,59079,59080,118159
61482,,98qnbhppob0j,59080,59081,118161
61483,,6oc8vmthoymj,59081,59082,118163
61484,,ewssq4rkmwcj,59082,59083,118165
61485,,yqlbu-vwjncj,59083,59084,118167
61486,,qxbp0nklkg4j,59084,59085,118169
61487,,nvoypo09qvcj,59086,59087,118173
61488,,d4pxzn5uqkoj,59087,59088,118175
61489,,fkrudikh2moj,59088,59089,118177
61490,,67n0l4ybcnej,59089,59090,118179
61491,,hms2ht2ozwuj,59090,59091,118181
61492,,gkmk6o_x9pcj,59091,59092,118183
61493,,url:http://portal.acm.org/ft_gateway.cfm3fid3d110195526type3dpdf,59092,59093,118185
61494,,8pbh3c_b3daj,59093,59094,118187
61495,,bd9wifrtcvej,59094,59095,118189
61496,,jvhts-6k2fuj,59095,59096,118191
61497,,t72tfxsvamej,59096,59097,118193
61498,,h9vxk33kqx0j,59097,59098,118195
61499,,wuivwx-lmuwj,59098,59099,118197
61500,,nfm1nudgg-qj,59099,59100,118199
61501,,flotep2xkyoj,59100,59101,118201
61502,,url:http://www.csa.com/partners/viewrecord.php3frequester3dgs26collection3dtrd26recid3da8622907ah,59101,59102,118203
61503,,2t5i0yvqgccj,59103,59104,118207
61504,,g0mmiqalmquj,59104,59105,118209
61505,,appywh8fmygj,59105,59106,118211
61506,,75_wippd1a4j,59106,59107,118213
61507,,r8hadfw66ksj,59107,59108,118215
61508,,8vcq5k9ru4wj,59108,59109,118217
61509,,pbrlodgoduij,59109,59110,118219
61510,,lz2grenzzrej,59110,59111,118221
61511,,gej7rbztg94j,59111,59112,118223
61512,,abhqowqz1pgj,59112,59113,118225
61513,,mq570m4affwj,59113,59114,118227
61514,,fv65komegdyj,59114,59115,118229
61515,,pmkvwdgji-mj,59115,59116,118231
61516,,bls0ojtz2twj,59116,59117,118233
61517,,_bfc8khj4qij,59117,59118,118235
61518,,5vz9vzvrsrmj,59118,59119,118237
61519,,xfb0su7dvk0j,59119,59120,118239
61520,,avdejbghvmij,59120,59121,118241
61521,,7bitau8qhpej,59121,59122,118243
61522,,2rsjuyud_xij,59122,59123,118245
61523,,kee6sd-ozeej,59123,59124,118247
61524,,bkljmkgrln0j,59124,59125,118249
61525,,emzw_cqk35gj,59125,59126,118251
61526,,aiowdqrmizwj,59126,59127,118253
61527,,gkeopxim4gkj,59127,59128,118255
61528,,d1xwpsmzcfcj,59128,59129,118257
61529,,me4__jyifwoj,59129,59130,118259
61530,,yvkc62tcwkqj,59130,59131,118261
61531,,tte6f_wljgmj,59131,59132,118263
61532,,qveqbp1lywej,59132,59133,118265
61533,,l_x1s1fk3ykj,59133,59134,118267
61534,,url:http://adsabs.harvard.edu/abs/1990mit..reptq....h,59134,59135,118269
61535,,gw0zeg2xnjwj,59135,59136,118271
61536,,3egam6vqhg0j,59136,59137,118273
61537,,en81uwadrjaj,59137,59138,118275
61538,,eezk1w63skcj,59138,59139,118277
61539,,ih9hp7iuvqqj,59139,59140,118279
61540,,wk_v-9st3xij,59140,59141,118281
61541,,wc6dlmt75ikj,59141,59142,118283
61542,,ajz4oycomtgj,59142,59143,118285
61543,,5aomnesniqwj,59143,59144,118287
61544,,g9scds7t_myj,59144,59145,118289
61545,,9-9venwyacej,59145,59146,118291
61546,,34rbp90vkpgj,59146,59147,118293
61547,,054ftonqxuyj,59147,59148,118295
61548,,lmj3op07ipej,59148,59149,118297
61549,,78k87pml0gqj,59149,59150,118299
61550,,l_bbjea1mo8j,59150,59151,118301
61551,,gmegoq2uulmj,59151,59152,118303
61552,,url:http://www.csa.com/partners/viewrecord.php3frequester3dgs26collection3dtrd26recid3d8608720322md,59152,59153,118305
61553,,qj9kgx4rjlmj,59153,59154,118307
61554,,eqbq6dxmckej,59155,59156,118311
61555,,vcwk-ke6hgej,59156,59157,118313
61556,,oqxpqgpopa4j,59157,59158,118315
61557,,ke_rrumk1xqj,59158,59159,118317
61558,,dsrg_0mlqz0j,59159,59160,118319
61559,,url:http://portal.acm.org/citation.cfm3fid3d38713.38742,59160,59161,118321
61560,,e3wrtwfuu2oj,59161,59162,118323
61561,,d4wwcmwezc0j,59162,59163,118325
61562,,url:http://portal.acm.org/ft_gateway.cfm3fid3d102763626type3dpdf,59163,59164,118327
61563,,hqxnwex_k_ij,59164,59165,118329
61564,,c0r0itvlqpkj,59165,59166,118331
61565,,je_yc2n-4nkj,59166,59167,118333
61566,,6yalc7gn4tsj,59167,59168,118335
61567,,o-jkvpnvramj,59168,59169,118337
61568,,url:http://portal.acm.org/citation.cfm3fid3d319878.31993826dl3dguide26dl3dacm26type3dseries26idx3d31987826part3dproceedings26wanttype3dproceedings26title3dinternational2520multimedia2520conference26cfid3d1111111126cftoken3d2222222,59169,59170,118339
61569,,mllsaqbfb1oj,59170,59171,118341
61570,,sowxnzzayuuj,59171,59172,118343
61571,,url:http://portal.acm.org/citation.cfm3fid3d1007677,59172,59173,118345
61572,,k2h7iuzrrvmj,59173,59174,118347
61573,,mwl6iy4cnd4j,59174,59175,118349
61574,,y_zysn5-f3mj,59175,59176,118351
61575,,i5trav6kqo4j,59176,59177,118353
61576,,c0mztcewne0j,59177,59178,118355
61577,,cz01t5giwhwj,59178,59179,118357
61578,,tfvdhk-8s14j,59179,59180,118359
61579,,g2zdqpr7kisj,59180,59181,118361
61580,,jzlonxijnfuj,59181,59182,118363
61581,,7drzi7gbwt0j,59182,59183,118365
61582,,wjekqp_a0cmj,59183,59184,118367
61583,,7xca9kqmtiaj,59185,59186,118371
61584,,xo3lgvna2ruj,59186,59187,118373
61585,,ta7xbwt0tcwj,59187,59188,118375
61586,,lz8d83jcpu8j,59188,59189,118377
61587,,bkh_ifndjdoj,59189,59190,118379
61588,,yh5t1bp0tggj,59190,59191,118381
61589,,zdy5zmpsmgcj,59191,59192,118383
61590,,kh-ceer6s8qj,59192,59193,118385
61591,,yabwsyqur-8j,59193,59194,118387
61592,,80subkbbupaj,59194,59195,118389
61593,,cwkaoniuesaj,59195,59196,118391
61594,,url:http://doi.wiley.com/10.1002/tl.186,59196,59197,118393
61595,,url:http://portal.acm.org/citation.cfm3fid3d234286.1057808,59197,59198,118395
61596,,nawlytxmzl8j,59198,59199,118397
61597,,mjvvyh6adqaj,59199,59200,118399
61598,,pm7jehv6tuoj,59200,59201,118401
61599,,mmr55vefu00j,59201,59202,118403
61600,,eahzkjq-bi8j,59202,59203,118405
61601,,vyam8gmauyqj,59203,59204,118407
61602,,srvlgghsy7kj,59204,59205,118409
61603,,2d3inxthxwoj,59205,59206,118411
61604,,mngbak2u140j,59206,59207,118413
61605,,bdq4sa_5yhoj,59207,59208,118415
61606,,x1up0i3hqi0j,59208,59209,118417
61607,,hee03evbflsj,59209,59210,118419
61608,,jgsydu_8uzcj,59210,59211,118421
61609,,whgvkyyxhwmj,59211,59212,118423
61610,,cvv48v9g84ej,59212,59213,118425
61611,,iup2jp2mob0j,59213,59214,118427
61612,,jdwwiabompsj,59214,59215,118429
61613,,w-nkqkykaycj,59215,59216,118431
61614,,qyzr7fvrphqj,59216,59217,118433
61615,,r8wfuikowfkj,59217,59218,118435
61616,,g1zkmkjnmw8j,59218,59219,118437
61617,,5yfar4w1u9qj,59219,59220,118439
61618,,3oi9qjr3u6yj,59220,59221,118441
61619,,asscsauutxwj,59221,59222,118443
61620,,gvqtnwbsf9oj,59222,59223,118445
61621,,m8m-agkih3yj,59223,59224,118447
61622,,ydhkbffeceej,59224,59225,118449
61623,,i7ifovdfog8j,59225,59226,118451
61624,,8emn5uwicfmj,59226,59227,118453
61625,,mr8szpn8g4ej,59227,59228,118455
61626,,laowxph_emej,59228,59229,118457
61627,,ro1liuqvp0uj,59229,59230,118459
61628,,ku_zrwkdmjuj,59230,59231,118461
61629,,url:http://www.csa.com/partners/viewrecord.php3frequester3dgs26collection3dtrd26recid3dn9210526ah,59231,59232,118463
61630,,uwei1z7903oj,59232,59233,118465
61631,,1tjmhu9hogqj,59233,59234,118467
61632,,xbzpmrdw7k8j,59234,59235,118469
61633,,rozigorqw9oj,59235,59236,118471
61634,,auwaiuwpi88j,59236,59237,118473
61635,,wodbzpktlekj,59237,59238,118475
61636,,zbojvpxsyboj,59238,59239,118477
61637,,url:http://portal.acm.org/citation.cfm3fid3d100215.100258,59239,59240,118479
61638,,epfm3pdaa2kj,59240,59241,118481
61639,,sf6armuaspoj,59241,59242,118483
61640,,whcqfxw0ykcj,59242,59243,118485
61641,,blnzqf4yyk0j,59243,59244,118487
61642,,mjfxv3uukg4j,59244,59245,118489
61643,,9ed6vwqs4wqj,59245,59246,118491
61644,,euwqvhq7-uyj,59246,59247,118493
61645,,ehycjbb7pb8j,59247,59248,118495
61646,,ilwfjrx22vyj,59248,59249,118497
61647,,attxhyi-l-aj,59249,59250,118499
61648,,vjaofpt9644j,59250,59251,118501
61649,,e7n82yyp8uij,59251,59252,118503
61650,,url:http://www.springerlink.com/index/g08034312u27126v.pdf,59252,59253,118505
61651,,iecf1ntjdo0j,59253,59254,118507
61652,,g7lrazfw8hoj,59254,59255,118509
61653,,2zkhsttxrlwj,59255,59256,118511
61654,,ym8qesugdjyj,59256,59257,118513
61655,,iaqxzr4fmqaj,59257,59258,118515
61656,,sgl0bseamkcj,59258,59259,118517
61657,,url:http://portal.acm.org/ft_gateway.cfm3fid3d13031826type3dpdf26dl3dportal26dl3dacm26cfid3d1111111126cftoken3d2222222,59259,59260,118519
61658,,xg7lgosifzqj,59260,59261,118521
61659,,t1lndc6xhb4j,59261,59262,118523
61660,,hbbbpadwpdoj,59262,59263,118525
61661,,url:http://portal.acm.org/citation.cfm3fid3d1041410.1041430,59263,59264,118527
61662,,er0poabycfmj,59264,59265,118529
61663,,nmxkojkvimgj,59265,59266,118531
61664,,iwl7ebgyy38j,59266,59267,118533
61665,,356jyb4b6ryj,59267,59268,118535
61666,,qwmfia1hurij,59268,59269,118537
61667,,jhp8aib7gssj,59269,59270,118539
61668,,url:http://portal.acm.org/ft_gateway.cfm3fid3d110123326type3dpdf,59270,59271,118541
61669,,0vmkmzywsx0j,59271,59272,118543
61670,,wugywy6vwbej,59272,59273,118545
61671,,dd8gc-_cwt4j,59273,59274,118547
61672,,url:http://www.csa.com/partners/viewrecord.php3frequester3dgs26collection3dtrd26recid3dn9210507ah,59274,59275,118549
61673,,mm2aib9mpyij,59275,59276,118551
61674,,pgk6pfdhomwj,59276,59277,118553
61675,,a6w0vrtdzswj,59277,59278,118555
61676,,,59278,59279,118557
61677,,cagfle0tm6qj,59280,59281,118561
61678,,sx5g1zkjflmj,59281,59282,118563
61679,,rghfa2eecuij,59282,59283,118565
61680,,28mt88pg7skj,59283,59284,118567
61681,,kuy7cz44ggmj,59284,59285,118569
61682,,v6qowdfgbjwj,59285,59286,118571
61683,,gdx6ybr0bgcj,59286,59287,118573
61684,,swydmtyvobaj,59287,59288,118575
61685,,,59288,59289,118577
61686,,qv0nsl__h2oj,59289,59290,118579
61687,,oticho8rdngj,59290,59291,118581
61688,,barmjgvwmumj,59291,59292,118583
61689,,5c3kkgrgilmj,59292,59293,118585
61690,,n-7fav7tjzyj,59293,59294,118587
61691,,etkd2r1optij,59294,59295,118589
61692,,shi9z7hq3fcj,59295,59296,118591
61693,,kp2rfwomi24j,59296,59297,118593
61694,,vt5cpb0q1vkj,59297,59298,118595
61695,,rcgydcoyp1oj,59298,59299,118597
61696,,qsgxfmkvt4ij,59299,59300,118599
61697,,gj_mp9uplb8j,59300,59301,118601
61698,,grhvi4pct0ij,59301,59302,118603
61699,,url:http://portal.acm.org/citation.cfm3fid3d192593.19737926dl3dguide26dl3dacm26type3dseries26idx3d19259326part3dproceedings26wanttype3dproceedings26title3dinternational2520multimedia2520conference26cfid3d1111111126cftoken3d2222222,59302,59303,118605
61700,,anivo49wsfsj,59303,59304,118607
61701,,2fkwwnajbwij,59304,59305,118609
61702,,sn5j6hj-ba8j,59305,59306,118611
61703,,7esmodcjsxyj,59306,59307,118613
61704,,r1gpcrr-x3wj,59307,59308,118615
61705,,wp9so78gnk8j,59308,59309,118617
61706,,9f8m7gcegi0j,59309,59310,118619
61707,,vzbdz52l7xcj,59310,59311,118621
61708,,sqbz0pkg_-4j,59311,59312,118623
61709,,wpml6ex7gkoj,59312,59313,118625
61710,,coyol1bzlj0j,59315,59316,118631
61711,,xcuorrvcclwj,59316,59317,118633
61712,,hj5kvte92nwj,59317,59318,118635
61713,,hnk7_6ywiz8j,59318,59319,118637
61714,,hsqlyqc11tgj,59319,59320,118639
61715,,yqq83fj3owej,59320,59321,118641
61716,,bywmwdhbmzuj,59321,59322,118643
61717,,tlwtrztpqj4j,59322,59323,118645
61718,,f52gq64lt2gj,59323,59324,118647
61719,,fryixt0kwmyj,59324,59325,118649
61720,,i35aiunts7aj,59325,59326,118651
61721,,38mychpdskuj,59326,59327,118653
61722,,cdyfem-qebaj,59327,59328,118655
61723,,w00lh7xf7zyj,59328,59329,118657
61724,,dpnetta7au4j,59329,59330,118659
61725,,n4by17dhgwsj,59330,59331,118661
61726,,inlmlv5jztaj,59331,59332,118663
61727,,i1jeshn7wnyj,59332,59333,118665
61728,,jsucrxtxhw4j,59333,59334,118667
61729,,hmlumiibs4mj,59334,59335,118669
61730,,5tdpnrcwm1mj,59335,59336,118671
61731,,4yugfbghdp8j,59336,59337,118673
61732,,szosacjd9dmj,59337,59338,118675
61733,,5ziid0k2zsuj,59338,59339,118677
61734,,p31veabwygoj,59340,59341,118681
61735,,vyw0a6swdbqj,59341,59342,118683
61736,,_f9oj62nenkj,59342,59343,118685
61737,,iqew9ssj2qaj,59343,59344,118687
61738,,x7i_t3z-vesj,59344,59345,118689
61739,,kw8ud6cyi54j,59346,59347,118693
61740,,r17oalqvrd4j,59347,59348,118695
61741,,no8lhskppt8j,59348,59349,118697
61742,,cqgdhd9fm5cj,59349,59350,118699
61743,,zjhgj5jwp7uj,59350,59351,118701
61744,,u7zphoabmlkj,59351,59352,118703
61745,,pjp_5vvmqoaj,59352,59353,118705
61746,,44ac6ppafwej,59353,59354,118707
61747,,yycmfwpmpn0j,59354,59355,118709
61748,,pmrmiwa0auwj,59355,59356,118711
61749,,tg_s5r-bkcaj,59356,59357,118713
61750,,url:http://portal.acm.org/ft_gateway.cfm3fid3d17014626type3dpdf26dl3dguide26dl3dacm26cfid3d1111111126cftoken3d2222222,59357,59358,118715
61751,,ozv_iqbovayj,59358,59359,118717
61752,,zetdoxwrxmmj,59359,59360,118719
61753,,qp4zdk8gl8uj,59361,59362,118723
61754,,cmeu5e-6leuj,59362,59363,118725
61755,,nacbrh0irb0j,59363,59364,118727
61756,,ylzbcf2sklyj,59364,59365,118729
61757,,r4vbtfwr-6sj,59365,59366,118731
61758,,bcj3a3zbbr0j,59366,59367,118733
61759,,uhonxkzo5cij,59367,59368,118735
61760,,chxtmo9talkj,59368,59369,118737
61761,,url:http://portal.acm.org/ft_gateway.cfm3fid3d102763926type3dpdf,59369,59370,118739
61762,,piuaf19dle4j,59370,59371,118741
61763,,3k9vwwmjiwyj,59371,59372,118743
61764,,lpiihzrhfg8j,59372,59373,118745
61765,,hheedo6tex0j,59373,59374,118747
61766,,o2ufs5ispp4j,59374,59375,118749
61767,,zxzfhq4709sj,59375,59376,118751
61768,,48rz1fbvtfyj,59376,59377,118753
61769,,_qjmw0c7hqoj,59377,59378,118755
61770,,lwegcsyu580j,59378,59379,118757
61771,,sypfum6b9egj,59379,59380,118759
61772,,,59380,59381,118761
61773,,cumxkef3rhqj,59381,59382,118763
61774,,p5fbf2qt2faj,59382,59383,118765
61775,,l37p8ke0d_cj,59383,59384,118767
61776,,ki-_d27zvaqj,59384,59385,118769
61777,,ggogccn-v1ij,59385,59386,118771
61778,,rj-yoqw2e3oj,59386,59387,118773
61779,,o1kwtumxumgj,59387,59388,118775
61780,,ftmd0zzvav0j,59388,59389,118777
61781,,zvqenbh98u8j,59389,59390,118779
61782,,,59391,59392,118783
61783,,jzqgyi5vyxyj,59392,59393,118785
61784,,rbp0f4ufmgej,59393,59394,118787
61785,,shurnckbhduj,59394,59395,118789
61786,,-6turpzj7hsj,59395,59396,118791
61787,,q-_jiz0mawej,59396,59397,118793
61788,,hhejkcvsjryj,59397,59398,118795
61789,,f_nfsxlxssyj,59398,59399,118797
61790,,url:http://portal.acm.org/citation.cfm3fid3d217279.21526826dl3dguide26dl3dacm26type3dseries26idx3dseries31626part3dproceedings26wanttype3dproceedings26title3dinternational2520multimedia2520conference26cfid3d1111111126cftoken3d2222222,59399,59400,118799
61791,,fhcdbszqop4j,59400,59401,118801
61792,,pdz0jbok5yoj,59401,59402,118803
61793,,url:http://adsabs.harvard.edu/abs/1976injme..57...15d,59402,59403,118805
61794,,rzsto28xh-ej,59403,59404,118807
61795,,1jezukzkuk4j,59404,59405,118809
61796,,ovk7nd_n9p8j,59405,59406,118811
61797,,lmv3aousviwj,59406,59407,118813
61798,,owemw9vnlzmj,59407,59408,118815
61799,,e2gmcs0ai7aj,59408,59409,118817
61800,,jfadblcg0j0j,59409,59410,118819
61801,,vdsqgk0zpgqj,59410,59411,118821
61802,,rwyh-jf3yauj,59411,59412,118823
61803,,700c5ma6pgqj,59412,59413,118825
61804,,q2hnopkx1w8j,59413,59414,118827
61805,,npwizjavqtcj,59414,59415,118829
61806,,bfkype4h9i0j,59415,59416,118831
61807,,qexzr6kprkqj,59416,59417,118833
61808,,kgg_rg4ahowj,59417,59418,118835
61809,,qaozkquufqkj,59418,59419,118837
61810,,amjohce_s_yj,59419,59420,118839
61811,,zgm5vcmzz-mj,59420,59421,118841
61812,,xooxiqfwktej,59421,59422,118843
61813,,1u9a4dfuosoj,59422,59423,118845
61814,,gf_rmtghs-8j,59423,59424,118847
61815,,nvgd3hfbzaqj,59424,59425,118849
61816,,ytgobiw3fsmj,59425,59426,118851
61817,,ob5s-dhd9hoj,59426,59427,118853
61818,,pkjsqjnhheoj,59427,59428,118855
61819,,duo5ggyrmjyj,59428,59429,118857
61820,,6taxcrvvyiij,59429,59430,118859
61821,,tt5lshzcn4ij,59430,59431,118861
61822,,vfvrvfqrneuj,59431,59432,118863
61823,,fggvvgpd69uj,59432,59433,118865
61824,,zntx0sw20g0j,59433,59434,118867
61825,,hb_hc_j1p24j,59434,59435,118869
61826,,ncpseqg7mpsj,59435,59436,118871
61827,,bev-l3phf0ij,59436,59437,118873
61828,,48xv24x9fscj,59437,59438,118875
61829,,jekoemcuipkj,59438,59439,118877
61830,,lie_aseuy1yj,59439,59440,118879
61831,,cqmgkl-qszuj,59440,59441,118881
61832,,mjk2dmqrg0cj,59441,59442,118883
61833,,dcn7qsp4raaj,59442,59443,118885
61834,,6rur6u1mjmij,59443,59444,118887
61835,,fyw_xdggfd4j,59444,59445,118889
61836,,ftddtqm--m0j,59445,59446,118891
61837,,gk92u37g31wj,59446,59447,118893
61838,,qdszfk2rdzwj,59447,59448,118895
61839,,ko08lju9mwkj,59448,59449,118897
61840,,nm4m4jvra4mj,59449,59450,118899
61841,,w00disnukkej,59450,59451,118901
61842,,yfc1qwzckiaj,59451,59452,118903
61843,,dc4kf1wnqx8j,59452,59453,118905
61844,,zyp4rn261u4j,59453,59454,118907
61845,,f2lmsqc5d6ej,59454,59455,118909
61846,,efw-rjh64eyj,59455,59456,118911
61847,,mschcl-vktij,59456,59457,118913
61848,,jsne39oatjoj,59457,59458,118915
61849,,wptdbyahbzej,59458,59459,118917
61850,,ryjtjncntruj,59459,59460,118919
61851,,gehi-url0oaj,59460,59461,118921
61852,,u-4mepviejgj,59461,59462,118923
61853,,afbwcqp-vpcj,59462,59463,118925
61854,,,59463,59464,118927
61855,,9xwslrbwapij,59464,59465,118929
61856,,xcmjspshfq4j,59465,59466,118931
61857,,02xw3psfbocj,59466,59467,118933
61858,,hitkyzzbjikj,59467,59468,118935
61859,,cidxtqnytsej,59468,59469,118937
61860,,z85ukaz5ma4j,59469,59470,118939
61861,,url:http://www.csa.com/partners/viewrecord.php3frequester3dgs26collection3denv26recid3d8913244,59470,59471,118941
61862,,k7nb3hziot8j,59471,59472,118943
61863,,enjfjyr_mlwj,59472,59473,118945
61864,,r_kudjh9qjqj,59473,59474,118947
61865,,ydsorv6vicyj,59474,59475,118949
61866,,lxdkxwn0znqj,59475,59476,118951
61867,,j4ltaimudrwj,59476,59477,118953
61868,,vsbifrby9ogj,59477,59478,118955
61869,,5wcgt7bnx7yj,59478,59479,118957
61870,,t-fpmp82jzij,59480,59481,118961
61871,,1rjs8zszz_4j,59481,59482,118963
61872,,viifxzaolgsj,59482,59483,118965
61873,,zfjlrl0ia_wj,59483,59484,118967
61874,,c6ocucch1ryj,59484,59485,118969
61875,,sr1nx-rbvxuj,59485,59486,118971
61876,,iwhlp_hsn6oj,59486,59487,118973
61877,,uzmvgpnjen8j,59487,59488,118975
61878,,l6qo-xfohfej,59488,59489,118977
61879,,soswib_ktoej,59489,59490,118979
61880,,0vvwghntommj,59490,59491,118981
61881,,1bz4eaf3-4kj,59491,59492,118983
61882,,url:http://www.springerlink.com/index/p44m360615819n47.pdf,59492,59493,118985
61883,,url:http://www.csa.com/partners/viewrecord.php3frequester3dgs26collection3dtrd26recid3d0116705ci,59493,59494,118987
61884,,nardvjmdjayj,59494,59495,118989
61885,,tmxjkvx9hq0j,59495,59496,118991
61886,,hemdyky5tl4j,59496,59497,118993
61887,,7_owl4xrtkej,59498,59499,118997
61888,,u_u5k0_wzjuj,59499,59500,118999
61889,,n7hx1za3fqwj,59500,59501,119001
61890,,esp25zxedokj,59501,59502,119003
61891,,1nw6uzj3bfaj,59502,59503,119005
61892,,url:http://adsabs.harvard.edu/abs/1987stin...8830552k,59503,59504,119007
61893,,d9zso5ycklsj,59504,59505,119009
61894,,of386g76f2aj,59505,59506,119011
61895,,url:http://doi.wiley.com/10.1002/he.85,59506,59507,119013
61896,,za4o_6i3ozsj,59507,59508,119015
61897,,dxa63q9rgikj,59508,59509,119017
61898,,hxw7ypbx1gaj,59509,59510,119019
61899,,url:http://adsabs.harvard.edu/abs/1974phdt.........8o,59510,59511,119021
61900,,_aun0jx8_tkj,59511,59512,119023
61901,,6bxvtsmgjskj,59512,59513,119025
61902,,u_e9mnarv7cj,59513,59514,119027
61903,,jch-7pa_4xkj,59514,59515,119029
61904,,zsfufdvtbc0j,59515,59516,119031
61905,,url:http://portal.acm.org/citation.cfm3fid3d1084805.1084820,59516,59517,119033
61906,,yrv_j8sm-faj,59517,59518,119035
61907,,ft52yx9kdnmj,59518,59519,119037
61908,,abpe7s8h4xgj,59519,59520,119039
61909,,p-p0bxpjghij,59520,59521,119041
61910,,8ldlnknrmjej,59521,59522,119043
61911,,1gfywzlmz2aj,59522,59523,119045
61912,,nvjvovsphbmj,59523,59524,119047
61913,,gobf44nbvooj,59524,59525,119049
61914,,fas53imqvloj,59525,59526,119051
61915,,khxcpeslcluj,59526,59527,119053
61916,,7qbxvnud6juj,59527,59528,119055
61917,,x03n-7szkzoj,59528,59529,119057
61918,,4qwasa39oxgj,59529,59530,119059
61919,,i8gbxzyhq5sj,59530,59531,119061
61920,,zx6sqtl8fduj,59531,59532,119063
61921,,4iqmyy0p2nsj,59532,59533,119065
61922,,hbt5xgatk2qj,59533,59534,119067
61923,,cwc-7b595suj,59534,59535,119069
61924,,tsgz5tqsqcaj,59535,59536,119071
61925,,mbdcngbf9wmj,59536,59537,119073
61926,,url:http://portal.acm.org/ft_gateway.cfm3fid3d102763526type3dpdf,59537,59538,119075
61927,,ryitbxplrlmj,59538,59539,119077
61928,,yq87na0agsij,59539,59540,119079
61929,,sk1qjurlo4oj,59540,59541,119081
61930,,mt8hx4objk4j,59541,59542,119083
61931,,3vkokoxzoduj,59542,59543,119085
61932,,mmkfha8tq50j,59543,59544,119087
61933,,axpqwgyrylgj,59544,59545,119089
61934,,ve7497m3izkj,59545,59546,119091
61935,,aagfsi6sgbyj,59546,59547,119093
61936,,iou9gqb0g8aj,59547,59548,119095
61937,,_nxkh69v2tij,59548,59549,119097
61938,,zucxd3me7jqj,59549,59550,119099
61939,,wr04hiejliyj,59550,59551,119101
61940,,olxpxej0pm0j,59551,59552,119103
61941,,k_agxx5kvnoj,59552,59553,119105
61942,,354lbzjroyoj,59553,59554,119107
61943,,kwtvs4gon3qj,59554,59555,119109
61944,,g3f2vp12m4kj,59555,59556,119111
61945,,rdq68ltjhsyj,59556,59557,119113
61946,,vqmayteescej,59557,59558,119115
61947,,yjuuqg5dwfyj,59558,59559,119117
61948,,vibvtfmll4uj,59559,59560,119119
61949,,y8-mm_70mkyj,59560,59561,119121
61950,,url:http://www.csa.com/partners/viewrecord.php3frequester3dgs26collection3dtrd26recid3d0878909ci,59561,59562,119123
61951,,nsf0fykv_zoj,59562,59563,119125
61952,,hf4ss54tyfej,59563,59564,119127
61953,,36v3q-9esk4j,59564,59565,119129
61954,,wlqbkt65nnwj,59565,59566,119131
61955,,url:http://www.springerlink.com/index/l3571r81k6326428.pdf,59566,59567,119133
61956,,5jeyhw8cpiaj,59567,59568,119135
61957,,qyuk23y4nboj,59568,59569,119137
61958,,aixyubr0bsoj,59569,59570,119139
61959,,uzecnw5u3v4j,59570,59571,119141
61960,,vfth6fzopdaj,59571,59572,119143
61961,,_u6jlvgiofsj,59572,59573,119145
61962,,hicgyocuzqoj,59573,59574,119147
61963,,iao1ve1zkgwj,59574,59575,119149
61964,,1bqrusaic7gj,59575,59576,119151
61965,,mh39f5848ckj,59576,59577,119153
61966,,u9gxcfeqvcyj,59577,59578,119155
61967,,r8_gru6dpbaj,59578,59579,119157
61968,,8waj24fpqnyj,59579,59580,119159
61969,,5jwlm3cb7uej,59580,59581,119161
61970,,ajp7a2zooa8j,59581,59582,119163
61971,,xm8b5yfrgbaj,59582,59583,119165
61972,,dwhqcmz4hgmj,59583,59584,119167
61973,,jdjq84cp_0ij,59584,59585,119169
61974,,h5bxbxkf1wyj,59585,59586,119171
61975,,jaldtsd-iygj,59586,59587,119173
61976,,1xdpxdvb2h8j,59587,59588,119175
61977,,fhfttevouywj,59588,59589,119177
61978,,8cww9ujmexqj,59589,59590,119179
61979,,vvzfyqszunuj,59590,59591,119181
61980,,url:http://portal.acm.org/citation.cfm3fid3d171926.171960,59591,59592,119183
61981,,drgr0hp5jlmj,59592,59593,119185
61982,,ga_pdd9fb3qj,59593,59594,119187
61983,,8ffqtff0lv4j,59594,59595,119189
61984,,8jmtcumkm3ij,59595,59596,119191
61985,,mvm4cmye9h0j,59596,59597,119193
61986,,jygrmfpxo4uj,59597,59598,119195
61987,,ld9jjhio4euj,59599,59600,119199
61988,,ee_4ccq5kwuj,59600,59601,119201
61989,,0pb6bgymrsgj,59601,59602,119203
61990,,eiztpplamfmj,59602,59603,119205
61991,,3w6dekw-fyyj,59603,59604,119207
61992,,sy7mad-gw34j,59604,59605,119209
61993,,uzt6vdilf6wj,59606,59607,119213
61994,,kpu89y3t3qaj,59607,59608,119215
61995,,66ktlum4-gaj,59608,59609,119217
61996,,url:http://portal.acm.org/citation.cfm3fid3d1084805.1084829,59609,59610,119219
61997,,qm7l598rr1kj,59610,59611,119221
61998,,ic4ycutcgbej,59611,59612,119223
61999,,3rbwbbhxafoj,59612,59613,119225
62000,,glu7hk0ejrwj,59613,59614,119227
62001,,oagpyyhokcij,59614,59615,119229
62002,,dnmvfrepe3ij,59615,59616,119231
62003,,v_ixeuf_c-sj,59616,59617,119233
62004,,ndgzsmnoofwj,59617,59618,119235
62005,,1fyki_19cn0j,59618,59619,119237
62006,,q17balwbwlcj,59619,59620,119239
62007,,7wrmkr1t2cej,59621,59622,119243
62008,,2cygtse5o1uj,59622,59623,119245
62009,,hsbqv86btg8j,59623,59624,119247
62010,,qzxjzajap9uj,59624,59625,119249
62011,,qy0uqewjzdkj,59625,59626,119251
62012,,qa8d9xomz_uj,59626,59627,119253
62013,,ocbie3s6-fmj,59627,59628,119255
62014,,url:http://www.csa.com/partners/viewrecord.php3frequester3dgs26collection3dtrd26recid3da8622928ah,59628,59629,119257
62015,,fwovpad6ramj,59629,59630,119259
62016,,lyocgvcdowqj,59630,59631,119261
62017,,zuexgnsuyp8j,59631,59632,119263
62018,,hdpdompazfij,59632,59633,119265
62019,,9j47nqdezzaj,59633,59634,119267
62020,,ih4lj8mkqa0j,59634,59635,119269
62021,,dy7eafodwfkj,59635,59636,119271
62022,,dcufm3ofmxwj,59636,59637,119273
62023,,hzdagosmvxcj,59637,59638,119275
62024,,nrt9ixa9naej,59638,59639,119277
62025,,tnbpik2_kruj,59639,59640,119279
62026,,dqfexxixvz4j,59640,59641,119281
62027,,xxf3kfuckj4j,59642,59643,119285
62028,,pze0p9lshlmj,59643,59644,119287
62029,,v8jdvadkptoj,59644,59645,119289
62030,,,59646,59647,119293
62031,,dmurwuxrm08j,59647,59648,119295
62032,,7ibmrund_vgj,59648,59649,119297
62033,,n02zd15gdykj,59649,59650,119299
62034,,gvrgawjxt8aj,59650,59651,119301
62035,,9noyq1ynp10j,59651,59652,119303
62036,,o73wtnntpvaj,59652,59653,119305
62037,,xijypb231faj,59653,59654,119307
62038,,url:http://www.csa.com/partners/viewrecord.php3frequester3dgs26collection3dtrd26recid3dn9210456ah,59654,59655,119309
62039,,myhkhvcvez0j,59655,59656,119311
62040,,3zqma3af600j,59656,59657,119313
62041,,nwsubozql70j,59657,59658,119315
62042,,mqu7b9pijh0j,59658,59659,119317
62043,,sgi-hudsov8j,59659,59660,119319
62044,,dls80cayvowj,59660,59661,119321
62045,,kwi_vbotqhaj,59661,59662,119323
62046,,nxuj5tk0nkoj,59662,59663,119325
62047,,hrkbxbyadxgj,59663,59664,119327
62048,,lpcvfkbjpsej,59664,59665,119329
62049,,dcouku9oc80j,59665,59666,119331
62050,,dd_6i2ckrs4j,59666,59667,119333
62051,,i89ggbrr_zij,59667,59668,119335
62052,,fmv5y-kvpwsj,59668,59669,119337
62053,,agtg0b9wam4j,59669,59670,119339
62054,,gg3ihnc4j3uj,59670,59671,119341
62055,,xmapaf7ybgqj,59671,59672,119343
62056,,cwnounr2c5qj,59672,59673,119345
62057,,1xdveeleee4j,59673,59674,119347
62058,,pxzwcqpxebkj,59674,59675,119349
62059,,26rpzrcikl0j,59675,59676,119351
62060,,u94ip92xsywj,59676,59677,119353
62061,,urqiww8qxqkj,59677,59678,119355
62062,,a1jrowqa8qej,59678,59679,119357
62063,,cuuazo1wdywj,59679,59680,119359
62064,,ot-na7xbojwj,59680,59681,119361
62065,,nnzc9ivbtgqj,59681,59682,119363
62066,,kqood6rao1aj,59682,59683,119365
62067,,xhig2tlumzsj,59684,59685,119369
62068,,1qtvkvik2zwj,59685,59686,119371
62069,,ds1c2vwyyyyj,59686,59687,119373
62070,,url:http://www.csa.com/partners/viewrecord.php3frequester3dgs26collection3dtrd26recid3d200111000450mt26recid3da0032579ah,59687,59688,119375
62071,,bydhfpdzsbuj,59688,59689,119377
62072,,url:http://portal.acm.org/ft_gateway.cfm3fid3d16665026type3dpdf26coll3dguide26dl3dacm26cfid3d1111111126cftoken3d2222222,59690,59691,119381
62073,,m97yripnpl0j,59691,59692,119383
62074,,url:http://portal.acm.org/ft_gateway.cfm3fid3d109962726type3dpdf,59692,59693,119385
62075,,url:http://pubs.acs.org/cgi-bin/abstract.cgi/achre4/2005/38/i05/abs/ar040118a.html,59693,59694,119387
62076,,rp5fxz8gwvej,59694,59695,119389
62077,,url:http://www.csa.com/partners/viewrecord.php3frequester3dgs26collection3dtrd26recid3dn9210402ah,59695,59696,119391
62078,,mshskppahygj,59696,59697,119393
62079,,kxewyojeyjyj,59697,59698,119395
62080,,a9drpn1hjugj,59698,59699,119397
62081,,ll5lnwd6xa8j,59699,59700,119399
62082,,bud_dy5qmrgj,59700,59701,119401
62083,,rxhvo3smaf0j,59701,59702,119403
62084,,wfseetswvmyj,59702,59703,119405
62085,,kjnjqu8efpgj,59703,59704,119407
62086,,1xdms8-xieyj,59704,59705,119409
62087,,n1om0fskl_gj,59705,59706,119411
62088,,xdasc3yvwvyj,59706,59707,119413
62089,,ah6sda47x4yj,59707,59708,119415
62090,,pzhh8bkjugoj,59708,59709,119417
62091,,ked9n_k3wosj,59709,59710,119419
62092,,8xsl2983534j,59710,59711,119421
62093,,ijfbru7gliej,59711,59712,119423
62094,,7t-vfaiwpigj,59712,59713,119425
62095,,bzvbdhqfx-wj,59713,59714,119427
62096,,ycqf5tqgle0j,59714,59715,119429
62097,,mmrosaxk4poj,59715,59716,119431
62098,,rres5vrqqpsj,59716,59717,119433
62099,,hheeu0ewzdoj,59717,59718,119435
62100,,5gug8dsa9hgj,59718,59719,119437
62101,,url:http://doi.wiley.com/10.1002/he.9709,59719,59720,119439
62102,,udr4w5sf5icj,59720,59721,119441
62103,,togxig36mpqj,59721,59722,119443
62104,,gvoozijnohwj,59722,59723,119445
62105,,bplc_rrz_b0j,59723,59724,119447
62106,,oqge2umtmiij,59724,59725,119449
62107,,0greqgb8ajej,59725,59726,119451
62108,,rt7n0xhigw8j,59726,59727,119453
62109,,owqzc3ecspij,59727,59728,119455
62110,,fu0_vszt_nuj,59728,59729,119457
62111,,1dbql6r2tzmj,59729,59730,119459
62112,,jtftfljw3yaj,59730,59731,119461
62113,,4m6y7kib1jej,59731,59732,119463
62114,,7mzwdy09aygj,59732,59733,119465
62115,,xdvvfurczaaj,59733,59734,119467
62116,,gkc9whq6d44j,59734,59735,119469
62117,,tfyoonnxbcoj,59735,59736,119471
62118,,bnp9mhabpb8j,59736,59737,119473
62119,,,59737,59738,119475
62120,,_rryy388cz4j,59738,59739,119477
62121,,-115fz10rwsj,59739,59740,119479
62122,,4vsayzwds0aj,59740,59741,119481
62123,,8nxes4ut_1yj,59741,59742,119483
62124,,staxkmy4wkoj,59742,59743,119485
62125,,,59743,59744,119487
62126,,fscknub5dyaj,59744,59745,119489
62127,,cpqruu7bw5mj,59745,59746,119491
62128,,qx44s6mrotsj,59746,59747,119493
62129,,8cp5vl2hw8aj,59747,59748,119495
62130,,logsf8toklmj,59748,59749,119497
62131,,qam95km87eij,59749,59750,119499
62132,,8qqahyrjqboj,59750,59751,119501
62133,,g_qy-sfxa_0j,59751,59752,119503
62134,,ku-jan4ynwsj,59752,59753,119505
62135,,nkj_pfmz0s0j,59753,59754,119507
62136,,_s5mzts02mcj,59754,59755,119509
62137,,url:http://www.ingentaconnect.com/search/expand3fpub3dinfobike://pep/jae/2003/00000217/00000012/art0000726unc3d,59755,59756,119511
62138,,ounudsusjdoj,59756,59757,119513
62139,,atlczmjay7aj,59757,59758,119515
62140,,qotursw9lcij,59758,59759,119517
62141,,ggulgtkx9ukj,59759,59760,119519
62142,,abrczv130rej,59760,59761,119521
62143,,3thnpjrwx-wj,59761,59762,119523
62144,,gjsx2oodkg8j,59762,59763,119525
62145,,jwlihayxanyj,59763,59764,119527
62146,,d9zsfwnhf98j,59764,59765,119529
62147,,url:http://doi.wiley.com/10.1002/he.11202,59765,59766,119531
62148,,ccsceec8fwgj,59766,59767,119533
62149,,j5rpasrl248j,59767,59768,119535
62150,,fgvtoglfgpqj,59768,59769,119537
62151,,uqh6sfc5428j,59769,59770,119539
62152,,jfsz6c0cjuqj,59770,59771,119541
62153,,mkgiigghsvij,59771,59772,119543
62154,,v7jchd339juj,59772,59773,119545
62155,,hkapjwzppzmj,59773,59774,119547
62156,,4v9kqmfdaucj,59774,59775,119549
62157,,mz_ugivvbogj,59776,59777,119553
62158,,url:http://portal.acm.org/citation.cfm3fid3d38767,59777,59778,119555
62159,,url:http://www.springerlink.com/index/vk86767387v28764.pdf,59778,59779,119557
62160,,vhco33orww8j,59779,59780,119559
62161,,k1xp9ajm8zqj,59780,59781,119561
62162,,cbb8qivu2huj,59781,59782,119563
62163,,xj7jfsmwfo0j,59782,59783,119565
62164,,zln10pn_tluj,59783,59784,119567
62165,,04fgmnb9om4j,59784,59785,119569
62166,,boiqx-dgtkwj,59785,59786,119571
62167,,nc8zcsajwkkj,59786,59787,119573
62168,,m_lppnxru14j,59787,59788,119575
62169,,ay0u8nl_crwj,59788,59789,119577
62170,,rzayup2mgskj,59789,59790,119579
62171,,url:http://portal.acm.org/citation.cfm3fid3d345508.34562226dl3dguide26dl3dacm26type3dseries26idx3d34550826part3dproceedings26wanttype3dproceedings26title3dannual2520acm2520conference2520on2520research2520and2520development2520in2520information2520retrieval26cfid3d1111111126cftoken3d2222222,59790,59791,119581
62172,,sbqqvrnwspyj,59791,59792,119583
62173,,ywqutytlpo8j,59792,59793,119585
62174,,dkujymjrlimj,59793,59794,119587
62175,,mdh2eyjdqaaj,59794,59795,119589
62176,,pwefi0xffcoj,59795,59796,119591
62177,,kfqkeofv4dqj,59796,59797,119593
62178,,d8of7tvcll8j,59797,59798,119595
62179,,url:http://portal.acm.org/citation.cfm3fid3d318013.31809826dl3dportal26dl3dacm26type3dseries26idx3d31801326part3dproceedings26wanttype3dproceedings26title3dannual2520acm2520ieee2520design2520automation2520conference26cfid3d1111111126cftoken3d2222222,59798,59799,119597
62180,,8fe2wofpvjmj,59799,59800,119599
62181,,_y6kldnf50aj,59800,59801,119601
62182,,uxvagz6wlcsj,59801,59802,119603
62183,,o6hvagbscc0j,59802,59803,119605
62184,,v0c3pqbxcwyj,59803,59804,119607
62185,,bavatfo4wcoj,59804,59805,119609
62186,,eix8czruercj,59805,59806,119611
62187,,url:http://portal.acm.org/ft_gateway.cfm3fid3d110119726type3dpdf,59807,59808,119615
62188,,kkadntfk1joj,59808,59809,119617
62189,,j4pkc4zpa8wj,59809,59810,119619
62190,,ppclkd9jz8yj,59810,59811,119621
62191,,o1huetg8heqj,59811,59812,119623
62192,,6bxiekj4kcij,59812,59813,119625
62193,,fgzkpjjkwyaj,59813,59814,119627
62194,,opjb_vtxst0j,59814,59815,119629
62195,,offotv3tb24j,59815,59816,119631
62196,,dxqxoofqg9wj,59816,59817,119633
62197,,bx1klejpr2cj,59817,59818,119635
62198,,egqq9rv6imaj,59818,59819,119637
62199,,hfdwiogodu0j,59819,59820,119639
62200,,v4dmjvtwv-uj,59820,59821,119641
62201,,ung9gwkaoj8j,59822,59823,119645
62202,,99n4rxndaqmj,59823,59824,119647
62203,,7qrsvj_lk-mj,59824,59825,119649
62204,,cch7yc2bbryj,59825,59826,119651
62205,,zjlwd4agfbej,59826,59827,119653
62206,,9v0urtfuliwj,59827,59828,119655
62207,,url:http://www.csa.com/partners/viewrecord.php3frequester3dgs26collection3dtrd26recid3dn9210426ah,59828,59829,119657
62208,,qrysstprwzuj,59829,59830,119659
62209,,d2d9gmxygqaj,59830,59831,119661
62210,,guuojig2ifwj,59832,59833,119665
62211,,jffyogj-6eij,59833,59834,119667
62212,,fienhovllckj,59834,59835,119669
62213,,8yn8mk6a9z4j,59835,59836,119671
62214,,aqznuowvmwcj,59836,59837,119673
62215,,t9nmzzsmvaaj,59837,59838,119675
62216,,yoxyl7gqu-qj,59838,59839,119677
62217,,zqi7uljxhumj,59839,59840,119679
62218,,,59840,59841,119681
62219,,tor8dvx3htej,59841,59842,119683
62220,,ntbryrod2bsj,59842,59843,119685
62221,,hwtrmmpb4oqj,59843,59844,119687
62222,,url:http://adsabs.harvard.edu/abs/1999uma..conf.....i,59844,59845,119689
62223,,28jvklf3120j,59845,59846,119691
62224,,glt7qoh74a8j,59846,59847,119693
62225,,hlxsx6menxwj,59848,59849,119697
62226,,nzofcketf0mj,59849,59850,119699
62227,,dthlmzbqgfqj,59850,59851,119701
62228,,6bss5yygc2uj,59851,59852,119703
62229,,sxej1sugozaj,59852,59853,119705
62230,,77uyrppzpfqj,59853,59854,119707
62231,,xtigobjbjv0j,59854,59855,119709
62232,,2wgebtxtseuj,59855,59856,119711
62233,,snvxbbs5qakj,59856,59857,119713
62234,,4hyhv6nzca4j,59857,59858,119715
62235,,obqqi6ebwh8j,59858,59859,119717
62236,,url:http://portal.acm.org/ft_gateway.cfm3fid3d110132026type3dpdf,59859,59860,119719
62237,,c61liqnmspkj,59860,59861,119721
62238,,89reptrccjaj,59861,59862,119723
62239,,wuynzmqqbxgj,59862,59863,119725
62240,,ufjhklluk8ej,59863,59864,119727
62241,,mxzfxygenimj,59864,59865,119729
62242,,wv41gslwnamj,59865,59866,119731
62243,,jkdp9njlez8j,59866,59867,119733
62244,,e5kfkfueowsj,59867,59868,119735
62245,,ovgzrx1yg4qj,59868,59869,119737
62246,,ijwoymovmx4j,59869,59870,119739
62247,,v_ljhgtsfbgj,59870,59871,119741
62248,,fhhh2kcicekj,59871,59872,119743
62249,,waflkeu8vbsj,59872,59873,119745
62250,,fwin5kobmwyj,59873,59874,119747
62251,,url:http://www.csa.com/partners/viewrecord.php3frequester3dgs26collection3dtrd26recid3dn9210369ah,59874,59875,119749
62252,,gx9lzmqt4guj,59875,59876,119751
62253,,sa7ax5qhuioj,59876,59877,119753
62254,,1axdu7iwxlqj,59877,59878,119755
62255,,x4fl9ccwmg0j,59878,59879,119757
62256,,u4roz3-u3jaj,59879,59880,119759
62257,,bosfrzb01zqj,59880,59881,119761
62258,,pq-g7zqg_rqj,59881,59882,119763
62259,,9_hammghjiej,59882,59883,119765
62260,,hvswlofzy14j,59883,59884,119767
62261,,z1l5uaxzvvwj,59884,59885,119769
62262,,gg59wj0o6rgj,59885,59886,119771
62263,,jh47gs_b5cyj,59886,59887,119773
62264,,ycocr7cskqej,59887,59888,119775
62265,,hcodbd6dazsj,59888,59889,119777
62266,,dcuu4jysue0j,59889,59890,119779
62267,,ng8ro-qsb_kj,59890,59891,119781
62268,,phof_c4sz2sj,59891,59892,119783
62269,,qpddv_9ut8kj,59892,59893,119785
62270,,mduq-f6t9hcj,59893,59894,119787
62271,,hlrdara3zskj,59894,59895,119789
62272,,ewae7a4a2k0j,59895,59896,119791
62273,,url:http://adsabs.harvard.edu/abs/1980phdt........20t,59896,59897,119793
62274,,lumuq9vvouwj,59897,59898,119795
62275,,url:http://www.csa.com/partners/viewrecord.php3frequester3dgs26collection3denv26recid3d10407,59898,59899,119797
62276,,url:http://links.jstor.org/sici3fsici3d0146-4949(196223)3253a3253c29253a2522vocai253e2.0.co253b2-s,59899,59900,119799
62277,,4wb2ozqwrlej,59900,59901,119801
62278,,b7l1a67cmmgj,59901,59902,119803
62279,,npsca_qvspqj,59902,59903,119805
62280,,3fytgif-6hej,59903,59904,119807
62281,,eqz5pnjsakmj,59904,59905,119809
62282,,l-qhssxc2pwj,59905,59906,119811
62283,,vculxbvpfcoj,59906,59907,119813
62284,,xpwftfrzfbuj,59907,59908,119815
62285,,ugt1r-ajafqj,59908,59909,119817
62286,,rpjgqn2wpruj,59909,59910,119819
62287,,-8dv7b8zzhcj,59910,59911,119821
62288,,vatcpbmcviij,59911,59912,119823
62289,,mokvmnhykmwj,59912,59913,119825
62290,,ohg4l7mgw-sj,59913,59914,119827
62291,,rlzbh_ctzvoj,59914,59915,119829
62292,,_s96qqdxsr8j,59915,59916,119831
62293,,mgqfsiouleoj,59916,59917,119833
62294,,ymovgxbcrlcj,59917,59918,119835
62295,,3ezwanhi2_oj,59918,59919,119837
62296,,ag-ocqo5ztaj,59919,59920,119839
62297,,unst_fzflg0j,59920,59921,119841
62298,,k1wynssn5nej,59921,59922,119843
62299,,e2zharkv5dsj,59922,59923,119845
62300,,z0ocign4pvmj,59923,59924,119847
62301,,url:http://adsabs.harvard.edu/abs/2000stin...0011066c,59924,59925,119849
62302,,stjwk0osinsj,59925,59926,119851
62303,,oym-61uaxkaj,59926,59927,119853
62304,,i8wbyxw2zhyj,59927,59928,119855
62305,,mn725tliq0aj,59928,59929,119857
62306,,url:http://portal.acm.org/ft_gateway.cfm3fid3d109962226type3dpdf,59930,59931,119861
62307,,c4gezksvdduj,59931,59932,119863
62308,,ex-ixr3ktdwj,59932,59933,119865
62309,,mgups8yx0taj,59933,59934,119867
62310,,e6llu4bioxuj,59934,59935,119869
62311,,hglboudolyuj,59935,59936,119871
62312,,wc1dpg_gndsj,59936,59937,119873
62313,,patg_df5xxkj,59937,59938,119875
62314,,kh018ymr8kej,59938,59939,119877
62315,,url:http://portal.acm.org/citation.cfm3fid3d144111.144155,59939,59940,119879
62316,,eye6xqrf0iej,59940,59941,119881
62317,,dsn8bgfqbm8j,59941,59942,119883
62318,,b9crwyldnkej,59942,59943,119885
62319,,n3vkezhqkokj,59943,59944,119887
62320,,tnwn6p-ddjmj,59944,59945,119889
62321,,zzkfvrdwm_4j,59945,59946,119891
62322,,zcvq1fdn_d0j,59947,59948,119895
62323,,xhrnjw7pxjwj,59948,59949,119897
62324,,f1lhnwczc_8j,59949,59950,119899
62325,,aakbxz9boooj,59950,59951,119901
62326,,pusgz-wvejsj,59951,59952,119903
62327,,4yim3vc2msoj,59952,59953,119905
62328,,mvhnydpy-iwj,59953,59954,119907
62329,,ra8-qy_qjzoj,59954,59955,119909
62330,,lw4kaclysaij,59955,59956,119911
62331,,i6u9diu_avgj,59956,59957,119913
62332,,p8ipj1vinkoj,59957,59958,119915
62333,,j8acg6t8fwuj,59958,59959,119917
62334,,yz3_6gnxqiaj,59959,59960,119919
62335,,aandlagddhsj,59960,59961,119921
62336,,ucvnggclc38j,59961,59962,119923
62337,,ihxuwmrhcbgj,59962,59963,119925
62338,,sqy1tqgenxsj,59963,59964,119927
62339,,9slasvrmy-yj,59964,59965,119929
62340,,0r8bwbn9tccj,59965,59966,119931
62341,,nabaevs6yvcj,59966,59967,119933
62342,,pzqdckbgbmsj,59967,59968,119935
62343,,uqejy7j3_nij,59968,59969,119937
62344,,uttl711_oucj,59969,59970,119939
62345,,ukmz4l1sj28j,59970,59971,119941
62346,,textivz73x0j,59971,59972,119943
62347,,url:http://portal.acm.org/citation.cfm3fid3d192593.19736026dl3dportal26dl3dacm26type3dseries26idx3d19259326part3dproceedings26wanttype3dproceedings26title3dinternational2520multimedia2520conference26cfid3d1111111126cftoken3d2222222,59972,59973,119945
62348,,sjbdpb-ntxyj,59973,59974,119947
62349,,uuvhh2askmej,59974,59975,119949
62350,,toztobktoy4j,59975,59976,119951
62351,,vilsmhdw9poj,59976,59977,119953
62352,,burn7dy0b1oj,59977,59978,119955
62353,,sze0_zmz7dkj,59978,59979,119957
62354,,url:http://www.springerlink.com/index/u431075v68120767.pdf,59979,59980,119959
62355,,rbq97auxepyj,59980,59981,119961
62356,,ljmti6z5skij,59981,59982,119963
62357,,wk4encffb9cj,59982,59983,119965
62358,,vhtea7s86yej,59983,59984,119967
62359,,ieulbmucy64j,59984,59985,119969
62360,,url:http://ieeexplore.ieee.org/iel4/5812/15497/00718124.pdf3farnumber3d718124,59985,59986,119971
62361,,hzrrmrftbxsj,59986,59987,119973
62362,,jmtbk7qahdsj,59987,59988,119975
62363,,qolvbdqpsdwj,59988,59989,119977
62364,,rsw0warsufyj,59989,59990,119979
62365,,fktoulyztxmj,59990,59991,119981
62366,,pcadhxjbwhcj,59991,59992,119983
62367,,sebbg_58gomj,59992,59993,119985
62368,,iwnloycqx-yj,59993,59994,119987
62369,,9qgitw0-epmj,59994,59995,119989
62370,,0gwmfg7anqkj,59995,59996,119991
62371,,5_ds68h1gs0j,59997,59998,119995
62372,,wdrorlvc5jej,59998,59999,119997
62373,,url:http://www.ncbi.nlm.nih.gov/entrez/query.fcgi3fcmd3dretrieve26db3dpubmed26list_uids3d1565473226dopt3dcitation,60000,60001,120001
62374,,hjnaj5rbnh4j,60001,60002,120003
62375,,wdhkpqb0yjyj,60002,60003,120005
62376,,u9bdfg8czo4j,60003,60004,120007
62377,,n5diqcagl5uj,60004,60005,120009
62378,,xfyqy489c2kj,60005,60006,120011
62379,,wyyn5zka4zwj,60006,60007,120013
62380,,qgjruu99hxmj,60007,60008,120015
62381,,djqcmcybu_aj,60008,60009,120017
62382,,w9vvce8pli0j,60009,60010,120019
62383,,mra8g44ux0cj,60010,60011,120021
62384,,8k2msd-0gtmj,60011,60012,120023
62385,,lovibdhxfjkj,60012,60013,120025
62386,,woquinoyxjoj,60013,60014,120027
62387,,60zssadovkcj,60014,60015,120029
62388,,qlxvlzpug6gj,60015,60016,120031
62389,,xnwttedzzawj,60016,60017,120033
62390,,8mtkzecwxcuj,60017,60018,120035
62391,,uzu6vb2zf8ej,60018,60019,120037
62392,,rajm11mpbiyj,60019,60020,120039
62393,,bmwp4tmz9jgj,60020,60021,120041
62394,,e3f50zxmfoaj,60021,60022,120043
62395,,o4kxax0qcfqj,60022,60023,120045
62396,,of-rq-hi4pkj,60023,60024,120047
62397,,3j7ulocwbaej,60024,60025,120049
62398,,gdby1nozyvuj,60025,60026,120051
62399,,5wfnh6qogusj,60026,60027,120053
62400,,6gta5ieyrt4j,60027,60028,120055
62401,,lkiibwv1whqj,60028,60029,120057
62402,,vnhhaxojxdsj,60029,60030,120059
62403,,5wu3pofgnpkj,60030,60031,120061
62404,,gtwxcs-6qzwj,60031,60032,120063
62405,,ixrrm3x0r1cj,60032,60033,120065
62406,,xvmqfukijtej,60033,60034,120067
62407,,jiilddstbk8j,60034,60035,120069
62408,,nhutpm1a_oqj,60035,60036,120071
62409,,gzkrecit1pwj,60036,60037,120073
62410,,url:http://www.springerlink.com/index/j28w1152150707l7.pdf,60037,60038,120075
62411,,url:http://www.csa.com/partners/viewrecord.php3frequester3dgs26collection3dtrd26recid3d199907720270md,60038,60039,120077
62412,,vozeoncclmmj,60039,60040,120079
62413,,xta-elbpjz8j,60040,60041,120081
62414,,8cgy8cvmr3mj,60041,60042,120083
62415,,fkttrhvp374j,60042,60043,120085
62416,,e8u_krxa1dsj,60043,60044,120087
62417,,kynwqu7qilcj,60044,60045,120089
62418,,xlduf0ifdocj,60045,60046,120091
62419,,mz8jpk6y2vcj,60046,60047,120093
62420,,truc38gfekij,60047,60048,120095
62421,,url:http://portal.acm.org/ft_gateway.cfm3fid3d110137026type3dpdf,60048,60049,120097
62422,,x68ojkoxqmcj,60049,60050,120099
62423,,xfoaos0wxoej,60050,60051,120101
62424,,jud0bi4bhccj,60051,60052,120103
62425,,,60052,60053,120105
62426,,j53kxq0aqgmj,60053,60054,120107
62427,,ls1aalor2qaj,60054,60055,120109
62428,,url:http://www.csa.com/partners/viewrecord.php3frequester3dgs26collection3dtrd26recid3dn9210415ah,60055,60056,120111
62429,,h1idpepwj-ij,60056,60057,120113
62430,,wklikjybax8j,60057,60058,120115
62431,,5cgwb4mapsqj,60058,60059,120117
62432,,4tbxa2s7htsj,60059,60060,120119
62433,,6cnvgqh-u6sj,60060,60061,120121
62434,,a0mzlwdiu-4j,60061,60062,120123
62435,,ukwtbxpmxo8j,60062,60063,120125
62436,,oujc794gz6oj,60063,60064,120127
62437,,url:http://ieeexplore.ieee.org/iel5/98/19576/00904902.pdf3farnumber3d904902,60064,60065,120129
62438,,espslon3wqij,60065,60066,120131
62439,,wgv9zvnj484j,60066,60067,120133
62440,,r-pcebsdt00j,60067,60068,120135
62441,,gvpizvmiouwj,60068,60069,120137
62442,,cmk8rmj8dvmj,60069,60070,120139
62443,,,60070,60071,120141
62444,,rw9sjhkxdl0j,60071,60072,120143
62445,,3kwqxu2duj0j,60072,60073,120145
62446,,pfvvqehkuj0j,60073,60074,120147
62447,,tjrxkgdun54j,60074,60075,120149
62448,,c_ojbgd2lhuj,60075,60076,120151
62449,,eparew6k28mj,60076,60077,120153
62450,,a3j5yrxnpiqj,60077,60078,120155
62451,,cuqz0i636_yj,60078,60079,120157
62452,,noltubvio7qj,60079,60080,120159
62453,,ze8eqq0bziej,60080,60081,120161
62454,,frmuulqm7vij,60081,60082,120163
62455,,0ut9ounkbwcj,60082,60083,120165
62456,,r6ipd4jbtccj,60083,60084,120167
62457,,subrkfvk0foj,60084,60085,120169
62458,,r3sjmzd6ckuj,60085,60086,120171
62459,,87olejpxkcoj,60086,60087,120173
62460,,s-dsvbvan7yj,60087,60088,120175
62461,,dwn4ebe74dgj,60088,60089,120177
62462,,zzxhlywb4zmj,60089,60090,120179
62463,,zr5v5s8uzfej,60090,60091,120181
62464,,ax2lauxmhfaj,60091,60092,120183
62465,,ngudgenwywoj,60092,60093,120185
62466,,rzzjz_7yjb8j,60093,60094,120187
62467,,gpdawa2fw6yj,60094,60095,120189
62468,,dke2fq6rfz8j,60095,60096,120191
62469,,dgs4ikt_1ecj,60096,60097,120193
62470,,qnq1vr42mugj,60097,60098,120195
62471,,0kbfj6as_9sj,60098,60099,120197
62472,,xlg2jcyoragj,60099,60100,120199
62473,,pjieyslsigej,60100,60101,120201
62474,,ispb-sqgtsij,60101,60102,120203
62475,,qjllr7kk12gj,60102,60103,120205
62476,,rzcu16p42baj,60103,60104,120207
62477,,url:http://www.csa.com/partners/viewrecord.php3frequester3dgs26collection3denv26recid3d7704293,60104,60105,120209
62478,,gkzoq0zeigmj,60105,60106,120211
62479,,rxnridvgnlsj,60106,60107,120213
62480,,tayequ1ffz8j,60107,60108,120215
62481,,j06bgjtoeroj,60108,60109,120217
62482,,a7mm5kfk3zwj,60109,60110,120219
62483,,stbgnh74jo0j,60110,60111,120221
62484,,sklyd45prc4j,60111,60112,120223
62485,,xtl9h6kzhcwj,60112,60113,120225
62486,,z3p7y2oy15cj,60113,60114,120227
62487,,toe4qi-blocj,60114,60115,120229
62488,,cjtcbcktztoj,60115,60116,120231
62489,,qn3cfdfhp0ij,60117,60118,120235
62490,,sek0qkuwkjgj,60118,60119,120237
62491,,jwys4b5uljuj,60119,60120,120239
62492,,yblan_vp1hij,60120,60121,120241
62493,,hlrci-5jq9ij,60121,60122,120243
62494,,d7vy6vdq_7ej,60122,60123,120245
62495,,jlixhprol9mj,60123,60124,120247
62496,,bgbbnwce5qmj,60124,60125,120249
62497,,azb0zoisb2ej,60125,60126,120251
62498,,rfdqdxvhlooj,60126,60127,120253
62499,,zs2lioldeacj,60127,60128,120255
62500,,ug77e3mh6zwj,60128,60129,120257
62501,,url:http://dx.doi.org/10.1524/auto.51.4.a9.34760,60129,60130,120259
62502,,2n6tzol3kfkj,60130,60131,120261
62503,,kwq_pcl7dooj,60131,60132,120263
62504,,url:http://ieeexplore.ieee.org/iel3/3990/11481/00547914.pdf3farnumber3d547914,60132,60133,120265
62505,,cxih3vmijaoj,60133,60134,120267
62506,,ke1crrhoxuoj,60134,60135,120269
62507,,url:http://www.csa.com/partners/viewrecord.php3frequester3dgs26collection3dtrd26recid3dn9210434ah,60135,60136,120271
62508,,dc-3ouqopuyj,60136,60137,120273
62509,,1rytvhxvmbsj,60137,60138,120275
62510,,c_-4fjw4bsgj,60138,60139,120277
62511,,txrdacc-rnyj,60139,60140,120279
62512,,tut1sih_1oqj,60140,60141,120281
62513,,kqfgc1jkhu4j,60141,60142,120283
62514,,sf9tlydiadoj,60142,60143,120285
62515,,pbqwmswljtcj,60143,60144,120287
62516,,k7f8beuaneqj,60144,60145,120289
62517,,xsud1v-wza4j,60145,60146,120291
62518,,vkvxs3j9ap4j,60146,60147,120293
62519,,w360dgolmryj,60147,60148,120295
62520,,ztwynpa8mgwj,60148,60149,120297
62521,,q85qjacm9soj,60149,60150,120299
62522,,_1ndtuggjcij,60150,60151,120301
62523,,ucchpn1ocagj,60152,60153,120305
62524,,kzbtz_9z4asj,60153,60154,120307
62525,,5jcyeyea280j,60154,60155,120309
62526,,ynaqcjimbd8j,60155,60156,120311
62527,,enrxg8l0u7wj,60156,60157,120313
62528,,n1pqzjjlmoij,60157,60158,120315
62529,,pr9asdlvndij,60158,60159,120317
62530,,zcukb7jbmu4j,60159,60160,120319
62531,,szxxwa8xbbij,60160,60161,120321
62532,,fuwnnbw8escj,60161,60162,120323
62533,,radr46gjqeyj,60162,60163,120325
62534,,7af2agzolawj,60163,60164,120327
62535,,pjotcx33odmj,60164,60165,120329
62536,,asgsk0tdjqoj,60167,60168,120335
62537,,_lb6_nce5_ij,60168,60169,120337
62538,,t0j871wovdej,60169,60170,120339
62539,,p6nzv7n975wj,60170,60171,120341
62540,,3rr94ixw5cuj,60171,60172,120343
62541,,uukdngpwoyyj,60172,60173,120345
62542,,yokkqgpzkgcj,60173,60174,120347
62543,,qsg649m85uej,60174,60175,120349
62544,,pejt0m0yur0j,60175,60176,120351
62545,,8loon2mhuh0j,60176,60177,120353
62546,,inq2af_nxr4j,60177,60178,120355
62547,,y2g8vmtuwv8j,60178,60179,120357
62548,,i2miwhi0poij,60179,60180,120359
62549,,rg0h3ofq_iaj,60180,60181,120361
62550,,url:http://portal.acm.org/ft_gateway.cfm3fid3d109966026type3dpdf,60181,60182,120363
62551,,8q-a2pbphb8j,60182,60183,120365
62552,,r9ga8rfgosgj,60183,60184,120367
62553,,_aa2qeg_o30j,60184,60185,120369
62554,,6enqy4qchesj,60185,60186,120371
62555,,url:http://portal.acm.org/ft_gateway.cfm3fid3d110123926type3dpdf,60187,60188,120375
62556,,sbpi8xidfaij,60188,60189,120377
62557,,kzavcj-ivhcj,60189,60190,120379
62558,,wnsyfyff1jkj,60190,60191,120381
62559,,4ptcoy1yfqej,60191,60192,120383
62560,,acmp1bhxsz0j,60192,60193,120385
62561,,pjlwmkje7acj,60193,60194,120387
62562,,ndjkbtpdtiyj,60194,60195,120389
62563,,b0-i4vthbzej,60195,60196,120391
62564,,35htordkjjcj,60196,60197,120393
62565,,jfpnzay3q7yj,60197,60198,120395
62566,,wyyq5ekqscuj,60198,60199,120397
62567,,st2gmzbzw3wj,60199,60200,120399
62568,,iojspbjk1fmj,60200,60201,120401
62569,,u_9mhaeqpfaj,60201,60202,120403
62570,,k1psyoqrppgj,60202,60203,120405
62571,,qsdzgwezexgj,60203,60204,120407
62572,,to54b-e2mxmj,60204,60205,120409
62573,,3vd-hexv4gsj,60205,60206,120411
62574,,coi42io9e8gj,60206,60207,120413
62575,,xcjrxoi5lcgj,60207,60208,120415
62576,,ggc1x3m8mxsj,60208,60209,120417
62577,,uvw-yxxohooj,60209,60210,120419
62578,,i834pu7agw8j,60210,60211,120421
62579,,unrbj_fwem8j,60211,60212,120423
62580,,z2ox6xdfa_8j,60212,60213,120425
62581,,dsj-_ptvglqj,60213,60214,120427
62582,,p-rha9nwxaqj,60214,60215,120429
62583,,nnzlypbbyguj,60215,60216,120431
62584,,_g9ezylu-iij,60216,60217,120433
62585,,j_mqy88frxuj,60217,60218,120435
62586,,f_8ls4rxbp0j,60218,60219,120437
62587,,9riycjkr018j,60219,60220,120439
62588,,b8w6lncuzzuj,60220,60221,120441
62589,,wjdrowiwebsj,60221,60222,120443
62590,,le7ppo6mutoj,60222,60223,120445
62591,,d456h3rpg3cj,60223,60224,120447
62592,,ynt8na5ef4sj,60224,60225,120449
62593,,0bumwy5nopmj,60225,60226,120451
62594,,e604s_pnraaj,60226,60227,120453
62595,,a_e0ojuioe4j,60227,60228,120455
62596,,beboe4pvnmuj,60228,60229,120457
62597,,jwzkmggzivoj,60229,60230,120459
62598,,ktesz1rmxjqj,60230,60231,120461
62599,,tamqrbpi_qgj,60231,60232,120463
62600,,6fsh2-boujcj,60232,60233,120465
62601,,zdb6ldry12uj,60233,60234,120467
62602,,,60234,60235,120469
62603,,ex51ekjcj3qj,60235,60236,120471
62604,,oulyxbpuiqaj,60236,60237,120473
62605,,5aaznelkgakj,60237,60238,120475
62606,,qeehwkobycsj,60238,60239,120477
62607,,cp4va-bln6mj,60239,60240,120479
62608,,5qc_f1thacij,60240,60241,120481
62609,,5smk3mjsutkj,60241,60242,120483
62610,,tcndk3kmugsj,60243,60244,120487
62611,,1dfosvqtfgqj,60244,60245,120489
62612,,3upcl18cs9wj,60245,60246,120491
62613,,w2nznhyfbz8j,60246,60247,120493
62614,,0vykzvignekj,60247,60248,120495
62615,,xg-cmcdozacj,60248,60249,120497
62616,,yppbbmj9b8yj,60250,60251,120501
62617,,adywbodp_yij,60251,60252,120503
62618,,t_u9fqc3a0wj,60252,60253,120505
62619,,zxwhr2xpwbej,60253,60254,120507
62620,,url:http://links.jstor.org/sici3fsici3d0146-4949(196622)7253a2253c211253apvsnea253e2.0.co253b2-2,60254,60255,120509
62621,,7hn2vsn735sj,60255,60256,120511
62622,,n90reqtqucqj,60256,60257,120513
62623,,kdsqy9r3bu0j,60257,60258,120515
62624,,f29prrm7kxcj,60258,60259,120517
62625,,qn7unbzgftwj,60259,60260,120519
62626,,wzaqymgaxegj,60260,60261,120521
62627,,t3n6u7c5tikj,60261,60262,120523
62628,,yad8mde_kv8j,60262,60263,120525
62629,,ptrfjxdrlhyj,60263,60264,120527
62630,,yg5enymdqjaj,60264,60265,120529
62631,,4t4i9w52uryj,60266,60267,120533
62632,,m_ao8zdvquej,60267,60268,120535
62633,,t_6vyy8hee8j,60269,60270,120539
62634,,vohhrlrno7gj,60270,60271,120541
62635,,y_hpevl4yd4j,60271,60272,120543
62636,,qt-ds1d04wcj,60272,60273,120545
62637,,x2rungshypoj,60273,60274,120547
62638,,morovgdhxmmj,60274,60275,120549
62639,,ey_zk9ynk0yj,60275,60276,120551
62640,,aqypghurmocj,60276,60277,120553
62641,,oqwwpznilswj,60277,60278,120555
62642,,xe1liyl6_kaj,60278,60279,120557
62643,,tiago7g7yuaj,60279,60280,120559
62644,,c2cd6y4ijouj,60280,60281,120561
62645,,aluzrqucabqj,60281,60282,120563
62646,,url:http://portal.acm.org/citation.cfm3fid3d171926.171997,60282,60283,120565
62647,,oanoa6hlo-mj,60283,60284,120567
62648,,s8xgdc8p-5oj,60284,60285,120569
62649,,url:http://portal.acm.org/ft_gateway.cfm3fid3d110128926type3dpdf,60285,60286,120571
62650,,d9w5nb6v828j,60286,60287,120573
62651,,rkgsu7v0bkqj,60287,60288,120575
62652,,lhzgz5wsf-0j,60288,60289,120577
62653,,jo09fewdu_uj,60289,60290,120579
62654,,mmjvvqrule8j,60290,60291,120581
62655,,38ml4icjv7kj,60291,60292,120583
62656,,p5qh-vvle6ej,60292,60293,120585
62657,,rftsx5zy1jij,60293,60294,120587
62658,,bo0uupfccamj,60294,60295,120589
62659,,hr1ybsvnc9wj,60295,60296,120591
62660,,udaopc821_ij,60296,60297,120593
62661,,su9-zg4pdt8j,60297,60298,120595
62662,,d96kfygz1egj,60298,60299,120597
62663,,url:http://portal.acm.org/ft_gateway.cfm3fid3d102774326type3dpdf,60299,60300,120599
62664,,0ujygkl3jqwj,60300,60301,120601
62665,,0g3tecvmm6ij,60301,60302,120603
62666,,ruf0r5nt39qj,60302,60303,120605
62667,,yopr5frw-ekj,60303,60304,120607
62668,,qnb3ir0kaxcj,60304,60305,120609
62669,,fdik9vvwgeaj,60305,60306,120611
62670,,pz4vyhbvvgoj,60307,60308,120615
62671,,the9hrmweyoj,60308,60309,120617
62672,,omn0nxwtlnuj,60309,60310,120619
62673,,iscocuecw94j,60310,60311,120621
62674,,vtbd9vp8lkkj,60311,60312,120623
62675,,bal74uwor_kj,60312,60313,120625
62676,,zbuhvdtrj0ij,60313,60314,120627
62677,,r8c101xb3qij,60314,60315,120629
62678,,dklmpeiyyucj,60315,60316,120631
62679,,49owi-bq4pmj,60316,60317,120633
62680,,sygt6zs46a0j,60317,60318,120635
62681,,imkkcu6e7hgj,60318,60319,120637
62682,,dpkeixz_-9ej,60319,60320,120639
62683,,xa_wholvg7gj,60320,60321,120641
62684,,en0gbufxrmej,60321,60322,120643
62685,,jm8lrwyv2y4j,60322,60323,120645
62686,,xknqzhdvdssj,60323,60324,120647
62687,,ixnqfiq0uaoj,60324,60325,120649
62688,,ghbparnqfeej,60325,60326,120651
62689,,n6d6as8yc44j,60326,60327,120653
62690,,a2_91dpczxuj,60327,60328,120655
62691,,url:http://adsabs.harvard.edu/abs/1990mit..repts....k,60328,60329,120657
62692,,gsiuhmivm6sj,60329,60330,120659
62693,,fiynpoz1anaj,60330,60331,120661
62694,,osyb__1t0qcj,60331,60332,120663
62695,,url:http://portal.acm.org/citation.cfm3fid3d1086228.1086273,60332,60333,120665
62696,,url:http://www.springerlink.com/index/2h6ncyq8tqbbmntd.pdf,60333,60334,120667
62697,,8ezefzfdiyuj,60334,60335,120669
62698,,euvvfm7uga4j,60336,60337,120673
62699,,url:http://portal.acm.org/citation.cfm3fid3d1066284,60337,60338,120675
62700,,yylbruk0ne8j,60338,60339,120677
62701,,cai_f0zny0ij,60339,60340,120679
62702,,zrjxrk-8hdsj,60341,60342,120683
62703,,qdituvfgxqoj,60342,60343,120685
62704,,a-dvhtrdxi4j,60343,60344,120687
62705,,yiwh0l_cwp4j,60344,60345,120689
62706,,6_uzx-mzbkwj,60345,60346,120691
62707,,kzha11eunfyj,60346,60347,120693
62708,,pceio3ltplgj,60347,60348,120695
62709,,qwpocgtwdroj,60348,60349,120697
62710,,0pistxyfniqj,60349,60350,120699
62711,,njmtlcohslej,60350,60351,120701
62712,,patbgvxdp1wj,60352,60353,120705
62713,,is-v43qgq90j,60353,60354,120707
62714,,9lqngohcuhcj,60354,60355,120709
62715,,st9ylpadsp4j,60355,60356,120711
62716,,7su7sqm5uosj,60356,60357,120713
62717,,oqkiv6s56gej,60357,60358,120715
62718,,bhqjwuwvudij,60358,60359,120717
62719,,aep41xpjovgj,60359,60360,120719
62720,,wipgtjeji0kj,60361,60362,120723
62721,,nby5dlln5ooj,60362,60363,120725
62722,,zneryxguha4j,60363,60364,120727
62723,,tngu2ormswej,60364,60365,120729
62724,,a9xn-zvu1duj,60365,60366,120731
62725,,uvl3g6ea5lqj,60366,60367,120733
62726,,gemycblxzukj,60367,60368,120735
62727,,vsmhdvubhfcj,60368,60369,120737
62728,,sktaaod9goyj,60369,60370,120739
62729,,y1io_ifpcgoj,60370,60371,120741
62730,,88mr-by5vc4j,60371,60372,120743
62731,,mpb0qsmztnwj,60372,60373,120745
62732,,jmc-99eybkkj,60373,60374,120747
62733,,url:http://ieeexplore.ieee.org/iel3/3962/11444/00518688.pdf3farnumber3d518688,60374,60375,120749
62734,,7saydu4nrfqj,60375,60376,120751
62735,,bx0oe6kp_gkj,60376,60377,120753
62736,,oocnarzt6nwj,60377,60378,120755
62737,,ayaywl1ev9oj,60378,60379,120757
62738,,02gpjzrjrh4j,60379,60380,120759
62739,,uvgnqqkj5uoj,60380,60381,120761
62740,,jqzecqceolyj,60381,60382,120763
62741,,c0uyg4dwcpcj,60382,60383,120765
62742,,9szasawzydmj,60383,60384,120767
62743,,poteue0mqs4j,60385,60386,120771
62744,,afmww6u_joaj,60387,60388,120775
62745,,rjkrhvsbodaj,60388,60389,120777
62746,,euoqs3o1bsqj,60389,60390,120779
62747,,6nejqkkf9dij,60390,60391,120781
62748,,d9utqptsnnoj,60391,60392,120783
62749,,clo4zhq7rysj,60392,60393,120785
62750,,zea2ptmyrzwj,60393,60394,120787
62751,,etrptfzbz1qj,60394,60395,120789
62752,,wfa26k-mlvmj,60395,60396,120791
62753,,j9stb5pc7bqj,60396,60397,120793
62754,,pqg4yax-pnuj,60397,60398,120795
62755,,yisgksbbkgwj,60398,60399,120797
62756,,uyhawmg90fgj,60399,60400,120799
62757,,zcrakegng4ij,60400,60401,120801
62758,,2v5rhj48y2kj,60401,60402,120803
62759,,naf1swlgz4qj,60402,60403,120805
62760,,ona6yz-lm5gj,60403,60404,120807
62761,,2nh9cenq0duj,60404,60405,120809
62762,,ssnrkxg5sewj,60405,60406,120811
62763,,url:http://links.jstor.org/sici3fsici3d0146-4949(196424252f21)5253a1253c26253atocatn253e2.0.co253b2-y,60406,60407,120813
62764,,ojid8eetqruj,60407,60408,120815
62765,,2gsn44bjrhmj,60408,60409,120817
62766,,t-ntmxvt0sij,60409,60410,120819
62767,,biq65uhikf8j,60410,60411,120821
62768,,5nx0pdsqtrmj,60411,60412,120823
62769,,u7owxk6bpy4j,60412,60413,120825
62770,,bza3royvzvij,60413,60414,120827
62771,,uzxi26shtcqj,60414,60415,120829
62772,,hqus5fnpqzyj,60415,60416,120831
62773,,url:http://www.csa.com/partners/viewrecord.php3frequester3dgs26collection3dtrd26recid3d0014649ci,60416,60417,120833
62774,,sgmffhnof4ij,60417,60418,120835
62775,,kwepv5b9dicj,60418,60419,120837
62776,,5xl5zgnmyqaj,60419,60420,120839
62777,,1j6izi_7ftwj,60420,60421,120841
62778,,dkehpymoiiwj,60421,60422,120843
62779,,jen9velp7gaj,60422,60423,120845
62780,,0tvrmyrjxooj,60423,60424,120847
62781,,4kcfhapgmsej,60424,60425,120849
62782,,xpkpytkul6ij,60425,60426,120851
62783,,wiy1riocykwj,60426,60427,120853
62784,,7ilaqerw4pqj,60427,60428,120855
62785,,fwllk-cnwz0j,60428,60429,120857
62786,,4cuckhuxdxoj,60429,60430,120859
62787,,joqjvvs98-sj,60430,60431,120861
62788,,x2cb7l1yuzij,60431,60432,120863
62789,,uf5n0zirybqj,60432,60433,120865
62790,,f4qco_bzmzqj,60433,60434,120867
62791,,ow2_gtqmci4j,60435,60436,120871
62792,,wg_mgg83-l0j,60436,60437,120873
62793,,93wm25l8mdej,60437,60438,120875
62794,,,60438,60439,120877
62795,,qw88_7wcss0j,60439,60440,120879
62796,,vkzmlt3vdjwj,60440,60441,120881
62797,,hwplbg_c0lej,60441,60442,120883
62798,,ogzag2sy5emj,60442,60443,120885
62799,,1-r6rp6xabuj,60443,60444,120887
62800,,kgu_qus_cjqj,60444,60445,120889
62801,,n_ypqx7a4gsj,60445,60446,120891
62802,,qhluuwl074ej,60446,60447,120893
62803,,qkbsltdhiaaj,60447,60448,120895
62804,,wmis4ebtol8j,60448,60449,120897
62805,,,60449,60450,120899
62806,,q43qb55cs90j,60450,60451,120901
62807,,movqozozemcj,60452,60453,120905
62808,,zzsxx-hjkeuj,60453,60454,120907
62809,,wvmkila-cqmj,60454,60455,120909
62810,,rivzcrxhoakj,60455,60456,120911
62811,,vls9ybwvmgcj,60456,60457,120913
62812,,7j2ccsbxp2ej,60457,60458,120915
62813,,79clzhqsxlkj,60458,60459,120917
62814,,scvi0zt7mnaj,60459,60460,120919
62815,,u0vaeqmgceoj,60460,60461,120921
62816,,6fmbikhuyggj,60461,60462,120923
62817,,uhh8noa3r_gj,60462,60463,120925
62818,,laj1h1tska8j,60463,60464,120927
62819,,ihbufqjoxj4j,60464,60465,120929
62820,,aniwvc0qfxuj,60465,60466,120931
62821,,h30mlgw2mlej,60466,60467,120933
62822,,2p9nomk9_0mj,60467,60468,120935
62823,,pknrymmxbmqj,60468,60469,120937
62824,,_olnvaednyyj,60469,60470,120939
62825,,339ayrpwqluj,60470,60471,120941
62826,,1s2c9dwrk-wj,60471,60472,120943
62827,,ytuooasiewij,60472,60473,120945
62828,,wwqero8or0yj,60473,60474,120947
62829,,vsbohouymegj,60474,60475,120949
62830,,sqy5mdahpucj,60475,60476,120951
62831,,gw5h7vcrwhij,60476,60477,120953
62832,,igxuqju6jfmj,60477,60478,120955
62833,,lr7mg_jpvgsj,60478,60479,120957
62834,,lb9hg0pmhw0j,60479,60480,120959
62835,,2jfol488qooj,60480,60481,120961
62836,,url:http://portal.acm.org/citation.cfm3fid3d582353.582398,60481,60482,120963
62837,,cvrhipto51yj,60482,60483,120965
62838,,dvhlp6javlcj,60483,60484,120967
62839,,qzhbga7a7kuj,60484,60485,120969
62840,,orcbz7l14iaj,60485,60486,120971
62841,,erjfzmyxuasj,60486,60487,120973
62842,,8pn5qfkziywj,60487,60488,120975
62843,,3mmnssdc7rqj,60488,60489,120977
62844,,grb4rsisuxgj,60489,60490,120979
62845,,6nrwb_aflqwj,60490,60491,120981
62846,,eu2mmoed3kgj,60491,60492,120983
62847,,l-veg4pczo4j,60492,60493,120985
62848,,m13hjlqpnomj,60493,60494,120987
62849,,ins299jsh1yj,60494,60495,120989
62850,,kntasi7w1tgj,60495,60496,120991
62851,,2oxiebsy6qoj,60497,60498,120995
62852,,eq6mxjb6izaj,60498,60499,120997
62853,,x5nfkcjdvnqj,60499,60500,120999
62854,,c8qc0yh2lucj,60500,60501,121001
62855,,qlbsetnrokqj,60501,60502,121003
62856,,tg4mfc3xt44j,60502,60503,121005
62857,,4fr9jzbszocj,60504,60505,121009
62858,,gohd3wbjyl0j,60505,60506,121011
62859,,2peykna96x4j,60506,60507,121013
62860,,4tmafl4re_ij,60507,60508,121015
62861,,gm1fjneuyi0j,60508,60509,121017
62862,,sibwgt86ezuj,60509,60510,121019
62863,,vjtsu6y2xsgj,60510,60511,121021
62864,,k-jph9kvizoj,60511,60512,121023
62865,,wuflnk1frjwj,60512,60513,121025
62866,,yilqsgodf6yj,60513,60514,121027
62867,,a9dgie7kwjgj,60514,60515,121029
62868,,byzcrtfgra4j,60515,60516,121031
62869,,mt_uovbs_iyj,60516,60517,121033
62870,,0ioihdfzvjuj,60517,60518,121035
62871,,mtb3lraorkqj,60518,60519,121037
62872,,ad5vs44pkyyj,60519,60520,121039
62873,,gk_ncrasr0uj,60520,60521,121041
62874,,vh8wq8vmpqkj,60521,60522,121043
62875,,l9kmso-2huqj,60522,60523,121045
62876,,h2qojswcmngj,60523,60524,121047
62877,,reytzgzk6fmj,60524,60525,121049
62878,,s3sine_lgqsj,60525,60526,121051
62879,,sgvsex0ux1ij,60526,60527,121053
62880,,zmfryq7n7ewj,60527,60528,121055
62881,,bgio4elji64j,60528,60529,121057
62882,,lc2notmtydsj,60529,60530,121059
62883,,uopokthhbqqj,60530,60531,121061
62884,,81l5n-8a4byj,60531,60532,121063
62885,,48tt_x0qlkyj,60532,60533,121065
62886,,onidf7rxizuj,60533,60534,121067
62887,,eecob5sdwk4j,60534,60535,121069
62888,,vtnnjo3jqgcj,60535,60536,121071
62889,,6ruhqbcozoaj,60536,60537,121073
62890,,9mwyzsfg89wj,60537,60538,121075
62891,,gnnrugkrktej,60538,60539,121077
62892,,9efaolelvn0j,60539,60540,121079
62893,,6uuxegphaqcj,60540,60541,121081
62894,,luwf8u6bnaoj,60541,60542,121083
62895,,h0wysu_bjr8j,60542,60543,121085
62896,,url:http://portal.acm.org/citation.cfm3fid3d1027527.1027567,60543,60544,121087
62897,,5v39rzio-zsj,60544,60545,121089
62898,,jliim5phisuj,60545,60546,121091
62899,,_5dsszqzzquj,60546,60547,121093
62900,,e9ethjdedfmj,60547,60548,121095
62901,,vkwdbzsed2ij,60548,60549,121097
62902,,u6ydqzp-uaaj,60549,60550,121099
62903,,url:http://www.ncbi.nlm.nih.gov/entrez/query.fcgi3fcmd3dretrieve26db3dpubmed26list_uids3d1565473626dopt3dcitation,60550,60551,121101
62904,,rfjonkafupej,60551,60552,121103
62905,,kdvur5ldnwej,60552,60553,121105
62906,,wbpfe7c-vmkj,60553,60554,121107
62907,,gbhmzjdf0iuj,60554,60555,121109
62908,,scwiuwopsgej,60555,60556,121111
62909,,bh_dufoz_haj,60556,60557,121113
62910,,heqbsbg7d1kj,60557,60558,121115
62911,,lfwxk613uvyj,60558,60559,121117
62912,,hgxln1satxyj,60559,60560,121119
62913,,oathgtzs91wj,60560,60561,121121
62914,,url:http://portal.acm.org/ft_gateway.cfm3fid3d37368426type3dpdf26dl3dguide26dl3dacm26cfid3d1111111126cftoken3d2222222,60561,60562,121123
62915,,zra1xahrc7cj,60562,60563,121125
62916,,sldcppj0qoej,60563,60564,121127
62917,,wisoxmsnmnuj,60565,60566,121131
62918,,5takrxrsfpqj,60566,60567,121133
62919,,ajoadxrjw5cj,60567,60568,121135
62920,,3pwkgrwajcij,60568,60569,121137
62921,,pxahebccwhsj,60569,60570,121139
62922,,fnhxoqgxctij,60570,60571,121141
62923,,vsddvliycmij,60571,60572,121143
62924,,tgggsxff7paj,60572,60573,121145
62925,,igwfwmn1_aaj,60573,60574,121147
62926,,url:http://portal.acm.org/ft_gateway.cfm3fid3d110117826type3dpdf,60574,60575,121149
62927,,lq9qvmpoq3cj,60575,60576,121151
62928,,yr2klyft1jsj,60576,60577,121153
62929,,hzz-_oeruhkj,60577,60578,121155
62930,,xbgsavfnkcqj,60578,60579,121157
62931,,,60579,60580,121159
62932,,k__-tiat-cqj,60580,60581,121161
62933,,y5qdyx_bdxyj,60581,60582,121163
62934,,rz-utpdxlmoj,60582,60583,121165
62935,,ivnkeiw36bcj,60583,60584,121167
62936,,tjqqyarf6boj,60584,60585,121169
62937,,bpkz_b2fuzaj,60585,60586,121171
62938,,u_iewsxbwckj,60586,60587,121173
62939,,ciyvi4f6wlmj,60587,60588,121175
62940,,5imt_jj9gcej,60588,60589,121177
62941,,ym9fiyzmt2uj,60589,60590,121179
62942,,yb-bfbtlctmj,60590,60591,121181
62943,,rzsh8byrqaoj,60591,60592,121183
62944,,kruouavvjhkj,60592,60593,121185
62945,,uslsgvi1mruj,60593,60594,121187
62946,,dvs9gbdwojwj,60594,60595,121189
62947,,mounbimdly4j,60595,60596,121191
62948,,fivpwwez_98j,60596,60597,121193
62949,,yxo4sa8_vqoj,60597,60598,121195
62950,,uyff2wjvaq4j,60598,60599,121197
62951,,p-m7mmos2auj,60599,60600,121199
62952,,i1vtw-293koj,60600,60601,121201
62953,,z47v3rnwj3gj,60601,60602,121203
62954,,pbpkqyqsjlij,60603,60604,121207
62955,,c-m5dws55kcj,60604,60605,121209
62956,,url:http://books.google.com/books3fhl3den26lr3d26id3dtgu8cbmvrcgc26oi3dfnd26pg3dpp826sig3dwaxyk6qaijelq_waei6y_st0ki426prev3dhttp://scholar.google.com/scholar253fstart253d2002526num253d1002526hl253den2526lr253d2526sa253dn,60605,60606,121211
62957,,yluggoulncmj,60606,60607,121213
62958,,ahb1zw5jf-4j,60607,60608,121215
62959,,qnbwg1ohibuj,60608,60609,121217
62960,,fohhylg0romj,60609,60610,121219
62961,,oasiyc-vi9ej,60610,60611,121221
62962,,w4_bnhm_x9ij,60611,60612,121223
62963,,yjef9mxktnoj,60612,60613,121225
62964,,9xkzd2b9jsqj,60613,60614,121227
62965,,yty7qocl87qj,60614,60615,121229
62966,,7vbhemuwp2yj,60615,60616,121231
62967,,ulnitsbu0tyj,60616,60617,121233
62968,,dfslxg4p5vuj,60617,60618,121235
62969,,esj_s7vcnosj,60618,60619,121237
62970,,8kfbnz4o5aij,60619,60620,121239
62971,,iboq4slsxpkj,60621,60622,121243
62972,,url:http://doi.wiley.com/10.1002/he.102,60622,60623,121245
62973,,_wb29d5shoaj,60623,60624,121247
62974,,og4fcakr20ij,60624,60625,121249
62975,,wrb3bthapkgj,60625,60626,121251
62976,,ck8etiz37-gj,60626,60627,121253
62977,,cyhuoerhnnij,60627,60628,121255
62978,,gugmddrk_y0j,60628,60629,121257
62979,,url:http://portal.acm.org/ft_gateway.cfm3fid3d110126626type3dpdf,60629,60630,121259
62980,,c_ldf3chjwqj,60630,60631,121261
62981,,sj0vjyxdwqoj,60631,60632,121263
62982,,uv6dd8rfg2ij,60632,60633,121265
62983,,nxoco87wlguj,60634,60635,121269
62984,,neyvdgosbwij,60635,60636,121271
62985,,t7buaro4icaj,60636,60637,121273
62986,,kadv5u4qiqij,60637,60638,121275
62987,,gzgupgdv8kej,60638,60639,121277
62988,,url:http://www.ncbi.nlm.nih.gov/entrez/query.fcgi3fcmd3dretrieve26db3dpubmed26list_uids3d73911526dopt3dcitation,60639,60640,121279
62989,,ootwvayldvsj,60640,60641,121281
62990,,url:http://www.springerlink.com/index/q117235573687434.pdf,60641,60642,121283
62991,,n14pbymoiiqj,60642,60643,121285
62992,,ybalhdw71woj,60643,60644,121287
62993,,zfinaqtfvbej,60644,60645,121289
62994,,e8p8laj5scqj,60645,60646,121291
62995,,tyxd6zlokwsj,60646,60647,121293
62996,,3o17xle3ne0j,60647,60648,121295
62997,,h_gbqcgkctyj,60648,60649,121297
62998,,2h6u_86-uzej,60649,60650,121299
62999,,vmxzeja08coj,60650,60651,121301
63000,,mmfrax5bdjqj,60651,60652,121303
63001,,1kfjb7z9aouj,60652,60653,121305
63002,,bmmbflomzikj,60653,60654,121307
63003,,3ikewc0duwsj,60654,60655,121309
63004,,url:http://doi.wiley.com/10.1002/ace.8701,60655,60656,121311
63005,,k09rqm9crq4j,60656,60657,121313
63006,,9kkevdqp8zmj,60657,60658,121315
63007,,ddtkvcpclukj,60658,60659,121317
63008,,3u6kcyd-ueij,60659,60660,121319
63009,,psgho47dxhgj,60660,60661,121321
63010,,vhhmvk7yekuj,60661,60662,121323
63011,,u2t3mhgowjqj,60662,60663,121325
63012,,xexdbxzob-yj,60663,60664,121327
63013,,j1tjkcljsa4j,60664,60665,121329
63014,,zsgvyidtdg4j,60665,60666,121331
63015,,xz8zkgieggkj,60666,60667,121333
63016,,sireomxgnf0j,60667,60668,121335
63017,,edseo6dkha0j,60668,60669,121337
63018,,6iq-j_rmhoaj,60670,60671,121341
63019,,jan9mcifwn8j,60671,60672,121343
63020,,jwwwcfwkl_0j,60672,60673,121345
63021,,nb8k1kn_kgkj,60673,60674,121347
63022,,kmrqkczvps8j,60674,60675,121349
63023,,ovxczbk1xdsj,60675,60676,121351
63024,,,60676,60677,121353
63025,,rh_mimm7bwmj,60677,60678,121355
63026,,j2cwp4hnmpuj,60678,60679,121357
63027,,adsghpymr-8j,60679,60680,121359
63028,,tlpgqmstd6qj,60680,60681,121361
63029,,8pt8pmd8diuj,60681,60682,121363
63030,,ggfzrw5uwu0j,60682,60683,121365
63031,,gezqam6ivw0j,60683,60684,121367
63032,,zpag0yhuf9uj,60684,60685,121369
63033,,fbvdbfzaim4j,60685,60686,121371
63034,,edldq5pbp_yj,60686,60687,121373
63035,,nsct2xcjmsgj,60687,60688,121375
63036,,7oniu5idkbcj,60688,60689,121377
63037,,7in9athayzmj,60689,60690,121379
63038,,duyoezhcdnqj,60690,60691,121381
63039,,seop4wwfq5wj,60691,60692,121383
63040,,2nvzq5htofuj,60692,60693,121385
63041,,t3jhwchcnr4j,60693,60694,121387
63042,,u0z86vwr8sej,60694,60695,121389
63043,,url:http://www.ncbi.nlm.nih.gov/entrez/query.fcgi3fcmd3dretrieve26db3dpubmed26list_uids3d74842326dopt3dcitation,60695,60696,121391
63044,,6srintwaad4j,60696,60697,121393
63045,,ucacluhcawcj,60697,60698,121395
63046,,ciowpfhbhtej,60698,60699,121397
63047,,wuf1upcwmaij,60699,60700,121399
63048,,omkjgja24soj,60700,60701,121401
63049,,egi4nuvwffcj,60701,60702,121403
63050,,hwexi--yqwcj,60702,60703,121405
63051,,cdwwqszkzbkj,60703,60704,121407
63052,,skl4isibuwwj,60704,60705,121409
63053,,njv2gwah5i0j,60705,60706,121411
63054,,3gzyowc8vfcj,60706,60707,121413
63055,,yakzvzhbqj8j,60707,60708,121415
63056,,ptlhsteaqh0j,60708,60709,121417
63057,,rgo_glcelhaj,60709,60710,121419
63058,,rrn16yycwmoj,60710,60711,121421
63059,,dc-ptnojpi0j,60711,60712,121423
63060,,url:http://www.springerlink.com/index/v47hq167t8763hqx.pdf,60712,60713,121425
63061,,fo43puhu1ycj,60713,60714,121427
63062,,xagwi2rdveuj,60714,60715,121429
63063,,e5ppl8luhm4j,60715,60716,121431
63064,,ba4lrb834f4j,60716,60717,121433
63065,,p5txbjrbz2yj,60717,60718,121435
63066,,pdhwquxvtdoj,60718,60719,121437
63067,,url:http://doi.wiley.com/10.1002/tl.98,60719,60720,121439
63068,,ucbbye2vo4yj,60720,60721,121441
63069,,cd7znxwe1lej,60721,60722,121443
63070,,akztoqmybhcj,60722,60723,121445
63071,,vyuufnrh__wj,60723,60724,121447
63072,,ythq_igpiiuj,60724,60725,121449
63073,,rtbmjgoao5ij,60725,60726,121451
63074,,2yfh0dlfne4j,60726,60727,121453
63075,,9xkbtxge_ooj,60727,60728,121455
63076,,wygq_mhdp9sj,60728,60729,121457
63077,,url:http://www.csa.com/partners/viewrecord.php3frequester3dgs26collection3dtrd26recid3da7214161ah,60729,60730,121459
63078,,n1ebll92pwwj,60730,60731,121461
63079,,url:http://www.geography.org.uk/journals/journals.asp3farticleid3d14,60731,60732,121463
63080,,xpiwzihp7p8j,60732,60733,121465
63081,,_g2vhsuyxh8j,60733,60734,121467
63082,,loauy9f_dd8j,60734,60735,121469
63083,,_p9w4qvvlnaj,60735,60736,121471
63084,,0uaesnyvjs0j,60736,60737,121473
63085,,mlnoe-1jmygj,60737,60738,121475
63086,,bsuivmv643ej,60738,60739,121477
63087,,,60739,60740,121479
63088,,ztfqm0giu34j,60740,60741,121481
63089,,qlh1ribj5fij,60741,60742,121483
63090,,wfbsshllujoj,60742,60743,121485
63091,,ybnezgmh540j,60743,60744,121487
63092,,cs4k1zowrtaj,60744,60745,121489
63093,,i4wrohbqfywj,60745,60746,121491
63094,,fuqy4webeb4j,60746,60747,121493
63095,,tbar0vr3rhmj,60747,60748,121495
63096,,oefks5rsawkj,60748,60749,121497
63097,,vmye_4fk3m0j,60749,60750,121499
63098,,blagxodp19aj,60750,60751,121501
63099,,rr07wfsurl4j,60751,60752,121503
63100,,3nmdfnbzcxij,60752,60753,121505
63101,,lnnvryg9moaj,60753,60754,121507
63102,,url:http://www.csa.com/partners/viewrecord.php3frequester3dgs26collection3dtrd26recid3d0309543ci26recid3d0309543ea,60754,60755,121509
63103,,jd3xzrjefk8j,60755,60756,121511
63104,,70mopnqxxpej,60756,60757,121513
63105,,url:http://ieeexplore.ieee.org/iel5/9217/29235/01320079.pdf3farnumber3d1320079,60757,60758,121515
63106,,url:http://portal.acm.org/citation.cfm3fid3d117764.117771,60758,60759,121517
63107,,ttdldvgyiwij,60759,60760,121519
63108,,yx9cxygsw9cj,60760,60761,121521
63109,,x4yg_la5vusj,60761,60762,121523
63110,,psw5rds0lkgj,60762,60763,121525
63111,,ho9sm86fviuj,60763,60764,121527
63112,,u5wwfkwzbzkj,60764,60765,121529
63113,,url:http://portal.acm.org/ft_gateway.cfm3fid3d108626526type3dpdf,60765,60766,121531
63114,,5fqmeji7ksoj,60766,60767,121533
63115,,ukuwlnal6u4j,60767,60768,121535
63116,,jgoaxfwc9doj,60768,60769,121537
63117,,rvcsdzwxkpuj,60769,60770,121539
63118,,owxv_z6wvxij,60770,60771,121541
63119,,hq_oswc1ar0j,60771,60772,121543
63120,,mrj-skgz3w0j,60772,60773,121545
63121,,yqqdmt8bh2uj,60773,60774,121547
63122,,xxwou2lolp4j,60774,60775,121549
63123,,mj042otjl-4j,60775,60776,121551
63124,,bsowfxkmmomj,60776,60777,121553
63125,,gqgfdiqm1vyj,60777,60778,121555
63126,,gknn2fafr5mj,60778,60779,121557
63127,,cy5hzuugnxkj,60779,60780,121559
63128,,ui4wyndjlyij,60781,60782,121563
63129,,r4fed_awskwj,60782,60783,121565
63130,,89pp7_1fnb8j,60783,60784,121567
63131,,gpz1g50zvy4j,60784,60785,121569
63132,,i8_2xlhlojej,60785,60786,121571
63133,,nxn-7wlm8uij,60786,60787,121573
63134,,ufx74mxuitej,60787,60788,121575
63135,,rq9b0-wpyzej,60788,60789,121577
63136,,w1sxwrc4cbij,60789,60790,121579
63137,,ncii3byamcsj,60790,60791,121581
63138,,ozm1myb4ksej,60791,60792,121583
63139,,6szbejxfqy0j,60792,60793,121585
63140,,tk5ixd2ed08j,60793,60794,121587
63141,,igpcifj28mwj,60795,60796,121591
63142,,o0ee0y3g_kyj,60796,60797,121593
63143,,nns5nvwvvoij,60797,60798,121595
63144,,i8wshndvc7aj,60798,60799,121597
63145,,jclg9ywoadaj,60799,60800,121599
63146,,aguh7etx8pgj,60801,60802,121603
63147,,swchuljnr7uj,60802,60803,121605
63148,,40iknwedu18j,60803,60804,121607
63149,,t-b-6_crkhij,60804,60805,121609
63150,,wv2pcsao96aj,60805,60806,121611
63151,,enug70kepm8j,60806,60807,121613
63152,,tmw2yanropwj,60807,60808,121615
63153,,cgll4-88rpgj,60808,60809,121617
63154,,hjgdewwrrpgj,60809,60810,121619
63155,,pqbl6pddpr0j,60810,60811,121621
63156,,21euc_erxeaj,60811,60812,121623
63157,,oc7_bmow2jkj,60812,60813,121625
63158,,sdhfnislcbwj,60813,60814,121627
63159,,s3hqmszlifoj,60814,60815,121629
63160,,zyl8sjbq9noj,60815,60816,121631
63161,,url:http://portal.acm.org/ft_gateway.cfm3fid3d60387226type3dpdf26dl3dguide26dl3dacm26cfid3d1111111126cftoken3d2222222,60816,60817,121633
63162,,,60817,60818,121635
63163,,sh3oobadepgj,60818,60819,121637
63164,,9rlujupuu_gj,60819,60820,121639
63165,,lr5cfnomtx0j,60820,60821,121641
63166,,vt2jqxum8g8j,60821,60822,121643
63167,,url:http://links.jstor.org/sici3fsici3d0146-4949(196324)4253a1253c109253ajdsab253e2.0.co253b2-r,60822,60823,121645
63168,,vdferp0fapuj,60823,60824,121647
63169,,ukcdwsjxqkqj,60824,60825,121649
63170,,kuogazdhjrqj,60825,60826,121651
63171,,m9im3txp6hij,60826,60827,121653
63172,,3tdyppnpmvmj,60827,60828,121655
63173,,cvqobigf3fqj,60828,60829,121657
63174,,deavrxlmar8j,60829,60830,121659
63175,,y35mpyy4630j,60830,60831,121661
63176,,dauhzqcrcyij,60831,60832,121663
63177,,qtxek4al0-yj,60832,60833,121665
63178,,q3krd34ijygj,60833,60834,121667
63179,,aehvgtfcykuj,60834,60835,121669
63180,,ge5usb8zsh0j,60835,60836,121671
63181,,rklzvsmujw4j,60836,60837,121673
63182,,l-g6c1rqurqj,60837,60838,121675
63183,,bez16vkjdfwj,60838,60839,121677
63184,,url:http://portal.acm.org/ft_gateway.cfm3fid3d37371326type3dpdf26dl3dguide26dl3dacm26cfid3d1111111126cftoken3d2222222,60839,60840,121679
63185,,h99kcvmnspij,60840,60841,121681
63186,,jb7mefn0f9uj,60841,60842,121683
63187,,iskco-aumngj,60842,60843,121685
63188,,p__wfzawxnej,60843,60844,121687
63189,,url:http://www.quebecpharmacie.org/archives/2001/nd/qp_nd01_785_8.pdf,60844,60845,121689
63190,,qob5-swkin8j,60845,60846,121691
63191,,url:http://portal.acm.org/citation.cfm3fid3d22693126dl3dportal26dl3dacm26type3dproceeding26idx3d22693126part3dproceedings26wanttype3dproceedings26title3dinternational2520conference2520on2520digital2520libraries26cfid3d1111111126cftoken3d2222222,60846,60847,121693
63192,,za6odkmrqtcj,60847,60848,121695
63193,,url:http://portal.acm.org/citation.cfm3fid3d226931.22697326dl3dportal26dl3dacm26type3dseries26idx3dseries49226part3dproceedings26wanttype3dproceedings26title3dinternational2520conference2520on2520digital2520libraries26cfid3d1111111126cftoken3d2222222,60848,60849,121697
63194,,ctyfrlzvrmmj,60849,60850,121699
63195,,url:http://portal.acm.org/citation.cfm3fid3d226931.22697026dl3dportal26dl3dacm26type3dseries26idx3dseries49226part3dproceedings26wanttype3dproceedings26title3dinternational2520conference2520on2520digital2520libraries26cfid3d1111111126cftoken3d2222222,60850,60851,121701
63196,,o-fzp19hu2ij,60851,60852,121703
63197,,url:http://portal.acm.org/citation.cfm3fid3d263690.26434126dl3dportal26dl3dacm26type3dseries26idx3dseries49226part3dproceedings26wanttype3dproceedings26title3dinternational2520conference2520on2520digital2520libraries26cfid3d1111111126cftoken3d2222222,60852,60853,121705
63198,,3j2opukr6s8j,60853,60854,121707
63199,,gvrrqi19-kcj,60854,60855,121709
63200,,url:http://portal.acm.org/citation.cfm3fid3d217279.21531926dl3dportal26dl3dacm26type3dseries26idx3dseries31626part3dproceedings26wanttype3dproceedings26title3dinternational2520multimedia2520conference26cfid3d1111111126cftoken3d2222222,60855,60856,121711
63201,,pgqk5xg-u2aj,60856,60857,121713
63202,,mnxollgerb4j,60857,60858,121715
63203,,266e4exwvgoj,60858,60859,121717
63204,,url:http://portal.acm.org/citation.cfm3fid3d226931.22697526dl3dportal26dl3dacm26type3dseries26idx3dseries49226part3dproceedings26wanttype3dproceedings26title3dinternational2520conference2520on2520digital2520libraries26cfid3d1111111126cftoken3d2222222,60859,60860,121719
63205,,url:http://portal.acm.org/ft_gateway.cfm3fid3d31006626type3dpdf26dl3dguide26dl3dacm26cfid3d1111111126cftoken3d2222222,60860,60861,121721
63206,,url:http://portal.acm.org/citation.cfm3fid3d226931.22698026dl3dportal26dl3dacm26type3dseries26idx3dseries49226part3dproceedings26wanttype3dproceedings26title3dinternational2520conference2520on2520digital2520libraries26cfid3d1111111126cftoken3d2222222,60861,60862,121723
63207,,url:http://links.jstor.org/sici3fsici3d0146-4949(196523)6253a3253c293253a2522a2522pdp253e2.0.co253b2-7,60862,60863,121725
63208,,url:http://portal.acm.org/citation.cfm3fid3d226931.22697426dl3dportal26dl3dacm26type3dseries26idx3dseries49226part3dproceedings26wanttype3dproceedings26title3dinternational2520conference2520on2520digital2520libraries26cfid3d1111111126cftoken3d2222222,60863,60864,121727
63209,,vvdf4ogrwnoj,60864,60865,121729
63210,,url:http://portal.acm.org/citation.cfm3fid3d263690.26434926dl3dportal26dl3dacm26type3dseries26idx3dseries49226part3dproceedings26wanttype3dproceedings26title3dinternational2520conference2520on2520digital2520libraries26cfid3d1111111126cftoken3d2222222,60865,60866,121731
63211,,al-tz4jxzfcj,60866,60867,121733
63212,,url:http://portal.acm.org/citation.cfm3fid3d263690.26434226dl3dportal26dl3dacm26type3dseries26idx3dseries49226part3dproceedings26wanttype3dproceedings26title3dinternational2520conference2520on2520digital2520libraries26cfid3d1111111126cftoken3d2222222,60867,60868,121735
63213,,sth5tcdlqu8j,60868,60869,121737
63214,,url:http://portal.acm.org/citation.cfm3fid3d226931.22698526dl3dportal26dl3dacm26type3dseries26idx3dseries49226part3dproceedings26wanttype3dproceedings26title3dinternational2520conference2520on2520digital2520libraries26cfid3d1111111126cftoken3d2222222,60869,60870,121739
63215,,pnypnly-uvwj,60870,60871,121741
63216,,url:http://portal.acm.org/citation.cfm3fid3d226931.22696826dl3dportal26dl3dacm26type3dseries26idx3dseries49226part3dproceedings26wanttype3dproceedings26title3dinternational2520conference2520on2520digital2520libraries26cfid3d1111111126cftoken3d2222222,60871,60872,121743
63217,,url:http://portal.acm.org/citation.cfm3fid3d263690.26433826dl3dportal26dl3dacm26type3dseries26idx3dseries49226part3dproceedings26wanttype3dproceedings26title3dinternational2520conference2520on2520digital2520libraries26cfid3d1111111126cftoken3d2222222,60873,60874,121747
63218,,ohezp4_kouij,60874,60875,121749
63219,,url:http://portal.acm.org/citation.cfm3fid3d217279.21532126dl3dportal26dl3dacm26type3dseries26idx3dseries31626part3dproceedings26wanttype3dproceedings26title3dinternational2520multimedia2520conference26cfid3d1111111126cftoken3d2222222,60875,60876,121751
63220,,ec6fqm5icsij,60876,60877,121753
63221,,url:http://portal.acm.org/citation.cfm3fid3d217279.21532226dl3dportal26dl3dacm26type3dseries26idx3dseries31626part3dproceedings26wanttype3dproceedings26title3dinternational2520multimedia2520conference26cfid3d1111111126cftoken3d2222222,60877,60878,121755
63222,,6ajl4qpbw6ij,60878,60879,121757
63223,,url:http://portal.acm.org/citation.cfm3fid3d226931.22697626dl3dportal26dl3dacm26type3dseries26idx3dseries49226part3dproceedings26wanttype3dproceedings26title3dinternational2520conference2520on2520digital2520libraries26cfid3d1111111126cftoken3d2222222,60879,60880,121759
63224,,k5za2mf27byj,60880,60881,121761
63225,,url:http://portal.acm.org/citation.cfm3fid3d226931.22698426dl3dportal26dl3dacm26type3dseries26idx3dseries49226part3dproceedings26wanttype3dproceedings26title3dinternational2520conference2520on2520digital2520libraries26cfid3d1111111126cftoken3d2222222,60881,60882,121763
63226,,eqynpseeefij,60882,60883,121765
63227,,url:http://portal.acm.org/citation.cfm3fid3d226931.22696226dl3dportal26dl3dacm26type3dseries26idx3dseries49226part3dproceedings26wanttype3dproceedings26title3dinternational2520conference2520on2520digital2520libraries26cfid3d1111111126cftoken3d2222222,60883,60884,121767
63228,,l81inwcuz5sj,60884,60885,121769
63229,,url:http://portal.acm.org/citation.cfm3fid3d263690.26435026dl3dportal26dl3dacm26type3dseries26idx3dseries49226part3dproceedings26wanttype3dproceedings26title3dinternational2520conference2520on2520digital2520libraries26cfid3d1111111126cftoken3d2222222,60885,60886,121771
63230,,hu5w7vw4-swj,60886,60887,121773
63231,,url:http://portal.acm.org/citation.cfm3fid3d226931.22698126dl3dguide26dl3dacm26type3dseries26idx3dseries49226part3dproceedings26wanttype3dproceedings26title3dinternational2520conference2520on2520digital2520libraries26cfid3d1111111126cftoken3d2222222,60887,60888,121775
63232,,bjdvvd_jpdyj,60888,60889,121777
63233,,url:http://portal.acm.org/citation.cfm3fid3d226931.22697826dl3dportal26dl3dacm26type3dseries26idx3dseries49226part3dproceedings26wanttype3dproceedings26title3dinternational2520conference2520on2520digital2520libraries26cfid3d1111111126cftoken3d2222222,60889,60890,121779
63234,,zjjbvguknyqj,60890,60891,121781
63235,,koxebyxns6kj,60891,60892,121783
63236,,url:http://doi.wiley.com/10.1002/he.147,60892,60893,121785
63237,,wjcuu6m0ugqj,60893,60894,121787
63238,,fdbg9bpfx9qj,60894,60895,121789
63239,,url:http://portal.acm.org/citation.cfm3fid3d263690.26434026dl3dportal26dl3dacm26type3dseries26idx3dseries49226part3dproceedings26wanttype3dproceedings26title3dinternational2520conference2520on2520digital2520libraries26cfid3d1111111126cftoken3d2222222,60895,60896,121791
63240,,pwsvekrsd5oj,60896,60897,121793
63241,,url:http://portal.acm.org/citation.cfm3fid3d263690.26434826dl3dportal26dl3dacm26type3dseries26idx3dseries49226part3dproceedings26wanttype3dproceedings26title3dinternational2520conference2520on2520digital2520libraries26cfid3d1111111126cftoken3d2222222,60897,60898,121795
63242,,rxa6glg4_pwj,60898,60899,121797
63243,,url:http://portal.acm.org/citation.cfm3fid3d226931.22697926dl3dportal26dl3dacm26type3dseries26idx3dseries49226part3dproceedings26wanttype3dproceedings26title3dinternational2520conference2520on2520digital2520libraries26cfid3d1111111126cftoken3d2222222,60899,60900,121799
63244,,,60900,60901,121801
63245,,url:http://portal.acm.org/citation.cfm3fid3d226931.22696926dl3dportal26dl3dacm26type3dseries26idx3dseries49226part3dproceedings26wanttype3dproceedings26title3dinternational2520conference2520on2520digital2520libraries26cfid3d1111111126cftoken3d2222222,60901,60902,121803
63246,,dxli7hrx1lyj,60902,60903,121805
63247,,_utatx9zoaaj,60904,60905,121809
63248,,djh6evgrzryj,60905,60906,121811
63249,,xborazerfyaj,60906,60907,121813
63250,,6thozqkasckj,60907,60908,121815
63251,,qmwdlkds0tgj,60908,60909,121817
63252,,baoif8l2naqj,60909,60910,121819
63253,,0hozyxrwcgcj,60910,60911,121821
63254,,zx54ixu4wkkj,60911,60912,121823
63255,,1aybgpr7tdkj,60912,60913,121825
63256,,b9yid0ilecoj,60913,60914,121827
63257,,0mcbjo8xseoj,60915,60916,121831
63258,,nrqi8tbynwmj,60916,60917,121833
63259,,mmfe3hp2zbej,60917,60918,121835
63260,,url:http://doi.wiley.com/10.1002/anie.197903221,60918,60919,121837
63261,,igc2hestbkqj,60919,60920,121839
63262,,rq7jhor7hxqj,60920,60921,121841
63263,,wifslw1wdgmj,60921,60922,121843
63264,,fuk50fbsjnsj,60922,60923,121845
63265,,fv4tp1x7mqwj,60923,60924,121847
63266,,wwwjb2diz9kj,60924,60925,121849
63267,,bdxerhpw5cmj,60925,60926,121851
63268,,cs-huy5p8kwj,60926,60927,121853
63269,,jmhbjdhpghgj,60927,60928,121855
63270,,gc_w8_irdvoj,60928,60929,121857
63271,,nhs8pxjdaqmj,60929,60930,121859
63272,,1balpm4disoj,60930,60931,121861
63273,,jjalrryrlzsj,60931,60932,121863
63274,,17a4honafwgj,60932,60933,121865
63275,,mzzft5rh-hyj,60933,60934,121867
63276,,mdvscfhvlq8j,60934,60935,121869
63277,,os9wl6vjyiqj,60935,60936,121871
63278,,dzogv_m2db8j,60936,60937,121873
63279,,gczc0ejubrej,60937,60938,121875
63280,,l9dw7lt7mx8j,60938,60939,121877
63281,,1qw9y8shuswj,60939,60940,121879
63282,,pukgururixcj,60940,60941,121881
63283,,t8ds8vjd0doj,60941,60942,121883
63284,,pbtu7xy2z_cj,60942,60943,121885
63285,,,60943,60944,121887
63286,,url:http://www.csa.com/partners/viewrecord.php3frequester3dgs26collection3dtrd26recid3d468964ci,60944,60945,121889
63287,,kivegdzy3gij,60945,60946,121891
63288,,lsszeospv-yj,60946,60947,121893
63289,,hvka-niy6-gj,60947,60948,121895
63290,,7_tlnhti7bqj,60948,60949,121897
63291,,0ej9m4dkbsqj,60949,60950,121899
63292,,shexatscreqj,60950,60951,121901
63293,,e4qozjvqm7ij,60951,60952,121903
63294,,kurwqxuegzcj,60952,60953,121905
63295,,74pe75dkdzqj,60953,60954,121907
63296,,ayljr4znm8gj,60954,60955,121909
63297,,ec01oitl_fqj,60955,60956,121911
63298,,sluuhbltyjij,60956,60957,121913
63299,,msgsn9npky0j,60957,60958,121915
63300,,heuexnvxdsoj,60958,60959,121917
63301,,2cyeemckluqj,60959,60960,121919
63302,,3vf6ejjr0ruj,60960,60961,121921
63303,,8y18sfvo9fkj,60961,60962,121923
63304,,00-p8zcfo4uj,60962,60963,121925
63305,,bzu53fdhayuj,60963,60964,121927
63306,,vxaerli5ovoj,60964,60965,121929
63307,,sd-_q3rgsr4j,60965,60966,121931
63308,,1bgohffn7a4j,60966,60967,121933
63309,,49buf_66hgcj,60967,60968,121935
63310,,rprib1kt8qgj,60968,60969,121937
63311,,9k_ywtjbhtij,60969,60970,121939
63312,,bxoz8xsv0foj,60970,60971,121941
63313,,k_aeropx21uj,60971,60972,121943
63314,,rgg19vxtynkj,60972,60973,121945
63315,,civzogg0kw4j,60973,60974,121947
63316,,nhj-yxrq8m0j,60974,60975,121949
63317,,y3doilzrmcqj,60975,60976,121951
63318,,71y3oljh5cwj,60976,60977,121953
63319,,iro0lyv_qd0j,60977,60978,121955
63320,,mjf-dhvetqej,60978,60979,121957
63321,,zddzmnsmpakj,60979,60980,121959
63322,,tdnmscee0kqj,60980,60981,121961
63323,,aqe9b2ivpiwj,60981,60982,121963
63324,,fskgyyrr4ugj,60983,60984,121967
63325,,j00eujtbkpaj,60984,60985,121969
63326,,url:http://www.csa.com/partners/viewrecord.php3frequester3dgs26collection3dtrd26recid3dn9210564ah,60985,60986,121971
63327,,vifipbpnsg8j,60986,60987,121973
63328,,ar8phh8yvnej,60987,60988,121975
63329,,bagig-84r6wj,60988,60989,121977
63330,,m28bjmp5h3kj,60989,60990,121979
63331,,fspfyk2suz0j,60990,60991,121981
63332,,u2lo5idmeomj,60991,60992,121983
63333,,emde3tj0nrcj,60992,60993,121985
63334,,or2wgmm7it4j,60994,60995,121989
63335,,hf12ow8307uj,60995,60996,121991
63336,,e7ch4jlm-euj,60996,60997,121993
63337,,7i_lkkl0xdaj,60997,60998,121995
63338,,vd3yy3ar8wwj,60998,60999,121997
63339,,zpco-0akj3uj,60999,61000,121999
63340,,,61000,61001,122001
63341,,wfjn_mltnwwj,61001,61002,122003
63342,,yh5fuqznz5oj,61002,61003,122005
63343,,5bk4tirj3wwj,61003,61004,122007
63344,,url:http://www.csa.com/partners/viewrecord.php3frequester3dgs26collection3denv26recid3d7901463,61004,61005,122009
63345,,rznwa8uj1ocj,61005,61006,122011
63346,,lnne8zgxw_sj,61006,61007,122013
63347,,apcw5xnqm34j,61007,61008,122015
63348,,,61008,61009,122017
63349,,pflcbqbbml8j,61009,61010,122019
63350,,gfnj57icyz4j,61010,61011,122021
63351,,7j13zyqpmbyj,61011,61012,122023
63352,,idmea4ub37gj,61012,61013,122025
63353,,7zmnprgqcumj,61013,61014,122027
63354,,4jc1i_eydzgj,61014,61015,122029
63355,,vn1-zklgdxyj,61015,61016,122031
63356,,_0werrij168j,61016,61017,122033
63357,,url:http://portal.acm.org/citation.cfm3fid3d288552,61017,61018,122035
63358,,url:http://adsabs.harvard.edu/abs/1974mit..repts....s,61018,61019,122037
63359,,-9banxhnwjaj,61019,61020,122039
63360,,url:http://portal.acm.org/citation.cfm3fid3d354384.35439026dl3dguide26dl3dacm26type3dseries26idx3d35438426part3dproceedings26wanttype3dproceedings26title3dinternational2520multimedia2520conference26cfid3d1111111126cftoken3d2222222,61020,61021,122041
63361,,vbhyhhkoczmj,61021,61022,122043
63362,,szt9pwkdf80j,61022,61023,122045
63363,,teoeecbju3wj,61023,61024,122047
63364,,knkwc8etyvmj,61024,61025,122049
63365,,url:http://doi.wiley.com/10.1002/he.10802,61025,61026,122051
63366,,dutsatybnxmj,61026,61027,122053
63367,,url:http://links.jstor.org/sici3fsici3d0146-4949(196424252f21)5253a1253c37253acwitu253e2.0.co253b2-w,61027,61028,122055
63368,,sj7wrpr2fzuj,61028,61029,122057
63369,,to1xaxck-m8j,61029,61030,122059
63370,,url:http://www.csa.com/partners/viewrecord.php3frequester3dgs26collection3dtrd26recid3dn9210524ah,61030,61031,122061
63371,,tfrqd3uhdbij,61031,61032,122063
63372,,czgjstvtkzuj,61032,61033,122065
63373,,heffis8fqcqj,61033,61034,122067
63374,,99efsjly6bcj,61034,61035,122069
63375,,itwxi43mvsoj,61035,61036,122071
63376,,fat2lzknoiaj,61036,61037,122073
63377,,nue1gmjq3cej,61037,61038,122075
63378,,sw8m618nhfyj,61038,61039,122077
63379,,2bbsnf0rx6aj,61039,61040,122079
63380,,_qbv4wky1pmj,61040,61041,122081
63381,,vscrsf8fedij,61041,61042,122083
63382,,3xqd49lc-fuj,61042,61043,122085
63383,,s3eubi6brmwj,61043,61044,122087
63384,,8-v5f3h85ywj,61044,61045,122089
63385,,u3ywmigfy7uj,61045,61046,122091
63386,,4uevvmhxgdsj,61046,61047,122093
63387,,uq1vg2r8gacj,61047,61048,122095
63388,,chk1gh97nbsj,61048,61049,122097
63389,,s0nqisqlscqj,61049,61050,122099
63390,,jhjguru02z0j,61050,61051,122101
63391,,url:http://www.csa.com/partners/viewrecord.php3frequester3dgs26collection3denv26recid3d8913240,61051,61052,122103
63392,,v5o37yacelij,61052,61053,122105
63393,,az0ufah84yij,61054,61055,122109
63394,,jk-epkfpatkj,61055,61056,122111
63395,,3rblvqebkbcj,61056,61057,122113
63396,,9ezy-8ym50qj,61057,61058,122115
63397,,5kcgd_t7sucj,61058,61059,122117
63398,,url:http://doi.wiley.com/10.1002/he.139,61060,61061,122121
63399,,83l6obxcyrcj,61061,61062,122123
63400,,pydjd9ucmokj,61062,61063,122125
63401,,r_fx0g6yvmkj,61063,61064,122127
63402,,7uxvylbb0zaj,61064,61065,122129
63403,,vfg-zpmblqaj,61066,61067,122133
63404,,5psdv34tu_oj,61067,61068,122135
63405,,l-v9rfjotsoj,61068,61069,122137
63406,,gfety7cuqhyj,61069,61070,122139
63407,,url:http://portal.acm.org/citation.cfm3fid3d984395.98440126coll3dguide26dl3dguide26idx3dj68926part3dperiodical26wanttype3dperiodical26title3dacm2520sigmod2520record26cfid3d1111111126cftoken3d2222222,61070,61071,122141
63408,,njcje-cufjsj,61071,61072,122143
63409,,vkovveo1dqij,61072,61073,122145
63410,,yuee5inwqfaj,61073,61074,122147
63411,,ki0whabugmaj,61075,61076,122151
63412,,ww9dwxzjju0j,61076,61077,122153
63413,,f3hl1d_pnp8j,61077,61078,122155
63414,,xcbx7cd3r38j,61078,61079,122157
63415,,ivey3orjltuj,61079,61080,122159
63416,,hwnf6r-4ijkj,61080,61081,122161
63417,,vbapgwskifmj,61081,61082,122163
63418,,hzw6mnbilhmj,61082,61083,122165
63419,,url:http://adsabs.harvard.edu/abs/1975mit..reptr....l,61083,61084,122167
63420,,mkzyjnmnj5gj,61084,61085,122169
63421,,tnkvhhs5l0kj,61085,61086,122171
63422,,mqmqawjfrb4j,61086,61087,122173
63423,,ju2svmq0ligj,61087,61088,122175
63424,,fw2zymgbvwuj,61088,61089,122177
63425,,b4wcl3z-vb0j,61089,61090,122179
63426,,hznvylhm_poj,61091,61092,122183
63427,,ugcaqdoezcuj,61092,61093,122185
63428,,mncelv3zcekj,61093,61094,122187
63429,,md1f2uffdn4j,61094,61095,122189
63430,,url:http://adsabs.harvard.edu/abs/1984phdt........28h,61095,61096,122191
63431,,an7we1d1uekj,61096,61097,122193
63432,,caxsj3bokgij,61097,61098,122195
63433,,o7pnlqk8froj,61098,61099,122197
63434,,jqwsqmw8scej,61099,61100,122199
63435,,-48b7d8kqdij,61100,61101,122201
63436,,url:http://links.jstor.org/sici3fsici3d0146-4949(196123)2253a3253c27253afastro253e2.0.co253b2-u,61101,61102,122203
63437,,9casphriw90j,61102,61103,122205
63438,,8i0ywhyvnfyj,61103,61104,122207
63439,,d9p4pj77oeej,61104,61105,122209
63440,,ns5g4ij7oomj,61105,61106,122211
63441,,ojxb5uebuxuj,61106,61107,122213
63442,,w2of27g8ozwj,61107,61108,122215
63443,,f9pghe4nackj,61108,61109,122217
63444,,zmrwzafmrhqj,61109,61110,122219
63445,,m2ycduvy0daj,61110,61111,122221
63446,,vnjzvdk0ewgj,61111,61112,122223
63447,,dbzppz4p5sej,61112,61113,122225
63448,,lvphlrsjfy8j,61113,61114,122227
63449,,d-whgdac7zgj,61114,61115,122229
63450,,8hslslsk9eyj,61115,61116,122231
63451,,url:http://portal.acm.org/ft_gateway.cfm3fid3d102761026type3dpdf,61116,61117,122233
63452,,gjn5g_mpe0wj,61117,61118,122235
63453,,xnbs4akj8-cj,61118,61119,122237
63454,,yu7q9zpiegkj,61119,61120,122239
63455,,nd6muhvkwf8j,61120,61121,122241
63456,,zr4mkwn0yl4j,61121,61122,122243
63457,,5tq-46b3xzyj,61122,61123,122245
63458,,url:http://portal.acm.org/citation.cfm3fid3d144111.144120,61123,61124,122247
63459,,wpkxyoe4dqyj,61124,61125,122249
63460,,url:http://www.csa.com/partners/viewrecord.php3frequester3dgs26collection3dtrd26recid3d0177662ci,61125,61126,122251
63461,,fyi6fhobm5oj,61126,61127,122253
63462,,n2ndfdwovbmj,61127,61128,122255
63463,,ag2rdivy2naj,61128,61129,122257
63464,,1bl_2-leuquj,61129,61130,122259
63465,,dxzdmfsje2mj,61130,61131,122261
63466,,kp4njvv-4d4j,61131,61132,122263
63467,,egqhfyylhl8j,61132,61133,122265
63468,,ks8mqjtaqluj,61133,61134,122267
63469,,2gs7_ur-iooj,61134,61135,122269
63470,,l6nnfuic4xgj,61135,61136,122271
63471,,r3yltdh6qesj,61136,61137,122273
63472,,url:http://portal.acm.org/citation.cfm3fid3d192593.19743226dl3dguide26dl3dacm26type3dseries26idx3d19259326part3dproceedings26wanttype3dproceedings26title3dinternational2520multimedia2520conference26cfid3d1111111126cftoken3d2222222,61137,61138,122275
63473,,msahcwb3dduj,61138,61139,122277
63474,,dlaqfp_94xgj,61139,61140,122279
63475,,_ye8q98mac4j,61140,61141,122281
63476,,url:http://portal.acm.org/ft_gateway.cfm3fid3d102760326type3dpdf,61141,61142,122283
63477,,pmunc79mqbwj,61142,61143,122285
63478,,url:http://portal.acm.org/citation.cfm3fid3d565117.56514226dl3dguide26dl3dacm26type3dissue26idx3dj68926part3dperiodical26wanttype3dperiodical26title3dacm2520sigmod2520record26cfid3d1111111126cftoken3d2222222,61143,61144,122287
63479,,6kkhtoy3wyoj,61144,61145,122289
63480,,u9kd4ujqxv4j,61145,61146,122291
63481,,qsdagnbz3rmj,61146,61147,122293
63482,,wndfgskwezqj,61147,61148,122295
63483,,ifa-btr3tnmj,61148,61149,122297
63484,,el2u5dwyylej,61149,61150,122299
63485,,6ozp34lws0wj,61150,61151,122301
63486,,tw5aa2zxylyj,61151,61152,122303
63487,,wqnxhs5aflcj,61152,61153,122305
63488,,w80_ho4ttcyj,61153,61154,122307
63489,,h7pi4aqu00yj,61154,61155,122309
63490,,url:http://www.springerlink.com/index/q051n7x0271thm14.pdf,61155,61156,122311
63491,,_y_kxpkxmgaj,61156,61157,122313
63492,,0atgrjkba4mj,61157,61158,122315
63493,,6yrecueyqx8j,61158,61159,122317
63494,,qbllvjpwrb0j,61159,61160,122319
63495,,n_vvk23zfx8j,61161,61162,122323
63496,,xfodeg6rjj0j,61163,61164,122327
63497,,bjdbaaramdwj,61164,61165,122329
63498,,p6di2tvbzy8j,61165,61166,122331
63499,,tnxm-wp9gwyj,61166,61167,122333
63500,,2zihjncwqegj,61167,61168,122335
63501,,umt53mj4edkj,61168,61169,122337
63502,,56u2j96vsrsj,61169,61170,122339
63503,,5dsyh91rjh0j,61170,61171,122341
63504,,bi2pazueloqj,61171,61172,122343
63505,,rrmg7dmd6xij,61172,61173,122345
63506,,0bi58q1bhrgj,61173,61174,122347
63507,,bhzrj7zv3rgj,61174,61175,122349
63508,,vy1xtekb5yej,61175,61176,122351
63509,,6lbnpiev6jaj,61176,61177,122353
63510,,ddrybiboan8j,61177,61178,122355
63511,,iv27qjy6nduj,61178,61179,122357
63512,,ii0nxgqc0kij,61179,61180,122359
63513,,gkfv9mxmrxcj,61180,61181,122361
63514,,l91c0qu-xecj,61181,61182,122363
63515,,19hgujkcb9cj,61182,61183,122365
63516,,url:http://www.csa.com/partners/viewrecord.php3frequester3dgs26collection3dtrd26recid3dn9210467ah,61183,61184,122367
63517,,frr2g_iwa7ij,61184,61185,122369
63518,,ldxtzsif3w4j,61185,61186,122371
63519,,cjvsnpnowg8j,61186,61187,122373
63520,,7jfq7k71bfuj,61187,61188,122375
63521,,n_rtuagp3gqj,61188,61189,122377
63522,,vvp1ohdffpuj,61189,61190,122379
63523,,ghv9zy35jcuj,61190,61191,122381
63524,,4cx6qlvr3tsj,61191,61192,122383
63525,,vbtwuvmcyeij,61192,61193,122385
63526,,xgqg9wwqlakj,61193,61194,122387
63527,,i0dmduzpu0yj,61194,61195,122389
63528,,axlvqxhijicj,61195,61196,122391
63529,,qmakj5tjyosj,61196,61197,122393
63530,,ovgvlzfszzoj,61197,61198,122395
63531,,r36hs1cwausj,61198,61199,122397
63532,,9xgovahkpy8j,61199,61200,122399
63533,,9sr3soxtvxkj,61200,61201,122401
63534,,tzg0chjjvmqj,61201,61202,122403
63535,,ossee34mn2cj,61202,61203,122405
63536,,y5eppw9xlykj,61203,61204,122407
63537,,f1tfwt1m1rej,61204,61205,122409
63538,,mpjjzxbm1kwj,61205,61206,122411
63539,,iusjae5mgfwj,61206,61207,122413
63540,,g6uw5kdambsj,61207,61208,122415
63541,,ceszmakmkdij,61208,61209,122417
63542,,url:http://portal.acm.org/ft_gateway.cfm3fid3d106520526type3dpdf,61209,61210,122419
63543,,nujpb2x3yhkj,61210,61211,122421
63544,,3sfdx4oo0pmj,61211,61212,122423
63545,,yqocqmzntd0j,61212,61213,122425
63546,,vhou8qyt5t4j,61213,61214,122427
63547,,url:http://links.jstor.org/sici3fsici3d0146-4949(196021252f22)1253a2253c66253as253e2.0.co253b2-r,61214,61215,122429
63548,,mx_-ddjdmgqj,61215,61216,122431
63549,,oepo-16pjlgj,61216,61217,122433
63550,,xzx4qjcwlxyj,61217,61218,122435
63551,,mnsgrchwqvaj,61219,61220,122439
63552,,qgbylj3tbjmj,61220,61221,122441
63553,,6ehkvih1onoj,61221,61222,122443
63554,,kqzf2rezkcgj,61222,61223,122445
63555,,rn--yzixgl0j,61223,61224,122447
63556,,xyolbd0inkyj,61224,61225,122449
63557,,url:http://www.csa.com/partners/viewrecord.php3frequester3dgs26collection3dtrd26recid3d200111010700mt26recid3da0032630ah,61225,61226,122451
63558,,sf6r_ivl3kij,61226,61227,122453
63559,,kdsfb6obxd8j,61227,61228,122455
63560,,uv2btjnfybcj,61228,61229,122457
63561,,3rudaqocpkmj,61229,61230,122459
63562,,rru4dph4f6cj,61230,61231,122461
63563,,g6q8jzafsewj,61231,61232,122463
63564,,q6n_kqo6rwaj,61232,61233,122465
63565,,f2c57i1ttywj,61233,61234,122467
63566,,hrjxxxipcygj,61234,61235,122469
63567,,r-littarc1yj,61235,61236,122471
63568,,fzjr0hweirij,61236,61237,122473
63569,,jjpijeogcfuj,61237,61238,122475
63570,,khwohqy_gewj,61238,61239,122477
63571,,,61239,61240,122479
63572,,emrmabupzb4j,61240,61241,122481
63573,,yw97xzjkebuj,61241,61242,122483
63574,,url:http://portal.acm.org/ft_gateway.cfm3fid3d12205326type3dpdf,61242,61243,122485
63575,,fom1ju2cvfkj,61244,61245,122489
63576,,7d-z3ykwfkcj,61245,61246,122491
63577,,morlumkabxkj,61246,61247,122493
63578,,k6dl9eq9pewj,61247,61248,122495
63579,,hzsjxpnt1coj,61248,61249,122497
63580,,wocgxlv_lgoj,61249,61250,122499
63581,,hovqda2gd2uj,61250,61251,122501
63582,,bee3uezvznuj,61251,61252,122503
63583,,url:http://www.csa.com/partners/viewrecord.php3frequester3dgs26collection3dtrd26recid3d0972190ci,61252,61253,122505
63584,,ici4rcqiengj,61253,61254,122507
63585,,1wwy0lgghruj,61254,61255,122509
63586,,o4a3ynyyyoej,61255,61256,122511
63587,,wmrcqbljor0j,61256,61257,122513
63588,,eecha0wigqgj,61257,61258,122515
63589,,nlmndatvroej,61258,61259,122517
63590,,yknrc1nqcjwj,61259,61260,122519
63591,,gczdcnc0-smj,61260,61261,122521
63592,,fz-nrkkijnuj,61262,61263,122525
63593,,kii56whr8xoj,61263,61264,122527
63594,,rw3dgj1arywj,61265,61266,122531
63595,,goiuvzc_m1wj,61266,61267,122533
63596,,ojvbdh7zgiuj,61267,61268,122535
63597,,8ol7-llb38oj,61268,61269,122537
63598,,_7ksycxxsswj,61269,61270,122539
63599,,3ga7d4kf7bwj,61270,61271,122541
63600,,oxlmfp16pruj,61271,61272,122543
63601,,url:http://www.springerlink.com/index/u5633g77440860p5.pdf,61272,61273,122545
63602,,uru9upfnos4j,61273,61274,122547
63603,,hj8pj0hfbdkj,61274,61275,122549
63604,,6vgomcl1cq8j,61275,61276,122551
63605,,x6snfkm70dcj,61276,61277,122553
63606,,8n2x07ws5ikj,61277,61278,122555
63607,,url:http://portal.acm.org/ft_gateway.cfm3fid3d102765526type3dpdf,61278,61279,122557
63608,,8a8y03f1omej,61279,61280,122559
63609,,dwegnogjnkcj,61280,61281,122561
63610,,2aysypua6laj,61281,61282,122563
63611,,mb_dkhzjozoj,61282,61283,122565
63612,,kwgqtf9whisj,61283,61284,122567
63613,,xdedqzwuzyej,61284,61285,122569
63614,,ku7nopnrhu0j,61285,61286,122571
63615,,lddabod7jhkj,61286,61287,122573
63616,,url:http://links.jstor.org/sici3fsici3d0146-4949(196423)5253a3253c185253attrhim253e2.0.co253b2-z,61287,61288,122575
63617,,jhrzrcr0fc4j,61288,61289,122577
63618,,zj6gn0riesqj,61289,61290,122579
63619,,n-gdkonams8j,61291,61292,122583
63620,,lvzisb4dnimj,61292,61293,122585
63621,,yutdk6czrcaj,61293,61294,122587
63622,,snipitueur0j,61294,61295,122589
63623,,url:http://portal.acm.org/citation.cfm3fid3d26368726dl3d,61295,61296,122591
63624,,sqcnhhjx9yyj,61296,61297,122593
63625,,6bbgx_dydngj,61297,61298,122595
63626,,9efgmwfj1pkj,61298,61299,122597
63627,,cmxsz8pe0uej,61299,61300,122599
63628,,x3hlwjgl7zij,61300,61301,122601
63629,,liepqdauchsj,61301,61302,122603
63630,,i232icl_la8j,61302,61303,122605
63631,,9nkd3jyhe1kj,61303,61304,122607
63632,,fk3eq5if2k8j,61304,61305,122609
63633,,fb1lnevigz4j,61305,61306,122611
63634,,h0sptpcylpej,61306,61307,122613
63635,,tppmqop1rhsj,61307,61308,122615
63636,,_5abbndtzpgj,61308,61309,122617
63637,,zz5brzlitdkj,61311,61312,122623
63638,,tdd1t6hcyfkj,61312,61313,122625
63639,,url:http://doi.wiley.com/10.1002/ace.106,61313,61314,122627
63640,,ct7clzm8qscj,61314,61315,122629
63641,,0hf2zlsblkej,61315,61316,122631
63642,,bystshutyluj,61316,61317,122633
63643,,9spmkptqsvyj,61317,61318,122635
63644,,url:http://portal.acm.org/ft_gateway.cfm3fid3d110750526type3dpdf,61318,61319,122637
63645,,wlfzrytlu0yj,61320,61321,122641
63646,,zzbxwumfb3ej,61321,61322,122643
63647,,vagoaegz66yj,61322,61323,122645
63648,,k-reuatn1dmj,61323,61324,122647
63649,,a1p3mlfzdkgj,61324,61325,122649
63650,,kqkkhd6p_cij,61325,61326,122651
63651,,zfsy_n1dd9cj,61326,61327,122653
63652,,xozioemc1fgj,61327,61328,122655
63653,,wydx47pzgigj,61328,61329,122657
63654,,mw2mbomo1_kj,61329,61330,122659
63655,,mhpjtgehctqj,61330,61331,122661
63656,,iwucqqewwgwj,61331,61332,122663
63657,,zcdrfcjv2ggj,61332,61333,122665
63658,,d7by8a0arhij,61333,61334,122667
63659,,uqtzf5oeh0ej,61334,61335,122669
63660,,bnzqx98qqokj,61335,61336,122671
63661,,z7sh7wg8aaej,61336,61337,122673
63662,,dnrmrzd9tloj,61337,61338,122675
63663,,to-uhzj8tvyj,61338,61339,122677
63664,,ryi3unjq4lij,61339,61340,122679
63665,,kncxblzuayij,61340,61341,122681
63666,,9g33mekjekuj,61341,61342,122683
63667,,redrjxskzuaj,61342,61343,122685
63668,,g4pfwgnnq7ij,61343,61344,122687
63669,,3anvwrltap8j,61344,61345,122689
63670,,szu1fnc66kwj,61345,61346,122691
63671,,3olmbiysv2oj,61346,61347,122693
63672,,d9bi2uodfqij,61347,61348,122695
63673,,y58ndt8wutgj,61348,61349,122697
63674,,grfmmkgwc0qj,61349,61350,122699
63675,,kleklcjbbu0j,61350,61351,122701
63676,,fiwvql_99moj,61351,61352,122703
63677,,3mvayjsrxiwj,61352,61353,122705
63678,,yhuile4k_cgj,61353,61354,122707
63679,,e1g9swt4iisj,61354,61355,122709
63680,,qovpqpy6mlej,61355,61356,122711
63681,,whgygmt06luj,61356,61357,122713
63682,,7gqmskogbrij,61357,61358,122715
63683,,oifyf-aj80cj,61358,61359,122717
63684,,qk0hjwxmztmj,61359,61360,122719
63685,,ubj57pbu2kwj,61360,61361,122721
63686,,qa_w9hgaof4j,61361,61362,122723
63687,,url:http://portal.acm.org/citation.cfm3fid3d264336,61362,61363,122725
63688,,bh0kk2eybeej,61363,61364,122727
63689,,xbd_tev11tyj,61364,61365,122729
63690,,lkrgd-nnnz8j,61365,61366,122731
63691,,qnjeh-3zt3gj,61366,61367,122733
63692,,lwpqocj7iu0j,61368,61369,122737
63693,,9p135_eje9aj,61369,61370,122739
63694,,xtclxyxsju4j,61370,61371,122741
63695,,uqzig2p_g-sj,61371,61372,122743
63696,,gvddzykaoqsj,61372,61373,122745
63697,,aeujawuwmvij,61373,61374,122747
63698,,hxfsjjqlnpaj,61374,61375,122749
63699,,qb1nsptzzm0j,61375,61376,122751
63700,,eapjqm9covgj,61376,61377,122753
63701,,gkwwl16x1jej,61377,61378,122755
63702,,i6ui3qwkdasj,61378,61379,122757
63703,,1ph0ggd2yecj,61379,61380,122759
63704,,qwdnh1eh-1cj,61380,61381,122761
63705,,ovf40ipyequj,61381,61382,122763
63706,,i-n74qkqjsyj,61382,61383,122765
63707,,,61383,61384,122767
63708,,u5vr1epenvsj,61384,61385,122769
63709,,wmqrkoqmf-yj,61385,61386,122771
63710,,rpijozy1n9gj,61386,61387,122773
63711,,mf5-qob-tgsj,61387,61388,122775
63712,,0in2he0w7nmj,61388,61389,122777
63713,,kfmruqeedy8j,61389,61390,122779
63714,,url:http://www.csa.com/partners/viewrecord.php3frequester3dgs26collection3dtrd26recid3d20021211038655mt26recid3da7423830ah,61390,61391,122781
63715,,b7kbrfp_zgcj,61391,61392,122783
63716,,ysmopkiinagj,61392,61393,122785
63717,,uj9uizivwvoj,61393,61394,122787
63718,,jabuzpw3ku8j,61394,61395,122789
63719,,ltf5yqsl8smj,61395,61396,122791
63720,,bm9urel5vu4j,61396,61397,122793
63721,,zo1qhcawutej,61397,61398,122795
63722,,kzzocdzmvccj,61398,61399,122797
63723,,rfdlrjoqemej,61399,61400,122799
63724,,bdepowwt3kuj,61400,61401,122801
63725,,mylnwe6o6l0j,61401,61402,122803
63726,,qx2fgjtdsbgj,61402,61403,122805
63727,,drlcxfukchuj,61403,61404,122807
63728,,ohcxbs_cnzqj,61404,61405,122809
63729,,mq_0vwwdylej,61405,61406,122811
63730,,neweplfu6s8j,61406,61407,122813
63731,,4i9bgcd4bnsj,61407,61408,122815
63732,,,61408,61409,122817
63733,,9hpkiwdifecj,61409,61410,122819
63734,,w-dtwigkqhcj,61410,61411,122821
63735,,6sto1cwgwp0j,61411,61412,122823
63736,,7fhxnqvjxxgj,61412,61413,122825
63737,,s9ppxncsh40j,61413,61414,122827
63738,,g-hk8pplyyuj,61414,61415,122829
63739,,quabe9uutekj,61415,61416,122831
63740,,olbu2ue_jecj,61416,61417,122833
63741,,mljzpgv0chej,61417,61418,122835
63742,,erprbxmiixaj,61418,61419,122837
63743,,wqwcfwbljiyj,61419,61420,122839
63744,,wkw4z-6zfoij,61420,61421,122841
63745,,url:http://portal.acm.org/citation.cfm3fid3d127229.127236,61421,61422,122843
63746,,6lr7kq7wtvwj,61422,61423,122845
63747,,zjw3mwjy64cj,61423,61424,122847
63748,,zrvb4sll_6yj,61424,61425,122849
63749,,8jmn0kvlc-ij,61425,61426,122851
63750,,glu9ny0ecgij,61427,61428,122855
63751,,s4bwsjvm3oej,61428,61429,122857
63752,,iisqgkb5aasj,61430,61431,122861
63753,,2m8k2ddkir0j,61431,61432,122863
63754,,c7r1pezzkdyj,61432,61433,122865
63755,,i8ps-sadfruj,61433,61434,122867
63756,,8ovgnqrl8bej,61434,61435,122869
63757,,avv6lmebgwsj,61435,61436,122871
63758,,hfkxkvcqtfwj,61436,61437,122873
63759,,jsydj_ocb4sj,61437,61438,122875
63760,,,61438,61439,122877
63761,,gxi9_mo8weqj,61439,61440,122879
63762,,ouobbmivk00j,61440,61441,122881
63763,,3oahlg0ts6gj,61441,61442,122883
63764,,wzdydps4xiwj,61442,61443,122885
63765,,tgmql4cqaysj,61443,61444,122887
63766,,2duvsfl-nzuj,61444,61445,122889
63767,,jab63jlu3n0j,61445,61446,122891
63768,,qrirdmwbkaaj,61446,61447,122893
63769,,epcbkrsonbkj,61447,61448,122895
63770,,iqpwhmls-u4j,61448,61449,122897
63771,,lsd5c3idvckj,61449,61450,122899
63772,,pfmirw3lr4sj,61450,61451,122901
63773,,sln2xf91ioyj,61451,61452,122903
63774,,wxodr8e2zrmj,61452,61453,122905
63775,,yecuu7lempwj,61453,61454,122907
63776,,rkbwxobcjzyj,61454,61455,122909
63777,,c_rrt-2uyfaj,61455,61456,122911
63778,,oqouphx4sraj,61456,61457,122913
63779,,aidbvodvv1kj,61457,61458,122915
63780,,8nj5sco32hwj,61458,61459,122917
63781,,k5q2hhxbpuwj,61459,61460,122919
63782,,fnqbgp13qwuj,61460,61461,122921
63783,,ynwsw7pv-a4j,61461,61462,122923
63784,,kete3p_qb60j,61462,61463,122925
63785,,rtij3rja-uyj,61463,61464,122927
63786,,z9vwji-nplsj,61464,61465,122929
63787,,eknpbfz3eiqj,61465,61466,122931
63788,,6jrc49jnlmwj,61466,61467,122933
63789,,url:http://portal.acm.org/citation.cfm3fid3d971699.31892726coll3dguide26dl3dacm26idx3dj68926part3dperiodical26wanttype3dperiodical26title3dacm2520sigmod2520record26cfid3d1111111126cftoken3d2222222,61467,61468,122935
63790,,fix908hezouj,61468,61469,122937
63791,,7ymctbsnjzmj,61469,61470,122939
63792,,wuiyuxoqp7aj,61470,61471,122941
63793,,mxxsld-gnrwj,61471,61472,122943
63794,,jwdbmrzxxeoj,61472,61473,122945
63795,,url:http://www.csa.com/partners/viewrecord.php3frequester3dgs26collection3dtrd26recid3d7506140203md26recid3d017504530094ai,61473,61474,122947
63796,,cw09blmq0-ij,61474,61475,122949
63797,,nnrypt7k9b0j,61475,61476,122951
63798,,h50fqsrhgp8j,61476,61477,122953
63799,,nhyycewset8j,61478,61479,122957
63800,,zmqjps4owauj,61479,61480,122959
63801,,y0gqoxwrnsaj,61480,61481,122961
63802,,5vzwv9tsvimj,61481,61482,122963
63803,,7ygkneyk4xuj,61482,61483,122965
63804,,ndeiwfmwm00j,61483,61484,122967
63805,,bykb43ayfumj,61484,61485,122969
63806,,ankhbas9-p4j,61485,61486,122971
63807,,api6-xxt3aej,61486,61487,122973
63808,,2bnf13q6h3qj,61487,61488,122975
63809,,2v2bnigsy1kj,61488,61489,122977
63810,,mxmofzw0vqyj,61489,61490,122979
63811,,url:http://portal.acm.org/citation.cfm3fid3d984382.98439126coll3dguide26dl3dacm26type3dissue26idx3dj68926part3dperiodical26wanttype3dperiodical26title3dacm2520sigmod2520record26cfid3d1111111126cftoken3d2222222,61490,61491,122981
63812,,khxvmjw33ewj,61491,61492,122983
63813,,ztemknt1hwwj,61492,61493,122985
63814,,mrvqfvjcsw0j,61493,61494,122987
63815,,lsedurw3bxmj,61494,61495,122989
63816,,nkjj2uthqxsj,61495,61496,122991
63817,,qk1ytmpnnrcj,61496,61497,122993
63818,,ekh2uzyrdcoj,61497,61498,122995
63819,,llfxleqmi1kj,61498,61499,122997
63820,,2mbaeg3ivv0j,61499,61500,122999
63821,,o2w_y99mikkj,61500,61501,123001
63822,,_bv-_6uygwuj,61501,61502,123003
63823,,qfe9jaig_xmj,61502,61503,123005
63824,,g1z7o5krav0j,61503,61504,123007
63825,,url:http://www.kluweronline.com/article.asp3fpips3d514715526pdf3d1,61504,61505,123009
63826,,kuipivp04s8j,61505,61506,123011
63827,,rsq7xsdorg8j,61506,61507,123013
63828,,rzogqmeofwej,61507,61508,123015
63829,,9-krsxybklaj,61508,61509,123017
63830,,5mrafkeglxuj,61509,61510,123019
63831,,phunh5dwsacj,61510,61511,123021
63832,,qaukuupuihej,61511,61512,123023
63833,,jkrbytaax6uj,61512,61513,123025
63834,,url:http://www.csa.com/partners/viewrecord.php3frequester3dgs26collection3dtrd26recid3dn9210537ah,61513,61514,123027
63835,,jlov3tx84iaj,61514,61515,123029
63836,,elxj_wvez0kj,61515,61516,123031
63837,,url:http://portal.acm.org/ft_gateway.cfm3fid3d106624326type3dpdf,61516,61517,123033
63838,,o49dbltcylyj,61517,61518,123035
63839,,icjkcxiygn0j,61518,61519,123037
63840,,xeawrdubn48j,61519,61520,123039
63841,,9slyrfhhiwoj,61520,61521,123041
63842,,9hh7kaedio4j,61521,61522,123043
63843,,lehulf-ov9yj,61522,61523,123045
63844,,zid6tc51tnij,61523,61524,123047
63845,,5vxm6j2hrpwj,61524,61525,123049
63846,,fyvscdkos3mj,61525,61526,123051
63847,,vewkmlxymusj,61526,61527,123053
63848,,htytvuwpvqsj,61527,61528,123055
63849,,yeqqfspoo40j,61528,61529,123057
63850,,url:http://www.springerlink.com/index/x3ku700451371120.pdf,61529,61530,123059
63851,,uze356nnjq4j,61530,61531,123061
63852,,vmbdkdlaiogj,61531,61532,123063
63853,,7q_f-kpf5hmj,61532,61533,123065
63854,,_yfipoyvc3uj,61533,61534,123067
63855,,n-znbzeur68j,61534,61535,123069
63856,,bkz_hnk95y0j,61535,61536,123071
63857,,pkpd1d2sx1cj,61536,61537,123073
63858,,ixhfzyd8fg4j,61537,61538,123075
63859,,m1qnhqfswwij,61538,61539,123077
63860,,url:http://doi.wiley.com/10.1002/anie.199400851,61539,61540,123079
63861,,wx8czycnu30j,61540,61541,123081
63862,,p0svdjjdlfgj,61541,61542,123083
63863,,becwoadl71cj,61542,61543,123085
63864,,dijz9ztudx8j,61543,61544,123087
63865,,a65nqi7w2ikj,61544,61545,123089
63866,,7pb-jp1pc2wj,61545,61546,123091
63867,,url:http://portal.acm.org/ft_gateway.cfm3fid3d95715326type3dpdf26dl3dguide26dl3dacm26cfid3d1111111126cftoken3d2222222,61546,61547,123093
63868,,gryitmoyvzmj,61547,61548,123095
63869,,qgot5w2e3dij,61548,61549,123097
63870,,cy7tkglj_hsj,61549,61550,123099
63871,,v_vv7sr6tdsj,61550,61551,123101
63872,,angfijmfc4uj,61551,61552,123103
63873,,f3puyqu1skyj,61552,61553,123105
63874,,syxfagyq200j,61553,61554,123107
63875,,84lmlt7wzguj,61554,61555,123109
63876,,rfoxetjxwb0j,61555,61556,123111
63877,,7ymi5qkse2ej,61556,61557,123113
63878,,ty211qpribuj,61557,61558,123115
63879,,60hze9rgbwgj,61558,61559,123117
63880,,1wf0dklc39kj,61559,61560,123119
63881,,afvjsty6l_kj,61560,61561,123121
63882,,yf0zbbuokzuj,61561,61562,123123
63883,,url:http://www.csa.com/partners/viewrecord.php3frequester3dgs26collection3dtrd26recid3dn9210445ah,61563,61564,123127
63884,,ca5xonjmwgoj,61564,61565,123129
63885,,8fwnn0pxneqj,61565,61566,123131
63886,,vgbc5gyi7caj,61566,61567,123133
63887,,raegszzfdamj,61567,61568,123135
63888,,dex1izk3yxej,61568,61569,123137
63889,,r1loabvfwvuj,61569,61570,123139
63890,,gezagndzoyij,61570,61571,123141
63891,,url:http://www.sciencemag.org/cgi/reprint/289/5476/101.pdf,61571,61572,123143
63892,,ri6dlxq6mfgj,61572,61573,123145
63893,,l9hqt4a5yvij,61573,61574,123147
63894,,uahirl5icqwj,61574,61575,123149
63895,,oh9-na2b3iyj,61575,61576,123151
63896,,hatr4gppkcaj,61577,61578,123155
63897,,vzer3lbuol8j,61578,61579,123157
63898,,ecns8psr5awj,61579,61580,123159
63899,,r6re386s8pwj,61580,61581,123161
63900,,wrcv7yowoasj,61581,61582,123163
63901,,zjcsqgmh5buj,61582,61583,123165
63902,,xxnz72kakisj,61583,61584,123167
63903,,y-ewkgcasb0j,61584,61585,123169
63904,,blalg9kqclaj,61585,61586,123171
63905,,iy05mcjl0rqj,61586,61587,123173
63906,,nu2d8vvxtacj,61588,61589,123177
63907,,url:http://doi.wiley.com/10.1002/he.55,61589,61590,123179
63908,,gz0t4or_m7ej,61590,61591,123181
63909,,qunzzerun-8j,61591,61592,123183
63910,,dqfhchu6no8j,61592,61593,123185
63911,,hy4ljv1f7wwj,61593,61594,123187
63912,,szd_eknyj6sj,61595,61596,123191
63913,,83xwvqg-yquj,61596,61597,123193
63914,,12m1kllmaiej,61597,61598,123195
63915,,jame_ush30ej,61598,61599,123197
63916,,dxvahy7cvtyj,61599,61600,123199
63917,,url:http://www.csa.com/partners/viewrecord.php3frequester3dgs26collection3dtrd26recid3d443612ci,61600,61601,123201
63918,,0_sqfvbfpqgj,61601,61602,123203
63919,,uyxoik7dccoj,61602,61603,123205
63920,,tebnymwtyrkj,61603,61604,123207
63921,,pxzvbbxwhtij,61604,61605,123209
63922,,xh2qzze-kfkj,61605,61606,123211
63923,,ltwo5w4ewymj,61606,61607,123213
63924,,lxmpwl3elp8j,61607,61608,123215
63925,,lsk2jrwdhyaj,61608,61609,123217
63926,,cmfs8rr37s4j,61609,61610,123219
63927,,0b0e3ylwjdwj,61610,61611,123221
63928,,m0vqklfdtpuj,61611,61612,123223
63929,,by4jnkzcqnij,61612,61613,123225
63930,,utaedikcslaj,61613,61614,123227
63931,,swsgdd4w72qj,61614,61615,123229
63932,,url:http://adsabs.harvard.edu/abs/1991phdt........16n,61615,61616,123231
63933,,hu7v5fb1nmgj,61616,61617,123233
63934,,cfpyf9uykcoj,61617,61618,123235
63935,,0tsctdyvmvmj,61618,61619,123237
63936,,kxmjkqympf8j,61619,61620,123239
63937,,bfmedzuvpykj,61620,61621,123241
63938,,qvampqw3fgkj,61621,61622,123243
63939,,3hoc-mdhewuj,61622,61623,123245
63940,,zx9rkcyanj8j,61623,61624,123247
63941,,_sf5wrpmdboj,61624,61625,123249
63942,,z3mftzo-860j,61625,61626,123251
63943,,dn6kxtk1kxwj,61626,61627,123253
63944,,rbluxtxquqwj,61627,61628,123255
63945,,uil2kyq_4awj,61628,61629,123257
63946,,r1cuoedh4u0j,61629,61630,123259
63947,,disrwigj-1ij,61630,61631,123261
63948,,8hmkxaia8vej,61631,61632,123263
63949,,jpq4o61gmh0j,61632,61633,123265
63950,,t2jztc9_sx4j,61633,61634,123267
63951,,pxdivxnv5a0j,61634,61635,123269
63952,,url:http://links.jstor.org/sici3fsici3d0146-4949(196422)5253a2253c151253adhltpo253e2.0.co253b2-m,61635,61636,123271
63953,,ktov2vw9rbkj,61636,61637,123273
63954,,tvs2r5ksx3yj,61637,61638,123275
63955,,tzx957oorkqj,61638,61639,123277
63956,,url:http://www.springerlink.com/index/m2105v734467t145.pdf,61639,61640,123279
63957,,hjrr7ggfd6sj,61640,61641,123281
63958,,qcorcn496byj,61641,61642,123283
63959,,pcwfv812yhyj,61642,61643,123285
63960,,xcb7fabcbq0j,61643,61644,123287
63961,,y8qak6wqgosj,61644,61645,123289
63962,,avb-qsf8crij,61645,61646,123291
63963,,bml_tdt3gumj,61646,61647,123293
63964,,2urckhuk8ukj,61647,61648,123295
63965,,url:http://portal.acm.org/citation.cfm3fid3d984378.98438026coll3dguide26dl3dacm26idx3dj68926part3dperiodical26wanttype3dperiodical26title3dacm2520sigmod2520record26cfid3d1111111126cftoken3d2222222,61648,61649,123297
63966,,930uth7earkj,61649,61650,123299
63967,,iefwnaj-xoyj,61650,61651,123301
63968,,nxllab_vdwsj,61651,61652,123303
63969,,a3ff3djjhmyj,61652,61653,123305
63970,,1oyh3enaytuj,61653,61654,123307
63971,,acezjvnggwyj,61654,61655,123309
63972,,0dl3r7500nuj,61655,61656,123311
63973,,scg5f1reod0j,61656,61657,123313
63974,,6qkto4hl4jqj,61657,61658,123315
63975,,agscjljugr8j,61658,61659,123317
63976,,pwxpfvloqquj,61659,61660,123319
63977,,tdg3pwur0kaj,61660,61661,123321
63978,,gz4dtdtddqcj,61661,61662,123323
63979,,jllitkdmrlij,61662,61663,123325
63980,,octaufyxfdsj,61663,61664,123327
63981,,hgi6n-a8kymj,61664,61665,123329
63982,,rlici5xa57oj,61665,61666,123331
63983,,dlnggq0j5h8j,61666,61667,123333
63984,,fumx9lsi3qmj,61667,61668,123335
63985,,ypc8y1jw348j,61668,61669,123337
63986,,mu5mtd4qwvij,61669,61670,123339
63987,,e2f2aiaqbvoj,61670,61671,123341
63988,,ht-7ip7hwuuj,61671,61672,123343
63989,,bnjcndtwipoj,61672,61673,123345
63990,,ffm7wq1ohqcj,61673,61674,123347
63991,,wq0zdljm79yj,61674,61675,123349
63992,,2mmc0fe5d4aj,61675,61676,123351
63993,,dufg6tj0vq4j,61676,61677,123353
63994,,5trj9q_ri8yj,61677,61678,123355
63995,,u90rjafqaegj,61678,61679,123357
63996,,ypu9db1wnrcj,61679,61680,123359
63997,,cpwyam_lyyej,61680,61681,123361
63998,,d9tauf00rgyj,61681,61682,123363
63999,,nvtfd0bu_csj,61682,61683,123365
64000,,pyigd3yn_hqj,61683,61684,123367
64001,,srjr-8rcz4yj,61684,61685,123369
64002,,g8mlb6ud-quj,61685,61686,123371
64003,,fusqrjgip28j,61686,61687,123373
64004,,aizyapzkbqwj,61687,61688,123375
64005,,yyglatkmxz8j,61688,61689,123377
64006,,7ah4tgvorwoj,61689,61690,123379
64007,,eczzptbzqfcj,61690,61691,123381
64008,,ilui5rkjd74j,61691,61692,123383
64009,,opgdcyyojcyj,61693,61694,123387
64010,,url:http://portal.acm.org/ft_gateway.cfm3fid3d60426826type3dpdf26dl3dguide26dl3dacm26cfid3d1111111126cftoken3d2222222,61694,61695,123389
64011,,y3pjr-mhqf4j,61695,61696,123391
64012,,q9sceclahy4j,61696,61697,123393
64013,,sap_iyrodpqj,61697,61698,123395
64014,,ccahfuttn2mj,61698,61699,123397
64015,,gacwboqtmx4j,61699,61700,123399
64016,,meiox19wsykj,61700,61701,123401
64017,,url:http://pubs.acs.org/cgi-bin/abstract.cgi/achre4/2004/37/i12/abs/ar030279z.html,61701,61702,123403
64018,,rsnc3apuy3aj,61702,61703,123405
64019,,pep94ujpscej,61703,61704,123407
64020,,zwthbbfpt80j,61704,61705,123409
64021,,wz0x2fues5yj,61705,61706,123411
64022,,bdryfydykloj,61706,61707,123413
64023,,y-n4gelekx8j,61707,61708,123415
64024,,epiastwu6pij,61708,61709,123417
64025,,iispt2ufjgqj,61709,61710,123419
64026,,lfc8gijplmmj,61710,61711,123421
64027,,kcrcnuwb4usj,61711,61712,123423
64028,,mgsh5kvwvnqj,61712,61713,123425
64029,,8b1nk87l2koj,61713,61714,123427
64030,,r_bwfe1sbsaj,61714,61715,123429
64031,,ewu0kywx0bkj,61715,61716,123431
64032,,dlgqp1yc9-wj,61716,61717,123433
64033,,u8xe4uwdy-8j,61717,61718,123435
64034,,4e3bhrujoesj,61718,61719,123437
64035,,url:http://www.springerlink.com/index/jr05004383tw04k5.pdf,61719,61720,123439
64036,,jgy-tte0lguj,61720,61721,123441
64037,,ahmk8mr5o7sj,61721,61722,123443
64038,,caxpv8r2jscj,61722,61723,123445
64039,,z9rlcqmb4ikj,61723,61724,123447
64040,,kjd9qwmb0rqj,61724,61725,123449
64041,,7xdlw3xpjtwj,61725,61726,123451
64042,,url:http://portal.acm.org/citation.cfm3fid3d170036,61726,61727,123453
64043,,x2aebvxrd_ij,61727,61728,123455
64044,,c1c8cefst6ej,61728,61729,123457
64045,,9rhj4yobphqj,61729,61730,123459
64046,,3cxvmniiwyyj,61730,61731,123461
64047,,iryt3uobxhqj,61731,61732,123463
64048,,r6ktt0iqtvej,61732,61733,123465
64049,,ygkswxnbybcj,61733,61734,123467
64050,,1tlf_qjdshoj,61734,61735,123469
64051,,43pv6brjdlwj,61735,61736,123471
64052,,pjiha9hs2tsj,61736,61737,123473
64053,,gyg6axnfxhaj,61737,61738,123475
64054,,jbejq0aykk8j,61738,61739,123477
64055,,nprsetaxocaj,61739,61740,123479
64056,,cg-_la4oaykj,61740,61741,123481
64057,,ijtmgqtjdguj,61741,61742,123483
64058,,wbqiqy-f7yyj,61742,61743,123485
64059,,sdvvrcgkxamj,61743,61744,123487
64060,,aajxxjkosbsj,61744,61745,123489
64061,,imczscaxqfcj,61745,61746,123491
64062,,p2ffaut4ptkj,61746,61747,123493
64063,,uhlfs0ggqaaj,61747,61748,123495
64064,,bhevqt_tl8cj,61748,61749,123497
64065,,e-9ueucb4bwj,61749,61750,123499
64066,,lr0uf11dqasj,61750,61751,123501
64067,,2hlcmuvarbyj,61751,61752,123503
64068,,a3tmzwotgmyj,61752,61753,123505
64069,,wavvywjky_ej,61753,61754,123507
64070,,_ubf7mqsoioj,61754,61755,123509
64071,,jlpwpzlysqaj,61755,61756,123511
64072,,g23bijvjzmij,61756,61757,123513
64073,,63mcayoudeoj,61757,61758,123515
64074,,2yywcql-gbuj,61758,61759,123517
64075,,pgf1r6lxxm4j,61759,61760,123519
64076,,2ypeqzupisej,61760,61761,123521
64077,,bax8ykev6mcj,61761,61762,123523
64078,,8lyinscbwvwj,61762,61763,123525
64079,,okct2ocgtgwj,61763,61764,123527
64080,,c_ckagkq2-kj,61764,61765,123529
64081,,x7pvwywwgmej,61765,61766,123531
64082,,myhv6qccetqj,61766,61767,123533
64083,,hp2kcz8wiymj,61767,61768,123535
64084,,hkk8dzrdk6yj,61768,61769,123537
64085,,dfs0pet2fx8j,61769,61770,123539
64086,,qya8llrwiloj,61770,61771,123541
64087,,jtsrxtbo67ej,61771,61772,123543
64088,,8-3kqcrlmwmj,61772,61773,123545
64089,,7shvos0ynayj,61773,61774,123547
64090,,gpsvcysrkuqj,61774,61775,123549
64091,,pvyltmmbjckj,61775,61776,123551
64092,,y64liaha10kj,61776,61777,123553
64093,,nogxvwg3j2ij,61777,61778,123555
64094,,ce9zcs3ktdsj,61778,61779,123557
64095,,nm_-sut2y3oj,61779,61780,123559
64096,,9sepwnnlj5gj,61780,61781,123561
64097,,x1rvargo1cwj,61781,61782,123563
64098,,uztvovgtukmj,61782,61783,123565
64099,,eyo0wvreblqj,61783,61784,123567
64100,,xy7ur1_lsaqj,61784,61785,123569
64101,,0vjje__zevgj,61785,61786,123571
64102,,lk498ul6_ucj,61786,61787,123573
64103,,url:http://www.csa.com/partners/viewrecord.php3frequester3dgs26collection3dtrd26recid3dwca73277wc,61787,61788,123575
64104,,05uvpkakcwij,61788,61789,123577
64105,,xcekovw9_zsj,61789,61790,123579
64106,,omkv6jhrb1ij,61790,61791,123581
64107,,ikep8pkq8s4j,61791,61792,123583
64108,,laqsfhf1i6ij,61792,61793,123585
64109,,gw-odfhcinwj,61793,61794,123587
64110,,him9houxq0mj,61794,61795,123589
64111,,url:http://portal.acm.org/citation.cfm3fid3d192593.19744826dl3dguide26dl3dacm26type3dseries26idx3d19259326part3dproceedings26wanttype3dproceedings26title3dinternational2520multimedia2520conference26cfid3d1111111126cftoken3d2222222,61795,61796,123591
64112,,khlfwtataoqj,61796,61797,123593
64113,,1cyvegplxkkj,61797,61798,123595
64114,,ypkcydfqwmaj,61798,61799,123597
64115,,q5gf5y1qfs8j,61799,61800,123599
64116,,nzlldhldousj,61800,61801,123601
64117,,h_zvd3ekg1wj,61801,61802,123603
64118,,ts7df925tr8j,61802,61803,123605
64119,,rwetihmuzxcj,61803,61804,123607
64120,,aakj-v09gduj,61804,61805,123609
64121,,uwhb-z0jjc8j,61805,61806,123611
64122,,qx9xzkplhimj,61806,61807,123613
64123,,v4gkptpbu84j,61807,61808,123615
64124,,onip5e6q3imj,61809,61810,123619
64125,,ofmdspywtryj,61810,61811,123621
64126,,rwemyodbkqej,61811,61812,123623
64127,,tzuzt1_6f6uj,61812,61813,123625
64128,,jf7sjnk184kj,61813,61814,123627
64129,,4n8vnuzixbsj,61814,61815,123629
64130,,qp51gr_qfjoj,61815,61816,123631
64131,,9s1ibxc2sqej,61816,61817,123633
64132,,,61817,61818,123635
64133,,url:http://www.csa.com/partners/viewrecord.php3frequester3dgs26collection3dtrd26recid3da8622981ah,61818,61819,123637
64134,,maq6bedgjxqj,61819,61820,123639
64135,,6pdphcq6-jaj,61820,61821,123641
64136,,ehiw8j7apdij,61821,61822,123643
64137,,nlzzsuswtcaj,61822,61823,123645
64138,,xsmwqxb1ivoj,61823,61824,123647
64139,,_ihfyz9ty0wj,61824,61825,123649
64140,,uyeod6nkkomj,61825,61826,123651
64141,,qejup5u7po4j,61826,61827,123653
64142,,eed_pqbwohwj,61827,61828,123655
64143,,uaekdfhatqkj,61828,61829,123657
64144,,e29aphffhosj,61829,61830,123659
64145,,ptvxp4xsanaj,61830,61831,123661
64146,,rxu769f0cnsj,61831,61832,123663
64147,,_f4tgym33wij,61832,61833,123665
64148,,37o-kznuloej,61834,61835,123669
64149,,_7v_l2rhrrmj,61835,61836,123671
64150,,sne7xjk-mawj,61836,61837,123673
64151,,midpdoqazacj,61837,61838,123675
64152,,7avdfrsk6zcj,61838,61839,123677
64153,,kremmipcrswj,61839,61840,123679
64154,,gnccieha3huj,61840,61841,123681
64155,,f0etp9osfzaj,61841,61842,123683
64156,,fvpae-gas4gj,61843,61844,123687
64157,,5fdmf8rnhlsj,61844,61845,123689
64158,,sa3tntbckqgj,61845,61846,123691
64159,,lvu4b-jl6-ej,61846,61847,123693
64160,,eks7ycep6kaj,61847,61848,123695
64161,,jvm2neeh86wj,61848,61849,123697
64162,,url:http://www.ingentaconnect.com/search/expand3fpub3dinfobike://els/09505849/1995/00000037/00000001/art0000226unc3d,61849,61850,123699
64163,,nwlltp3rrwej,61850,61851,123701
64164,,m1ecrjqptbcj,61851,61852,123703
64165,,skmclpoa84ej,61852,61853,123705
64166,,hjwi00dglvij,61853,61854,123707
64167,,91wvzyip5uuj,61854,61855,123709
64168,,b7v1clxsx1gj,61855,61856,123711
64169,,aygqeip71_yj,61856,61857,123713
64170,,wuicp7dthagj,61857,61858,123715
64171,,jitftstu9zij,61858,61859,123717
64172,,xt5o3jc7jd0j,61859,61860,123719
64173,,cmwb9d2sutej,61860,61861,123721
64174,,wyd_i2rk3iwj,61861,61862,123723
64175,,wgjuw10m7uuj,61862,61863,123725
64176,,n0fvbydrodsj,61863,61864,123727
64177,,7l-z6pp6x08j,61864,61865,123729
64178,,ai2acen4-doj,61865,61866,123731
64179,,x-j6ibwi7u8j,61866,61867,123733
64180,,dnz6dt70-aij,61867,61868,123735
64181,,ed9i0ctgcmsj,61868,61869,123737
64182,,bjrf8pubuy0j,61869,61870,123739
64183,,mqcxqyav1b8j,61870,61871,123741
64184,,a7gqy2ung24j,61871,61872,123743
64185,,zo8qemlelbaj,61872,61873,123745
64186,,6wif-_hbzzgj,61873,61874,123747
64187,,ix5ysuadnnuj,61874,61875,123749
64188,,h5hsnzlyerqj,61875,61876,123751
64189,,kvob12r3tgqj,61876,61877,123753
64190,,url:http://portal.acm.org/ft_gateway.cfm3fid3d33545926type3dpdf26dl3dguide26dl3dguide26cfid3d1111111126cftoken3d2222222,61877,61878,123755
64191,,376bwxz2kh8j,61878,61879,123757
64192,,hmherzhzmyqj,61879,61880,123759
64193,,ncjfeseybxoj,61880,61881,123761
64194,,ax2c4qa7lv0j,61881,61882,123763
64195,,34sshlghnksj,61882,61883,123765
64196,,qpbobzjo6coj,61883,61884,123767
64197,,xamogoq1f-ej,61884,61885,123769
64198,,efmxkvbs6taj,61885,61886,123771
64199,,suqhrayfkg4j,61886,61887,123773
64200,,sf9rvg548aoj,61887,61888,123775
64201,,se_xnkjdtw0j,61888,61889,123777
64202,,e8tnhehzwaej,61889,61890,123779
64203,,orb1ih_p5usj,61890,61891,123781
64204,,uap3cykeqjsj,61891,61892,123783
64205,,zyckwzwhz0uj,61892,61893,123785
64206,,gkk6hlxepwij,61893,61894,123787
64207,,zkxgprmphnqj,61894,61895,123789
64208,,n5-pr09-mbqj,61895,61896,123791
64209,,5n4phonnbryj,61896,61897,123793
64210,,eymblgcgnv4j,61897,61898,123795
64211,,xa8mtbbwozaj,61898,61899,123797
64212,,da9lt8rbasoj,61899,61900,123799
64213,,cbnnhtu-ysaj,61900,61901,123801
64214,,zemyvu34fosj,61901,61902,123803
64215,,ifcurzzrq6aj,61902,61903,123805
64216,,eztzzeugjpwj,61903,61904,123807
64217,,ziggdi9dceuj,61904,61905,123809
64218,,c8ubrlh8euqj,61905,61906,123811
64219,,edx1qyobhh8j,61906,61907,123813
64220,,632lyb5mqlyj,61907,61908,123815
64221,,aw9y5304oxej,61908,61909,123817
64222,,c9ub1hnphuqj,61909,61910,123819
64223,,yhm4l6o3k5mj,61910,61911,123821
64224,,jpdtj32vzfaj,61911,61912,123823
64225,,url:http://portal.acm.org/citation.cfm3fid3d353053.35313626dl3dportal26dl3dacm26type3dseries26idx3dseries40626part3dproceedings26wanttype3dproceedings26title3dinternational2520conference2520on2520information2520systems26cfid3d1111111126cftoken3d2222222,61912,61913,123825
64226,,url:http://portal.acm.org/ft_gateway.cfm3fid3d108377926type3dpdf,61913,61914,123827
64227,,1mrzj9llj78j,61914,61915,123829
64228,,au3dyhkp1q8j,61915,61916,123831
64229,,2z1wp6v-0o0j,61916,61917,123833
64230,,vsb1dhe6zoyj,61917,61918,123835
64231,,h4jdo2our9wj,61918,61919,123837
64232,,xh9anv9p-rej,61919,61920,123839
64233,,url:http://portal.acm.org/ft_gateway.cfm3fid3d108627626type3dpdf,61920,61921,123841
64234,,xyq6cxynpn4j,61921,61922,123843
64235,,u8sjun-bmpej,61922,61923,123845
64236,,g4n8qabag4kj,61923,61924,123847
64237,,2q_j0_xy_wwj,61924,61925,123849
64238,,geyvf7cuqcaj,61925,61926,123851
64239,,dlmunia9jyij,61926,61927,123853
64240,,tpwu6p4t2pej,61927,61928,123855
64241,,zzd0v68orrij,61928,61929,123857
64242,,jnb5aofes7wj,61929,61930,123859
64243,,tgvtk1qs2eqj,61930,61931,123861
64244,,yyhhnn6bg34j,61931,61932,123863
64245,,lfq_iao2ahij,61932,61933,123865
64246,,ndx_un5utu8j,61933,61934,123867
64247,,x1zun3da5-wj,61934,61935,123869
64248,,piplxeokqn8j,61935,61936,123871
64249,,3gzhiwzyau8j,61936,61937,123873
64250,,xzrghzvzufkj,61937,61938,123875
64251,,gzumimr4b70j,61938,61939,123877
64252,,cjnicsfqrvyj,61939,61940,123879
64253,,d_o8mihyfwyj,61940,61941,123881
64254,,url:http://doi.wiley.com/10.1002/anie.199000871,61941,61942,123883
64255,,tjq1shnpvhcj,61943,61944,123887
64256,,v6xaupqm298j,61944,61945,123889
64257,,criburyc3vij,61945,61946,123891
64258,,qk3lvaus2suj,61946,61947,123893
64259,,5ussknwhvfij,61947,61948,123895
64260,,eu9p5uig71oj,61948,61949,123897
64261,,xu0_3tq8l4ij,61949,61950,123899
64262,,75o0igyvbz0j,61950,61951,123901
64263,,xb6holoq6gej,61951,61952,123903
64264,,s6kbqamvlyqj,61952,61953,123905
64265,,889ulwuj6xuj,61953,61954,123907
64266,,onezhxvclvuj,61954,61955,123909
64267,,nbaqotfaybej,61955,61956,123911
64268,,t9v-1y_x014j,61956,61957,123913
64269,,ko6m4fc8-80j,61957,61958,123915
64270,,y014vzmxyggj,61958,61959,123917
64271,,mua_a4lrwruj,61959,61960,123919
64272,,ywej5ii4zbij,61960,61961,123921
64273,,ydkl5otgbbyj,61961,61962,123923
64274,,jafbawam6uyj,61962,61963,123925
64275,,iujxqjexas8j,61963,61964,123927
64276,,6i9fkauyizmj,61964,61965,123929
64277,,ijoqkxl6gpmj,61965,61966,123931
64278,,pbc1epakvc8j,61966,61967,123933
64279,,ohx_lrlebvaj,61967,61968,123935
64280,,h9mp0nfc71kj,61969,61970,123939
64281,,zbuu0_ebmkwj,61970,61971,123941
64282,,9o3lmy-4de0j,61971,61972,123943
64283,,v2ttn2lihauj,61972,61973,123945
64284,,jrllo-i3pbcj,61973,61974,123947
64285,,yvzzgrf-i1uj,61974,61975,123949
64286,,ruouoavpmd8j,61975,61976,123951
64287,,yib0zhdizqqj,61976,61977,123953
64288,,gchlrjnqxucj,61977,61978,123955
64289,,4ng-hv4_1icj,61978,61979,123957
64290,,j1ijxu_03m8j,61979,61980,123959
64291,,url:http://doi.wiley.com/10.1002/he.114,61980,61981,123961
64292,,_e32dj7n4hej,61981,61982,123963
64293,,w4jax66tvrej,61982,61983,123965
64294,,1nadsc0_zw4j,61983,61984,123967
64295,,dkwntbi9xnej,61984,61985,123969
64296,,gujeq6awunsj,61985,61986,123971
64297,,frroeztcu_0j,61986,61987,123973
64298,,8ipbe_nyz5ej,61987,61988,123975
64299,,meuhubx2yucj,61988,61989,123977
64300,,04aognmfrs8j,61989,61990,123979
64301,,yydlozprwrmj,61990,61991,123981
64302,,ig0hxdf4sh8j,61991,61992,123983
64303,,fykyqmihaiej,61992,61993,123985
64304,,6f0ia9t9w_ej,61993,61994,123987
64305,,y7imj-jckqmj,61994,61995,123989
64306,,hwevs_q2jlwj,61995,61996,123991
64307,,5nkxkowjzxej,61996,61997,123993
64308,,url:http://portal.acm.org/ft_gateway.cfm3fid3d109961226type3dpdf,61997,61998,123995
64309,,gbdsovhbj_ij,61998,61999,123997
64310,,qwgjzfxi414j,61999,62000,123999
64311,,zrasreah7oyj,62000,62001,124001
64312,,refds4up9ksj,62001,62002,124003
64313,,k1lrkcnaawej,62002,62003,124005
64314,,tb6sphi-roej,62003,62004,124007
64315,,crzymdakn7wj,62004,62005,124009
64316,,ic9jcg8iaymj,62005,62006,124011
64317,,202wscfaiwgj,62006,62007,124013
64318,,4i-ccugb-xkj,62007,62008,124015
64319,,xuptqwqev8sj,62008,62009,124017
64320,,oa5fogx7wfej,62009,62010,124019
64321,,gkut2ugb_puj,62010,62011,124021
64322,,e3h3n9rr07aj,62011,62012,124023
64323,,dwhlh-muoiuj,62012,62013,124025
64324,,w7i1yef3yrsj,62013,62014,124027
64325,,hhbha9teirkj,62014,62015,124029
64326,,tzn6jrgefdsj,62015,62016,124031
64327,,otc6cxxhkpuj,62016,62017,124033
64328,,s4zo9gcqgtij,62017,62018,124035
64329,,xtwgro7-w4cj,62018,62019,124037
64330,,kbvwi72k_wmj,62019,62020,124039
64331,,96-utstz8aij,62020,62021,124041
64332,,3sqbgy_unowj,62021,62022,124043
64333,,hj4nrvtpdhwj,62022,62023,124045
64334,,kuuwcpbz2wsj,62023,62024,124047
64335,,qslyhmr53cqj,62024,62025,124049
64336,,ra8trgojgxsj,62025,62026,124051
64337,,v2aelxjinomj,62026,62027,124053
64338,,kmvwnyxzycmj,62027,62028,124055
64339,,4rg3m_ha2-gj,62028,62029,124057
64340,,hthmwnfauucj,62029,62030,124059
64341,,qash0xwzdecj,62030,62031,124061
64342,,jdrzog2zwtkj,62031,62032,124063
64343,,qdofzxd-wxkj,62032,62033,124065
64344,,kxbnmldilqyj,62033,62034,124067
64345,,gnrpnecka6wj,62034,62035,124069
64346,,cnzasdayv1ej,62035,62036,124071
64347,,l9nzjt2pqpcj,62037,62038,124075
64348,,url:http://portal.acm.org/ft_gateway.cfm3fid3d110121526type3dpdf,62038,62039,124077
64349,,,62039,62040,124079
64350,,nl71hk6j6esj,62040,62041,124081
64351,,tiwufeyxlfkj,62041,62042,124083
64352,,0h7oj5hzjqgj,62042,62043,124085
64353,,fitd6ee8iwuj,62043,62044,124087
64354,,,62044,62045,124089
64355,,hv6octnjfiuj,62045,62046,124091
64356,,q3blyhj0qtaj,62046,62047,124093
64357,,nn3yhjnha7gj,62047,62048,124095
64358,,fzrbcibdxuej,62048,62049,124097
64359,,kmmxfullye4j,62049,62050,124099
64360,,zge10kugoryj,62050,62051,124101
64361,,duhyelx26boj,62051,62052,124103
64362,,nikwgwshiycj,62052,62053,124105
64363,,url:http://portal.acm.org/citation.cfm3fid3d335223,62053,62054,124107
64364,,cnnejipglmkj,62054,62055,124109
64365,,gj5se9ujqhej,62055,62056,124111
64366,,is-hhd_lirej,62056,62057,124113
64367,,x0l2nv-6cngj,62057,62058,124115
64368,,enqngfjicj4j,62058,62059,124117
64369,,u9w8yb3fkjuj,62059,62060,124119
64370,,url:http://www.ingentaconnect.com/search/expand3fpub3dinfobike://pep/jae/2004/00000218/00000001/art0001026unc3d,62060,62061,124121
64371,,dnbk1ijpm6mj,62061,62062,124123
64372,,zlnqzbiz17wj,62062,62063,124125
64373,,txfjepp_ucwj,62063,62064,124127
64374,,km8wjdw4cb0j,62064,62065,124129
64375,,nxfw4_djpxkj,62065,62066,124131
64376,,niy7qlbmoiyj,62066,62067,124133
64377,,3fj-eef9xwmj,62067,62068,124135
64378,,vv6nr6rtwnij,62068,62069,124137
64379,,1kgixde6g90j,62069,62070,124139
64380,,zbfaue-x3-gj,62070,62071,124141
64381,,url:http://doi.wiley.com/10.1002/ace.26,62071,62072,124143
64382,,d5tya1oeky4j,62072,62073,124145
64383,,e1yweerxokmj,62073,62074,124147
64384,,f7swz2rndraj,62074,62075,124149
64385,,yw7ldtbmtcqj,62075,62076,124151
64386,,i4ovstgvax8j,62076,62077,124153
64387,,alpmdadp9suj,62077,62078,124155
64388,,7rmpxkpmwgqj,62078,62079,124157
64389,,sjomo7mxzjsj,62080,62081,124161
64390,,hfxtx4lh46uj,62081,62082,124163
64391,,w9dsqojwgdaj,62082,62083,124165
64392,,pqvepjasfvkj,62083,62084,124167
64393,,sjplyzwzx8wj,62084,62085,124169
64394,,8rfut4hqoj8j,62085,62086,124171
64395,,w-rmwy97grij,62086,62087,124173
64396,,7uce6_tf3qij,62087,62088,124175
64397,,fl1yknn8eucj,62088,62089,124177
64398,,gpmd9_yt-qwj,62089,62090,124179
64399,,vzj-epkitfgj,62090,62091,124181
64400,,hz_sdjinvqmj,62091,62092,124183
64401,,qoghzshdarsj,62092,62093,124185
64402,,url:http://www.ingentaconnect.com/search/expand3fpub3dinfobike://els/09505849/2000/00000042/00000004/art0006426unc3d,62093,62094,124187
64403,,cwk-qi8ssjgj,62094,62095,124189
64404,,kirr5k36occj,62095,62096,124191
64405,,oosrn27rys4j,62096,62097,124193
64406,,czsegvsr3zwj,62097,62098,124195
64407,,ad0r2e82xr8j,62098,62099,124197
64408,,b7pl2-7moqij,62100,62101,124201
64409,,lcvy4fftfnkj,62101,62102,124203
64410,,49nxxzfvbt8j,62102,62103,124205
64411,,f7vfmpw4wvgj,62103,62104,124207
64412,,btll8c6wd1wj,62104,62105,124209
64413,,5bnlj0ktg-gj,62105,62106,124211
64414,,w0s9wxcdgxaj,62106,62107,124213
64415,,url:http://doi.wiley.com/10.1002/tl.157,62107,62108,124215
64416,,6tjcs6-oh5ej,62108,62109,124217
64417,,qmu8c_bfdboj,62110,62111,124221
64418,,l1j6zi2vjxoj,62111,62112,124223
64419,,1zly2bb59aoj,62112,62113,124225
64420,,url:http://portal.acm.org/ft_gateway.cfm3fid3d102759626type3dpdf,62113,62114,124227
64421,,2kojjdgqfosj,62114,62115,124229
64422,,dm4xrdcrpyyj,62115,62116,124231
64423,,3u2brlqkaj4j,62116,62117,124233
64424,,bbzqvg5_ysmj,62117,62118,124235
64425,,rrrqyvxoh7ej,62118,62119,124237
64426,,8wfej9mpf_4j,62119,62120,124239
64427,,ritwdf5uzrsj,62120,62121,124241
64428,,ogytwyjwl1kj,62121,62122,124243
64429,,ph121jntz_qj,62122,62123,124245
64430,,6xxvj6-sr3gj,62123,62124,124247
64431,,dg2gkgc4up8j,62124,62125,124249
64432,,8wr_xb09kmoj,62125,62126,124251
64433,,sjbrvd2epaqj,62126,62127,124253
64434,,4zakw2uyrsej,62127,62128,124255
64435,,dobdpsgkqnmj,62128,62129,124257
64436,,wkgfb0cu5sej,62129,62130,124259
64437,,ij6xemkq9zaj,62130,62131,124261
64438,,n6jnvopablyj,62131,62132,124263
64439,,aa8qwsyt2f0j,62132,62133,124265
64440,,eycnq5glex4j,62133,62134,124267
64441,,vmfe7r0og8qj,62134,62135,124269
64442,,yalmjhffjuwj,62135,62136,124271
64443,,6wkdzhgxz8ij,62136,62137,124273
64444,,zehd3nn_9nsj,62137,62138,124275
64445,,f8nl3mdw6tsj,62138,62139,124277
64446,,g39hmdluxp0j,62139,62140,124279
64447,,vyujsoj--skj,62140,62141,124281
64448,,y5jyklyjni4j,62141,62142,124283
64449,,sucxuyo2rxgj,62142,62143,124285
64450,,osgk6chpnm0j,62143,62144,124287
64451,,wb0ghesnltyj,62144,62145,124289
64452,,cq9djanrqgcj,62145,62146,124291
64453,,ww6ri_ego4yj,62146,62147,124293
64454,,,62147,62148,124295
64455,,6tnpdgvlh_8j,62149,62150,124299
64456,,jkxelumoskej,62150,62151,124301
64457,,htdmzkisl4uj,62151,62152,124303
64458,,df9r17hfvaqj,62152,62153,124305
64459,,h4tkmhs263gj,62153,62154,124307
64460,,bzj3hmdoqvoj,62154,62155,124309
64461,,,62155,62156,124311
64462,,n_rfxnrzqpuj,62156,62157,124313
64463,,ozm0fzf78nej,62157,62158,124315
64464,,3e7dusjmaqyj,62158,62159,124317
64465,,98rf1w3kpo0j,62159,62160,124319
64466,,gwajzxam0kmj,62160,62161,124321
64467,,89z9ivt4ebgj,62161,62162,124323
64468,,nliu2tiyurkj,62162,62163,124325
64469,,0itelxlimnij,62163,62164,124327
64470,,url:http://adsabs.harvard.edu/abs/1976infph..16..213t,62164,62165,124329
64471,,ylzig4004j4j,62165,62166,124331
64472,,rvz7yr7ioymj,62166,62167,124333
64473,,url:http://doi.wiley.com/10.1002/tl.160,62167,62168,124335
64474,,,62168,62169,124337
64475,,dgq4mwww7tuj,62170,62171,124341
64476,,xqcmvzysehgj,62171,62172,124343
64477,,pky27jvjloqj,62172,62173,124345
64478,,w3pvknvtd9ej,62173,62174,124347
64479,,rijy1pewp_0j,62174,62175,124349
64480,,1obhqambj24j,62175,62176,124351
64481,,0fdnvjggo9yj,62176,62177,124353
64482,,z-u4r47ccmgj,62177,62178,124355
64483,,fpw4udrjcu8j,62178,62179,124357
64484,,gtdhy2ncygaj,62179,62180,124359
64485,,xk85fphqo9gj,62180,62181,124361
64486,,li2vmqjtzzwj,62181,62182,124363
64487,,rtby3dzvkw8j,62182,62183,124365
64488,,w9ecz5dqi8yj,62183,62184,124367
64489,,dosl9gnm5lej,62184,62185,124369
64490,,rkka3rpxpckj,62185,62186,124371
64491,,pu-d5tlkceoj,62186,62187,124373
64492,,kt_pa61aahqj,62187,62188,124375
64493,,url:http://portal.acm.org/citation.cfm3fid3d127229.127234,62189,62190,124379
64494,,url:http://www.csa.com/partners/viewrecord.php3frequester3dgs26collection3dtrd26recid3da8622958ah,62191,62192,124383
64495,,dpqbmtie-owj,62192,62193,124385
64496,,tsd_v6d-j1wj,62193,62194,124387
64497,,zxhi-xyq-vej,62194,62195,124389
64498,,url:http://portal.acm.org/citation.cfm3fid3d217279.21530126dl3dguide26dl3dacm26type3dseries26idx3dseries31626part3dproceedings26wanttype3dproceedings26title3dinternational2520multimedia2520conference26cfid3d1111111126cftoken3d2222222,62195,62196,124391
64499,,jfnanv86agij,62196,62197,124393
64500,,9zkpq3ynoboj,62197,62198,124395
64501,,url:http://doi.wiley.com/10.1002/tl.159,62198,62199,124397
64502,,dzfewy3jzfuj,62199,62200,124399
64503,,op3_uoqi_gqj,62200,62201,124401
64504,,hgbqftkv_soj,62201,62202,124403
64505,,wdy6kx-lcfuj,62202,62203,124405
64506,,ffpm2mnfac4j,62203,62204,124407
64507,,itpugmpseskj,62204,62205,124409
64508,,ydzlwr2f9jej,62205,62206,124411
64509,,7lb4cd2fr1qj,62206,62207,124413
64510,,url:http://portal.acm.org/citation.cfm3fid3d58236626dl3dacm26coll3dportal26cfid3d1111111126cftoken3d2222222,62207,62208,124415
64511,,gtsn7nmr9dqj,62208,62209,124417
64512,,1zsldf-yhnsj,62209,62210,124419
64513,,jerd8nex2yyj,62210,62211,124421
64514,,yk-lbuwq6nsj,62212,62213,124425
64515,,rzrmirkdi7cj,62213,62214,124427
64516,,6kwvqgva7ywj,62214,62215,124429
64517,,e06ayg7lwuaj,62215,62216,124431
64518,,tqwgtmnvnfkj,62216,62217,124433
64519,,mfjyk9hrsucj,62217,62218,124435
64520,,sjfselkjqiaj,62218,62219,124437
64521,,f5ffxog4yhmj,62219,62220,124439
64522,,n-ceyahfsj4j,62220,62221,124441
64523,,fbi8_vaua44j,62221,62222,124443
64524,,opt8jaslmw0j,62222,62223,124445
64525,,url:http://portal.acm.org/ft_gateway.cfm3fid3d102759526type3dpdf,62223,62224,124447
64526,,nqopdli3yhuj,62224,62225,124449
64527,,0wurzx4wm78j,62225,62226,124451
64528,,izljjdrubgqj,62226,62227,124453
64529,,aouuzstzhqij,62228,62229,124457
64530,,ylzewtzpiq4j,62229,62230,124459
64531,,zpuglbaasqcj,62230,62231,124461
64532,,fu12zz3zqz0j,62231,62232,124463
64533,,1wvhpqvubqoj,62232,62233,124465
64534,,svm3y3-z65mj,62233,62234,124467
64535,,2nkjnxvsxkcj,62234,62235,124469
64536,,chb8ywgc5suj,62235,62236,124471
64537,,0pdtpnfislqj,62236,62237,124473
64538,,kzi5s9z-rdej,62237,62238,124475
64539,,ny19rlla4zuj,62238,62239,124477
64540,,kp7_z11bxnij,62239,62240,124479
64541,,unfqapxarg4j,62240,62241,124481
64542,,yx8lwdsnryqj,62241,62242,124483
64543,,tbpuh_1cro4j,62242,62243,124485
64544,,ix52p4erv5sj,62243,62244,124487
64545,,quklkejoi0uj,62245,62246,124491
64546,,vxflxciwzesj,62246,62247,124493
64547,,8lmpl-px0gaj,62247,62248,124495
64548,,hawlqu-xqwij,62248,62249,124497
64549,,im6tkyvzwacj,62249,62250,124499
64550,,zfor-xtdwuoj,62250,62251,124501
64551,,jeydnfjct6mj,62251,62252,124503
64552,,6pn0fmgof6oj,62252,62253,124505
64553,,yz3xlehsmfsj,62253,62254,124507
64554,,ym2ujnjacb0j,62254,62255,124509
64555,,_cpnv6dqrmej,62255,62256,124511
64556,,yyed3mgh-jcj,62256,62257,124513
64557,,9vdvrle03kcj,62258,62259,124517
64558,,14tjvs3yklkj,62259,62260,124519
64559,,gd0cf250nk0j,62260,62261,124521
64560,,7dq-vuzwd9sj,62261,62262,124523
64561,,exggda9rfgij,62262,62263,124525
64562,,1bvs1ruu6emj,62263,62264,124527
64563,,,62264,62265,124529
64564,,f5j0ze057vsj,62265,62266,124531
64565,,epiqbms5vw0j,62266,62267,124533
64566,,oljhg7glrooj,62267,62268,124535
64567,,3kdemwv8xxqj,62268,62269,124537
64568,,-0uma-mvnb4j,62269,62270,124539
64569,,c1vjkqglkp4j,62270,62271,124541
64570,,-0n_mkkdmk4j,62271,62272,124543
64571,,rcnaqoi7g10j,62272,62273,124545
64572,,wfyxqcbrdncj,62273,62274,124547
64573,,m9in1w1-awyj,62274,62275,124549
64574,,pea6madivvaj,62275,62276,124551
64575,,fvhul7kkh30j,62276,62277,124553
64576,,url:http://doi.wiley.com/10.1002/tl.101,62277,62278,124555
64577,,kafiwnyp_wyj,62278,62279,124557
64578,,ncynjm4ccakj,62279,62280,124559
64579,,h6cvignaaqij,62280,62281,124561
64580,,uh-bigp9hsqj,62281,62282,124563
64581,,6ygij3_egwoj,62282,62283,124565
64582,,pfujlvmzai8j,62283,62284,124567
64583,,tygyrtcyctej,62284,62285,124569
64584,,url:http://portal.acm.org/ft_gateway.cfm3fid3d110116826type3dpdf,62285,62286,124571
64585,,mtv6dfzt8r0j,62286,62287,124573
64586,,g0--6bzrzikj,62287,62288,124575
64587,,k8rv0m-cjt4j,62288,62289,124577
64588,,a763ng-wqh8j,62289,62290,124579
64589,,0kiqzaifljkj,62290,62291,124581
64590,,ubzm0wwfpfwj,62291,62292,124583
64591,,aq7fxadt96qj,62292,62293,124585
64592,,djsdhpbyvpcj,62293,62294,124587
64593,,mzxbj2v6jlej,62295,62296,124591
64594,,exkfbhj5zo8j,62296,62297,124593
64595,,ukwbhef9rsmj,62297,62298,124595
64596,,yeyvhoxkweaj,62298,62299,124597
64597,,t0rxlzz0wl4j,62299,62300,124599
64598,,fzs7vmw3pamj,62300,62301,124601
64599,,1lq8islfvucj,62301,62302,124603
64600,,wngevzjezjyj,62302,62303,124605
64601,,rqmkqwc2hzqj,62303,62304,124607
64602,,kb_gv0fio28j,62304,62305,124609
64603,,mx7mimhg0dcj,62305,62306,124611
64604,,utejbc3cq_aj,62306,62307,124613
64605,,qrmbspif6sgj,62307,62308,124615
64606,,hnwvggukepej,62308,62309,124617
64607,,kjm8fkqoodqj,62309,62310,124619
64608,,deulto83e6wj,62310,62311,124621
64609,,nteto_7_oyaj,62311,62312,124623
64610,,hm4jetrlfx0j,62312,62313,124625
64611,,qn0wlreqt3ej,62313,62314,124627
64612,,oru9oygwhj4j,62314,62315,124629
64613,,kbraiwklo1wj,62315,62316,124631
64614,,url:http://www.csa.com/partners/viewrecord.php3frequester3dgs26collection3dtrd26recid3d0955855ci26recid3d0955855ea,62316,62317,124633
64615,,zq0jtsxps34j,62317,62318,124635
64616,,,62318,62319,124637
64617,,hcfznfvizgkj,62319,62320,124639
64618,,kulycnlrazwj,62320,62321,124641
64619,,_wznpwadxgwj,62321,62322,124643
64620,,l9_0psbr2_yj,62322,62323,124645
64621,,63km3poylloj,62323,62324,124647
64622,,url:http://www.csa.com/partners/viewrecord.php3frequester3dgs26collection3dtrd26recid3dn9210544ah,62324,62325,124649
64623,,pnd7jkhawhwj,62325,62326,124651
64624,,uvffihqkufkj,62326,62327,124653
64625,,ffo0hopnkxsj,62327,62328,124655
64626,,kawfnexcqjyj,62328,62329,124657
64627,,c3p4ooo1ziej,62330,62331,124661
64628,,lqs964krh34j,62331,62332,124663
64629,,cmfweejdwooj,62332,62333,124665
64630,,gkldxwnclgcj,62333,62334,124667
64631,,wjisfu-6xjoj,62334,62335,124669
64632,,l4slx8_caeqj,62335,62336,124671
64633,,qtcqt-f8np4j,62336,62337,124673
64634,,url:http://doi.ieeecomputersociety.org/10.1109/tkde.2004.1264826,62337,62338,124675
64635,,tcnivjlkeyij,62338,62339,124677
64636,,5jxneafqqwcj,62339,62340,124679
64637,,axjp98jn0jij,62340,62341,124681
64638,,11ns5975x2gj,62341,62342,124683
64639,,gnsrjezd168j,62342,62343,124685
64640,,5pjb4sajdbej,62343,62344,124687
64641,,la3xetvdvtqj,62344,62345,124689
64642,,grzwug_txcej,62345,62346,124691
64643,,bud8odwba2yj,62346,62347,124693
64644,,ybd0ymaujd4j,62347,62348,124695
64645,,m9tbsrfvnisj,62348,62349,124697
64646,,xb6yi6_et0kj,62349,62350,124699
64647,,url:http://www.csa.com/partners/viewrecord.php3frequester3dgs26collection3dtrd26recid3dn9227497ah,62350,62351,124701
64648,,url:http://portal.acm.org/ft_gateway.cfm3fid3d110124426type3dpdf,62351,62352,124703
64649,,lgithskttqej,62352,62353,124705
64650,,ey1qv1u890aj,62353,62354,124707
64651,,snpqwkbvu_mj,62354,62355,124709
64652,,tokriqz1m44j,62355,62356,124711
64653,,sssdekg-2_mj,62356,62357,124713
64654,,hie0zb83ykaj,62357,62358,124715
64655,,4yucxvwn0lej,62358,62359,124717
64656,,url:http://doi.wiley.com/10.1002/tl.125,62359,62360,124719
64657,,qgkrpqigxesj,62360,62361,124721
64658,,url:http://portal.acm.org/citation.cfm3fid3d171926.171938,62361,62362,124723
64659,,-3rfqtd7h08j,62362,62363,124725
64660,,jxhzzixirfgj,62363,62364,124727
64661,,2fzv3icugumj,62364,62365,124729
64662,,n8bvipeu1fsj,62365,62366,124731
64663,,camp-dqexd8j,62366,62367,124733
64664,,uuhclh6eipaj,62367,62368,124735
64665,,rvey3z7zhaej,62369,62370,124739
64666,,url:http://portal.acm.org/citation.cfm3fid3d1083784.1083803,62370,62371,124741
64667,,fecu4p9j5h0j,62371,62372,124743
64668,,url:http://www.springerlink.com/index/r92hy26vl8xftx4v.pdf,62372,62373,124745
64669,,0-hcx89cgh4j,62373,62374,124747
64670,,fnqbp7hox0kj,62374,62375,124749
64671,,cgjpjklfmhmj,62375,62376,124751
64672,,m7wdgietdyoj,62376,62377,124753
64673,,url:http://portal.acm.org/citation.cfm3fid3d525590.837944,62377,62378,124755
64674,,9jff1xt6t50j,62378,62379,124757
64675,,sbuhgarkhaoj,62380,62381,124761
64676,,jhooe_8uwdej,62381,62382,124763
64677,,,62382,62383,124765
64678,,wndvox2xbmij,62383,62384,124767
64679,,3atu7nlx9fij,62384,62385,124769
64680,,q4d2aqefxywj,62385,62386,124771
64681,,w6tfyhb7ptuj,62387,62388,124775
64682,,,62388,62389,124777
64683,,url:http://portal.acm.org/citation.cfm3fid3d51708.5171026dl3dguide26dl3dacm26idx3dj68926part3dperiodical26wanttype3dperiodical26title3dacm2520sigmod2520record26cfid3d1111111126cftoken3d2222222,62389,62390,124779
64684,,b6vrwvbmitaj,62390,62391,124781
64685,,qaisvbqeaxwj,62391,62392,124783
64686,,s6hjdo27yzgj,62392,62393,124785
64687,,zwh_jsol1_aj,62393,62394,124787
64688,,hrsc329vaamj,62394,62395,124789
64689,,ngq6saefagoj,62395,62396,124791
64690,,2iv-yp_mieqj,62396,62397,124793
64691,,iuijijsziwsj,62397,62398,124795
64692,,wvuaws6zrqmj,62398,62399,124797
64693,,u1kzenojtjaj,62399,62400,124799
64694,,ughgbxhdpfqj,62400,62401,124801
64695,,tb6_juzxemwj,62401,62402,124803
64696,,url:http://portal.acm.org/citation.cfm3fid3d234286.1057845,62402,62403,124805
64697,,mwububwimraj,62403,62404,124807
64698,,ul3uaqcuuh0j,62404,62405,124809
64699,,ju2ddqgett4j,62405,62406,124811
64700,,kpbzq1cvhzuj,62406,62407,124813
64701,,pv6nahn2sjuj,62407,62408,124815
64702,,fv8uot7iwekj,62408,62409,124817
64703,,6h712r6nl3qj,62409,62410,124819
64704,,fwessbeoawoj,62410,62411,124821
64705,,b2r9ozjj4sgj,62411,62412,124823
64706,,lnz04qjrn7oj,62412,62413,124825
64707,,5ic_ehgdmawj,62413,62414,124827
64708,,favlfypfjw0j,62414,62415,124829
64709,,5ux_plf7hnmj,62415,62416,124831
64710,,e0bl6gkmqzsj,62416,62417,124833
64711,,h0dtchtxvlmj,62417,62418,124835
64712,,15sbqyema0oj,62418,62419,124837
64713,,ubqdcup58s0j,62419,62420,124839
64714,,if4-zgnqrhyj,62420,62421,124841
64715,,mil-zyi2yeuj,62421,62422,124843
64716,,7ex2ghrfwauj,62422,62423,124845
64717,,ptfupscdb2oj,62423,62424,124847
64718,,bmgaweqliu8j,62424,62425,124849
64719,,ac6s_r3qqtqj,62425,62426,124851
64720,,zrtus_ltdmoj,62426,62427,124853
64721,,medmbwgz24yj,62427,62428,124855
64722,,url:http://www.ingentaconnect.com/content/pep/jae/2003/00000217/00000006/art00005,62428,62429,124857
64723,,dbnnn9w0ee0j,62429,62430,124859
64724,,jrgorbsfbrwj,62430,62431,124861
64725,,vvg-0fpzvd0j,62431,62432,124863
64726,,vbe5vcotncij,62432,62433,124865
64727,,9zcoqy2ushkj,62433,62434,124867
64728,,tfwq6anstqmj,62434,62435,124869
64729,,jwpgzxzv9xej,62435,62436,124871
64730,,47nsh5f6ox0j,62436,62437,124873
64731,,rhjrvjxmctcj,62437,62438,124875
64732,,idnpv86ixm0j,62438,62439,124877
64733,,lr6kfmacef8j,62439,62440,124879
64734,,kvdb1wuz-6qj,62440,62441,124881
64735,,yfhh44xutugj,62441,62442,124883
64736,,qcn2_rjpsgyj,62442,62443,124885
64737,,url:http://www.csa.com/partners/viewrecord.php3frequester3dgs26collection3dtrd26recid3d0582871ci,62443,62444,124887
64738,,z1jwy7z0hdej,62444,62445,124889
64739,,rmdds5ecobwj,62445,62446,124891
64740,,mr_ncep3_auj,62446,62447,124893
64741,,url:http://links.jstor.org/sici3fsici3d0146-4949(196323)4253a3253c279253aaanatt253e2.0.co253b2-u,62447,62448,124895
64742,,g-hc4qwyhgyj,62448,62449,124897
64743,,8dsoo_oprfaj,62450,62451,124901
64744,,8orcy1cmsi0j,62451,62452,124903
64745,,hj7s_-dkog0j,62452,62453,124905
64746,,fz0jes5vr5aj,62453,62454,124907
64747,,acx1qmfetwyj,62454,62455,124909
64748,,bconcg_x5csj,62455,62456,124911
64749,,bzxtawo_ljij,62456,62457,124913
64750,,xnb4qyi-a64j,62457,62458,124915
64751,,8wxxgdivnh8j,62458,62459,124917
64752,,0imwwes0umkj,62459,62460,124919
64753,,quk9bayd9vwj,62460,62461,124921
64754,,9clylaimjjgj,62461,62462,124923
64755,,5lbj_buekyij,62462,62463,124925
64756,,9bodwtxof6oj,62463,62464,124927
64757,,lcaeixtgmrqj,62464,62465,124929
64758,,fyfiognes5kj,62465,62466,124931
64759,,cbgwczygyowj,62466,62467,124933
64760,,skox1kpsu0kj,62467,62468,124935
64761,,tmr-hz853x8j,62468,62469,124937
64762,,r_bk6pefqhoj,62469,62470,124939
64763,,7dv6op3ddscj,62470,62471,124941
64764,,yirqrttezsaj,62471,62472,124943
64765,,_z3l8w3gdhaj,62472,62473,124945
64766,,hvgezxn1mvyj,62473,62474,124947
64767,,url:http://www.csa.com/partners/viewrecord.php3frequester3dgs26collection3dtrd26recid3dn9210574ah,62474,62475,124949
64768,,_ejfav3fnxyj,62476,62477,124953
64769,,trqtwgqvfccj,62477,62478,124955
64770,,xsxbniwf9_sj,62478,62479,124957
64771,,wrocio1flgij,62479,62480,124959
64772,,f42wooy-kr0j,62480,62481,124961
64773,,sh_-cwpbciwj,62481,62482,124963
64774,,kpalejcy2owj,62483,62484,124967
64775,,ytwkawyk7hej,62484,62485,124969
64776,,df43axwcnhwj,62485,62486,124971
64777,,yjbxt-l5lu4j,62486,62487,124973
64778,,aa-xia6xs6gj,62487,62488,124975
64779,,53ffyhhbqrij,62489,62490,124979
64780,,6c5usaevhcwj,62490,62491,124981
64781,,a1twduvultkj,62491,62492,124983
64782,,x94fvofjiiuj,62492,62493,124985
64783,,o6ssufspdwuj,62493,62494,124987
64784,,url:http://portal.acm.org/ft_gateway.cfm3fid3d100768526type3dpdf,62494,62495,124989
64785,,kz_b2mmlqjwj,62495,62496,124991
64786,,qaxocqqc5fyj,62496,62497,124993
64787,,6wlmxqgnz3yj,62497,62498,124995
64788,,fyglfdtp4akj,62498,62499,124997
64789,,5nfiu2dhylsj,62499,62500,124999
64790,,ast2d-qjgp0j,62500,62501,125001
64791,,tqg0jmsamoej,62501,62502,125003
64792,,iibaji6rguej,62502,62503,125005
64793,,uwj56vpcdmwj,62503,62504,125007
64794,,bf9f_jvt-dyj,62504,62505,125009
64795,,rcodexcauimj,62505,62506,125011
64796,,47o0kev7nzsj,62506,62507,125013
64797,,ivtrxwkm7doj,62507,62508,125015
64798,,j8xkokgf3sej,62508,62509,125017
64799,,_njbva2m_y8j,62509,62510,125019
64800,,kzpnkl60zeej,62510,62511,125021
64801,,6ks-ii0fy3oj,62511,62512,125023
64802,,go1ib3yflfoj,62512,62513,125025
64803,,mi4eenx5nl0j,62513,62514,125027
64804,,2lnlc05rdkej,62514,62515,125029
64805,,q9rkeshdmvuj,62515,62516,125031
64806,,rvksdcyzb8cj,62516,62517,125033
64807,,kgctqtwnuhsj,62517,62518,125035
64808,,1z7fdolnbcsj,62518,62519,125037
64809,,sc0jk0gbvqej,62519,62520,125039
64810,,url:http://www.csa.com/partners/viewrecord.php3frequester3dgs26collection3dtrd26recid3dn9210578ah,62520,62521,125041
64811,,oktgvfaauu4j,62521,62522,125043
64812,,hzsakv6qhs4j,62522,62523,125045
64813,,keu1p0nkfssj,62523,62524,125047
64814,,spldxzhama4j,62524,62525,125049
64815,,,62525,62526,125051
64816,,ufmkheyixjyj,62526,62527,125053
64817,,asiksgsf6csj,62527,62528,125055
64818,,k3pyxufk6wgj,62528,62529,125057
64819,,oi6eeufkr_0j,62529,62530,125059
64820,,pkyt-iu9msmj,62530,62531,125061
64821,,wp6-ypnvjf8j,62531,62532,125063
64822,,ppjsikiov9wj,62532,62533,125065
64823,,dzzxzr0ssfwj,62533,62534,125067
64824,,p3nnkm1o1xoj,62534,62535,125069
64825,,zg-ukxjf8iaj,62535,62536,125071
64826,,lhoqhoovwb8j,62536,62537,125073
64827,,w8cdypfryduj,62537,62538,125075
64828,,bfn8tdfro_wj,62538,62539,125077
64829,,4w_6_ilyhikj,62539,62540,125079
64830,,g64olbm1oqwj,62540,62541,125081
64831,,edpvbshebxgj,62541,62542,125083
64832,,bhpprnnbrawj,62542,62543,125085
64833,,cqg-ca9kh3sj,62543,62544,125087
64834,,ag9lupo9m-qj,62544,62545,125089
64835,,tfzra-h3d0sj,62545,62546,125091
64836,,otyrc8wtccmj,62546,62547,125093
64837,,h5xvg9ommzcj,62547,62548,125095
64838,,yeuk8wejclkj,62548,62549,125097
64839,,vh0dckfglfyj,62549,62550,125099
64840,,rya2xgf2h0cj,62550,62551,125101
64841,,hppjqpcztecj,62551,62552,125103
64842,,od81g1krekej,62552,62553,125105
64843,,ul2uilip4rgj,62553,62554,125107
64844,,mczqs2cqgtcj,62554,62555,125109
64845,,i802nzzcog8j,62555,62556,125111
64846,,url:http://www.springerlink.com/index/9bcxdma3fkbrt1u0.pdf,62556,62557,125113
64847,,rjkirvjv2b0j,62557,62558,125115
64848,,fueig5h8lpij,62559,62560,125119
64849,,tn0uwh8yxmej,62560,62561,125121
64850,,m8eh286-d0wj,62561,62562,125123
64851,,php0wif4sa8j,62562,62563,125125
64852,,wzcwnmp2pdqj,62563,62564,125127
64853,,url:http://journals.iucr.org/c/issues/1996/11/00/ka1196/ka1196.pdf,62564,62565,125129
64854,,ujhpk87lem8j,62565,62566,125131
64855,,ybiydgoqsrwj,62566,62567,125133
64856,,teh3e0ddkocj,62567,62568,125135
64857,,keadm4yd_qmj,62568,62569,125137
64858,,oq1oftqdoumj,62569,62570,125139
64859,,lzxtyg2n5wkj,62570,62571,125141
64860,,zlczxmrpn00j,62571,62572,125143
64861,,ec1zvztp6fgj,62572,62573,125145
64862,,lsdrkyeisgaj,62573,62574,125147
64863,,pmdzjs-kv1qj,62574,62575,125149
64864,,fec4ackbzo8j,62575,62576,125151
64865,,jqiaabc6zuuj,62576,62577,125153
64866,,,62577,62578,125155
64867,,oboj174awymj,62578,62579,125157
64868,,,62579,62580,125159
64869,,url:http://www.csa.com/partners/viewrecord.php3frequester3dgs26collection3dtrd26recid3dn9210554ah,62580,62581,125161
64870,,_3mif3mhcayj,62582,62583,125165
64871,,gr2nrtbhk10j,62583,62584,125167
64872,,wgiksxzp_4ij,62584,62585,125169
64873,,sqekeg7c4rqj,62585,62586,125171
64874,,udoc2ei-fkaj,62586,62587,125173
64875,,icx1t8u5y-gj,62587,62588,125175
64876,,oxgmjb9en7wj,62588,62589,125177
64877,,ujfa0tesab8j,62589,62590,125179
64878,,t8kdvglc17wj,62590,62591,125181
64879,,5d-czlu2aaij,62591,62592,125183
64880,,v_gdfhfq3cmj,62592,62593,125185
64881,,ofxiaudlszoj,62593,62594,125187
64882,,l-fqrmwjubkj,62594,62595,125189
64883,,95m-1gyvz5gj,62595,62596,125191
64884,,dgwfd8scuqej,62596,62597,125193
64885,,nbbnohmod78j,62597,62598,125195
64886,,rl1og_pozyqj,62598,62599,125197
64887,,chmnvju9v5sj,62599,62600,125199
64888,,trbjeqzcthwj,62600,62601,125201
64889,,fodsvrkhgrcj,62601,62602,125203
64890,,url:http://portal.acm.org/citation.cfm3fid3d144111.144127,62602,62603,125205
64891,,cds1bhvz46wj,62603,62604,125207
64892,,zkefe17zqxsj,62604,62605,125209
64893,,3zygvj6vawuj,62605,62606,125211
64894,,pk-8z28f5oaj,62606,62607,125213
64895,,fs5bamvvl3ej,62607,62608,125215
64896,,wqxgynfikhqj,62608,62609,125217
64897,,oxklbe2euyej,62609,62610,125219
64898,,ji5sfzuu_sqj,62610,62611,125221
64899,,bccko5c1zboj,62611,62612,125223
64900,,smzehdq3zbmj,62612,62613,125225
64901,,euwr8kldjlcj,62613,62614,125227
64902,,pzqmik7p4gmj,62615,62616,125231
64903,,3doggirjekwj,62616,62617,125233
64904,,zdyexsvws20j,62618,62619,125237
64905,,0hv_gvpyqbuj,62619,62620,125239
64906,,iqkur12s6jkj,62620,62621,125241
64907,,cscphrbmjpyj,62621,62622,125243
64908,,wo0t4_j6ovej,62622,62623,125245
64909,,hc_vcn78-joj,62623,62624,125247
64910,,p9uahvbitfwj,62624,62625,125249
64911,,pvrs9p3fxhej,62625,62626,125251
64912,,qekc_71-69gj,62626,62627,125253
64913,,url:http://www.csa.com/partners/viewrecord.php3frequester3dgs26collection3dtrd26recid3d0608318ci,62627,62628,125255
64914,,fqopzmvupbkj,62628,62629,125257
64915,,grxgxisj0d0j,62629,62630,125259
64916,,ne_2swce8yij,62630,62631,125261
64917,,ayq8dxt_tlij,62631,62632,125263
64918,,dlwtiveczluj,62632,62633,125265
64919,,mofupilcswuj,62633,62634,125267
64920,,b07tiwqzspmj,62634,62635,125269
64921,,aklsxy2vbj8j,62635,62636,125271
64922,,u659vibmvpaj,62636,62637,125273
64923,,1vyxgqssdauj,62637,62638,125275
64924,,m4nuym5d258j,62638,62639,125277
64925,,z2xgaw3ocmqj,62639,62640,125279
64926,,3zgnqsfwkbij,62640,62641,125281
64927,,v1dwpxxltd4j,62641,62642,125283
64928,,lvn9le3h9qgj,62642,62643,125285
64929,,286rpzlmymsj,62643,62644,125287
64930,,e80q-mbuducj,62644,62645,125289
64931,,hsveyrrcdz8j,62645,62646,125291
64932,,nhq3vj7li88j,62646,62647,125293
64933,,bzwhppfvn6kj,62647,62648,125295
64934,,2lhcyl4qjogj,62648,62649,125297
64935,,m82tn77ufjmj,62649,62650,125299
64936,,zk7fg3ts3wgj,62650,62651,125301
64937,,btxwahdbe_yj,62651,62652,125303
64938,,byofqmz8pkwj,62652,62653,125305
64939,,,62653,62654,125307
64940,,url:http://doi.wiley.com/10.1002/tl.100,62654,62655,125309
64941,,zsrhh23rduij,62655,62656,125311
64942,,rugqyta8pruj,62656,62657,125313
64943,,1xjk5bweve8j,62657,62658,125315
64944,,l-vts8zictuj,62658,62659,125317
64945,,9cdtw8dqv5ej,62659,62660,125319
64946,,bq5gf-gv1qaj,62660,62661,125321
64947,,e60hjn21zo0j,62661,62662,125323
64948,,wlsmd2h-lpmj,62662,62663,125325
64949,,url:http://ieeexplore.ieee.org/xpl/abs_free.jsp3farnumber3d1269671,62663,62664,125327
64950,,bow7vgn3sicj,62664,62665,125329
64951,,mticdbta36mj,62665,62666,125331
64952,,url:http://portal.acm.org/ft_gateway.cfm3fid3d100768226type3dpdf,62666,62667,125333
64953,,lmzxpfdofaej,62667,62668,125335
64954,,jnmqfkmpws8j,62668,62669,125337
64955,,zksievq8lpwj,62669,62670,125339
64956,,pxyyms_syfej,62670,62671,125341
64957,,49zs_9rrzhmj,62671,62672,125343
64958,,r-qvxrcuy3cj,62672,62673,125345
64959,,jqnuppznjrmj,62673,62674,125347
64960,,3zct6qkqmkqj,62674,62675,125349
64961,,k6dxuclxop0j,62676,62677,125353
64962,,a4ejfrvxaz8j,62677,62678,125355
64963,,f0obb0ijkicj,62678,62679,125357
64964,,ihgtfd5ygquj,62679,62680,125359
64965,,ymf22v7duicj,62680,62681,125361
64966,,6dawuhykqfuj,62681,62682,125363
64967,,sadofd9sdmwj,62682,62683,125365
64968,,4887fnmtr0ej,62683,62684,125367
64969,,xfzw0mbtmwoj,62684,62685,125369
64970,,lohkvbk3x4yj,62685,62686,125371
64971,,fo_-ucvyzhgj,62686,62687,125373
64972,,xyeaqgwggicj,62687,62688,125375
64973,,zglhmg80ri8j,62688,62689,125377
64974,,ylbfaqsw_8oj,62689,62690,125379
64975,,fhk2advaz0oj,62690,62691,125381
64976,,url:http://pubs.acs.org/cgi-bin/abstract.cgi/achre4/2005/38/i06/abs/ar0401000.html,62691,62692,125383
64977,,tdvnyae6cqej,62692,62693,125385
64978,,gmegvyaur6wj,62693,62694,125387
64979,,fp1fru_zpv4j,62694,62695,125389
64980,,i6npiqeclssj,62695,62696,125391
64981,,kjteyicv5dkj,62696,62697,125393
64982,,njiywavp_7aj,62697,62698,125395
64983,,url:http://portal.acm.org/citation.cfm3fid3d277951,62698,62699,125397
64984,,mxx8nqfktmej,62699,62700,125399
64985,,icaxicp7df8j,62700,62701,125401
64986,,ajfwlwzgyrcj,62701,62702,125403
64987,,vd-tjygjp04j,62702,62703,125405
64988,,url:http://www.springerlink.com/index/xtljx0531206m556.pdf,62703,62704,125407
64989,,3fhipioudqej,62704,62705,125409
64990,,xlwrsj_-ldkj,62705,62706,125411
64991,,1ashtvnopnoj,62706,62707,125413
64992,,moh6gzaulvkj,62707,62708,125415
64993,,o6pmdc9qlsaj,62708,62709,125417
64994,,url:http://portal.acm.org/ft_gateway.cfm3fid3d110136826type3dpdf,62709,62710,125419
64995,,ca738ldkymij,62710,62711,125421
64996,,fl5fcotq9kij,62711,62712,125423
64997,,0uh-bk_8ka0j,62712,62713,125425
64998,,m8avrxqq1bcj,62713,62714,125427
64999,,wyr0w8cqjygj,62714,62715,125429
65000,,url:http://portal.acm.org/citation.cfm3fid3d171926.171994,62715,62716,125431
65001,,nlwv73nt_twj,62716,62717,125433
65002,,tyiejip7d68j,62717,62718,125435
65003,,kw4hucyf8eqj,62718,62719,125437
65004,,2akcmc-cdioj,62719,62720,125439
65005,,ufvuucgik5wj,62720,62721,125441
65006,,,62721,62722,125443
65007,,rviftjustcaj,62722,62723,125445
65008,,g6joet7hnygj,62723,62724,125447
65009,,q_uc_dkdj1wj,62724,62725,125449
65010,,9njlsnalxuuj,62725,62726,125451
65011,,3s8thsvzrboj,62727,62728,125455
65012,,hbsaelfdgmwj,62728,62729,125457
65013,,5pocf_ifzv8j,62729,62730,125459
65014,,2_vg_vukhh8j,62730,62731,125461
65015,,ngkhzi8jtf4j,62731,62732,125463
65016,,ph38ifzxmloj,62732,62733,125465
65017,,og80nygrvs0j,62733,62734,125467
65018,,atlyqekulfoj,62735,62736,125471
65019,,uuvky7vnequj,62736,62737,125473
65020,,6l_rq9wumdcj,62737,62738,125475
65021,,qe6f_iu-siyj,62738,62739,125477
65022,,thlh2cnp5mqj,62739,62740,125479
65023,,bbm9jjvolhkj,62740,62741,125481
65024,,3kbcxl1w2rkj,62741,62742,125483
65025,,wq1_kiw9xrij,62742,62743,125485
65026,,eivp1pex4wqj,62743,62744,125487
65027,,lsjcfcwbxlij,62744,62745,125489
65028,,fx8cf3-c5ngj,62745,62746,125491
65029,,4safqssyvx0j,62746,62747,125493
65030,,8dd4lty-du0j,62747,62748,125495
65031,,cy2ioedq-z0j,62748,62749,125497
65032,,6qgeiagvi5oj,62749,62750,125499
65033,,kc7y8vjkszcj,62750,62751,125501
65034,,tphu8kxyip8j,62751,62752,125503
65035,,in5rglkh2-wj,62752,62753,125505
65036,,8uk_kjqlynsj,62753,62754,125507
65037,,adxhfbrgvzij,62754,62755,125509
65038,,jgoz72znygwj,62755,62756,125511
65039,,sv1uqt2zpzuj,62756,62757,125513
65040,,allavbydr-ej,62757,62758,125515
65041,,zls1lbphuw0j,62758,62759,125517
65042,,ofonn38m9oej,62759,62760,125519
65043,,pl6tuhztrkcj,62760,62761,125521
65044,,pfjiilalzmuj,62761,62762,125523
65045,,gvlupp_ifcoj,62762,62763,125525
65046,,lgj8c2v5opgj,62763,62764,125527
65047,,85mi-lovbbej,62764,62765,125529
65048,,5p9mmror9i4j,62765,62766,125531
65049,,0rsgkmmuywyj,62766,62767,125533
65050,,,62767,62768,125535
65051,,z3gudevh_4sj,62768,62769,125537
65052,,ikgn_rqii0qj,62769,62770,125539
65053,,5qxq4dbxinoj,62770,62771,125541
65054,,ncv4y_av23ej,62771,62772,125543
65055,,url:http://adsabs.harvard.edu/abs/1977phdt........43r,62772,62773,125545
65056,,8sk2_jtr1nij,62773,62774,125547
65057,,n5hm6sbjyw4j,62774,62775,125549
65058,,9xpmssqzt8gj,62775,62776,125551
65059,,6m9iakpf_m0j,62776,62777,125553
65060,,6b9xhbt7eqkj,62777,62778,125555
65061,,wcgpkandguij,62778,62779,125557
65062,,l22gpxg_kbwj,62779,62780,125559
65063,,url:http://portal.acm.org/citation.cfm3fid3d509252.509254,62780,62781,125561
65064,,wyml4lyyp2qj,62781,62782,125563
65065,,azdxz6yyqlsj,62782,62783,125565
65066,,fplccivvudoj,62783,62784,125567
65067,,cq0jtfo7dsyj,62784,62785,125569
65068,,3rmcofzbfcgj,62785,62786,125571
65069,,tosmdcd1fhuj,62786,62787,125573
65070,,url:http://portal.acm.org/citation.cfm3fid3d592199.592405,62787,62788,125575
65071,,amvcovwqinej,62788,62789,125577
65072,,uofvsqipvb4j,62789,62790,125579
65073,,erqqwpmwu2sj,62790,62791,125581
65074,,cgm_kkcj1n0j,62791,62792,125583
65075,,wa9ldvvndeij,62792,62793,125585
65076,,vvko1ayfbeaj,62793,62794,125587
65077,,tb8exjkprbgj,62794,62795,125589
65078,,ikwhaue8hnkj,62795,62796,125591
65079,,xoq7d3o28d0j,62796,62797,125593
65080,,znv5nsbuggqj,62797,62798,125595
65081,,mkz1bbmp6hgj,62798,62799,125597
65082,,jmku9rpct9sj,62799,62800,125599
65083,,iiaxqihbnnij,62800,62801,125601
65084,,syxm_6fwg_kj,62801,62802,125603
65085,,go_ztbf3lfqj,62802,62803,125605
65086,,url:http://portal.acm.org/ft_gateway.cfm3fid3d110751026type3dpdf,62803,62804,125607
65087,,ljx2qgq9idaj,62804,62805,125609
65088,,zua11hyl6xqj,62805,62806,125611
65089,,flogtkucfrcj,62806,62807,125613
65090,,0lxeazqypwuj,62808,62809,125617
65091,,wc5sfkahms8j,62809,62810,125619
65092,,mga48r87ijwj,62810,62811,125621
65093,,url:http://www.csa.com/partners/viewrecord.php3frequester3dgs26collection3dtrd26recid3d2005092515520ci,62811,62812,125623
65094,,nsg0fe72yzmj,62812,62813,125625
65095,,1jllgyw8cdaj,62813,62814,125627
65096,,icap8vlgyg8j,62814,62815,125629
65097,,d5iiootragaj,62815,62816,125631
65098,,qcu4r4fb4hcj,62816,62817,125633
65099,,1hpcjilbfgyj,62817,62818,125635
65100,,ymztqb7phtkj,62818,62819,125637
65101,,zco74flfdpsj,62820,62821,125641
65102,,lxzzpsdzrnwj,62821,62822,125643
65103,,4apwra3quu0j,62822,62823,125645
65104,,ev8frzmxsyyj,62823,62824,125647
65105,,2kakfgatbgaj,62824,62825,125649
65106,,rcy9m4uqpxej,62825,62826,125651
65107,,vo9umx5t6asj,62826,62827,125653
65108,,dqmvhlp_32aj,62827,62828,125655
65109,,8cogifevwnqj,62828,62829,125657
65110,,7l-fjdvabzej,62829,62830,125659
65111,,2g8ywp_eqsuj,62830,62831,125661
65112,,lg75ulpupt4j,62831,62832,125663
65113,,3yjwlmasvi0j,62832,62833,125665
65114,,url:http://portal.acm.org/ft_gateway.cfm3fid3d110122026type3dpdf,62833,62834,125667
65115,,7uuthkhglnsj,62835,62836,125671
65116,,fzlhctjqbhej,62836,62837,125673
65117,,l1_u8ygj3dmj,62837,62838,125675
65118,,injyytfzn50j,62838,62839,125677
65119,,etqnvmzoxzuj,62839,62840,125679
65120,,fbjmr2gkobaj,62840,62841,125681
65121,,vixrcnmbuqkj,62841,62842,125683
65122,,ich-kts_91qj,62842,62843,125685
65123,,qgel2v0eilej,62843,62844,125687
65124,,knhlhpd5stmj,62845,62846,125691
65125,,08lvkgu5uc8j,62846,62847,125693
65126,,izydjp-mt0ij,62847,62848,125695
65127,,3okfjvtfscyj,62848,62849,125697
65128,,bwqcvdfsvz0j,62849,62850,125699
65129,,4ohw4va2drsj,62850,62851,125701
65130,,ip6tmnia1y8j,62851,62852,125703
65131,,arqmkdnwnkmj,62852,62853,125705
65132,,zktmorlkcakj,62853,62854,125707
65133,,tsag-mwf0nmj,62854,62855,125709
65134,,jdlqioxfjxcj,62855,62856,125711
65135,,peemibc5zzcj,62856,62857,125713
65136,,gijckjc-nv4j,62857,62858,125715
65137,,0kgae34eylkj,62858,62859,125717
65138,,39w3k5lkfbgj,62859,62860,125719
65139,,tg36vtc7j_oj,62860,62861,125721
65140,,ppqb6vechbaj,62861,62862,125723
65141,,cdlwsrkx5vuj,62862,62863,125725
65142,,sw3p4ja-3awj,62863,62864,125727
65143,,szbf6voygcej,62864,62865,125729
65144,,unhydkwrs6sj,62865,62866,125731
65145,,_z_kqsngcxoj,62866,62867,125733
65146,,bulcare_64uj,62867,62868,125735
65147,,vk0b_fa351sj,62868,62869,125737
65148,,zrbpl3rbyaoj,62869,62870,125739
65149,,ghn_to32qe4j,62871,62872,125743
65150,,rnhjapnsvx8j,62872,62873,125745
65151,,i0mx5huihhcj,62873,62874,125747
65152,,ot2uw9vnp6gj,62875,62876,125751
65153,,qbasd1y5rsqj,62876,62877,125753
65154,,7arvzxtqc9mj,62877,62878,125755
65155,,ahbzu45s6muj,62878,62879,125757
65156,,vmuqxo5swmuj,62879,62880,125759
65157,,6h-_suxakp8j,62880,62881,125761
65158,,lg7yinkod6ij,62881,62882,125763
65159,,j7xbkrc16y8j,62882,62883,125765
65160,,wi6h1lcmamaj,62883,62884,125767
65161,,pnmhwby2dsqj,62884,62885,125769
65162,,q6z2sl5lb2mj,62885,62886,125771
65163,,id1te58yjluj,62886,62887,125773
65164,,lhi_v8gvrwgj,62887,62888,125775
65165,,waiajtdgaaqj,62888,62889,125777
65166,,,62889,62890,125779
65167,,gloiijqdymgj,62890,62891,125781
65168,,b8q_mkx4hi4j,62891,62892,125783
65169,,q3cj0uik654j,62892,62893,125785
65170,,frh9vdy-p5cj,62893,62894,125787
65171,,kyrf0xdojqcj,62894,62895,125789
65172,,na69d6cehbgj,62895,62896,125791
65173,,nzxvugjhmncj,62896,62897,125793
65174,,n1pcjxbeg-oj,62897,62898,125795
65175,,oercb_lzfecj,62899,62900,125799
65176,,i6rlgaquebmj,62900,62901,125801
65177,,hqmavcazmpsj,62901,62902,125803
65178,,url:http://portal.acm.org/ft_gateway.cfm3fid3d105815426type3dpdf,62902,62903,125805
65179,,xt4l9lbttcuj,62903,62904,125807
65180,,apr-klbhm1gj,62904,62905,125809
65181,,2i65vgufa3uj,62905,62906,125811
65182,,zif7zgvmlwaj,62906,62907,125813
65183,,drfwubfuuygj,62907,62908,125815
65184,,gajkgnrdmqmj,62908,62909,125817
65185,,yniboichufij,62910,62911,125821
65186,,d0srn24jmbuj,62911,62912,125823
65187,,url:http://www.csa.com/partners/viewrecord.php3frequester3dgs26collection3dtrd26recid3d0990385ci,62912,62913,125825
65188,,hqhdsqzvuqkj,62913,62914,125827
65189,,,62914,62915,125829
65190,,url:http://portal.acm.org/ft_gateway.cfm3fid3d50734526type3dpdf26dl3dguide26dl3dacm26cfid3d1111111126cftoken3d2222222,62915,62916,125831
65191,,url:http://portal.acm.org/ft_gateway.cfm3fid3d110133226type3dpdf,62916,62917,125833
65192,,0gbrghiqruuj,62917,62918,125835
65193,,ggtcbcx5fksj,62918,62919,125837
65194,,tn15leytle4j,62919,62920,125839
65195,,3ogdjmujkicj,62920,62921,125841
65196,,knuultxnirmj,62921,62922,125843
65197,,hsl7wlt7bzqj,62922,62923,125845
65198,,rkvemrnzlmwj,62923,62924,125847
65199,,q5gacuk-2awj,62924,62925,125849
65200,,,62925,62926,125851
65201,,3tj8kvhygxej,62926,62927,125853
65202,,2ppdwgf69zoj,62927,62928,125855
65203,,kkw473k7agsj,62928,62929,125857
65204,,_qmqv2gt8eqj,62929,62930,125859
65205,,9o2u8bhmwhcj,62930,62931,125861
65206,,bfdznz7ylx8j,62931,62932,125863
65207,,fw1sdznml2yj,62932,62933,125865
65208,,jwyu2fholpwj,62933,62934,125867
65209,,eajfyitmjnij,62934,62935,125869
65210,,tygksm7oaycj,62935,62936,125871
65211,,3vw2ugsgsqsj,62936,62937,125873
65212,,cyngy6mg8mgj,62937,62938,125875
65213,,tewt7e2ntbij,62938,62939,125877
65214,,zzg3ki_fyyij,62939,62940,125879
65215,,h8apxv0ytjkj,62941,62942,125883
65216,,wodbd94boigj,62942,62943,125885
65217,,url:http://portal.acm.org/ft_gateway.cfm3fid3d110116526type3dpdf,62943,62944,125887
65218,,08hoyze6yvsj,62944,62945,125889
65219,,jzeoiwtwdgwj,62945,62946,125891
65220,,6gmq2hptzy8j,62946,62947,125893
65221,,ffkxkk8hkt0j,62947,62948,125895
65222,,x35cpeuujxej,62948,62949,125897
65223,,dwgskwpyzo4j,62949,62950,125899
65224,,1dgngv8apryj,62950,62951,125901
65225,,nr2l2qnqtysj,62951,62952,125903
65226,,,62952,62953,125905
65227,,nvjpmgiqbfcj,62953,62954,125907
65228,,yo-plbm3lcoj,62954,62955,125909
65229,,3s4pcntge1qj,62955,62956,125911
65230,,eb7vw_tim1cj,62956,62957,125913
65231,,2myugbtupfgj,62957,62958,125915
65232,,8-6ea_5q-ucj,62958,62959,125917
65233,,4xvgnsskyn8j,62959,62960,125919
65234,,nv7d4ldttrwj,62960,62961,125921
65235,,sqy0b6jpamwj,62961,62962,125923
65236,,ub8wpbduavoj,62962,62963,125925
65237,,url:http://www.csa.com/partners/viewrecord.php3frequester3dgs26collection3denv26recid3d8913268,62963,62964,125927
65238,,ixesd-frswmj,62964,62965,125929
65239,,corgw2nhnnaj,62965,62966,125931
65240,,ghpiuphdcqkj,62966,62967,125933
65241,,wma2b9ylhusj,62967,62968,125935
65242,,1j2-n8adgqyj,62968,62969,125937
65243,,e1rsp-oxbx8j,62969,62970,125939
65244,,nd0yl_o4n9mj,62970,62971,125941
65245,,pceydo5iyduj,62971,62972,125943
65246,,d6_iatkfdeaj,62972,62973,125945
65247,,ynpbkjnvbeyj,62973,62974,125947
65248,,url:http://www.csa.com/partners/viewrecord.php3frequester3dgs26collection3dtrd26recid3d017204530166xai,62974,62975,125949
65249,,anxrt7gcrscj,62975,62976,125951
65250,,syy7cp023g4j,62976,62977,125953
65251,,a_ddnidhfamj,62977,62978,125955
65252,,ltzvv1z8mzij,62978,62979,125957
65253,,s1royluzyw8j,62979,62980,125959
65254,,kwgdgny0djmj,62980,62981,125961
65255,,6hz5of_s864j,62981,62982,125963
65256,,yqytpx-8k-uj,62983,62984,125967
65257,,rsay8g_ywzaj,62984,62985,125969
65258,,p9escxkhvbij,62985,62986,125971
65259,,url:http://portal.acm.org/citation.cfm3fid3d87252.88108,62986,62987,125973
65260,,qjkvyhhu_2kj,62987,62988,125975
65261,,zsboddat0f0j,62988,62989,125977
65262,,ao9vr76engyj,62989,62990,125979
65263,,ywvxi-rufryj,62990,62991,125981
65264,,4otaiccx3pwj,62991,62992,125983
65265,,vi_6kmmnmbmj,62992,62993,125985
65266,,lruvbcpwvhkj,62993,62994,125987
65267,,vhjatmjkuu8j,62994,62995,125989
65268,,hwczudl_2fcj,62995,62996,125991
65269,,d6zlbf7uvvij,62996,62997,125993
65270,,357h0eu7ejmj,62997,62998,125995
65271,,iy5f2vo9diwj,62998,62999,125997
65272,,r_m2msdxxomj,63000,63001,126001
65273,,8koz2sbabaoj,63001,63002,126003
65274,,xntlnks_h4ij,63002,63003,126005
65275,,gnowh2lhcn0j,63003,63004,126007
65276,,dxexokazc-sj,63004,63005,126009
65277,,2uu5qocvermj,63005,63006,126011
65278,,tyozl0vjz18j,63006,63007,126013
65279,,mglwokulmamj,63007,63008,126015
65280,,hyioe1eacxmj,63008,63009,126017
65281,,kh6dxxgkglqj,63010,63011,126021
65282,,f4e1tnbqugkj,63011,63012,126023
65283,,url:http://adsabs.harvard.edu/abs/1976scom.nasa..182l,63012,63013,126025
65284,,url:http://portal.acm.org/citation.cfm3fid3d187455,63013,63014,126027
65285,,fg4od4q36vqj,63014,63015,126029
65286,,pzcszo4vrjuj,63016,63017,126033
65287,,bym5iwgcukgj,63017,63018,126035
65288,,eritlh0k0zej,63018,63019,126037
65289,,j6i08uueyicj,63019,63020,126039
65290,,rlr4uzxpb3qj,63020,63021,126041
65291,,wkrtiplhypqj,63021,63022,126043
65292,,u6awxu1dur8j,63022,63023,126045
65293,,wmeghfogdxqj,63023,63024,126047
65294,,2kgmndceougj,63024,63025,126049
65295,,9txs2mla2dmj,63025,63026,126051
65296,,s_d1iqk5ovgj,63026,63027,126053
65297,,7qgsc35hjfaj,63027,63028,126055
65298,,qkzbalvdpcuj,63028,63029,126057
65299,,gyelzxhijx8j,63029,63030,126059
65300,,jsqtfovtpyoj,63030,63031,126061
65301,,r9w9flfpvhsj,63031,63032,126063
65302,,haoeyfml-4aj,63032,63033,126065
65303,,4xrkpj73zwoj,63033,63034,126067
65304,,age_mxfqeicj,63034,63035,126069
65305,,url:http://portal.acm.org/ft_gateway.cfm3fid3d24589126type3dpdf26dl3dguide26dl3dacm26cfid3d1111111126cftoken3d2222222,63035,63036,126071
65306,,3qxzu8saoxgj,63036,63037,126073
65307,,velct8hbmi4j,63037,63038,126075
65308,,h_omj8y8fmmj,63038,63039,126077
65309,,dgp79xfvuouj,63039,63040,126079
65310,,cc3ygxsel24j,63040,63041,126081
65311,,lvqp0dgimx8j,63041,63042,126083
65312,,oplzgjjzh9sj,63042,63043,126085
65313,,8bkwmmla5pej,63043,63044,126087
65314,,_r5-awiu0nwj,63044,63045,126089
65315,,72v2y1m70faj,63045,63046,126091
65316,,url:http://www.csa.com/partners/viewrecord.php3frequester3dgs26collection3dtrd26recid3d0662111ci26recid3d0662111ea,63046,63047,126093
65317,,y1z6mywyr_yj,63047,63048,126095
65318,,joxzlkz6h2qj,63048,63049,126097
65319,,lphltardi9yj,63049,63050,126099
65320,,xe_9efyh0bej,63050,63051,126101
65321,,p5bukzyrhj8j,63051,63052,126103
65322,,mwegotkglguj,63052,63053,126105
65323,,whfts1todr4j,63053,63054,126107
65324,,k6vccofj3puj,63054,63055,126109
65325,,url:http://www.csa.com/partners/viewrecord.php3frequester3dgs26collection3dtrd26recid3d0878769ci,63055,63056,126111
65326,,url:http://portal.acm.org/ft_gateway.cfm3fid3d108363226type3dpdf,63056,63057,126113
65327,,qw4ckujlogij,63057,63058,126115
65328,,1fnpk7eo3oqj,63058,63059,126117
65329,,zogpoesxygyj,63059,63060,126119
65330,,nm9dcxniznyj,63060,63061,126121
65331,,otzo97x1knsj,63061,63062,126123
65332,,mwcakgpn5qgj,63062,63063,126125
65333,,lmbeqtmrascj,63064,63065,126129
65334,,gqehj3-ukjij,63065,63066,126131
65335,,4zvpkx9nstwj,63066,63067,126133
65336,,vnndv0xmbvqj,63067,63068,126135
65337,,url:http://adsabs.harvard.edu/abs/1991emc..symps....g,63068,63069,126137
65338,,4gzkkswgohyj,63069,63070,126139
65339,,kmrvj3tawm8j,63070,63071,126141
65340,,fqgiegbi1_sj,63071,63072,126143
65341,,83jzzgkzlgwj,63072,63073,126145
65342,,jb2qlcxurt8j,63073,63074,126147
65343,,vsn5zy_dfgaj,63074,63075,126149
65344,,jpgvvjqfrkkj,63075,63076,126151
65345,,h4azx4x1ltcj,63076,63077,126153
65346,,mz9mbsz-3q0j,63077,63078,126155
65347,,jpajy-miq5qj,63078,63079,126157
65348,,dsfamnjtmfgj,63079,63080,126159
65349,,npaaksmflpcj,63080,63081,126161
65350,,gmrc4ks5s6uj,63081,63082,126163
65351,,url:http://portal.acm.org/ft_gateway.cfm3fid3d106621226type3dpdf,63082,63083,126165
65352,,621gi71gy64j,63083,63084,126167
65353,,yhfwhxxlc_yj,63084,63085,126169
65354,,xv9eu0qbytaj,63085,63086,126171
65355,,url:http://portal.acm.org/ft_gateway.cfm3fid3d98860326type3dpdf,63086,63087,126173
65356,,ckm9xhi_8k4j,63087,63088,126175
65357,,bb0y6zq-xrkj,63088,63089,126177
65358,,mzpfmeprefij,63089,63090,126179
65359,,u31rrwe6nwej,63090,63091,126181
65360,,4njsyqjrdpwj,63091,63092,126183
65361,,snvsqxxyvhkj,63092,63093,126185
65362,,uwguzacvxdqj,63093,63094,126187
65363,,sdejqbzi6v4j,63094,63095,126189
65364,,url:http://www.ncbi.nlm.nih.gov/entrez/query.fcgi3fcmd3dretrieve26db3dpubmed26list_uids3d74841726dopt3dcitation,63095,63096,126191
65365,,url:http://www.ncbi.nlm.nih.gov/entrez/query.fcgi3fcmd3dretrieve26db3dpubmed26list_uids3d64130126dopt3dcitation,63096,63097,126193
65366,,8qxqypkxpe0j,63097,63098,126195
65367,,ma5qppj_bmej,63098,63099,126197
65368,,alaapjszpb8j,63099,63100,126199
65369,,6gu9pokcjvej,63100,63101,126201
65370,,daftypsnp5qj,63101,63102,126203
65371,,9c5kjt4esacj,63102,63103,126205
65372,,url:http://adsabs.harvard.edu/abs/1980ucsb.rept.....b,63103,63104,126207
65373,,y1dmbjvbbvyj,63104,63105,126209
65374,,szg9m1b3h28j,63105,63106,126211
65375,,duplleayhvaj,63106,63107,126213
65376,,htyva_fv3pqj,63107,63108,126215
65377,,u5sukc5w5waj,63108,63109,126217
65378,,m3vqhvo5mfyj,63109,63110,126219
65379,,ilefq8advbcj,63110,63111,126221
65380,,7oixch2unzkj,63111,63112,126223
65381,,eultgkbg3paj,63112,63113,126225
65382,,xmx29f-egrij,63113,63114,126227
65383,,z7kvf1m41ryj,63114,63115,126229
65384,,7ozepzp1nxej,63115,63116,126231
65385,,3sxzbaglnmgj,63116,63117,126233
65386,,avodcufnovsj,63119,63120,126239
65387,,qneotts_inuj,63120,63121,126241
65388,,ymt5a0bb7amj,63121,63122,126243
65389,,aym7t8ndlpqj,63122,63123,126245
65390,,fbbkpqxp8rij,63123,63124,126247
65391,,q3ohrel7ppsj,63124,63125,126249
65392,,awuyrzscbpej,63125,63126,126251
65393,,smmotpemohwj,63126,63127,126253
65394,,pn11njhukd8j,63127,63128,126255
65395,,r3dyhkdvfkoj,63128,63129,126257
65396,,g7ktqnm6xnaj,63129,63130,126259
65397,,9htvnqruiycj,63130,63131,126261
65398,,byacv4fdah8j,63131,63132,126263
65399,,fqllnfzrqfej,63132,63133,126265
65400,,d3g3_kzkjmyj,63133,63134,126267
65401,,sibgv4_wprij,63134,63135,126269
65402,,gem8kn2iusij,63135,63136,126271
65403,,url:http://portal.acm.org/ft_gateway.cfm3fid3d110196226type3dpdf,63136,63137,126273
65404,,0gz2lsbdfg4j,63137,63138,126275
65405,,ybfdepmkwycj,63138,63139,126277
65406,,9woycpj3kamj,63139,63140,126279
65407,,xae8ayog1qyj,63140,63141,126281
65408,,hcfsemq1emmj,63141,63142,126283
65409,,lnf0ldcg16oj,63142,63143,126285
65410,,42agmxq62-cj,63143,63144,126287
65411,,06bv_9sonswj,63144,63145,126289
65412,,svisxcvs8bqj,63145,63146,126291
65413,,1wcwsdlff1oj,63146,63147,126293
65414,,exwe9r79qxej,63147,63148,126295
65415,,rbq8e1hccuij,63148,63149,126297
65416,,6eg_etjjm7ej,63149,63150,126299
65417,,url:http://www.csa.com/partners/viewrecord.php3frequester3dgs26collection3dtrd26recid3dn9210449ah,63150,63151,126301
65418,,6qq_nfnlpmsj,63151,63152,126303
65419,,unqk-rikowkj,63152,63153,126305
65420,,hw8ebrj5vrcj,63153,63154,126307
65421,,b2x2hbsqfvoj,63154,63155,126309
65422,,edwp3rvekokj,63155,63156,126311
65423,,ljpccflrq6aj,63156,63157,126313
65424,,snvtx8t2amaj,63157,63158,126315
65425,,7wqlaagea_uj,63158,63159,126317
65426,,url:http://portal.acm.org/citation.cfm3fid3d197206,63159,63160,126319
65427,,mlrzkjfsyruj,63160,63161,126321
65428,,xdhwllctrn0j,63161,63162,126323
65429,,sbnqbyqf3soj,63162,63163,126325
65430,,url:http://doi.wiley.com/10.1002/he.74,63163,63164,126327
65431,,xnhxjfzazn0j,63164,63165,126329
65432,,bskfyl2aohoj,63165,63166,126331
65433,,ialp-tlpub0j,63166,63167,126333
65434,,hvnimactbnej,63167,63168,126335
65435,,dxb8e4wh4g4j,63168,63169,126337
65436,,wzslrqvprhcj,63169,63170,126339
65437,,5v7hn4rz55wj,63170,63171,126341
65438,,gykt_cbztvaj,63171,63172,126343
65439,,v3fcimu9zbuj,63172,63173,126345
65440,,0cl977p77jkj,63173,63174,126347
65441,,rpesxui5cusj,63174,63175,126349
65442,,zemlqjircgcj,63175,63176,126351
65443,,4iib3ubgubuj,63176,63177,126353
65444,,,63177,63178,126355
65445,,qpverfntt3yj,63178,63179,126357
65446,,baxoqqakzn4j,63179,63180,126359
65447,,bp6qzdxpmqsj,63180,63181,126361
65448,,zpxpz1ymgjyj,63181,63182,126363
65449,,v0hdha3ydnsj,63182,63183,126365
65450,,z6g3raulbd8j,63184,63185,126369
65451,,m82fx3yhq1ej,63185,63186,126371
65452,,3ft-pxzbzouj,63186,63187,126373
65453,,oqdjq7qtvfqj,63187,63188,126375
65454,,gojpaojy4mgj,63188,63189,126377
65455,,y0zjdlxlqcoj,63189,63190,126379
65456,,yhs17p8_bdsj,63190,63191,126381
65457,,rtnl_1ewl-aj,63191,63192,126383
65458,,mzykcjdye-8j,63193,63194,126387
65459,,ybxzuobywc0j,63194,63195,126389
65460,,0gzcaxnwupyj,63195,63196,126391
65461,,t7dvxz0w36uj,63196,63197,126393
65462,,a0j_rb2db44j,63197,63198,126395
65463,,jp9ptmpdogwj,63198,63199,126397
65464,,j6fnhym0hsuj,63199,63200,126399
65465,,eairpskorq4j,63200,63201,126401
65466,,ru4rac6hdcaj,63201,63202,126403
65467,,p3ivc1awjqgj,63203,63204,126407
65468,,mnhhvrbr3suj,63204,63205,126409
65469,,uaecrxrakesj,63205,63206,126411
65470,,u1et7ldjixgj,63206,63207,126413
65471,,io21e2p6awmj,63208,63209,126417
65472,,2dqparhqymej,63209,63210,126419
65473,,kjdoep_zgfcj,63210,63211,126421
65474,,5_babjjyl9wj,63211,63212,126423
65475,,xuf4zu0181mj,63212,63213,126425
65476,,,63213,63214,126427
65477,,re9kktqrluuj,63214,63215,126429
65478,,xk9l_fs8haoj,63215,63216,126431
65479,,7bqpn3gk6x4j,63216,63217,126433
65480,,ybvpqohzxooj,63217,63218,126435
65481,,,63218,63219,126437
65482,,tw16mbi8ahcj,63219,63220,126439
65483,,ktpqj0-_rcmj,63220,63221,126441
65484,,ruj4pldkfq4j,63221,63222,126443
65485,,jqgywovgg-ij,63222,63223,126445
65486,,jmxhaemalrcj,63223,63224,126447
65487,,23g0n_xy1ykj,63224,63225,126449
65488,,yonmaqujkaej,63225,63226,126451
65489,,8xbx2h0s5vij,63226,63227,126453
65490,,url:http://portal.acm.org/ft_gateway.cfm3fid3d110119526type3dpdf,63227,63228,126455
65491,,menygmvra1kj,63228,63229,126457
65492,,ubttkdq5sqej,63229,63230,126459
65493,,gnplqkpvrxsj,63230,63231,126461
65494,,saqzkbdh-pgj,63232,63233,126465
65495,,9y4qajj6olwj,63233,63234,126467
65496,,ur5xziwekoij,63234,63235,126469
65497,,ng7iuwmnc10j,63235,63236,126471
65498,,i_6rwowak_uj,63236,63237,126473
65499,,vvkirgp5tqsj,63237,63238,126475
65500,,jgxx-rlwcx0j,63238,63239,126477
65501,,3vzvp6n7fxkj,63239,63240,126479
65502,,jxa_ir129eoj,63240,63241,126481
65503,,ck3kshnyvf8j,63241,63242,126483
65504,,s8wlaq-lxuuj,63242,63243,126485
65505,,hyq_6_v-cd4j,63243,63244,126487
65506,,uzifieohejmj,63244,63245,126489
65507,,5xijncbxmgej,63246,63247,126493
65508,,kgx5r-entfaj,63247,63248,126495
65509,,jy7qdzc2sfgj,63248,63249,126497
65510,,tefuzn3temyj,63249,63250,126499
65511,,cxetruifbhqj,63250,63251,126501
65512,,i9gb1hdpqvij,63251,63252,126503
65513,,eoukuv02rwej,63252,63253,126505
65514,,00ksbmmai08j,63253,63254,126507
65515,,no7kyp7hbnuj,63254,63255,126509
65516,,trwmbpcag0qj,63255,63256,126511
65517,,hwgdbu5gsegj,63256,63257,126513
65518,,url:http://portal.acm.org/ft_gateway.cfm3fid3d102771026type3dpdf,63257,63258,126515
65519,,clp1g9y3bxcj,63258,63259,126517
65520,,xmgpkkv2bkuj,63260,63261,126521
65521,,5ozanu2gkxoj,63261,63262,126523
65522,,f-hsaildsuej,63262,63263,126525
65523,,k3a5njdz1rcj,63263,63264,126527
65524,,k08dgh6zacyj,63264,63265,126529
65525,,cdbt1_2nfjoj,63265,63266,126531
65526,,do0obblcffmj,63266,63267,126533
65527,,ay6uzm5cda4j,63267,63268,126535
65528,,4lz35sic3b0j,63268,63269,126537
65529,,bvk74oggaaij,63270,63271,126541
65530,,igxiapulqgij,63271,63272,126543
65531,,x5gsonyn--4j,63272,63273,126545
65532,,url:http://www.csa.com/partners/viewrecord.php3frequester3dgs26collection3dtrd26recid3dn9210582ah,63273,63274,126547
65533,,s_poefuio8cj,63274,63275,126549
65534,,qj48tqj0mymj,63275,63276,126551
65535,,n1qxuky2qqwj,63276,63277,126553
65536,,url:http://www.csa.com/partners/viewrecord.php3frequester3dgs26collection3dtrd26recid3d200111010687mt26recid3da0032604ah,63277,63278,126555
65537,,fycqiklrlvqj,63278,63279,126557
65538,,7w93lx2stgoj,63279,63280,126559
65539,,cqlyvgbodlyj,63280,63281,126561
65540,,yzbmwmo0ufej,63281,63282,126563
65541,,zacy9uoyylej,63282,63283,126565
65542,,,63283,63284,126567
65543,,,63284,63285,126569
65544,,gzl3ewtlmt8j,63285,63286,126571
65545,,onucmwmn7imj,63286,63287,126573
65546,,url:http://doi.wiley.com/10.1002/he.150,63287,63288,126575
65547,,srlbaxim4z4j,63288,63289,126577
65548,,jzpgz2zujl0j,63289,63290,126579
65549,,r_zaweuhmt0j,63290,63291,126581
65550,,jktdhtg1udwj,63291,63292,126583
65551,,j-kuia1v8zsj,63292,63293,126585
65552,,2kx4a965twsj,63293,63294,126587
65553,,zcr_sgaevpgj,63294,63295,126589
65554,,y5j_m_urgdsj,63295,63296,126591
65555,,xgbszimtdogj,63296,63297,126593
65556,,42kl9yaw5cuj,63297,63298,126595
65557,,xf8s5n7ouimj,63298,63299,126597
65558,,avg5fueqg44j,63299,63300,126599
65559,,kblynbey41qj,63300,63301,126601
65560,,bbp-kfghbj4j,63301,63302,126603
65561,,gphz-m3l0ayj,63304,63305,126609
65562,,gxdoxlyal1oj,63305,63306,126611
65563,,tcj1e9wkwumj,63306,63307,126613
65564,,estzemfnix8j,63307,63308,126615
65565,,gegdprddg_wj,63308,63309,126617
65566,,nxtd37i7huyj,63309,63310,126619
65567,,vetjchfmjh8j,63310,63311,126621
65568,,f396vrxipiaj,63311,63312,126623
65569,,h9gqfspudvqj,63312,63313,126625
65570,,url:http://portal.acm.org/citation.cfm3fid3d645683.664449,63313,63314,126627
65571,,67xccex4sv4j,63314,63315,126629
65572,,wxyfvdza4m8j,63315,63316,126631
65573,,peph0vtzh5yj,63316,63317,126633
65574,,hwq30edzpauj,63317,63318,126635
65575,,url:http://portal.acm.org/ft_gateway.cfm3fid3d14099126type3dpdf26coll3dguide26dl3dacm26cfid3d1111111126cftoken3d2222222,63318,63319,126637
65576,,djbmzfn3z_oj,63319,63320,126639
65577,,i_ysccxol_gj,63320,63321,126641
65578,,pdtnhhjxs8kj,63321,63322,126643
65579,,pj58qvxat8ij,63322,63323,126645
65580,,gpzhrlpsc2sj,63323,63324,126647
65581,,iguid6perv0j,63324,63325,126649
65582,,kra9vv9mo_wj,63325,63326,126651
65583,,yszt4opitfmj,63326,63327,126653
65584,,nkewdtpjhyaj,63327,63328,126655
65585,,owk7_sgqmcwj,63328,63329,126657
65586,,,63329,63330,126659
65587,,bwfztxi1ccwj,63330,63331,126661
65588,,dlryfh8slacj,63331,63332,126663
65589,,ae_ok95tmyoj,63332,63333,126665
65590,,url:http://portal.acm.org/ft_gateway.cfm3fid3d26277126type3dpdf26dl3dguide26dl3dacm26cfid3d1111111126cftoken3d2222222,63334,63335,126669
65591,,fxmtrnmgs6gj,63335,63336,126671
65592,,dtmya-keds0j,63336,63337,126673
65593,,ureudzkqckcj,63337,63338,126675
65594,,zuhbq4awyagj,63338,63339,126677
65595,,o-zy8byw078j,63339,63340,126679
65596,,pkg14ogjxcqj,63340,63341,126681
65597,,3atdza2ffuij,63341,63342,126683
65598,,i0vgrku3iqcj,63342,63343,126685
65599,,m-lpejzho50j,63343,63344,126687
65600,,dizgepimieij,63344,63345,126689
65601,,wnenuwfqsv0j,63345,63346,126691
65602,,c3zbdrrj9wgj,63346,63347,126693
65603,,pzjznsq18d4j,63347,63348,126695
65604,,7gaalyf9ei0j,63348,63349,126697
65605,,oz9aajhyqj4j,63349,63350,126699
65606,,dxijggo6ewkj,63350,63351,126701
65607,,vevtzkoesfij,63352,63353,126705
65608,,m5xxw2d5fkoj,63354,63355,126709
65609,,cwju9viwztij,63355,63356,126711
65610,,8n31x2ueyvwj,63356,63357,126713
65611,,nk3mm2n23jij,63357,63358,126715
65612,,mih88uhhhhaj,63358,63359,126717
65613,,sj4y9ou1eaqj,63359,63360,126719
65614,,caivcfceb6oj,63360,63361,126721
65615,,epmtf8ydsyej,63361,63362,126723
65616,,5whbclckjymj,63362,63363,126725
65617,,,63363,63364,126727
65618,,55bwilyuayoj,63364,63365,126729
65619,,,63365,63366,126731
65620,,chydqde8cpsj,63366,63367,126733
65621,,jxz6dhdmibaj,63367,63368,126735
65622,,bxokbnhljksj,63368,63369,126737
65623,,pfeot_9szvoj,63369,63370,126739
65624,,dxgsvhyx06qj,63370,63371,126741
65625,,abfze1waldaj,63371,63372,126743
65626,,roxzlplxdukj,63372,63373,126745
65627,,qw6ll63me-yj,63373,63374,126747
65628,,k2y3cvt5gtaj,63375,63376,126751
65629,,url:http://doi.wiley.com/10.1002/he.10508,63376,63377,126753
65630,,w_ohicmbntsj,63377,63378,126755
65631,,o4fjqsd7r4uj,63379,63380,126759
65632,,wu7a5o-uy94j,63380,63381,126761
65633,,ya5vhgp0hnyj,63381,63382,126763
65634,,eoc3xx1grdcj,63382,63383,126765
65635,,stidqfsanukj,63384,63385,126769
65636,,noqzm82ir88j,63385,63386,126771
65637,,byb33gzdg18j,63387,63388,126775
65638,,ptqknmkm77ej,63388,63389,126777
65639,,usj0pbtukeyj,63389,63390,126779
65640,,gmetf-ualq4j,63390,63391,126781
65641,,rg1k76xpckij,63391,63392,126783
65642,,no6py2afx1qj,63392,63393,126785
65643,,lu1cypenxgkj,63393,63394,126787
65644,,mlm3f2idcg4j,63394,63395,126789
65645,,6i8hyehbelej,63395,63396,126791
65646,,zcsyvbukxtsj,63396,63397,126793
65647,,ox2lcw9yhz4j,63397,63398,126795
65648,,crwmuyoc79aj,63398,63399,126797
65649,,sf7ddyxggd8j,63399,63400,126799
65650,,xb63ragqymyj,63400,63401,126801
65651,,ptvsb01amgij,63401,63402,126803
65652,,q0nvv9ace4oj,63402,63403,126805
65653,,b5p52dmdvooj,63403,63404,126807
65654,,dtp0egnmjxij,63404,63405,126809
65655,,url:http://adsabs.harvard.edu/abs/1985mit..reptt....l,63405,63406,126811
65656,,ya-24ewgvtuj,63406,63407,126813
65657,,ttllom6ljwaj,63408,63409,126817
65658,,dw9o2iutmloj,63409,63410,126819
65659,,k5a3hro5zrsj,63410,63411,126821
65660,,b7szcrqyxk0j,63411,63412,126823
65661,,c3hxjggqphkj,63412,63413,126825
65662,,llsx3ahgpx0j,63413,63414,126827
65663,,j3xzubzcxjej,63414,63415,126829
65664,,mt4rra8twk4j,63415,63416,126831
65665,,0u9e7ubzytij,63416,63417,126833
65666,,wvrkpganem4j,63417,63418,126835
65667,,,63418,63419,126837
65668,,,63419,63420,126839
65669,,ba7ynch-38kj,63420,63421,126841
65670,,c3arf1tpqmyj,63421,63422,126843
65671,,xqkkcdfxfecj,63422,63423,126845
65672,,himueg-gensj,63423,63424,126847
65673,,akpyhxzsymsj,63424,63425,126849
65674,,sz91msjmaymj,63425,63426,126851
65675,,rzyjtl_1pdej,63426,63427,126853
65676,,pcan6ac67qaj,63428,63429,126857
65677,,g-xp436agvaj,63429,63430,126859
65678,,tkyv-to7f7gj,63430,63431,126861
65679,,mfovd4rqltgj,63431,63432,126863
65680,,2c8ee28n5rqj,63432,63433,126865
65681,,ngujp6jiwygj,63433,63434,126867
65682,,z9jsev9vi9sj,63434,63435,126869
65683,,ikllszirgxyj,63435,63436,126871
65684,,jjhfbnn9yowj,63436,63437,126873
65685,,vsgknz-kktsj,63437,63438,126875
65686,,i30nvf8gaymj,63438,63439,126877
65687,,26gyrcvb7tgj,63439,63440,126879
65688,,1trdi9xxttwj,63440,63441,126881
65689,,vpyxtyuvefqj,63441,63442,126883
65690,,tru1au3sfu8j,63442,63443,126885
65691,,bj5k--hv6-ej,63443,63444,126887
65692,,rmhbkszpenoj,63444,63445,126889
65693,,hza3gwnarqkj,63445,63446,126891
65694,,url:http://www.csa.com/partners/viewrecord.php3frequester3dgs26collection3dtrd26recid3d20021213011364mt26recid3da7423796ah,63446,63447,126893
65695,,omhk81_x_mqj,63447,63448,126895
65696,,tkrslioq87sj,63448,63449,126897
65697,,jwvb0c2einmj,63449,63450,126899
65698,,b3pxkfxtqa8j,63450,63451,126901
65699,,8shaccf7tg4j,63451,63452,126903
65700,,gxfvk7iyulqj,63452,63453,126905
65701,,zyulkrecngyj,63453,63454,126907
65702,,_dcxcac7ilij,63454,63455,126909
65703,,3sofq_1edbcj,63455,63456,126911
65704,,h6d9k2fzcemj,63456,63457,126913
65705,,m6rbxuxlwtmj,63457,63458,126915
65706,,mjzwfz6k720j,63458,63459,126917
65707,,7w2ulokb8rij,63459,63460,126919
65708,,ag-egyu2xyoj,63460,63461,126921
65709,,00rwclosmhgj,63461,63462,126923
65710,,57-mjmavid8j,63462,63463,126925
65711,,zn0eyv2ymzgj,63463,63464,126927
65712,,7sgacmnnyeyj,63464,63465,126929
65713,,url:http://www.ingentaconnect.com/content/els/13891286/2000/00000034/00000001/art00107,63465,63466,126931
65714,,9kmds1skn2uj,63466,63467,126933
65715,,glulxjefxgoj,63467,63468,126935
65716,,dtmirj_2hwyj,63468,63469,126937
65717,,url:http://www.csa.com/partners/viewrecord.php3frequester3dgs26collection3dtrd26recid3dn8621902ah,63469,63470,126939
65718,,wqblu-694uqj,63470,63471,126941
65719,,stzdycxpizkj,63471,63472,126943
65720,,kuynnvjtkemj,63473,63474,126947
65721,,can5puggskij,63474,63475,126949
65722,,ypjotpqa0pij,63475,63476,126951
65723,,aj-vh1ca-dej,63476,63477,126953
65724,,iciiudcd__8j,63477,63478,126955
65725,,kdcjhzwupjqj,63478,63479,126957
65726,,shko2fzilboj,63479,63480,126959
65727,,pys-ikvp1wmj,63480,63481,126961
65728,,rnoxycnderkj,63481,63482,126963
65729,,ouffvhhlj0aj,63482,63483,126965
65730,,tnu7l9gwudkj,63484,63485,126969
65731,,3j-yk1w9xxwj,63485,63486,126971
65732,,sr_eyl_rcwmj,63486,63487,126973
65733,,phtkhup_qqsj,63487,63488,126975
65734,,bcvyk3acowoj,63488,63489,126977
65735,,_x5vnwkll-uj,63490,63491,126981
65736,,d2txju_ptkyj,63491,63492,126983
65737,,guae4ve5ud4j,63492,63493,126985
65738,,9bo1knqmphej,63493,63494,126987
65739,,7gwkicpzccgj,63494,63495,126989
65740,,skn_a4r2-w0j,63495,63496,126991
65741,,c3m6aq_roqcj,63496,63497,126993
65742,,p434tviag6cj,63497,63498,126995
65743,,jtinmoklfmcj,63498,63499,126997
65744,,x12tdyjvadkj,63499,63500,126999
65745,,7dxa334td3wj,63500,63501,127001
65746,,wj0jfugmacoj,63501,63502,127003
65747,,pwi1qpho1v8j,63502,63503,127005
65748,,z3ht1wexcb0j,63503,63504,127007
65749,,kmwtcp_qyvij,63504,63505,127009
65750,,qz3gcy4cs2ij,63505,63506,127011
65751,,url:http://portal.acm.org/ft_gateway.cfm3fid3d110117226type3dpdf,63506,63507,127013
65752,,pvcvyxskrx0j,63507,63508,127015
65753,,uzxrpjdikuqj,63508,63509,127017
65754,,url:http://www.csa.com/partners/viewrecord.php3frequester3dgs26collection3dtrd26recid3dn9210495ah,63509,63510,127019
65755,,rze5ozhlslmj,63510,63511,127021
65756,,vfa2x4yztmgj,63511,63512,127023
65757,,btu5ihqr34gj,63512,63513,127025
65758,,txihhwih2scj,63513,63514,127027
65759,,orjd6unofuej,63514,63515,127029
65760,,url:http://doi.wiley.com/10.1002/anie.199000861,63516,63517,127033
65761,,url:http://ieeexplore.ieee.org/iel2/3038/8631/00379953.pdf3farnumber3d379953,63517,63518,127035
65762,,papjbhxzh60j,63518,63519,127037
65763,,xnwb0umskxmj,63519,63520,127039
65764,,_kzivrdweyyj,63520,63521,127041
65765,,cvp2k_1xa8mj,63521,63522,127043
65766,,mpbmouresecj,63522,63523,127045
65767,,nw-0uc44cpkj,63523,63524,127047
65768,,rgvtpovlkmoj,63524,63525,127049
65769,,dxa2oa2b4agj,63525,63526,127051
65770,,s8rccyegocyj,63526,63527,127053
65771,,zdse8fhb6vgj,63527,63528,127055
65772,,pwxra8tpcfmj,63528,63529,127057
65773,,wlgl5iipu7sj,63529,63530,127059
65774,,joy-dxxliyej,63530,63531,127061
65775,,2skfcfagq90j,63531,63532,127063
65776,,ny26jcmo6rsj,63532,63533,127065
65777,,tdcgyv34byqj,63533,63534,127067
65778,,rpljzcfsav8j,63534,63535,127069
65779,,q7_ipum6qsoj,63535,63536,127071
65780,,mi3zfem5ixaj,63536,63537,127073
65781,,ljb9givfn10j,63537,63538,127075
65782,,url:http://adsabs.harvard.edu/abs/1983stin...8315600d,63538,63539,127077
65783,,qymcw0627smj,63539,63540,127079
65784,,6fssilebi1sj,63540,63541,127081
65785,,rz_7ta_nh-4j,63541,63542,127083
65786,,ywnprdtujygj,63542,63543,127085
65787,,itfdlt39ml8j,63543,63544,127087
65788,,qo2-y2lwxdoj,63544,63545,127089
65789,,cnin2j-8jzkj,63545,63546,127091
65790,,k-qgq85inu0j,63546,63547,127093
65791,,2kdoho7p3eyj,63547,63548,127095
65792,,7blizwa7lj0j,63548,63549,127097
65793,,hnobhwbsrkcj,63549,63550,127099
65794,,atscxuxlipwj,63550,63551,127101
65795,,i74-7no225ij,63551,63552,127103
65796,,aq_te_cweqkj,63552,63553,127105
65797,,zavxzy8yymmj,63553,63554,127107
65798,,c_jhktvg37yj,63554,63555,127109
65799,,ybqbcbq3drgj,63555,63556,127111
65800,,ellgaeprcp4j,63556,63557,127113
65801,,6khwekhcdksj,63557,63558,127115
65802,,jgupo8c_vzkj,63558,63559,127117
65803,,la9cdngkyauj,63559,63560,127119
65804,,qvkma1ucdhgj,63560,63561,127121
65805,,xdgpus06d3ej,63561,63562,127123
65806,,6_0priasvsaj,63562,63563,127125
65807,,url:http://www.csa.com/partners/viewrecord.php3frequester3dgs26collection3dtrd26recid3d2337826ci,63563,63564,127127
65808,,hmk1datg8a0j,63564,63565,127129
65809,,u6toy_m3ceqj,63565,63566,127131
65810,,rkaj0xdce6cj,63566,63567,127133
65811,,puvrjuk-c38j,63567,63568,127135
65812,,omx24q2nytwj,63568,63569,127137
65813,,zwkfjawr-csj,63569,63570,127139
65814,,ttu3prhtlsyj,63570,63571,127141
65815,,rl50qpw8uaej,63571,63572,127143
65816,,on_w86oe4ruj,63572,63573,127145
65817,,untpur78tycj,63573,63574,127147
65818,,m9ykyxjngbgj,63574,63575,127149
65819,,9mzzqzmxoayj,63576,63577,127153
65820,,url:http://portal.acm.org/ft_gateway.cfm3fid3d109966126type3dpdf,63577,63578,127155
65821,,wrd2xdq3_hoj,63578,63579,127157
65822,,uiy1forqkvuj,63580,63581,127161
65823,,83pkxmbcmgoj,63581,63582,127163
65824,,9xh94ckf-cyj,63582,63583,127165
65825,,fdrhbm86nr8j,63583,63584,127167
65826,,lftujavnufej,63584,63585,127169
65827,,dmmtrhsnjacj,63585,63586,127171
65828,,vkgdypnkug0j,63586,63587,127173
65829,,iwh6jry_wlij,63587,63588,127175
65830,,8_-uo3dlvtyj,63588,63589,127177
65831,,sfgbg-11f58j,63589,63590,127179
65832,,xut5z6dzr2qj,63590,63591,127181
65833,,uyocmygznqcj,63591,63592,127183
65834,,uasratyuui4j,63592,63593,127185
65835,,kxmq2ulcwjmj,63593,63594,127187
65836,,sosnlk_7kl8j,63594,63595,127189
65837,,url:http://www.csa.com/partners/viewrecord.php3frequester3dgs26collection3dtrd26recid3d017301510002xai,63595,63596,127191
65838,,pspmly6z6pij,63596,63597,127193
65839,,2wkadwdkodij,63597,63598,127195
65840,,tkfvt9cinfqj,63598,63599,127197
65841,,ruuyvz1d1n4j,63599,63600,127199
65842,,url:http://doi.wiley.com/10.1002/ace.121,63600,63601,127201
65843,,q6gmskmsbwwj,63601,63602,127203
65844,,mw12xehrnu4j,63602,63603,127205
65845,,a42ni9ldibuj,63603,63604,127207
65846,,u9gbnfddie4j,63604,63605,127209
65847,,vfpqqg5-f_8j,63605,63606,127211
65848,,mwox19eh9esj,63606,63607,127213
65849,,etbazlzo5oqj,63607,63608,127215
65850,,v4pvzpabobuj,63608,63609,127217
65851,,uszs7mdxzv8j,63609,63610,127219
65852,,,63610,63611,127221
65853,,dcsafve8ufoj,63611,63612,127223
65854,,,63612,63613,127225
65855,,gny_3ohxupoj,63613,63614,127227
65856,,ggoekhrksjoj,63614,63615,127229
65857,,_jtkutgxc5ij,63615,63616,127231
65858,,ipkcmqwrjdwj,63616,63617,127233
65859,,qv90ws6ew6sj,63617,63618,127235
65860,,xbxtfhccyrkj,63618,63619,127237
65861,,z9kjdfjk1xkj,63619,63620,127239
65862,,jhj-nmsttl0j,63620,63621,127241
65863,,sbn6rfil-kuj,63621,63622,127243
65864,,m36v6drkngcj,63622,63623,127245
65865,,afurhtgjacyj,63623,63624,127247
65866,,7jrwqewkaowj,63624,63625,127249
65867,,nrk0i34ghicj,63625,63626,127251
65868,,82dzvq_ttwij,63626,63627,127253
65869,,lpg1vkcqhdaj,63627,63628,127255
65870,,url:http://ieeexplore.ieee.org/iel3/3990/11481/00547879.pdf3farnumber3d547879,63629,63630,127259
65871,,es0uggly-m0j,63630,63631,127261
65872,,7mhkesxuw9ej,63631,63632,127263
65873,,jbwwpkwgj5aj,63632,63633,127265
65874,,xxnju6rfto0j,63634,63635,127269
65875,,wuen24ft5koj,63635,63636,127271
65876,,xqcwfgpxwhej,63636,63637,127273
65877,,8z8wnqv-epij,63637,63638,127275
65878,,bb7u7psz-luj,63638,63639,127277
65879,,gw9dumy3hrij,63639,63640,127279
65880,,url:http://www.kluweronline.com/article.asp3fpips3d32107626pdf3d1,63640,63641,127281
65881,,ahwmmmtcmosj,63641,63642,127283
65882,,y1_z1_0dkiej,63642,63643,127285
65883,,url:http://portal.acm.org/citation.cfm3fid3d800025.80839226coll3dportal26dl3dacm26type3dseries26idx3dseries00326part3dseries26wanttype3dproceedings26title3dhistory2520of2520programming2520languages26cfid3d1111111126cftoken3d2222222,63643,63644,127287
65884,,vcpkfxmjiu0j,63644,63645,127289
65885,,exidff5qn98j,63645,63646,127291
65886,,b0ni6ggkvbuj,63646,63647,127293
65887,,h0ainvxk6eej,63647,63648,127295
65888,,rxkdq0d5jmcj,63648,63649,127297
65889,,vyw5hr0pz-ej,63649,63650,127299
65890,,64snybptk80j,63650,63651,127301
65891,,gu_xhgydarij,63651,63652,127303
65892,,ikmqwouyl-0j,63652,63653,127305
65893,,alvyh9wzawij,63653,63654,127307
65894,,wpell8r8js0j,63654,63655,127309
65895,,x0-8qtqf2xej,63655,63656,127311
65896,,r7xsund0bp0j,63656,63657,127313
65897,,ldmwhnh_n6sj,63657,63658,127315
65898,,ox8pgbszf7uj,63658,63659,127317
65899,,odejwcbtdlcj,63659,63660,127319
65900,,gnjydyzwprqj,63660,63661,127321
65901,,sfxqpbtxgkkj,63661,63662,127323
65902,,w7zbyekbllyj,63662,63663,127325
65903,,phzo0yspprwj,63663,63664,127327
65904,,rmxkfp-7dwaj,63664,63665,127329
65905,,cm5oam0zygij,63665,63666,127331
65906,,lqnbwvu1p8yj,63666,63667,127333
65907,,,63668,63669,127337
65908,,nlq3sbpmnygj,63669,63670,127339
65909,,e9xi224o0f0j,63670,63671,127341
65910,,hwphykbtefkj,63671,63672,127343
65911,,r6hbvospifcj,63672,63673,127345
65912,,cgzrimz8euwj,63673,63674,127347
65913,,2cxgqq-jdj0j,63674,63675,127349
65914,,vnildnv9jmsj,63675,63676,127351
65915,,dded8i8bn-qj,63676,63677,127353
65916,,_eezccb1bpyj,63677,63678,127355
65917,,yowdhslf7osj,63678,63679,127357
65918,,4nyxya7ujagj,63679,63680,127359
65919,,nsasp-dcjbqj,63680,63681,127361
65920,,4-ppunieva4j,63681,63682,127363
65921,,ywl9iufnhfoj,63682,63683,127365
65922,,rawp-of6gboj,63683,63684,127367
65923,,s6jjfjs_1nmj,63684,63685,127369
65924,,8rmhonwarxwj,63685,63686,127371
65925,,z01lcxal5ayj,63686,63687,127373
65926,,w-nmkvi-ogaj,63687,63688,127375
65927,,i5qpvt6p3u0j,63688,63689,127377
65928,,mlbxbzrygnaj,63690,63691,127381
65929,,wkchmdr2hl4j,63691,63692,127383
65930,,nrji1spa-1uj,63692,63693,127385
65931,,258mt12fulqj,63693,63694,127387
65932,,iedcnfe18d4j,63694,63695,127389
65933,,vlws4cb0eryj,63695,63696,127391
65934,,1opkrjmqr9aj,63696,63697,127393
65935,,wmqkutrwoiyj,63697,63698,127395
65936,,whfwfpp9xbwj,63698,63699,127397
65937,,nijxhpzay4ej,63699,63700,127399
65938,,fqt53lx9i4aj,63700,63701,127401
65939,,16fqwudabhej,63701,63702,127403
65940,,nyhffftclvsj,63702,63703,127405
65941,,w0moxouhgnuj,63703,63704,127407
65942,,knxveditfqsj,63704,63705,127409
65943,,taucjppx-d8j,63705,63706,127411
65944,,v3ymw17kw9sj,63706,63707,127413
65945,,kvcnrvhq3zoj,63707,63708,127415
65946,,ibkkv9ztrf0j,63708,63709,127417
65947,,sg0_awvjwi8j,63709,63710,127419
65948,,pexgaq1atkwj,63710,63711,127421
65949,,dpdqhqds8ooj,63711,63712,127423
65950,,fnwcg5zzpmyj,63712,63713,127425
65951,,orbm5zpauuuj,63713,63714,127427
65952,,yjsshub2bqyj,63714,63715,127429
65953,,o9sxbfijzaij,63715,63716,127431
65954,,dovy1r3qny4j,63716,63717,127433
65955,,doxlyhk0gnyj,63717,63718,127435
65956,,uxh027aenhij,63718,63719,127437
65957,,tjyp_pubawoj,63719,63720,127439
65958,,im7csxv6agwj,63720,63721,127441
65959,,ooxy3wpcr8uj,63721,63722,127443
65960,,pcpp6wktbhyj,63722,63723,127445
65961,,rmsa0lnk_eej,63723,63724,127447
65962,,dgamivaimg4j,63724,63725,127449
65963,,hcacojslbpmj,63725,63726,127451
65964,,_-w5tfgt6m4j,63726,63727,127453
65965,,ewlyjt9b0qej,63727,63728,127455
65966,,98rtzz7bw6uj,63728,63729,127457
65967,,5fuqpbpk_iyj,63729,63730,127459
65968,,d1m9re78tyij,63730,63731,127461
65969,,zavu8d_touuj,63731,63732,127463
65970,,qce58ty1fqkj,63732,63733,127465
65971,,j4qyxbotr5cj,63733,63734,127467
65972,,o7ni_lf5ym8j,63734,63735,127469
65973,,japvwg1azrqj,63735,63736,127471
65974,,3xwlbvhubvaj,63736,63737,127473
65975,,ee118kbh33kj,63737,63738,127475
65976,,0-9md6v1hwwj,63738,63739,127477
65977,,ty2arisx_7wj,63739,63740,127479
65978,,7jvbkozjrj4j,63740,63741,127481
65979,,xzcqgics66sj,63741,63742,127483
65980,,h2zhqp8cja8j,63742,63743,127485
65981,,nzxhbckx3hkj,63743,63744,127487
65982,,lvbecb4uc0aj,63744,63745,127489
65983,,q4uw_90gpbwj,63745,63746,127491
65984,,68qhq7crmegj,63746,63747,127493
65985,,url:http://www.ingentaconnect.com/search/expand3fpub3dinfobike://els/09505849/1998/00000040/00000005/art0005326unc3d,63747,63748,127495
65986,,7szq9vxhlsej,63748,63749,127497
65987,,2sogczeu-s4j,63750,63751,127501
65988,,ahdf-kb3bc4j,63751,63752,127503
65989,,dsyfkuowdkaj,63752,63753,127505
65990,,qnakmni8m6wj,63753,63754,127507
65991,,8vilgphraymj,63754,63755,127509
65992,,g_7fu6h398oj,63755,63756,127511
65993,,-ppdw-8pcxgj,63756,63757,127513
65994,,hq0vloddjx4j,63757,63758,127515
65995,,j6cy17-ld0ij,63758,63759,127517
65996,,rycmcaivassj,63759,63760,127519
65997,,gc_vbwnu5c4j,63760,63761,127521
65998,,kbkytylfmcgj,63761,63762,127523
65999,,mtr7ozfi0nij,63762,63763,127525
66000,,g3m1p-y_8ewj,63763,63764,127527
66001,,wp0aqpzzfdsj,63764,63765,127529
66002,,rzsxyptajqmj,63765,63766,127531
66003,,kyu8g5p4trmj,63766,63767,127533
66004,,rgxbvjuzgjwj,63767,63768,127535
66005,,x75cif4qr4cj,63768,63769,127537
66006,,p2fkvfcmpigj,63769,63770,127539
66007,,eyf_t9l8kjgj,63770,63771,127541
66008,,c4zy6frg9caj,63771,63772,127543
66009,,ofy2hnx22cmj,63772,63773,127545
66010,,mqeppwxga7aj,63773,63774,127547
66011,,xiwk98hltpsj,63775,63776,127551
66012,,3iflpekgllaj,63776,63777,127553
66013,,yt5daijmahwj,63777,63778,127555
66014,,u4leqmhwen0j,63778,63779,127557
66015,,td73f6wcvjyj,63779,63780,127559
66016,,6d6t9abw3qcj,63780,63781,127561
66017,,ezi0klnh9dsj,63781,63782,127563
66018,,supc457j-a0j,63782,63783,127565
66019,,kq_m1qi1m6ij,63783,63784,127567
66020,,ywv9l1amakej,63784,63785,127569
66021,,y07cx8eo7h4j,63785,63786,127571
66022,,goyihh09wj4j,63786,63787,127573
66023,,0oa8f0smcnaj,63787,63788,127575
66024,,p-ku8gkjxgsj,63788,63789,127577
66025,,or9s94onwrmj,63789,63790,127579
66026,,vwhi97b6pwyj,63790,63791,127581
66027,,w_xfuxnvlfoj,63791,63792,127583
66028,,9pzp7hdfl1kj,63792,63793,127585
66029,,jfog1nteuvmj,63793,63794,127587
66030,,ub7snwjepboj,63794,63795,127589
66031,,url:http://www.ingentaconnect.com/search/expand3fpub3dinfobike://els/09505849/1998/00000040/00000009/art0007226unc3d,63795,63796,127591
66032,,vzbhqicvr6aj,63796,63797,127593
66033,,od3eycz_dmaj,63797,63798,127595
66034,,0_bgyzt0ix4j,63798,63799,127597
66035,,o0h_0fve9m4j,63799,63800,127599
66036,,xex8jhkzoaqj,63800,63801,127601
66037,,0tkyk_cwlbwj,63802,63803,127605
66038,,zlsl_ybgx4gj,63803,63804,127607
66039,,q5zgl-f1qs0j,63804,63805,127609
66040,,0yhkoidlrjkj,63805,63806,127611
66041,,yjsuymicunij,63806,63807,127613
66042,,sulxso_wqjwj,63807,63808,127615
66043,,c2js-g1eezyj,63808,63809,127617
66044,,zxikkm7c6xcj,63809,63810,127619
66045,,ksrixqc7z5ej,63810,63811,127621
66046,,wusl4xeihesj,63811,63812,127623
66047,,sg4akuirivgj,63812,63813,127625
66048,,jwbtbu4f5coj,63813,63814,127627
66049,,r11_fhcawd0j,63814,63815,127629
66050,,87wmntunv6gj,63815,63816,127631
66051,,7tc9qcltknej,63816,63817,127633
66052,,is9dptq8fmcj,63817,63818,127635
66053,,projg8pbjyij,63818,63819,127637
66054,,7wbnrnvvswsj,63819,63820,127639
66055,,xlqdjxmbauuj,63820,63821,127641
66056,,cqeuxgod6t0j,63821,63822,127643
66057,,fszanl7t7iqj,63822,63823,127645
66058,,xyapp2tzroyj,63823,63824,127647
66059,,6hyu9e3zduoj,63824,63825,127649
66060,,qk_ipjqqnmmj,63825,63826,127651
66061,,y-svw-d6t9wj,63826,63827,127653
66062,,makpywrsnmmj,63827,63828,127655
66063,,grqcywyfmwij,63828,63829,127657
66064,,luptevb32umj,63829,63830,127659
66065,,fwj6anuqr4oj,63830,63831,127661
66066,,ijw49xdx2d0j,63831,63832,127663
66067,,uzi5yichzgoj,63832,63833,127665
66068,,rkrwp__epd8j,63833,63834,127667
66069,,xvxao7wwkw0j,63834,63835,127669
66070,,hwvbtbfsvpwj,63835,63836,127671
66071,,ybdeajzbbxyj,63836,63837,127673
66072,,f2szpe00xjuj,63838,63839,127677
66073,,e-b3deksy0sj,63839,63840,127679
66074,,ker2lbhfah4j,63840,63841,127681
66075,,nsffkjyz19cj,63841,63842,127683
66076,,6grfo6sbgksj,63844,63845,127689
66077,,pnbgta_updej,63845,63846,127691
66078,,juehwpievraj,63846,63847,127693
66079,,2xp5blv2wn4j,63847,63848,127695
66080,,krxytfvmyryj,63848,63849,127697
66081,,qnmrkru1s1mj,63849,63850,127699
66082,,mcerzmyfj1qj,63850,63851,127701
66083,,oashgjxcwb0j,63851,63852,127703
66084,,6n4wx5ugmj0j,63852,63853,127705
66085,,n8w6xekhc2kj,63853,63854,127707
66086,,nvs2ziex3muj,63854,63855,127709
66087,,eaoxzoauznej,63855,63856,127711
66088,,o9e2d-8xqfwj,63856,63857,127713
66089,,vdofwzcaruwj,63857,63858,127715
66090,,vmecp940faej,63858,63859,127717
66091,,cbopb0hx3pwj,63859,63860,127719
66092,,7gfc0l-2feej,63860,63861,127721
66093,,2u0cxnszat4j,63861,63862,127723
66094,,8dsnly8sbzgj,63862,63863,127725
66095,,yy57xt0-fz4j,63863,63864,127727
66096,,url:http://portal.acm.org/citation.cfm3fid3d161085,63864,63865,127729
66097,,url:http://www.csa.com/partners/viewrecord.php3frequester3dgs26collection3dtrd26recid3d1030053ci26recid3d1030053ea,63865,63866,127731
66098,,zgolb1gcilkj,63866,63867,127733
66099,,vpem3r3xpuaj,63867,63868,127735
66100,,ecfe4jkyt_mj,63868,63869,127737
66101,,xp13pnfrg_8j,63869,63870,127739
66102,,url:http://portal.acm.org/ft_gateway.cfm3fid3d95906726type3dpdf26dl3dguide26dl3dacm26cfid3d1111111126cftoken3d2222222,63870,63871,127741
66103,,jtmgx8sa3skj,63871,63872,127743
66104,,foyb_kd8j8sj,63872,63873,127745
66105,,zepbsvio0uqj,63873,63874,127747
66106,,hgemtgtk8ywj,63874,63875,127749
66107,,zeikjqz2km4j,63875,63876,127751
66108,,jq5z7ppksowj,63876,63877,127753
66109,,3png65aacnqj,63877,63878,127755
66110,,hzaa9z3mmvij,63878,63879,127757
66111,,z3btfwgpz0cj,63879,63880,127759
66112,,mpqoxd39gxuj,63880,63881,127761
66113,,33ccle2qyo0j,63881,63882,127763
66114,,d_dnceyzxdsj,63882,63883,127765
66115,,url:http://www.springerlink.com/index/1827577747g44258.pdf,63883,63884,127767
66116,,xyccfa0fpcmj,63884,63885,127769
66117,,mlrzlbc2rmuj,63885,63886,127771
66118,,ffvqf_pszjyj,63886,63887,127773
66119,,z1snqwhaljsj,63887,63888,127775
66120,,ld8gp9gcw28j,63888,63889,127777
66121,,rkb6ysfkx6cj,63889,63890,127779
66122,,url:http://doi.ieeecomputersociety.org/10.1109/tkde.2004.80,63890,63891,127781
66123,,hz9hwxc8vfmj,63891,63892,127783
66124,,khmefnw3f1cj,63892,63893,127785
66125,,,63893,63894,127787
66126,,75dmonrnyscj,63894,63895,127789
66127,,di1rct5fpzqj,63895,63896,127791
66128,,bnrpcpu4qimj,63896,63897,127793
66129,,cxwakcga6ysj,63897,63898,127795
66130,,rfrzhbxb-5ej,63898,63899,127797
66131,,egf3o1jh_kgj,63899,63900,127799
66132,,h1ckqpmhdnqj,63900,63901,127801
66133,,kznk5sfa6uwj,63901,63902,127803
66134,,jrkxooeu3joj,63902,63903,127805
66135,,9ccpmdcua5qj,63903,63904,127807
66136,,jmi7ktdkdz4j,63904,63905,127809
66137,,fsrlkucnpzoj,63905,63906,127811
66138,,t0dmtq8pjawj,63906,63907,127813
66139,,lywqpdxwdjyj,63907,63908,127815
66140,,hrlvsql3nicj,63909,63910,127819
66141,,gij7tju5hxyj,63910,63911,127821
66142,,ktpmiqavxgwj,63911,63912,127823
66143,,lrfehuqkhpij,63913,63914,127827
66144,,krwu4yscw3gj,63914,63915,127829
66145,,nt2zooltem8j,63915,63916,127831
66146,,xh4faygnlgqj,63916,63917,127833
66147,,g5aiphoplioj,63917,63918,127835
66148,,bsrnrgpzjkcj,63918,63919,127837
66149,,1lskgp9n104j,63919,63920,127839
66150,,1jmadqc8z-kj,63920,63921,127841
66151,,eftslnswa2ej,63921,63922,127843
66152,,aj7psghq7qwj,63922,63923,127845
66153,,0qagkzulq6ej,63923,63924,127847
66154,,dxraqmv6rn8j,63924,63925,127849
66155,,sm3tdzkhjt8j,63925,63926,127851
66156,,b1x0iuj6lgqj,63926,63927,127853
66157,,45sgqwc3vpoj,63927,63928,127855
66158,,ozhns02yysej,63928,63929,127857
66159,,wxpvgu-yn9aj,63929,63930,127859
66160,,pjb2itlrzhqj,63930,63931,127861
66161,,wc1vifera54j,63931,63932,127863
66162,,3vrwgl8t1dsj,63932,63933,127865
66163,,xxitu1atrgsj,63933,63934,127867
66164,,ubzgmknqafkj,63934,63935,127869
66165,,hgwi0njblaij,63935,63936,127871
66166,,d3cz4pgnnsaj,63936,63937,127873
66167,,url:http://portal.acm.org/ft_gateway.cfm3fid3d109956726type3dpdf,63937,63938,127875
66168,,onxcbq6mfpaj,63938,63939,127877
66169,,tfvqvv5662ej,63939,63940,127879
66170,,csh0yhdfziqj,63940,63941,127881
66171,,0zntia901s8j,63941,63942,127883
66172,,d-c2qxl0jhaj,63942,63943,127885
66173,,kla8evw3tzej,63943,63944,127887
66174,,vv7ykenn5mwj,63944,63945,127889
66175,,ykyic9kdcvkj,63946,63947,127893
66176,,url:http://www.ncbi.nlm.nih.gov/entrez/query.fcgi3fcmd3dretrieve26db3dpubmed26list_uids3d1635916726dopt3dcitation,63947,63948,127895
66177,,a_8pcydhowuj,63948,63949,127897
66178,,mxazuqunzvej,63950,63951,127901
66179,,tgbsknoikysj,63951,63952,127903
66180,,mrmcvhxyi5ej,63952,63953,127905
66181,,avntzl_kpc8j,63953,63954,127907
66182,,2bub5qqcw3qj,63954,63955,127909
66183,,wcs3k1qiivej,63955,63956,127911
66184,,url:http://www.springerlink.com/index/t16786356674078p.pdf,63956,63957,127913
66185,,yojvobuv4mkj,63957,63958,127915
66186,,bnjkqxoh_84j,63958,63959,127917
66187,,7cbwap93k5uj,63959,63960,127919
66188,,qig8th9dhbqj,63960,63961,127921
66189,,url:http://portal.acm.org/ft_gateway.cfm3fid3d109969126type3dpdf,63961,63962,127923
66190,,z-ni6gvqwgej,63962,63963,127925
66191,,8njxavd4o68j,63963,63964,127927
66192,,kgxelapx90mj,63964,63965,127929
66193,,rqzm0s9vagqj,63965,63966,127931
66194,,q1kzlsrg8xij,63966,63967,127933
66195,,ea9hw3ljwdej,63967,63968,127935
66196,,b6wbjsfqbwyj,63968,63969,127937
66197,,rwmzzmtpsawj,63969,63970,127939
66198,,5vsjltraa64j,63970,63971,127941
66199,,l6nypitv5c0j,63971,63972,127943
66200,,url:http://adsabs.harvard.edu/abs/1974phdt........26p,63972,63973,127945
66201,,2jpv7cby-loj,63973,63974,127947
66202,,3p-dhb5_hbkj,63974,63975,127949
66203,,2k2oiigakigj,63975,63976,127951
66204,,jxec-a3arpmj,63976,63977,127953
66205,,3yjsxkmfavmj,63977,63978,127955
66206,,3ghfjmaniqmj,63978,63979,127957
66207,,6busu7mxwhej,63979,63980,127959
66208,,t0ezexguunaj,63980,63981,127961
66209,,v9vklnlwpaaj,63981,63982,127963
66210,,pa-16fgmehaj,63982,63983,127965
66211,,v3mcwjn2bp0j,63983,63984,127967
66212,,ztasqm7tdzcj,63984,63985,127969
66213,,url:http://www.springerlink.com/index/p9363202v7u71214.pdf,63985,63986,127971
66214,,mtci5icvutoj,63986,63987,127973
66215,,wzknjjn90yaj,63987,63988,127975
66216,,pmeros33ickj,63988,63989,127977
66217,,jote_0ekqw8j,63989,63990,127979
66218,,hmsuopv_7nij,63990,63991,127981
66219,,url:http://www.csa.com/partners/viewrecord.php3frequester3dgs26collection3dtrd26recid3d20021214039900mt26recid3da7423806ah,63991,63992,127983
66220,,2rui2vzduw8j,63992,63993,127985
66221,,ry_cclbld0sj,63993,63994,127987
66222,,b2ljoobj_-cj,63994,63995,127989
66223,,dl2-xldaxeoj,63995,63996,127991
66224,,orojggvhxnaj,63997,63998,127995
66225,,url:http://portal.acm.org/citation.cfm3fid3d32043426dl3dguide26dl3dacm26type3dissue26idx3dj77726part3dperiodical26wanttype3dperiodical26title3dacm2520transactions2520on2520database2520systems2520(tods)26cfid3d1111111126cftoken3d2222222,63998,63999,127997
66226,,url:http://portal.acm.org/citation.cfm3fid3d154766.15540026dl3dportal26dl3dacm26type3dseries26idx3dseries00326part3dproceedings26wanttype3dproceedings26title3dhistory2520of2520programming2520languages26cfid3d1111111126cftoken3d2222222,63999,64000,127999
66227,,url:http://portal.acm.org/citation.cfm3fid3d154766.15539926dl3dportal26dl3dacm26type3dseries26idx3dseries00326part3dproceedings26wanttype3dproceedings26title3dhistory2520of2520programming2520languages26cfid3d1111111126cftoken3d2222222,64000,64001,128001
66228,,url:http://portal.acm.org/citation.cfm3fid3d800025.80838426dl3dguide26dl3dacm26type3dseries26idx3dseries00326part3dproceedings26wanttype3dproceedings26title3dhistory2520of2520programming2520languages26cfid3d1111111126cftoken3d2222222,64001,64002,128003
66229,,url:http://portal.acm.org/citation.cfm3fid3d800025.80837526dl3dguide26dl3dacm26type3dseries26idx3dseries00326part3dproceedings26wanttype3dproceedings26title3dhistory2520of2520programming2520languages26cfid3d1111111126cftoken3d2222222,64002,64003,128005
66230,,url:http://portal.acm.org/citation.cfm3fid3d154766.15559726dl3dportal26dl3dacm26type3dseries26idx3dseries00326part3dproceedings26wanttype3dproceedings26title3dhistory2520of2520programming2520languages26cfid3d1111111126cftoken3d2222222,64003,64004,128007
66231,,url:http://portal.acm.org/citation.cfm3fid3d154766.15538126dl3dportal26dl3dacm26type3dseries26idx3dseries00326part3dproceedings26wanttype3dproceedings26title3dhistory2520of2520programming2520languages26cfid3d1111111126cftoken3d2222222,64004,64005,128009
66232,,url:http://portal.acm.org/citation.cfm3fid3d154766.15538026dl3dportal26dl3dacm26type3dseries26idx3dseries00326part3dproceedings26wanttype3dproceedings26title3dhistory2520of2520programming2520languages26cfid3d1111111126cftoken3d2222222,64005,64006,128011
66233,,url:http://portal.acm.org/citation.cfm3fid3d22378426dl3dguide26dl3dacm26type3dproceeding26idx3d22378426part3dproceedings26wanttype3dproceedings26title3dinternational2520conference2520on2520management2520of2520data26cfid3d1111111126cftoken3d2222222,64007,64008,128015
66234,,url:http://portal.acm.org/citation.cfm3fid3d212433.22020926dl3dguide26dl3dacm26type3dseries26idx3d21243326part3dproceedings26wanttype3dproceedings26title3dsymposium2520on2520principles2520of2520database2520systems26cfid3d1111111126cftoken3d2222222,64008,64009,128017
66235,,url:http://portal.acm.org/citation.cfm3fid3d335168.33522826dl3dguide26dl3dacm26type3dseries26idx3d33516826part3dproceedings26wanttype3dproceedings26title3dsymposium2520on2520principles2520of2520database2520systems26cfid3d1111111126cftoken3d2222222,64009,64010,128019
66236,,url:http://portal.acm.org/citation.cfm3fid3d335168.33522126dl3dguide26dl3dacm26type3dseries26idx3d33516826part3dproceedings26wanttype3dproceedings26title3dsymposium2520on2520principles2520of2520database2520systems26cfid3d1111111126cftoken3d2222222,64010,64011,128021
66237,,url:http://portal.acm.org/citation.cfm3fid3d23326926dl3dguide26dl3dguide26type3dproceeding26idx3d23326926part3dproceedings26wanttype3dproceedings26title3dinternational2520conference2520on2520management2520of2520data2520and2520symposium2520on2520principles2520of2520database2520systems26cfid3d1111111126cftoken3d2222222,64011,64012,128023
66238,,url:http://portal.acm.org/citation.cfm3fid3d263661.26366526dl3dportal26dl3dacm26type3dseries26idx3d26366126part3dproceedings26wanttype3dproceedings26title3dsymposium2520on2520principles2520of2520database2520systems26cfid3d1111111126cftoken3d2222222,64013,64014,128027
66239,,url:http://portal.acm.org/citation.cfm3fid3d182591.18264026dl3dacm26dl3dacm26type3dseries26idx3d18259126part3dproceedings26wanttype3dproceedings26title3dsymposium2520on2520principles2520of2520database2520systems26cfid3d1111111126cftoken3d2222222,64014,64015,128029
66240,,url:http://portal.acm.org/citation.cfm3fid3d223784.22386526dl3dportal26dl3dacm26type3dseries26idx3d22378426part3dproceedings26wanttype3dproceedings26title3dinternational2520conference2520on2520management2520of2520data2520and2520symposium2520on2520principles2520of2520database2520systems26cfid3d1111111126cftoken3d2222222,64015,64016,128031
66241,,nrxhqmx4dk8j,64016,64017,128033
66242,,qgdd5ajiicij,64017,64018,128035
66243,,ol2ls2-g2xuj,64018,64019,128037
66244,,w5zeu02nngwj,64019,64020,128039
66245,,d0osfhj-75ej,64020,64021,128041
66246,,,64021,64022,128043
66247,,luf_8sa2noyj,64022,64023,128045
66248,,livb0pqymwij,64023,64024,128047
66249,,lox1ydnlwcaj,64024,64025,128049
66250,,espbeoxydp8j,64025,64026,128051
66251,,hwidxt12ksoj,64026,64027,128053
66252,,_ctasvt6tdyj,64027,64028,128055
66253,,jqdsmepodacj,64028,64029,128057
66254,,nxmyprbvd3sj,64029,64030,128059
66255,,ctx-e4xx1qij,64030,64031,128061
66256,,4qtshs7mj7mj,64031,64032,128063
66257,,vb1_zq4hrmej,64032,64033,128065
66258,,twmssljlk5cj,64033,64034,128067
66259,,qc2uuwczugaj,64034,64035,128069
66260,,3ro0j7ofqfkj,64035,64036,128071
66261,,cmljwfwok2cj,64036,64037,128073
66262,,ggz3lq3fcxuj,64037,64038,128075
66263,,cxgeszjdbf4j,64038,64039,128077
66264,,url:http://portal.acm.org/citation.cfm3fid3d335168.33522026dl3dguide26dl3dacm26type3dseries26idx3d33516826part3dproceedings26wanttype3dproceedings26title3dsymposium2520on2520principles2520of2520database2520systems26cfid3d1111111126cftoken3d2222222,64039,64040,128079
66265,,aoxfmny-wouj,64040,64041,128081
66266,,aprua7nf1cej,64041,64042,128083
66267,,rgndip-ygcaj,64042,64043,128085
66268,,qx0iyz4v8m4j,64043,64044,128087
66269,,0bi3qmfjd7aj,64044,64045,128089
66270,,u0ub_xkuycaj,64045,64046,128091
66271,,4fprrun33jej,64046,64047,128093
66272,,br-cu4lthgej,64047,64048,128095
66273,,vkjalxhfco8j,64048,64049,128097
66274,,url:http://www.rsc.org/ej/cc/2003/b209724a.pdf,64049,64050,128099
66275,,x3mo3bbxpkuj,64050,64051,128101
66276,,xaan850ve-kj,64051,64052,128103
66277,,url:http://www.ingentaconnect.com/content/els/09505849/1998/00000040/00000004/art00046,64052,64053,128105
66278,,mrjsyllg5oyj,64053,64054,128107
66279,,y5sef6unfgqj,64054,64055,128109
66280,,gve5djevcy0j,64055,64056,128111
66281,,gztqod2qwnaj,64056,64057,128113
66282,,kcyexouwctkj,64057,64058,128115
66283,,4pi_k-d9q-8j,64060,64061,128121
66284,,6k-b8o5a14gj,64061,64062,128123
66285,,amrnojcp6wuj,64062,64063,128125
66286,,vtfrsznt1lwj,64063,64064,128127
66287,,url:http://www.ingentaconnect.com/search/expand3fpub3dinfobike://els/09505849/1998/00000040/00000003/art0004726unc3d,64064,64065,128129
66288,,oegtzqch8v4j,64065,64066,128131
66289,,url:http://doi.wiley.com/10.1002/ace.8106,64066,64067,128133
66290,,b4zoo1nrygqj,64067,64068,128135
66291,,_q4zfz6cxokj,64068,64069,128137
66292,,iyemi5s4d8oj,64069,64070,128139
66293,,hrjjwsoyij4j,64070,64071,128141
66294,,wualrdckveyj,64071,64072,128143
66295,,miyssspwhwwj,64072,64073,128145
66296,,4qxr5cdlrfyj,64073,64074,128147
66297,,x38abhyn3wyj,64074,64075,128149
66298,,url:http://www.springerlink.com/index/kh080m1804080137.pdf,64075,64076,128151
66299,,zqmjngcijeuj,64076,64077,128153
66300,,e_9a4pw_9i8j,64077,64078,128155
66301,,syd-96wc7fij,64078,64079,128157
66302,,ad949veyclgj,64079,64080,128159
66303,,a_pmi6_8xb0j,64080,64081,128161
66304,,,64081,64082,128163
66305,,9tzxeumoqrij,64082,64083,128165
66306,,aapanwbenbej,64083,64084,128167
66307,,f1lxg-udxhwj,64084,64085,128169
66308,,suhw89b05pqj,64085,64086,128171
66309,,uze4oxq9mduj,64086,64087,128173
66310,,-0rp1c1l33cj,64087,64088,128175
66311,,9dztk_obit4j,64088,64089,128177
66312,,pqk9uazeemyj,64089,64090,128179
66313,,uus17v3-zjij,64090,64091,128181
66314,,kimz9lm1xtsj,64091,64092,128183
66315,,mdifqqtmbdwj,64092,64093,128185
66316,,awzpam_xwowj,64093,64094,128187
66317,,vi_lohdsftaj,64094,64095,128189
66318,,cay6vkc1ruuj,64095,64096,128191
66319,,6tearyrsfmgj,64096,64097,128193
66320,,url:http://www.csa.com/partners/viewrecord.php3frequester3dgs26collection3dtrd26recid3d20021214040858mt26recid3da7340040ah,64097,64098,128195
66321,,qtnx7kbyo0uj,64098,64099,128197
66322,,boiciratjgij,64099,64100,128199
66323,,20muj1tgckaj,64100,64101,128201
66324,,url:http://doi.wiley.com/10.1002/anie.199005101,64101,64102,128203
66325,,-7fmdbapl9kj,64102,64103,128205
66326,,r-uu1e1zhvsj,64103,64104,128207
66327,,_jj4eiyy9vcj,64104,64105,128209
66328,,squc_ipge3mj,64105,64106,128211
66329,,e1rxcyxwnh4j,64107,64108,128215
66330,,ujevr1tv5pyj,64108,64109,128217
66331,,mqzd0902csaj,64109,64110,128219
66332,,fyp3nbfw31yj,64110,64111,128221
66333,,9dsjjimxvfmj,64111,64112,128223
66334,,itht1-9bhfoj,64112,64113,128225
66335,,xp_qpoddjj4j,64113,64114,128227
66336,,0rqygzfzcfej,64114,64115,128229
66337,,9z4ijrpzen0j,64115,64116,128231
66338,,dzhtchqdgzij,64116,64117,128233
66339,,zsoc_ikq1j8j,64117,64118,128235
66340,,url:http://portal.acm.org/citation.cfm3fid3d212433.21245326dl3dportal26dl3dacm26type3dseries26idx3d21243326part3dproceedings26wanttype3dproceedings26title3dsymposium2520on2520principles2520of2520database2520systems26cfid3d1111111126cftoken3d2222222,64118,64119,128237
66341,,qqvouxiy5dmj,64119,64120,128239
66342,,p8g03i80e4ij,64120,64121,128241
66343,,h0civty1fn8j,64121,64122,128243
66344,,bqcu2mlvcpqj,64122,64123,128245
66345,,ksth2xoijqoj,64123,64124,128247
66346,,lbk1fujzxcgj,64124,64125,128249
66347,,v7cvvonzdaij,64125,64126,128251
66348,,isbc9sltyt8j,64126,64127,128253
66349,,avnemnrxj6sj,64127,64128,128255
66350,,cqn2sh8s2waj,64128,64129,128257
66351,,uxj2fvagczij,64129,64130,128259
66352,,pgezurk2cwgj,64130,64131,128261
66353,,z4pfhbrwewmj,64131,64132,128263
66354,,g-xqwh3czxqj,64132,64133,128265
66355,,h8mtclupursj,64133,64134,128267
66356,,38xwshhxhhwj,64134,64135,128269
66357,,tk75nozzcwsj,64136,64137,128273
66358,,guuzae2p0kyj,64137,64138,128275
66359,,zdkastlyyumj,64138,64139,128277
66360,,c3v83kipshmj,64139,64140,128279
66361,,gctywehemvwj,64140,64141,128281
66362,,url:http://portal.acm.org/ft_gateway.cfm3fid3d109972526type3dpdf,64141,64142,128283
66363,,npmtx6yguvuj,64142,64143,128285
66364,,0rsmbby_lasj,64144,64145,128289
66365,,ixazhrrdwx4j,64145,64146,128291
66366,,zs4ijaxfjyuj,64146,64147,128293
66367,,97gstq4bf0ej,64147,64148,128295
66368,,37otg1ws0-aj,64148,64149,128297
66369,,ate4dcbfbrsj,64149,64150,128299
66370,,-9jpopmkm_aj,64150,64151,128301
66371,,gzsrm_e6ovwj,64151,64152,128303
66372,,4nfll3pypvyj,64152,64153,128305
66373,,h5s2zu1avomj,64153,64154,128307
66374,,0i6s5_pov4uj,64154,64155,128309
66375,,a_tckspmw8gj,64155,64156,128311
66376,,rdx1liid2t8j,64156,64157,128313
66377,,ytggdtjn_w4j,64157,64158,128315
66378,,barnmuvil1uj,64158,64159,128317
66379,,9frasminf7wj,64159,64160,128319
66380,,ceus3iij1tij,64161,64162,128323
66381,,k5o1akmaltuj,64162,64163,128325
66382,,k6ccl44dtv4j,64163,64164,128327
66383,,,64164,64165,128329
66384,,g0o9cocxmaij,64165,64166,128331
66385,,h3q037ghnzoj,64166,64167,128333
66386,,tgbqbw9iw0yj,64167,64168,128335
66387,,xzjsfjim0wuj,64168,64169,128337
66388,,sbfgu4dnhzgj,64169,64170,128339
66389,,otg0w88qj_0j,64170,64171,128341
66390,,asi-ztpzzysj,64171,64172,128343
66391,,phapoasalmaj,64172,64173,128345
66392,,dhsb4ysbgp8j,64173,64174,128347
66393,,url:http://portal.acm.org/citation.cfm3fdoid3d263690.264337,64174,64175,128349
66394,,mjwnpgr5mbej,64175,64176,128351
66395,,qen1wvalpguj,64176,64177,128353
66396,,duvnbxcfb4wj,64177,64178,128355
66397,,hkxzoocfwf8j,64178,64179,128357
66398,,1c3luiv-yn8j,64179,64180,128359
66399,,c88esykud5kj,64180,64181,128361
66400,,gduko4hqbtqj,64181,64182,128363
66401,,lxzwzttri2ij,64182,64183,128365
66402,,vn7mb1e7ydij,64183,64184,128367
66403,,womvf3ykvukj,64184,64185,128369
66404,,4rvnd7keqlyj,64185,64186,128371
66405,,jojujt2snosj,64186,64187,128373
66406,,f2ffujb-bqgj,64187,64188,128375
66407,,4vh_culp12aj,64188,64189,128377
66408,,qom8unztcssj,64189,64190,128379
66409,,fmpsjw90-uej,64190,64191,128381
66410,,fi-3tlfjwiuj,64191,64192,128383
66411,,idjxg4rnhi0j,64193,64194,128387
66412,,3cdeaczlasuj,64194,64195,128389
66413,,zpnhu-b8vsgj,64195,64196,128391
66414,,uezuxbtk_jgj,64196,64197,128393
66415,,yx7pqhietzaj,64197,64198,128395
66416,,srpwp7299ygj,64198,64199,128397
66417,,gjfdwzzcwgsj,64199,64200,128399
66418,,gzrixrd2dbij,64200,64201,128401
66419,,ulghrzsfu6wj,64201,64202,128403
66420,,axp9hohmifqj,64202,64203,128405
66421,,p3yzsaw7hgyj,64203,64204,128407
66422,,j6lljn-4w_oj,64204,64205,128409
66423,,b7bcmgsedwwj,64205,64206,128411
66424,,suir08o8jqkj,64206,64207,128413
66425,,avt2zks4kf4j,64208,64209,128417
66426,,8f9felh4mxkj,64209,64210,128419
66427,,f6dj8yfdikcj,64210,64211,128421
66428,,kzsfgwfzl_ij,64211,64212,128423
66429,,l9sw0bgj1zuj,64212,64213,128425
66430,,nftzbnx-xiej,64213,64214,128427
66431,,u_ggugsh5iej,64214,64215,128429
66432,,pql6gm9-wqcj,64215,64216,128431
66433,,f-3bgz7p9s4j,64216,64217,128433
66434,,3_8fvhr65aij,64217,64218,128435
66435,,u6xnjylqr4cj,64218,64219,128437
66436,,q2k8xnsxivcj,64219,64220,128439
66437,,v6qu1chcllsj,64220,64221,128441
66438,,kgu0nr8baygj,64221,64222,128443
66439,,gtitw3zj3guj,64222,64223,128445
66440,,i0epghzdwo4j,64223,64224,128447
66441,,dmjkrw8uwtyj,64224,64225,128449
66442,,wkd289ifvaij,64226,64227,128453
66443,,9ine8y1udrkj,64227,64228,128455
66444,,8ucz54opvvoj,64228,64229,128457
66445,,slaan9trw-kj,64229,64230,128459
66446,,r9uuxvi7iw4j,64230,64231,128461
66447,,xssa5a6mj1uj,64231,64232,128463
66448,,url:http://doi.wiley.com/10.1002/he.10711,64232,64233,128465
66449,,siomqofot4ej,64233,64234,128467
66450,,ogzimap1_fej,64234,64235,128469
66451,,jfnkgh68g6ej,64235,64236,128471
66452,,ps4idqdrhasj,64236,64237,128473
66453,,_ywsmaeukwgj,64237,64238,128475
66454,,8ssazs0rwmuj,64238,64239,128477
66455,,tdyt3io1qs8j,64239,64240,128479
66456,,a5gvkbyyw9ij,64240,64241,128481
66457,,buh_obwdhdgj,64241,64242,128483
66458,,y55fhjz7kmej,64242,64243,128485
66459,,7o_syihstkkj,64243,64244,128487
66460,,a5pbh3gxeqkj,64244,64245,128489
66461,,lsbvzddald0j,64245,64246,128491
66462,,6xsaaoxbu8kj,64246,64247,128493
66463,,1ngc2zlanpmj,64247,64248,128495
66464,,ol1mkfnre4kj,64248,64249,128497
66465,,url:http://portal.acm.org/citation.cfm3fid3d202106.56978426coll3dportal26dl3dacm26idx3dj77726part3dtransaction26wanttype3dtransaction26title3dacm2520transactions2520on2520database2520systems2520(tods)26cfid3d1111111126cftoken3d2222222,64249,64250,128499
66466,,fupoda7awe8j,64250,64251,128501
66467,,zghvusjkja4j,64251,64252,128503
66468,,url:http://portal.acm.org/citation.cfm3fid3d342009.33549426dl3dguide26dl3dguide26type3dseries26idx3d34200926part3dproceedings26wanttype3dproceedings26title3dinternational2520conference2520on2520management2520of2520data26cfid3d1111111126cftoken3d2222222,64252,64253,128505
66469,,kzr28byqc0sj,64253,64254,128507
66470,,fqrj1hrex4qj,64254,64255,128509
66471,,tx4sgkjquiej,64255,64256,128511
66472,,url:http://portal.acm.org/citation.cfm3fid3d7690226dl3dportal26dl3dacm26type3dissue26idx3dj77726part3dperiodical26wanttype3dperiodical26title3dacm2520transactions2520on2520database2520systems2520(tods)26cfid3d1111111126cftoken3d2222222,64256,64257,128513
66473,,7hi3kksxknwj,64257,64258,128515
66474,,url:http://portal.acm.org/citation.cfm3fid3d35777526dl3dguide26dl3dacm26type3dissue26idx3dj77726part3dperiodical26wanttype3dperiodical26title3dacm2520transactions2520on2520database2520systems2520(tods)26cfid3d1111111126cftoken3d2222222,64258,64259,128517
66475,,u2fyu71sln8j,64259,64260,128519
66476,conf/vldb/rusinkiewiczktwm95,,64260,1,64261
66477,journals/sigmod/ouksel02,,64268,9,64277
66478,journals/sigmod/konig-riesmmpprsvw02,,64270,11,64281
66479,journals/sigmod/rossfs02,,64274,15,64289
66480,journals/sigmod/geller02,,64276,17,64293
66481,journals/sigmod/caplinskasev02,,64278,19,64297
66482,journals/sigmod/kemper02,,64283,24,64307
66483,conf/vldb/didriksengd95,,64296,37,64333
66484,journals/sigmod/cruzklswy02,,64304,45,64349
66485,journals/sigmod/ozsu02,,64312,53,64365
66486,conf/vldb/korth95,,64313,54,64367
66487,conf/vldb/reutercgsw95,,64315,56,64371
66488,journals/sigmod/goethals02,,64319,60,64379
66489,journals/sigmod/berzalm02,,64320,61,64381
66490,conf/vldb/wuyct95,,64321,62,64383
66491,journals/sigmod/snodgrass02a,,64324,65,64389
66492,conf/vldb/jagadishlrss94,,64327,68,64395
66493,journals/sigmod/kuijpers02,,64328,69,64397
66494,conf/vldb/galindo-legariapk94,,64329,70,64399
66495,journals/sigmod/weikum02,,64330,71,64401
66496,journals/sigmod/soffermc02,,64341,82,64423
66497,journals/sigmod/levenep02,,64343,84,64427
66498,journals/sigmod/crestanig02,,64344,85,64429
66499,journals/sigmod/meltonmjks02,,64347,88,64435
66500,journals/sigmod/winslett02b,,64348,89,64437
66501,conf/vldb/johnsons94,,64349,90,64439
66502,journals/sigmod/frankns02,,64354,95,64449
66503,journals/sigmod/badia02,,64356,97,64453
66504,journals/sigmod/winslett02c,,64360,101,64461
66505,journals/sigmod/wu02,,64362,103,64465
66506,conf/vldb/kalusd95,,64363,104,64467
66507,conf/vldb/ramakrishnangrswz95,,64368,109,64477
66508,journals/sigmod/buttlerccfhlprx02,,64369,110,64479
66509,conf/vldb/seligmanbnsw95,,64375,116,64491
66510,journals/sigmod/rossaa02,,64381,122,64503
66511,conf/vldb/brownmcl94,,64393,134,64527
66512,journals/sigmod/constantopouloscp01,,64404,145,64549
66513,journals/sigmod/rosshkrrss01,,64407,148,64555
66514,journals/sigmod/bernstein01,,64411,152,64563
66515,journals/sigmod/bunemanfsw01,,64412,153,64565
66516,journals/sigmod/biancheripp01,,64418,159,64577
66517,journals/sigmod/gunopulosk01,,64424,165,64589
66518,journals/sigmod/lenzerininns01,,64426,167,64593
66519,journals/sigmod/labrinidis01,,64435,176,64611
66520,journals/sigmod/snodgrass01a,,64445,186,64631
66521,journals/sigmod/hammer01,,64446,187,64633
66522,conf/vldb/anandbh94,,64447,188,64635
66523,journals/sigmod/ozsu01,,64448,189,64637
66524,conf/vldb/bernstein94,,64452,193,64645
66525,journals/sigmod/ozsu01a,,64464,205,64669
66526,journals/sigmod/barbara01,,64466,207,64673
66527,conf/vldb/zemankovai94,,64467,208,64675
66528,journals/sigmod/velacm01,,64473,214,64687
66529,journals/sigmod/scholl01,,64474,215,64689
66530,journals/sigmod/jagadish01,,64477,218,64695
66531,journals/sigmod/winslett01a,,64478,219,64697
66532,journals/sigmod/lohmangfs01,,64480,221,64701
66533,journals/sigmod/rosshlw01,,64482,223,64705
66534,conf/vldb/medianocd94,,64493,234,64727
66535,journals/sigmod/cuijo02,,64495,236,64731
66536,journals/sigmod/winslett02,,64500,241,64741
66537,journals/sigmod/rosskmv02,,64510,251,64761
66538,conf/vldb/poulovassiliss94,,64511,252,64763
66539,journals/sigmod/elderini02,,64513,254,64767
66540,journals/sigmod/franklin99b,,64525,266,64791
66541,journals/sigmod/rossflossvw00,,64528,269,64797
66542,journals/sigmod/jagadish00,,64533,274,64807
66543,journals/sigmod/snodgrass00,,64537,278,64815
66544,conf/sigmod/2003,,64543,284,64827
66545,journals/sigmod/roddickabdeghlmmmw00,,64549,290,64839
66546,journals/sigmod/franklin00,,64554,295,64849
66547,journals/sigmod/rossakssy00,,64562,303,64865
66548,journals/sigmod/wuy00,,64565,306,64871
66549,journals/sigmod/kantm00,,64569,310,64879
66550,journals/sigmod/ludwigg00,,64571,312,64883
66551,journals/sigmod/cruz00,,64572,313,64885
66552,journals/sigmod/naughton00,,64575,316,64891
66553,journals/sigmod/mendelzon00,,64577,318,64895
66554,journals/sigmod/ley00,,64578,319,64897
66555,journals/sigmod/snodgrass00a,,64580,321,64901
66556,conf/sigmod/raghavan03,,64583,324,64907
66557,journals/sigmod/hammer00,,64584,325,64909
66558,conf/sigmod/seshadri03,,64585,326,64911
66559,journals/sigmod/ozsoyoglu00,,64586,327,64913
66560,conf/sigmod/shivakumar03,,64587,328,64915
66561,conf/sigmod/zeller03,,64588,329,64917
66562,journals/sigmod/franklin00a,,64589,330,64919
66563,conf/sigmod/colliat03,,64590,331,64921
66564,conf/sigmod/aggarwal03,,64599,340,64939
66565,journals/sigmod/rossijp00,,64602,343,64945
66566,conf/sigmod/krishnamurthy03,,64604,345,64949
66567,journals/sigmod/casatids00,,64605,346,64951
66568,journals/sigmod/snodgrass00c,,64606,347,64953
66569,conf/sigmod/pruscino03,,64607,348,64955
66570,conf/sigmod/cabrera03,,64610,351,64961
66571,journals/sigmod/hasselbringhhkrrs00,,64611,352,64963
66572,journals/sigmod/franklin00b,,64613,354,64967
66573,journals/sigmod/snodgrass00b,,64619,360,64979
66574,journals/sigmod/boscmp01,,64622,363,64985
66575,conf/sigmod/qunlo03,,64630,371,65001
66576,journals/sigmod/rosscgllm01,,64633,374,65007
66577,journals/sigmod/snodgrass01,,64636,377,65013
66578,journals/sigmod/aggarwal01,,64639,380,65019
66579,journals/sigmod/franklin98a,,64653,394,65047
66580,journals/sigmod/snodgrasshmoprrwy98,,64658,399,65057
66581,journals/sigmod/snodgrass98c,,64670,411,65081
66582,conf/sigmod/bohannondgklns03,,64676,417,65093
66583,journals/sigmod/snodgrassacfllorrsv99,,64678,419,65097
66584,journals/sigmod/franklin98b,,64685,426,65111
66585,journals/sigmod/eisenbergm99,,64690,431,65121
66586,journals/sigmod/mackay99,,64692,433,65125
66587,journals/sigmod/hanson99,,64696,437,65133
66588,conf/sigmod/agichteing03,,64699,440,65139
66589,conf/sigmod/liufp03,,64702,443,65145
66590,journals/sigmod/gal99,,64703,444,65147
66591,conf/sigmod/shashab02,,64708,449,65157
66592,conf/sigmod/2002,,64714,455,65169
66593,journals/sigmod/snodgrass99,,64720,461,65181
66594,journals/sigmod/kim99,,64722,463,65185
66595,journals/sigmod/snodgrass99a,,64729,470,65199
66596,journals/sigmod/ozsoyoglu99,,64730,471,65201
66597,journals/sigmod/franklin99,,64737,478,65215
66598,journals/sigmod/cfp99,,64741,482,65223
66599,journals/sigmod/franklin99a,,64743,484,65227
66600,conf/sigmod/aggarwal02,,64749,490,65239
66601,journals/sigmod/etzion99,,64756,497,65253
66602,journals/sigmod/libkin99a,,64763,504,65267
66603,conf/sigmod/dattadtvsr02,,64772,513,65285
66604,journals/sigmod/baaderjn97,,64777,518,65295
66605,journals/sigmod/nestorovam97,,64779,520,65299
66606,journals/sigmod/snodgrass97a,,64780,521,65301
66607,journals/sigmod/suciu97,,64787,528,65315
66608,journals/sigmod/franklin97a,,64793,534,65327
66609,journals/sigmod/conradehrsssv97,,64797,538,65335
66610,journals/sigmod/snodgrass97,,64804,545,65349
66611,journals/sigmod/silberschatzz97,,64818,559,65377
66612,journals/sigmod/konig-riesl97,,64830,571,65401
66613,journals/sigmod/rosenthalhrs97,,64835,576,65411
66614,journals/sigmod/atzenim98,,64837,578,65415
66615,journals/sigmod/snodgrass98b,,64839,580,65419
66616,journals/sigmod/borgidacs98,,64866,607,65473
66617,conf/sigmod/kiesslinghfe01,,64880,621,65501
66618,journals/sigmod/snodgrass98,,64881,622,65503
66619,journals/sigmod/mendelzon98,,64882,623,65505
66620,journals/sigmod/rosenthal98,,64888,629,65517
66621,conf/sigmod/schusterw01,,64890,631,65521
66622,conf/sigmod/fabretjlprs01,,64898,639,65537
66623,journals/sigmod/act-net96,,64901,642,65543
66624,journals/sigmod/bestavrosls96,,64908,649,65557
66625,journals/sigmod/dandreaj96,,64916,657,65573
66626,conf/sigmod/larson01,,64919,660,65579
66627,conf/sigmod/shouctrh01,,64925,666,65591
66628,conf/sigmod/claypoolrzsk01,,64937,678,65615
66629,journals/sigmod/haritsas96,,64939,680,65619
66630,conf/sigmod/mohan01,,64957,698,65655
66631,journals/sigmod/anonymous96,,64960,701,65661
66632,journals/sigmod/gunther97,,64971,712,65683
66633,journals/sigmod/riekertmw97,,64978,719,65697
66634,conf/sigmod/sahuguet01,,64979,720,65699
66635,journals/sigmod/date96,,64982,723,65705
66636,conf/sigmod/whitneys01,,65000,741,65741
66637,conf/sigmod/wuaa01,,65008,749,65757
66638,journals/sigmod/bhashyam96,,65014,755,65769
66639,conf/sigmod/changc01,,65023,764,65787
66640,conf/sigmod/rosenthal01,,65024,765,65789
66641,conf/sigmod/ohhp00,,65030,771,65801
66642,journals/sigmod/segev95,,65031,772,65803
66643,journals/sigmod/karlapalemls95,,65034,775,65809
66644,journals/sigmod/jaegerf95,,65041,782,65823
66645,journals/sigmod/klass94,,65061,802,65863
66646,journals/sigmod/wedekind94,,65062,803,65865
66647,conf/sigmod/2000,,65064,805,65869
66648,journals/sigmod/segev94b,,65072,813,65885
66649,journals/sigmod/alonso95,,65076,817,65893
66650,journals/sigmod/x95,,65081,822,65903
66651,journals/sigmod/qian95,,65083,824,65907
66652,journals/sigmod/venkatraop95,,65098,839,65937
66653,journals/sigmod/dunhamh95,,65115,856,65971
66654,conf/sigmod/nori00,,65125,866,65991
66655,conf/sigmod/hellerstein00,,65126,867,65993
66656,conf/sigmod/ramakrishnan00,,65129,870,65999
66657,journals/sigmod/abiteboulh95,,65130,871,66001
66658,journals/sigmod/leecl95,,65142,883,66025
66659,journals/sigmod/x95a,,65149,890,66039
66660,journals/sigmod/alonso95a,,65154,895,66049
66661,journals/sigmod/alonso94,,65156,897,66053
66662,conf/sigmod/rodriguez-martinez00,,65167,908,66075
66663,conf/sigmod/berckends00,,65175,916,66091
66664,conf/sigmod/sarawagi00,,65177,918,66095
66665,conf/sigmod/peimhz00,,65178,919,66097
66666,journals/sigmod/qian94a,,65225,966,66191
66667,journals/sigmod/x94b,,65226,967,66193
66668,journals/sigmod/group94,,65234,975,66209
66669,conf/sigmod/kohler99,,65243,984,66227
66670,journals/sigmod/alonso94b,,65244,985,66229
66671,journals/sigmod/rosneblatt94,,65247,988,66235
66672,conf/sigmod/ozsu99,,65249,990,66239
66673,journals/sigmod/geppertd94,,65255,996,66251
66674,journals/sigmod/kim94,,65261,1002,66263
66675,journals/sigmod/stonebraker94,,65262,1003,66265
66676,journals/sigmod/x94,,65272,1013,66285
66677,journals/sigmod/x94a,,65277,1018,66295
66678,journals/sigmod/alonso94a,,65280,1021,66301
66679,conf/vldb/shanmugasundaramksff01,,65310,1051,66361
66680,conf/sigmod/bonnetbccchkmmoss99,,65311,1052,66363
66681,conf/sigmod/roussopoulosks99,,65313,1054,66367
66682,conf/vldb/sundarahcas01,,65317,1058,66375
66683,conf/sigmod/marathes99,,65319,1060,66379
66684,conf/vldb/adler01,,65326,1067,66393
66685,conf/sigmod/seshadri99,,65329,1070,66399
66686,conf/vldb/stillgerlmk01,,65332,1073,66405
66687,conf/vldb/sondag01,,65334,1075,66409
66688,conf/sigmod/garofalakisrrs99,,65335,1076,66411
66689,conf/vldb/seegerbbksds01,,65337,1078,66415
66690,conf/vldb/sol01,,65345,1086,66431
66691,conf/vldb/oconnellwg01,,65377,1118,66495
66692,conf/vldb/tsuraadkw01,,65379,1120,66499
66693,conf/sigmod/bouguettayabh99,,65384,1125,66509
66694,conf/vldb/kahvecis01,,65405,1146,66551
66695,conf/vldb/basufp00,,65429,1170,66599
66696,conf/vldb/nori00,,65434,1175,66609
66697,conf/vldb/narayanans01,,65479,1220,66699
66698,conf/vldb/dattadtvrf01,,65482,1223,66705
66699,conf/sigmod/lacroixsc98,,65487,1228,66715
66700,conf/sigmod/kiepuszewskimo98,,65490,1231,66721
66701,conf/vldb/morishimakkt01,,65491,1232,66723
66702,conf/vldb/ambitekkmst01,,65494,1235,66729
66703,conf/vldb/koschbbhhlrt01,,65499,1240,66739
66704,conf/sigmod/roussopouloskr97,,65503,1244,66747
66705,conf/sigmod/eaton98,,65511,1252,66763
66706,conf/sigmod/kemperkm98,,65518,1259,66777
66707,conf/vldb/cuiw01,,65519,1260,66779
66708,conf/sigmod/mylopoulos98,,65521,1262,66783
66709,conf/vldb/ozdenghnsdggw01,,65526,1267,66793
66710,conf/sigmod/nglk98,,65534,1275,66809
66711,conf/sigmod/chan98,,65536,1277,66813
66712,conf/vldb/laneen00,,65540,1281,66821
66713,conf/sigmod/careyk97,,65544,1285,66829
66714,conf/vldb/kemperkw99,,65545,1286,66831
66715,conf/vldb/carey00,,65546,1287,66833
66716,conf/vldb/brodie00,,65559,1300,66859
66717,conf/vldb/team00,,65563,1304,66867
66718,conf/sigmod/tsueipk97,,65566,1307,66873
66719,conf/vldb/schek00,,65569,1310,66879
66720,conf/sigmod/chaudhuri97,,65637,1378,67015
66721,conf/vldb/wangz00,,65641,1382,67023
66722,conf/sigmod/lichh97,,65649,1390,67039
66723,conf/vldb/x00,,65662,1403,67065
66724,conf/sigmod/shasha97,,65663,1404,67067
66725,conf/vldb/ramaswamy00,,65666,1407,67073
66726,conf/sigmod/bilirisfop96,,65693,1434,67127
66727,conf/vldb/naumannlf99,,65696,1437,67133
66728,conf/vldb/josifovskir99,,65699,1440,67139
66729,conf/vldb/blum99,,65709,1450,67159
66730,conf/sigmod/bohma96,,65752,1493,67245
66731,conf/vldb/carinoobs99,,65756,1497,67253
66732,conf/sigmod/bernstein96,,65758,1499,67257
66733,conf/vldb/sarawagi99,,65785,1526,67311
66734,conf/sigmod/gettys95,,65827,1568,67395
66735,conf/vldb/rezendeh98,,65839,1580,67419
66736,conf/vldb/braumandlck98,,65840,1581,67421
66737,conf/sigmod/imielinskiv95,,65841,1582,67423
66738,conf/sigmod/gardarinmp95,,65850,1591,67441
66739,conf/vldb/hoskingc99,,65868,1609,67477
66740,conf/sigmod/dans95,,65878,1619,67497
66741,conf/vldb/helmerwm98,,65880,1621,67501
66742,conf/sigmod/team95c,,65881,1622,67503
66743,conf/sigmod/team95,,65882,1623,67505
66744,conf/sigmod/gray95,,65891,1632,67523
66745,conf/vldb/gibsonkr98,,65892,1633,67525
66746,conf/sigmod/edelstein95,,65898,1639,67537
66747,conf/sigmod/bampahl95,,65900,1641,67541
66748,conf/sigmod/french95,,65903,1644,67547
66749,conf/sigmod/atkinson95,,65906,1647,67553
66750,conf/sigmod/levine95,,65910,1651,67561
66751,conf/sigmod/deutsch95,,65913,1654,67567
66752,conf/sigmod/faloutsos95,,65915,1656,67571
66753,conf/sigmod/mattosm95,,65917,1658,67575
66754,conf/sigmod/gibson95,,65922,1663,67585
66755,conf/sigmod/thomasdm95,,65926,1667,67593
66756,conf/vldb/humborstadsht97,,65932,1673,67605
66757,conf/sigmod/cerifpp95,,65939,1680,67619
66758,conf/sigmod/keimk95,,65955,1696,67651
66759,conf/vldb/gibbonsmp97,,65957,1698,67655
66760,conf/sigmod/swamis94,,65987,1728,67715
66761,conf/sigmod/brinkhoffkss94a,,65989,1730,67719
66762,conf/vldb/gehrkerg98,,65995,1736,67731
66763,conf/sigmod/dietterich94,,65996,1737,67733
66764,conf/sigmod/ahn94,,66018,1759,67777
66765,conf/vldb/floresculs98,,66033,1774,67807
66766,conf/vldb/blottks98,,66035,1776,67811
66767,conf/sigmod/whited94,,66039,1780,67819
66768,conf/sigmod/ubell94,,66057,1798,67855
66769,conf/vldb/gupta96,,66097,1838,67935
66770,conf/vldb/malaika96,,66101,1842,67943
66771,journals/sigmod/winslett03c,,66122,1863,67985
66772,journals/sigmod/rossgr03,,66124,1865,67989
66773,conf/vldb/baralispt97,,66125,1866,67991
66774,journals/sigmod/wangd03,,66126,1867,67993
66775,journals/sigmod/galianom03,,66129,1870,67999
66776,journals/sigmod/wiegand03,,66130,1871,68001
66777,conf/vldb/ngc97,,66134,1875,68009
66778,conf/vldb/llirbatst97,,66139,1880,68019
66779,conf/vldb/lichh97,,66150,1891,68041
66780,journals/sigmod/nejdlss03,,66151,1892,68043
66781,journals/sigmod/hammer03,,66152,1893,68045
66782,journals/sigmod/ozsu03a,,66154,1895,68049
66783,conf/vldb/lockemannkkkn97,,66155,1896,68051
66784,journals/sigmod/chamberlin03,,66159,1900,68059
66785,journals/sigmod/giorgini03,,66165,1906,68071
66786,journals/sigmod/lenzvjs03,,66167,1908,68075
66787,journals/sigmod/kambhampatik03,,66169,1910,68079
66788,conf/vldb/garofalakisi97,,66177,1918,68095
66789,journals/sigmod/chrysanthissz03,,66184,1925,68109
66790,journals/sigmod/jonsson03,,66186,1927,68113
66791,journals/sigmod/anisimov03,,66190,1931,68121
66792,journals/sigmod/winslett03b,,66193,1934,68127
66793,journals/sigmod/cherniakv03,,66194,1935,68129
66794,conf/vldb/mininggroup96,,66199,1940,68139
66795,conf/vldb/bhashyam96,,66202,1943,68145
66796,conf/vldb/baru96,,66204,1945,68149
66797,journals/sigmod/aberercddhps03,,66211,1952,68163
66798,journals/sigmod/weikumsr03,,66212,1953,68165
66799,journals/sigmod/rossno03,,66215,1956,68171
66800,journals/sigmod/chongftsykdjj03,,66216,1957,68173
66801,journals/sigmod/winslett03a,,66218,1959,68177
66802,journals/sigmod/hoffner03,,66224,1965,68189
66803,journals/sigmod/ozsu03,,66236,1977,68213
66804,conf/vldb/belussif95,,66242,1983,68225
66805,journals/sigmod/oconnellw03,,66247,1988,68235
66806,journals/sigmod/winslett03,,66251,1992,68243
66807,conf/vldb/webersnss03,,66293,2034,68327
66808,conf/vldb/hardinglm03,,66295,2036,68331
66809,conf/vldb/witkowskibbfgss03,,66317,2058,68375
66810,conf/vldb/chendz03,,66333,2074,68407
66811,conf/vldb/koch03,,66338,2079,68417
66812,conf/vldb/ramanan03,,66347,2088,68435
66813,conf/vldb/tsoiss03,,66369,2110,68479
66814,conf/vldb/kraftsrm03,,66372,2113,68485
66815,conf/vldb/blottk02,,66380,2121,68501
66816,conf/vldb/lakshmanannwzj02,,66393,2134,68527
66817,conf/vldb/vingralek02,,66397,2138,68535
66818,conf/vldb/laudbcsr02,,66408,2149,68557
66819,conf/vldb/alexandrovabbbcdfhjkkkllmmmpnpprrssw02,,66409,2150,68559
66820,conf/vldb/ohuratpk02,,66416,2157,68573
66821,conf/vldb/lihkspac02,,66417,2158,68575
66822,conf/vldb/king02,,66418,2159,68577
66823,conf/vldb/liuj02,,66430,2171,68601
66824,conf/vldb/rantzauchm02,,66432,2173,68605
66825,conf/vldb/herlekardrgs02,,66433,2174,68607
66826,conf/vldb/chirkovahs01,,66439,2180,68619
66827,conf/vldb/nori02,,66452,2193,68645
66828,conf/vldb/garofalakisg02,,66453,2194,68647
66829,conf/vldb/chakrabarti02,,66456,2197,68653
66830,conf/vldb/faloutsos02,,66457,2198,68655
66831,conf/vldb/imielinskib02,,66458,2199,68657
66832,conf/vldb/weikummhz02,,66459,2200,68659
66833,conf/vldb/conradgjm02,,66462,2203,68665
66834,conf/vldb/candanalph02,,66502,2243,68745
66835,journals/tods/goldmanl94,,66511,2252,68763
66836,journals/tods/chomicki95,,66514,2255,68769
66837,journals/tods/keen97,,66538,2279,68817
66838,journals/vldb/chakrabartirs03,,66543,2284,68827
66839,journals/tods/kim94,,66556,2297,68853
66840,journals/tods/yang94,,66562,2303,68865
66841,journals/tods/rosenthalr94,,66565,2306,68871
66842,journals/tods/hsusy01,,66581,2322,68903
66843,journals/vldb/aslanm99,,66636,2377,69013
66844,journals/vldb/ozsuc98,,66645,2386,69031
66845,journals/vldb/huangdt99,,66649,2390,69039
66846,journals/vldb/atzenim00,,66659,2400,69059
66847,journals/vldb/georgeh00,,66660,2401,69061
66848,journals/vldb/widoms00,,66667,2408,69075
66849,journals/vldb/cobb97,,66670,2411,69081
66850,journals/vldb/muckp97,,66674,2415,69089
66851,journals/vldb/papazogluk97a,,66683,2424,69107
66852,journals/vldb/han98,,66694,2435,69129
66853,journals/vldb/bernsteinps00,,66736,2477,69213
66854,journals/vldb/claussenkkw00,,66742,2483,69225
66855,journals/vldb/turkerg01,,66751,2492,69243
66856,journals/vldb/casatisg01,,66760,2501,69261
66857,journals/vldb/ooihlt96,,66766,2507,69273
66858,journals/vldb/fanggm96,,66770,2511,69281
66859,journals/vldb/amielbds96,,66771,2512,69283
66860,journals/vldb/evangelidiss97,,66774,2515,69289
66861,journals/vldb/c95b,,66786,2527,69313
66862,journals/vldb/c95c,,66792,2533,69325
66863,journals/vldb/c94c,,66800,2541,69341
66864,journals/vldb/c95,,66810,2551,69361
66865,journals/vldb/c94,,66818,2559,69377
66866,journals/vldb/c94b,,66822,2563,69385
66867,journals/vldb/c94a,,66827,2568,69395
66868,journals/sigmod/salgadoe03,,66836,2577,69413
66869,conf/vldb/lakshmananss96,,66839,2580,69419
66870,journals/sigmod/winslettmy03,,66842,2583,69425
66871,journals/sigmod/ozsu02b,,66845,2586,69431
66872,conf/vldb/cochranepm96,,66847,2588,69435
66873,conf/vldb/rengarajan96,,66859,2600,69459
66874,conf/vldb/rysns96,,66862,2603,69465
66875,journals/sigmod/rossgn03,,66870,2611,69481
